,PlayerId,MatchId,card1,card2,card3,card4,card5,sumofcards,dealcard1,dealcard2,dealcard3,dealcard4,dealcard5,sumofdeal,blkjck,winloss,plybustbeat,dlbustbeat,plwinamt,dlwinamt,ply2cardsum,matches_played,win_percent,bljk_per,wstrat_per,cluster,normal_df
0,98,20001,10,11,0,0,0,21,10,10,0,0,0,20,win,win,plwin,beat,25,0,21,220,0.422727273,0.054545455,0.55,1,0.28664435
1,68,20001,10,8,0,0,0,18,10,10,0,0,0,20,nowin,loss,beat,dlwin,0,10,18,205,0.434146341,0.029268293,0.6,2,0.59483189
2,35,20001,7,6,0,10,0,23,10,10,0,0,0,20,nowin,loss,bust,plbust,0,10,13,202,0.410891089,0.044554455,0.633663366,2,0.598681573
3,32,20001,11,2,6,0,0,19,10,10,0,0,0,20,nowin,loss,beat,dlwin,0,10,13,189,0.391534392,0.037037037,0.53968254,0,0.013579086
4,45,20001,2,10,0,8,0,20,10,10,0,0,0,20,nowin,push,push,push,10,0,12,196,0.428571429,0.051020408,0.612244898,2,0.598821767
5,40,20001,10,9,0,0,0,19,10,10,0,0,0,20,nowin,loss,beat,dlwin,0,10,19,196,0.367346939,0.030612245,0.617346939,0,0.025358183
6,20,20002,4,6,11,0,0,21,9,4,10,0,0,23,nowin,win,dlbust,bust,20,0,10,186,0.456989247,0.037634409,0.537634409,1,0.301097108
7,117,20002,10,11,0,0,0,21,9,4,10,0,0,23,win,win,dlbust,bust,25,0,21,173,0.410404624,0.069364162,0.606936416,2,0.578610282
8,66,20002,10,10,0,0,0,20,9,4,10,0,0,23,nowin,win,dlbust,bust,20,0,20,217,0.456221198,0.064516129,0.626728111,3,0.924304367
9,101,20002,2,7,9,0,0,18,9,4,10,0,0,23,nowin,win,dlbust,bust,20,0,9,205,0.424390244,0.068292683,0.63902439,2,0.614740646
10,49,20002,5,10,0,3,0,18,9,4,10,0,0,23,nowin,win,dlbust,bust,20,0,15,207,0.396135266,0.053140097,0.594202899,0,0.028306925
11,102,20002,5,6,10,0,0,21,9,4,10,0,0,23,nowin,win,dlbust,bust,20,0,11,192,0.338541667,0.046875,0.5625,0,0.003306118
12,19,20003,10,10,0,0,0,20,5,10,10,0,0,25,nowin,win,dlbust,bust,20,0,20,237,0.41350211,0.054852321,0.628691983,2,0.597373826
13,144,20003,6,8,0,0,0,14,5,10,10,0,0,25,nowin,win,dlbust,bust,20,0,14,202,0.386138614,0.054455446,0.564356436,0,0.018006244
14,31,20003,9,8,0,0,0,17,5,10,10,0,0,25,nowin,win,dlbust,bust,20,0,17,188,0.473404255,0.058510638,0.515957447,1,0.300306557
15,17,20003,2,10,0,0,0,12,5,10,10,0,0,25,nowin,win,dlbust,bust,20,0,12,171,0.444444444,0.070175439,0.555555556,1,0.302364894
16,7,20003,2,7,10,0,0,19,5,10,10,0,0,25,nowin,win,dlbust,bust,20,0,9,183,0.442622951,0.06010929,0.62295082,2,0.619303341
17,44,20003,7,10,0,0,0,17,5,10,10,0,0,25,nowin,win,dlbust,bust,20,0,17,219,0.433789954,0.050228311,0.534246575,1,0.285551035
18,5,20004,10,3,0,10,0,23,10,6,8,0,0,24,nowin,loss,bust,plbust,0,10,13,203,0.42364532,0.02955665,0.596059113,2,0.582508076
19,58,20004,4,4,9,0,0,17,10,6,8,0,0,24,nowin,win,dlbust,bust,20,0,8,195,0.430769231,0.041025641,0.584615385,2,0.580497586
20,7,20004,3,4,7,2,3,19,10,6,8,0,0,24,nowin,win,dlbust,bust,20,0,7,183,0.442622951,0.06010929,0.62295082,2,0.619303341
21,148,20004,2,3,6,4,2,17,10,6,8,0,0,24,nowin,win,dlbust,bust,20,0,5,204,0.401960784,0.078431373,0.593137255,0,0.029789521
22,100,20004,6,2,11,0,0,19,10,6,8,0,0,24,nowin,win,dlbust,bust,20,0,8,190,0.452631579,0.036842105,0.594736842,3,0.888671154
23,143,20004,10,3,0,1,10,24,10,6,8,0,0,24,nowin,loss,bust,plbust,0,10,13,203,0.463054187,0.044334975,0.57635468,3,0.883143365
24,63,20005,6,10,0,3,0,19,1,3,10,3,0,17,nowin,win,plwin,beat,20,0,16,216,0.467592593,0.037037037,0.62037037,3,0.931690496
25,91,20005,10,5,0,10,0,25,1,3,10,3,0,17,nowin,loss,bust,plbust,0,10,15,194,0.417525773,0.046391753,0.515463918,1,0.266616552
26,26,20005,8,7,0,7,0,22,1,3,10,3,0,17,nowin,loss,bust,plbust,0,10,15,203,0.463054187,0.0591133,0.541871921,1,0.306802864
27,27,20005,2,11,6,0,0,19,1,3,10,3,0,17,nowin,win,plwin,beat,20,0,13,178,0.370786517,0.016853933,0.573033708,0,0.015536309
28,41,20005,10,4,0,10,0,24,1,3,10,3,0,17,nowin,loss,bust,plbust,0,10,14,192,0.364583333,0.036458333,0.520833333,0,0.00089702
29,90,20005,9,10,0,0,0,19,1,3,10,3,0,17,nowin,win,plwin,beat,20,0,19,201,0.447761194,0.049751244,0.60199005,3,0.889945023
30,90,20006,10,10,0,0,0,20,10,8,0,0,0,18,nowin,win,plwin,beat,20,0,20,201,0.447761194,0.049751244,0.60199005,3,0.889945023
31,67,20006,11,10,0,0,0,21,10,8,0,0,0,18,win,win,plwin,beat,25,0,21,195,0.369230769,0.041025641,0.569230769,0,0.014139427
32,53,20006,8,10,0,0,0,18,10,8,0,0,0,18,nowin,push,push,push,10,0,18,250,0.372,0.064,0.564,0,0.013687345
33,57,20006,6,9,0,7,0,22,10,8,0,0,0,18,nowin,loss,bust,plbust,0,10,15,192,0.46875,0.052083333,0.59375,3,0.907001181
34,15,20006,6,10,0,7,0,23,10,8,0,0,0,18,nowin,loss,bust,plbust,0,10,16,212,0.410377358,0.051886792,0.561320755,0,0.024517408
35,38,20006,6,10,0,3,0,19,10,8,0,0,0,18,nowin,win,plwin,beat,20,0,16,202,0.361386139,0.03960396,0.564356436,0,0.010597953
36,53,20007,10,7,0,0,0,17,4,9,6,0,0,19,nowin,loss,beat,dlwin,0,10,17,250,0.372,0.064,0.564,0,0.013687345
37,123,20007,2,5,6,0,0,13,4,9,6,0,0,19,nowin,loss,beat,dlwin,0,10,7,205,0.43902439,0.034146341,0.614634146,2,0.609962544
38,130,20007,10,11,0,0,0,21,4,9,6,0,0,19,win,win,plwin,beat,25,0,21,219,0.410958904,0.03652968,0.566210046,0,0.025888739
39,123,20007,1,1,10,0,0,12,4,9,6,0,0,19,nowin,loss,beat,dlwin,0,10,2,205,0.43902439,0.034146341,0.614634146,2,0.609962544
40,9,20007,7,10,0,0,0,17,4,9,6,0,0,19,nowin,loss,beat,dlwin,0,10,17,194,0.37628866,0.015463918,0.541237113,0,0.009396796
41,33,20007,5,10,0,0,0,15,4,9,6,0,0,19,nowin,loss,beat,dlwin,0,10,15,192,0.4375,0.057291667,0.625,2,0.616208916
42,88,20008,10,10,0,0,0,20,2,10,10,0,0,22,nowin,win,dlbust,bust,20,0,20,206,0.466019417,0.033980583,0.54368932,1,0.309467903
43,15,20008,7,3,9,0,0,19,2,10,10,0,0,22,nowin,win,dlbust,bust,20,0,10,212,0.410377358,0.051886792,0.561320755,0,0.024517408
44,17,20008,9,10,0,0,0,19,2,10,10,0,0,22,nowin,win,dlbust,bust,20,0,19,171,0.444444444,0.070175439,0.555555556,1,0.302364894
45,150,20008,10,7,0,0,0,17,2,10,10,0,0,22,nowin,win,dlbust,bust,20,0,17,192,0.401041667,0.036458333,0.567708333,0,0.023287458
46,57,20008,10,11,0,0,0,21,2,10,10,0,0,22,win,win,dlbust,bust,25,0,21,192,0.46875,0.052083333,0.59375,3,0.907001181
47,147,20008,9,10,0,0,0,19,2,10,10,0,0,22,nowin,win,dlbust,bust,20,0,19,205,0.380487805,0.014634146,0.536585366,0,0.00951447
48,45,20009,10,7,0,0,0,17,10,10,0,0,0,20,nowin,loss,beat,dlwin,0,10,17,196,0.428571429,0.051020408,0.612244898,2,0.598821767
49,70,20009,11,1,7,0,0,19,10,10,0,0,0,20,nowin,loss,beat,dlwin,0,10,12,228,0.385964912,0.039473684,0.557017544,0,0.016157125
50,97,20009,3,7,10,0,0,20,10,10,0,0,0,20,nowin,push,push,push,10,0,10,182,0.450549451,0.06043956,0.692307692,2,0.677372279
51,46,20009,8,10,0,0,0,18,10,10,0,0,0,20,nowin,loss,beat,dlwin,0,10,18,186,0.403225806,0.048387097,0.591397849,0,0.029742194
52,82,20009,10,8,0,0,0,18,10,10,0,0,0,20,nowin,loss,beat,dlwin,0,10,18,225,0.408888889,0.075555556,0.577777778,0,0.028101874
53,43,20009,10,10,0,0,0,20,10,10,0,0,0,20,nowin,push,push,push,10,0,20,192,0.40625,0.041666667,0.609375,2,0.576671372
54,120,20010,6,2,9,0,0,17,2,5,5,8,0,20,nowin,loss,beat,dlwin,0,10,8,202,0.440594059,0.034653465,0.618811881,2,0.614441029
55,128,20010,4,4,10,0,0,18,2,5,5,8,0,20,nowin,loss,beat,dlwin,0,10,8,227,0.356828194,0.052863436,0.577092511,0,0.012352564
56,26,20010,10,8,0,0,0,18,2,5,5,8,0,20,nowin,loss,beat,dlwin,0,10,18,203,0.463054187,0.0591133,0.541871921,1,0.306802864
57,140,20010,9,5,0,0,0,14,2,5,5,8,0,20,nowin,loss,beat,dlwin,0,10,14,210,0.466666667,0.023809524,0.604761905,3,0.915293335
58,9,20010,11,1,2,0,0,14,2,5,5,8,0,20,nowin,loss,beat,dlwin,0,10,12,194,0.37628866,0.015463918,0.541237113,0,0.009396796
59,105,20010,3,5,9,0,0,17,2,5,5,8,0,20,nowin,loss,beat,dlwin,0,10,8,198,0.414141414,0.070707071,0.590909091,0,0.032889494
60,61,20011,10,10,0,0,0,20,7,10,0,0,0,17,nowin,win,plwin,beat,20,0,20,194,0.427835052,0.077319588,0.603092784,2,0.591437139
61,53,20011,5,7,0,10,0,22,7,10,0,0,0,17,nowin,loss,bust,plbust,0,10,12,250,0.372,0.064,0.564,0,0.013687345
62,89,20011,8,10,0,0,0,18,7,10,0,0,0,17,nowin,win,plwin,beat,20,0,18,212,0.537735849,0.047169811,0.594339623,3,0.990167191
63,25,20011,3,10,0,2,9,24,7,10,0,0,0,17,nowin,loss,bust,plbust,0,10,13,190,0.463157895,0.063157895,0.536842105,1,0.304401563
64,148,20011,2,11,2,8,0,23,7,10,0,0,0,17,nowin,loss,bust,plbust,0,10,13,204,0.401960784,0.078431373,0.593137255,0,0.029789521
65,40,20011,3,8,2,10,0,23,7,10,0,0,0,17,nowin,loss,bust,plbust,0,10,11,196,0.367346939,0.030612245,0.617346939,0,0.025358183
66,40,20012,7,11,0,0,0,18,4,10,10,0,0,24,nowin,win,dlbust,bust,20,0,18,196,0.367346939,0.030612245,0.617346939,0,0.025358183
67,144,20012,3,7,8,0,0,18,4,10,10,0,0,24,nowin,win,dlbust,bust,20,0,10,202,0.386138614,0.054455446,0.564356436,0,0.018006244
68,122,20012,11,10,0,0,0,21,4,10,10,0,0,24,win,win,dlbust,bust,25,0,21,210,0.347619048,0.052380952,0.59047619,0,0.012873677
69,38,20012,5,10,0,0,0,15,4,10,10,0,0,24,nowin,win,dlbust,bust,20,0,15,202,0.361386139,0.03960396,0.564356436,0,0.010597953
70,96,20012,10,7,0,0,0,17,4,10,10,0,0,24,nowin,win,dlbust,bust,20,0,17,190,0.468421053,0.057894737,0.584210526,3,0.897263354
71,70,20012,2,4,11,0,0,17,4,10,10,0,0,24,nowin,win,dlbust,bust,20,0,6,228,0.385964912,0.039473684,0.557017544,0,0.016157125
72,2,20013,6,4,2,9,0,21,10,11,0,0,0,21,nowin,push,push,push,10,0,10,200,0.445,0.035,0.64,2,0.633962549
73,145,20013,2,7,10,0,0,19,10,11,0,0,0,21,nowin,loss,beat,dlwin,0,10,9,188,0.441489362,0.031914894,0.622340426,2,0.617837093
74,25,20013,10,10,0,0,0,20,10,11,0,0,0,21,nowin,loss,beat,dlwin,0,10,20,190,0.463157895,0.063157895,0.536842105,1,0.304401563
75,14,20013,4,4,4,10,0,22,10,11,0,0,0,21,nowin,loss,bust,plbust,0,10,8,202,0.391089109,0.01980198,0.628712871,2,0.577264877
76,80,20013,10,10,0,0,0,20,10,11,0,0,0,21,nowin,loss,beat,dlwin,0,10,20,186,0.419354839,0.059139785,0.623655914,2,0.59892924
77,58,20013,10,10,0,0,0,20,10,11,0,0,0,21,nowin,loss,beat,dlwin,0,10,20,195,0.430769231,0.041025641,0.584615385,2,0.580497586
78,31,20014,8,10,0,0,0,18,10,10,0,0,0,20,nowin,loss,beat,dlwin,0,10,18,188,0.473404255,0.058510638,0.515957447,1,0.300306557
79,50,20014,10,11,0,0,0,21,10,10,0,0,0,20,win,win,plwin,beat,25,0,21,202,0.405940594,0.04950495,0.54950495,0,0.020296079
80,47,20014,7,8,0,4,0,19,10,10,0,0,0,20,nowin,loss,beat,dlwin,0,10,15,210,0.438095238,0.057142857,0.623809524,2,0.615868808
81,135,20014,10,6,0,6,0,22,10,10,0,0,0,20,nowin,loss,bust,plbust,0,10,16,179,0.391061453,0.067039106,0.586592179,0,0.024924662
82,48,20014,7,7,0,9,0,23,10,10,0,0,0,20,nowin,loss,bust,plbust,0,10,14,203,0.413793103,0.019704433,0.600985222,2,0.577280801
83,131,20014,10,10,0,0,0,20,10,10,0,0,0,20,nowin,push,push,push,10,0,20,217,0.410138249,0.069124424,0.543778802,0,0.02015021
84,142,20015,4,8,0,5,0,17,3,9,5,0,0,17,nowin,push,push,push,10,0,12,211,0.417061611,0.047393365,0.526066351,1,0.271531309
85,19,20015,9,3,0,4,0,16,3,9,5,0,0,17,nowin,loss,beat,dlwin,0,10,12,237,0.41350211,0.054852321,0.628691983,2,0.597373826
86,34,20015,7,7,0,0,0,14,3,9,5,0,0,17,nowin,loss,beat,dlwin,0,10,14,202,0.5,0.079207921,0.618811881,3,0.968961434
87,34,20015,7,10,0,0,0,17,3,9,5,0,0,17,nowin,push,push,push,10,0,17,202,0.5,0.079207921,0.618811881,3,0.968961434
88,131,20015,8,8,0,0,0,16,3,9,5,0,0,17,nowin,loss,beat,dlwin,0,10,16,217,0.410138249,0.069124424,0.543778802,0,0.02015021
89,122,20015,5,9,0,0,0,14,3,9,5,0,0,17,nowin,loss,beat,dlwin,0,10,14,210,0.347619048,0.052380952,0.59047619,0,0.012873677
90,11,20016,10,8,0,0,0,18,10,10,0,0,0,20,nowin,loss,beat,dlwin,0,10,18,236,0.457627119,0.016949153,0.588983051,3,0.889015813
91,103,20016,10,10,0,0,0,20,10,10,0,0,0,20,nowin,push,push,push,10,0,20,203,0.379310345,0.064039409,0.551724138,0,0.012869209
92,111,20016,10,3,0,1,6,20,10,10,0,0,0,20,nowin,push,push,push,10,0,13,180,0.433333333,0.055555556,0.611111111,2,0.602264492
93,130,20016,2,10,0,6,0,18,10,10,0,0,0,20,nowin,loss,beat,dlwin,0,10,12,219,0.410958904,0.03652968,0.566210046,0,0.025888739
94,81,20016,6,4,6,10,0,26,10,10,0,0,0,20,nowin,loss,bust,plbust,0,10,10,182,0.395604396,0.043956044,0.60989011,2,0.567491261
95,101,20016,10,7,0,0,0,17,10,10,0,0,0,20,nowin,loss,beat,dlwin,0,10,17,205,0.424390244,0.068292683,0.63902439,2,0.614740646
96,76,20017,11,10,0,0,0,21,10,3,10,0,0,23,win,win,dlbust,bust,25,0,21,189,0.534391534,0.079365079,0.608465608,3,1
97,21,20017,3,9,0,10,0,22,10,3,10,0,0,23,nowin,loss,bust,plbust,0,10,12,214,0.359813084,0.042056075,0.626168224,0,0.025263474
98,70,20017,4,7,6,0,0,17,10,3,10,0,0,23,nowin,win,dlbust,bust,20,0,11,228,0.385964912,0.039473684,0.557017544,0,0.016157125
99,85,20017,3,4,9,10,0,26,10,3,10,0,0,23,nowin,loss,bust,plbust,0,10,7,195,0.41025641,0.066666667,0.594871795,0,0.03269711
100,131,20017,10,11,0,0,0,21,10,3,10,0,0,23,win,win,dlbust,bust,25,0,21,217,0.410138249,0.069124424,0.543778802,0,0.02015021
101,51,20017,11,10,0,0,0,21,10,3,10,0,0,23,win,win,dlbust,bust,25,0,21,189,0.529100529,0.068783069,0.608465608,3,0.993665715
102,50,20018,3,10,0,0,0,13,5,10,4,0,0,19,nowin,loss,beat,dlwin,0,10,13,202,0.405940594,0.04950495,0.54950495,0,0.020296079
103,103,20018,7,10,0,0,0,17,5,10,4,0,0,19,nowin,loss,beat,dlwin,0,10,17,203,0.379310345,0.064039409,0.551724138,0,0.012869209
104,71,20018,10,9,0,0,0,19,5,10,4,0,0,19,nowin,push,push,push,10,0,19,193,0.352331606,0.046632124,0.585492228,0,0.013063661
105,48,20018,10,10,0,0,0,20,5,10,4,0,0,19,nowin,win,plwin,beat,20,0,20,203,0.413793103,0.019704433,0.600985222,2,0.577280801
106,21,20018,5,11,3,0,0,19,5,10,4,0,0,19,nowin,push,push,push,10,0,16,214,0.359813084,0.042056075,0.626168224,0,0.025263474
107,32,20018,3,5,9,0,0,17,5,10,4,0,0,19,nowin,loss,beat,dlwin,0,10,8,189,0.391534392,0.037037037,0.53968254,0,0.013579086
108,111,20019,7,5,0,0,0,12,6,10,9,0,0,25,nowin,win,dlbust,bust,20,0,12,180,0.433333333,0.055555556,0.611111111,2,0.602264492
109,116,20019,8,5,0,0,0,13,6,10,9,0,0,25,nowin,win,dlbust,bust,20,0,13,195,0.425641026,0.056410256,0.538461538,1,0.28273747
110,59,20019,6,2,9,0,0,17,6,10,9,0,0,25,nowin,win,dlbust,bust,20,0,8,228,0.429824561,0.048245614,0.543859649,1,0.287885446
111,118,20019,10,10,0,0,0,20,6,10,9,0,0,25,nowin,win,dlbust,bust,20,0,20,216,0.393518519,0.037037037,0.555555556,0,0.018059873
112,103,20019,11,2,5,0,0,18,6,10,9,0,0,25,nowin,win,dlbust,bust,20,0,13,203,0.379310345,0.064039409,0.551724138,0,0.012869209
113,112,20019,1,5,9,0,0,15,6,10,9,0,0,25,nowin,win,dlbust,bust,20,0,6,203,0.448275862,0.054187192,0.600985222,3,0.889576933
114,124,20020,11,2,6,0,0,19,10,11,0,0,0,21,nowin,loss,beat,dlwin,0,10,13,202,0.47029703,0.064356436,0.584158416,3,0.899458193
115,59,20020,10,3,0,10,0,23,10,11,0,0,0,21,nowin,loss,bust,plbust,0,10,13,228,0.429824561,0.048245614,0.543859649,1,0.287885446
116,148,20020,3,7,10,0,0,20,10,11,0,0,0,21,nowin,loss,beat,dlwin,0,10,10,204,0.401960784,0.078431373,0.593137255,0,0.029789521
117,27,20020,10,9,0,0,0,19,10,11,0,0,0,21,nowin,loss,beat,dlwin,0,10,19,178,0.370786517,0.016853933,0.573033708,0,0.015536309
118,52,20020,8,5,0,10,0,23,10,11,0,0,0,21,nowin,loss,bust,plbust,0,10,13,217,0.414746544,0.02764977,0.599078341,2,0.576736024
119,119,20020,11,7,0,0,0,18,10,11,0,0,0,21,nowin,loss,beat,dlwin,0,10,18,190,0.405263158,0.068421053,0.515789474,0,0.011837158
120,53,20021,10,5,0,8,0,23,10,6,2,0,0,18,nowin,loss,bust,plbust,0,10,15,250,0.372,0.064,0.564,0,0.013687345
121,47,20021,10,10,0,0,0,20,10,6,2,0,0,18,nowin,win,plwin,beat,20,0,20,210,0.438095238,0.057142857,0.623809524,2,0.615868808
122,137,20021,3,4,10,0,0,17,10,6,2,0,0,18,nowin,loss,beat,dlwin,0,10,7,194,0.417525773,0.046391753,0.536082474,1,0.276714602
123,46,20021,10,5,0,10,0,25,10,6,2,0,0,18,nowin,loss,bust,plbust,0,10,15,186,0.403225806,0.048387097,0.591397849,0,0.029742194
124,49,20021,10,10,0,0,0,20,10,6,2,0,0,18,nowin,win,plwin,beat,20,0,20,207,0.396135266,0.053140097,0.594202899,0,0.028306925
125,2,20021,10,10,0,0,0,20,10,6,2,0,0,18,nowin,win,plwin,beat,20,0,20,200,0.445,0.035,0.64,2,0.633962549
126,2,20022,10,10,0,0,0,20,10,10,0,0,0,20,nowin,push,push,push,10,0,20,200,0.445,0.035,0.64,2,0.633962549
127,62,20022,5,5,10,0,0,20,10,10,0,0,0,20,nowin,push,push,push,10,0,10,178,0.370786517,0.028089888,0.54494382,0,0.008657722
128,61,20022,2,10,0,9,0,21,10,10,0,0,0,20,nowin,win,plwin,beat,20,0,12,194,0.427835052,0.077319588,0.603092784,2,0.591437139
129,55,20022,4,4,10,0,0,18,10,10,0,0,0,20,nowin,loss,beat,dlwin,0,10,8,191,0.371727749,0.057591623,0.54973822,0,0.01011347
130,83,20022,10,7,0,0,0,17,10,10,0,0,0,20,nowin,loss,beat,dlwin,0,10,17,193,0.424870466,0.051813472,0.678756477,2,0.644360335
131,74,20022,10,8,0,0,0,18,10,10,0,0,0,20,nowin,loss,beat,dlwin,0,10,18,209,0.411483254,0.04784689,0.531100478,0,0.017448125
132,3,20023,7,11,0,0,0,18,5,5,4,4,0,18,nowin,push,push,push,10,0,18,190,0.431578947,0.026315789,0.542105263,1,0.288076384
133,54,20023,10,9,0,0,0,19,5,5,4,4,0,18,nowin,win,plwin,beat,20,0,19,185,0.437837838,0.032432432,0.556756757,1,0.29899854
134,99,20023,8,2,10,0,0,20,5,5,4,4,0,18,nowin,win,plwin,beat,20,0,10,207,0.47826087,0.062801932,0.637681159,3,0.961418446
135,39,20023,7,2,8,0,0,17,5,5,4,4,0,18,nowin,loss,beat,dlwin,0,10,9,191,0.429319372,0.062827225,0.57591623,0,0.033760763
136,29,20023,10,3,0,0,0,13,5,5,4,4,0,18,nowin,loss,beat,dlwin,0,10,13,189,0.44973545,0.058201058,0.544973545,1,0.300349439
137,122,20023,10,5,0,0,0,15,5,5,4,4,0,18,nowin,loss,beat,dlwin,0,10,15,210,0.347619048,0.052380952,0.59047619,0,0.012873677
138,137,20024,6,3,6,2,0,17,10,3,6,0,0,19,nowin,loss,beat,dlwin,0,10,9,194,0.417525773,0.046391753,0.536082474,1,0.276714602
139,80,20024,10,4,0,5,0,19,10,3,6,0,0,19,nowin,push,push,push,10,0,14,186,0.419354839,0.059139785,0.623655914,2,0.59892924
140,40,20024,8,2,5,10,0,25,10,3,6,0,0,19,nowin,loss,bust,plbust,0,10,10,196,0.367346939,0.030612245,0.617346939,0,0.025358183
141,84,20024,7,8,0,3,0,18,10,3,6,0,0,19,nowin,loss,beat,dlwin,0,10,15,195,0.379487179,0.056410256,0.569230769,0,0.017209119
142,27,20024,3,10,0,5,0,18,10,3,6,0,0,19,nowin,loss,beat,dlwin,0,10,13,178,0.370786517,0.016853933,0.573033708,0,0.015536309
143,34,20024,10,3,0,3,9,25,10,3,6,0,0,19,nowin,loss,bust,plbust,0,10,13,202,0.5,0.079207921,0.618811881,3,0.968961434
144,113,20025,10,10,0,0,0,20,9,10,0,0,0,19,nowin,win,plwin,beat,20,0,20,199,0.407035176,0.055276382,0.668341709,2,0.620695264
145,102,20025,6,7,0,10,0,23,9,10,0,0,0,19,nowin,loss,bust,plbust,0,10,13,192,0.338541667,0.046875,0.5625,0,0.003306118
146,51,20025,4,10,0,5,0,19,9,10,0,0,0,19,nowin,push,push,push,10,0,14,189,0.529100529,0.068783069,0.608465608,3,0.993665715
147,111,20025,7,8,0,9,0,24,9,10,0,0,0,19,nowin,loss,bust,plbust,0,10,15,180,0.433333333,0.055555556,0.611111111,2,0.602264492
148,59,20025,8,9,0,0,0,17,9,10,0,0,0,19,nowin,loss,beat,dlwin,0,10,17,228,0.429824561,0.048245614,0.543859649,1,0.287885446
149,16,20025,10,10,0,0,0,20,9,10,0,0,0,19,nowin,win,plwin,beat,20,0,20,220,0.427272727,0.081818182,0.6,2,0.588660176
150,48,20026,1,6,7,0,0,14,5,2,8,10,0,25,nowin,win,dlbust,bust,20,0,7,203,0.413793103,0.019704433,0.600985222,2,0.577280801
151,134,20026,10,9,0,0,0,19,5,2,8,10,0,25,nowin,win,dlbust,bust,20,0,19,185,0.443243243,0.021621622,0.545945946,1,0.296939509
152,37,20026,10,11,0,0,0,21,5,2,8,10,0,25,win,win,dlbust,bust,25,0,21,208,0.394230769,0.038461538,0.581730769,0,0.024682772
153,140,20026,6,10,0,0,0,16,5,2,8,10,0,25,nowin,win,dlbust,bust,20,0,16,210,0.466666667,0.023809524,0.604761905,3,0.915293335
154,10,20026,5,4,7,0,0,16,5,2,8,10,0,25,nowin,win,dlbust,bust,20,0,9,191,0.413612565,0.057591623,0.596858639,2,0.574087175
155,77,20026,6,1,10,0,0,17,5,2,8,10,0,25,nowin,win,dlbust,bust,20,0,7,200,0.455,0.04,0.62,3,0.916252116
156,142,20027,10,11,0,0,0,21,7,2,7,9,0,25,win,win,dlbust,bust,25,0,21,211,0.417061611,0.047393365,0.526066351,1,0.271531309
157,149,20027,3,4,11,0,0,18,7,2,7,9,0,25,nowin,win,dlbust,bust,20,0,7,225,0.457777778,0.057777778,0.648888889,2,0.651965595
158,122,20027,1,5,7,10,0,23,7,2,7,9,0,25,nowin,loss,bust,plbust,0,10,6,210,0.347619048,0.052380952,0.59047619,0,0.012873677
159,64,20027,3,11,1,7,0,22,7,2,7,9,0,25,nowin,loss,bust,plbust,0,10,14,187,0.363636364,0.048128342,0.631016043,0,0.027594885
160,125,20027,10,10,0,0,0,20,7,2,7,9,0,25,nowin,win,dlbust,bust,20,0,20,219,0.438356164,0.050228311,0.575342466,1,0.308411257
161,76,20027,6,3,10,0,0,19,7,2,7,9,0,25,nowin,win,dlbust,bust,20,0,9,189,0.534391534,0.079365079,0.608465608,3,1
162,129,20028,4,5,6,8,0,23,10,4,10,0,0,24,nowin,loss,bust,plbust,0,10,9,201,0.422885572,0.064676617,0.55721393,0,0.027255383
163,83,20028,6,4,2,2,7,21,10,4,10,0,0,24,nowin,win,dlbust,bust,20,0,10,193,0.424870466,0.051813472,0.678756477,2,0.644360335
164,33,20028,2,8,10,0,0,20,10,4,10,0,0,24,nowin,win,dlbust,bust,20,0,10,192,0.4375,0.057291667,0.625,2,0.616208916
165,104,20028,6,8,0,8,0,22,10,4,10,0,0,24,nowin,loss,bust,plbust,0,10,14,209,0.363636364,0.052631579,0.593301435,0,0.018359419
166,13,20028,8,3,8,0,0,19,10,4,10,0,0,24,nowin,win,dlbust,bust,20,0,11,206,0.417475728,0.063106796,0.621359223,2,0.59555479
167,148,20028,10,2,0,10,0,22,10,4,10,0,0,24,nowin,loss,bust,plbust,0,10,12,204,0.401960784,0.078431373,0.593137255,0,0.029789521
168,78,20029,2,10,0,0,0,12,6,9,1,9,0,25,nowin,win,dlbust,bust,20,0,12,201,0.517412935,0.034825871,0.587064677,3,0.95871112
169,133,20029,6,2,4,0,0,12,6,9,1,9,0,25,nowin,win,dlbust,bust,20,0,8,201,0.47761194,0.064676617,0.611940299,3,0.935428111
170,105,20029,10,3,0,0,0,13,6,9,1,9,0,25,nowin,win,dlbust,bust,20,0,13,198,0.414141414,0.070707071,0.590909091,0,0.032889494
171,24,20029,10,6,0,0,0,16,6,9,1,9,0,25,nowin,win,dlbust,bust,20,0,16,207,0.458937198,0.048309179,0.570048309,1,0.318138014
172,103,20029,8,6,0,0,0,14,6,9,1,9,0,25,nowin,win,dlbust,bust,20,0,14,203,0.379310345,0.064039409,0.551724138,0,0.012869209
173,79,20029,10,3,0,0,0,13,6,9,1,9,0,25,nowin,win,dlbust,bust,20,0,13,211,0.436018957,0.028436019,0.672985782,2,0.650131054
174,41,20030,2,10,0,2,7,21,7,7,3,0,0,17,nowin,win,plwin,beat,20,0,12,192,0.364583333,0.036458333,0.520833333,0,0.00089702
175,22,20030,6,10,0,1,0,17,7,7,3,0,0,17,nowin,push,push,push,10,0,16,187,0.481283422,0.042780749,0.577540107,3,0.906128176
176,65,20030,10,5,0,4,0,19,7,7,3,0,0,17,nowin,win,plwin,beat,20,0,15,203,0.492610837,0.054187192,0.571428571,3,0.913702814
177,17,20030,8,4,0,3,3,18,7,7,3,0,0,17,nowin,win,plwin,beat,20,0,12,171,0.444444444,0.070175439,0.555555556,1,0.302364894
178,55,20030,10,4,0,3,0,17,7,7,3,0,0,17,nowin,push,push,push,10,0,14,191,0.371727749,0.057591623,0.54973822,0,0.01011347
179,101,20030,3,8,10,0,0,21,7,7,3,0,0,17,nowin,win,plwin,beat,20,0,11,205,0.424390244,0.068292683,0.63902439,2,0.614740646
180,19,20031,10,3,0,5,0,18,10,4,6,0,0,20,nowin,loss,beat,dlwin,0,10,13,237,0.41350211,0.054852321,0.628691983,2,0.597373826
181,16,20031,6,5,6,0,0,17,10,4,6,0,0,20,nowin,loss,beat,dlwin,0,10,11,220,0.427272727,0.081818182,0.6,2,0.588660176
182,108,20031,4,4,4,3,8,23,10,4,6,0,0,20,nowin,loss,bust,plbust,0,10,8,193,0.435233161,0.056994819,0.559585492,1,0.298824795
183,51,20031,10,9,0,0,0,19,10,4,6,0,0,20,nowin,loss,beat,dlwin,0,10,19,189,0.529100529,0.068783069,0.608465608,3,0.993665715
184,123,20031,7,4,7,0,0,18,10,4,6,0,0,20,nowin,loss,beat,dlwin,0,10,11,205,0.43902439,0.034146341,0.614634146,2,0.609962544
185,80,20031,2,10,0,10,0,22,10,4,6,0,0,20,nowin,loss,bust,plbust,0,10,12,186,0.419354839,0.059139785,0.623655914,2,0.59892924
186,15,20032,10,3,0,3,4,20,10,10,0,0,0,20,nowin,push,push,push,10,0,13,212,0.410377358,0.051886792,0.561320755,0,0.024517408
187,70,20032,10,6,0,8,0,24,10,10,0,0,0,20,nowin,loss,bust,plbust,0,10,16,228,0.385964912,0.039473684,0.557017544,0,0.016157125
188,73,20032,10,10,0,0,0,20,10,10,0,0,0,20,nowin,push,push,push,10,0,20,181,0.375690608,0.011049724,0.596685083,0,0.022795773
189,55,20032,10,9,0,0,0,19,10,10,0,0,0,20,nowin,loss,beat,dlwin,0,10,19,191,0.371727749,0.057591623,0.54973822,0,0.01011347
190,78,20032,5,6,5,4,0,20,10,10,0,0,0,20,nowin,push,push,push,10,0,11,201,0.517412935,0.034825871,0.587064677,3,0.95871112
191,127,20032,4,11,3,0,0,18,10,10,0,0,0,20,nowin,loss,beat,dlwin,0,10,15,201,0.402985075,0.029850746,0.60199005,0,0.032263937
192,120,20033,10,10,0,0,0,20,5,3,10,0,0,18,nowin,win,plwin,beat,20,0,20,202,0.440594059,0.034653465,0.618811881,2,0.614441029
193,3,20033,4,6,5,0,0,15,5,3,10,0,0,18,nowin,loss,beat,dlwin,0,10,10,190,0.431578947,0.026315789,0.542105263,1,0.288076384
194,89,20033,10,10,0,0,0,20,5,3,10,0,0,18,nowin,win,plwin,beat,20,0,20,212,0.537735849,0.047169811,0.594339623,3,0.990167191
195,127,20033,10,6,0,0,0,16,5,3,10,0,0,18,nowin,loss,beat,dlwin,0,10,16,201,0.402985075,0.029850746,0.60199005,0,0.032263937
196,1,20033,9,10,0,0,0,19,5,3,10,0,0,18,nowin,win,plwin,beat,20,0,19,197,0.406091371,0.025380711,0.649746193,2,0.606186955
197,137,20033,8,9,0,0,0,17,5,3,10,0,0,18,nowin,loss,beat,dlwin,0,10,17,194,0.417525773,0.046391753,0.536082474,1,0.276714602
198,121,20034,9,11,0,0,0,20,8,10,0,0,0,18,nowin,win,plwin,beat,20,0,20,195,0.456410256,0.025641026,0.512820513,1,0.288597791
199,133,20034,7,10,0,0,0,17,8,10,0,0,0,18,nowin,loss,beat,dlwin,0,10,17,201,0.47761194,0.064676617,0.611940299,3,0.935428111
200,54,20034,10,9,0,0,0,19,8,10,0,0,0,18,nowin,win,plwin,beat,20,0,19,185,0.437837838,0.032432432,0.556756757,1,0.29899854
201,130,20034,10,9,0,0,0,19,8,10,0,0,0,18,nowin,win,plwin,beat,20,0,19,219,0.410958904,0.03652968,0.566210046,0,0.025888739
202,48,20034,10,10,0,0,0,20,8,10,0,0,0,18,nowin,win,plwin,beat,20,0,20,203,0.413793103,0.019704433,0.600985222,2,0.577280801
203,43,20034,3,10,0,10,0,23,8,10,0,0,0,18,nowin,loss,bust,plbust,0,10,13,192,0.40625,0.041666667,0.609375,2,0.576671372
204,150,20035,3,4,9,10,0,26,10,6,6,0,0,22,nowin,loss,bust,plbust,0,10,7,192,0.401041667,0.036458333,0.567708333,0,0.023287458
205,13,20035,4,2,10,8,0,24,10,6,6,0,0,22,nowin,loss,bust,plbust,0,10,6,206,0.417475728,0.063106796,0.621359223,2,0.59555479
206,121,20035,3,5,9,0,0,17,10,6,6,0,0,22,nowin,win,dlbust,bust,20,0,8,195,0.456410256,0.025641026,0.512820513,1,0.288597791
207,44,20035,1,5,10,4,0,20,10,6,6,0,0,22,nowin,win,dlbust,bust,20,0,6,219,0.433789954,0.050228311,0.534246575,1,0.285551035
208,123,20035,11,6,4,0,0,21,10,6,6,0,0,22,nowin,win,dlbust,bust,20,0,17,205,0.43902439,0.034146341,0.614634146,2,0.609962544
209,138,20035,9,4,0,10,0,23,10,6,6,0,0,22,nowin,loss,bust,plbust,0,10,13,190,0.442105263,0.047368421,0.610526316,2,0.609711065
210,15,20036,10,7,0,0,0,17,10,7,0,0,0,17,nowin,push,push,push,10,0,17,212,0.410377358,0.051886792,0.561320755,0,0.024517408
211,81,20036,10,2,0,7,0,19,10,7,0,0,0,17,nowin,win,plwin,beat,20,0,12,182,0.395604396,0.043956044,0.60989011,2,0.567491261
212,112,20036,1,2,10,6,0,19,10,7,0,0,0,17,nowin,win,plwin,beat,20,0,3,203,0.448275862,0.054187192,0.600985222,3,0.889576933
213,7,20036,8,10,0,0,0,18,10,7,0,0,0,17,nowin,win,plwin,beat,20,0,18,183,0.442622951,0.06010929,0.62295082,2,0.619303341
214,127,20036,4,3,2,6,10,25,10,7,0,0,0,17,nowin,loss,bust,plbust,0,10,7,201,0.402985075,0.029850746,0.60199005,0,0.032263937
215,49,20036,4,10,0,5,0,19,10,7,0,0,0,17,nowin,win,plwin,beat,20,0,14,207,0.396135266,0.053140097,0.594202899,0,0.028306925
216,88,20037,5,6,10,0,0,21,4,5,6,2,0,17,nowin,win,plwin,beat,20,0,11,206,0.466019417,0.033980583,0.54368932,1,0.309467903
217,52,20037,10,7,0,0,0,17,4,5,6,2,0,17,nowin,push,push,push,10,0,17,217,0.414746544,0.02764977,0.599078341,2,0.576736024
218,11,20037,3,9,0,0,0,12,4,5,6,2,0,17,nowin,loss,beat,dlwin,0,10,12,236,0.457627119,0.016949153,0.588983051,3,0.889015813
219,54,20037,6,4,5,0,0,15,4,5,6,2,0,17,nowin,loss,beat,dlwin,0,10,10,185,0.437837838,0.032432432,0.556756757,1,0.29899854
220,11,20037,6,10,0,0,0,16,4,5,6,2,0,17,nowin,loss,beat,dlwin,0,10,16,236,0.457627119,0.016949153,0.588983051,3,0.889015813
221,62,20037,5,10,0,0,0,15,4,5,6,2,0,17,nowin,loss,beat,dlwin,0,10,15,178,0.370786517,0.028089888,0.54494382,0,0.008657722
222,87,20038,3,6,10,0,0,19,5,4,4,9,0,22,nowin,win,dlbust,bust,20,0,9,202,0.405940594,0.054455446,0.628712871,2,0.590599801
223,91,20038,6,2,10,0,0,18,5,4,4,9,0,22,nowin,win,dlbust,bust,20,0,8,194,0.417525773,0.046391753,0.515463918,1,0.266616552
224,95,20038,8,10,0,0,0,18,5,4,4,9,0,22,nowin,win,dlbust,bust,20,0,18,218,0.412844037,0.04587156,0.559633028,0,0.024842385
225,60,20038,10,10,0,0,0,20,5,4,4,9,0,22,nowin,win,dlbust,bust,20,0,20,227,0.418502203,0.022026432,0.559471366,0,0.026496258
226,12,20038,8,10,0,0,0,18,5,4,4,9,0,22,nowin,win,dlbust,bust,20,0,18,189,0.470899471,0.015873016,0.613756614,3,0.929171178
227,69,20038,4,10,0,0,0,14,5,4,4,9,0,22,nowin,win,dlbust,bust,20,0,14,194,0.365979381,0.030927835,0.515463918,0,0
228,54,20039,4,9,0,0,0,13,2,7,2,1,10,22,nowin,win,dlbust,bust,20,0,13,185,0.437837838,0.032432432,0.556756757,1,0.29899854
229,68,20039,10,5,0,0,0,15,2,7,2,1,10,22,nowin,win,dlbust,bust,20,0,15,205,0.434146341,0.029268293,0.6,2,0.59483189
230,107,20039,11,9,0,0,0,20,2,7,2,1,10,22,nowin,win,dlbust,bust,20,0,20,218,0.444954128,0.073394495,0.600917431,2,0.605210014
231,53,20039,10,9,0,0,0,19,2,7,2,1,10,22,nowin,win,dlbust,bust,20,0,19,250,0.372,0.064,0.564,0,0.013687345
232,141,20039,10,7,0,0,0,17,2,7,2,1,10,22,nowin,win,dlbust,bust,20,0,17,202,0.420792079,0.074257426,0.564356436,0,0.028377851
233,91,20039,11,8,0,0,0,19,2,7,2,1,10,22,nowin,win,dlbust,bust,20,0,19,194,0.417525773,0.046391753,0.515463918,1,0.266616552
234,19,20040,10,3,0,0,0,13,2,8,3,3,1,17,nowin,loss,beat,dlwin,0,10,13,237,0.41350211,0.054852321,0.628691983,2,0.597373826
235,3,20040,10,10,0,0,0,20,2,8,3,3,1,17,nowin,win,plwin,beat,20,0,20,190,0.431578947,0.026315789,0.542105263,1,0.288076384
236,78,20040,7,6,0,0,0,13,2,8,3,3,1,17,nowin,loss,beat,dlwin,0,10,13,201,0.517412935,0.034825871,0.587064677,3,0.95871112
237,78,20040,10,10,0,0,0,20,2,8,3,3,1,17,nowin,win,plwin,beat,20,0,20,201,0.517412935,0.034825871,0.587064677,3,0.95871112
238,27,20040,5,10,0,0,0,15,2,8,3,3,1,17,nowin,loss,beat,dlwin,0,10,15,178,0.370786517,0.016853933,0.573033708,0,0.015536309
239,87,20040,5,10,0,0,0,15,2,8,3,3,1,17,nowin,loss,beat,dlwin,0,10,15,202,0.405940594,0.054455446,0.628712871,2,0.590599801
240,85,20041,10,10,0,0,0,20,2,4,2,6,4,18,nowin,win,plwin,beat,20,0,20,195,0.41025641,0.066666667,0.594871795,0,0.03269711
241,135,20041,10,10,0,0,0,20,2,4,2,6,4,18,nowin,win,plwin,beat,20,0,20,179,0.391061453,0.067039106,0.586592179,0,0.024924662
242,23,20041,10,4,0,0,0,14,2,4,2,6,4,18,nowin,loss,beat,dlwin,0,10,14,208,0.427884615,0.0625,0.552884615,1,0.29114424
243,139,20041,10,8,0,0,0,18,2,4,2,6,4,18,nowin,push,push,push,10,0,18,192,0.380208333,0.036458333,0.59375,0,0.023429169
244,69,20041,10,6,0,0,0,16,2,4,2,6,4,18,nowin,loss,beat,dlwin,0,10,16,194,0.365979381,0.030927835,0.515463918,0,0
245,59,20041,7,10,0,0,0,17,2,4,2,6,4,18,nowin,loss,beat,dlwin,0,10,17,228,0.429824561,0.048245614,0.543859649,1,0.287885446
246,83,20042,9,5,0,3,0,17,7,4,1,9,0,21,nowin,loss,beat,dlwin,0,10,14,193,0.424870466,0.051813472,0.678756477,2,0.644360335
247,66,20042,10,4,0,2,10,26,7,4,1,9,0,21,nowin,loss,bust,plbust,0,10,14,217,0.456221198,0.064516129,0.626728111,3,0.924304367
248,53,20042,10,9,0,0,0,19,7,4,1,9,0,21,nowin,loss,beat,dlwin,0,10,19,250,0.372,0.064,0.564,0,0.013687345
249,27,20042,3,10,0,5,0,18,7,4,1,9,0,21,nowin,loss,beat,dlwin,0,10,13,178,0.370786517,0.016853933,0.573033708,0,0.015536309
250,107,20042,10,3,0,10,0,23,7,4,1,9,0,21,nowin,loss,bust,plbust,0,10,13,218,0.444954128,0.073394495,0.600917431,2,0.605210014
251,50,20042,6,2,3,10,0,21,7,4,1,9,0,21,nowin,push,push,push,10,0,8,202,0.405940594,0.04950495,0.54950495,0,0.020296079
252,148,20043,3,4,11,0,0,18,11,6,0,0,0,17,nowin,win,plwin,beat,20,0,7,204,0.401960784,0.078431373,0.593137255,0,0.029789521
253,147,20043,10,4,0,5,0,19,11,6,0,0,0,17,nowin,win,plwin,beat,20,0,14,205,0.380487805,0.014634146,0.536585366,0,0.00951447
254,44,20043,10,6,0,4,0,20,11,6,0,0,0,17,nowin,win,plwin,beat,20,0,16,219,0.433789954,0.050228311,0.534246575,1,0.285551035
255,30,20043,9,10,0,0,0,19,11,6,0,0,0,17,nowin,win,plwin,beat,20,0,19,206,0.393203883,0.033980583,0.601941748,0,0.029324648
256,70,20043,1,3,9,10,0,23,11,6,0,0,0,17,nowin,loss,bust,plbust,0,10,4,228,0.385964912,0.039473684,0.557017544,0,0.016157125
257,132,20043,10,10,0,0,0,20,11,6,0,0,0,17,nowin,win,plwin,beat,20,0,20,194,0.412371134,0.036082474,0.649484536,2,0.611633238
258,141,20044,10,11,0,0,0,21,8,4,1,2,9,24,win,win,dlbust,bust,25,0,21,202,0.420792079,0.074257426,0.564356436,0,0.028377851
259,101,20044,3,5,10,0,0,18,8,4,1,2,9,24,nowin,win,dlbust,bust,20,0,8,205,0.424390244,0.068292683,0.63902439,2,0.614740646
260,7,20044,7,5,0,10,0,22,8,4,1,2,9,24,nowin,loss,bust,plbust,0,10,12,183,0.442622951,0.06010929,0.62295082,2,0.619303341
261,144,20044,3,6,10,0,0,19,8,4,1,2,9,24,nowin,win,dlbust,bust,20,0,9,202,0.386138614,0.054455446,0.564356436,0,0.018006244
262,27,20044,6,5,2,10,0,23,8,4,1,2,9,24,nowin,loss,bust,plbust,0,10,11,178,0.370786517,0.016853933,0.573033708,0,0.015536309
263,90,20044,7,10,0,0,0,17,8,4,1,2,9,24,nowin,win,dlbust,bust,20,0,17,201,0.447761194,0.049751244,0.60199005,3,0.889945023
264,68,20045,3,9,0,0,0,12,6,10,8,0,0,24,nowin,win,dlbust,bust,20,0,12,205,0.434146341,0.029268293,0.6,2,0.59483189
265,34,20045,11,9,0,0,0,20,6,10,8,0,0,24,nowin,win,dlbust,bust,20,0,20,202,0.5,0.079207921,0.618811881,3,0.968961434
266,63,20045,7,10,0,0,0,17,6,10,8,0,0,24,nowin,win,dlbust,bust,20,0,17,216,0.467592593,0.037037037,0.62037037,3,0.931690496
267,26,20045,10,9,0,0,0,19,6,10,8,0,0,24,nowin,win,dlbust,bust,20,0,19,203,0.463054187,0.0591133,0.541871921,1,0.306802864
268,126,20045,10,3,0,0,0,13,6,10,8,0,0,24,nowin,win,dlbust,bust,20,0,13,188,0.457446809,0.074468085,0.60106383,3,0.900633203
269,51,20045,9,10,0,0,0,19,6,10,8,0,0,24,nowin,win,dlbust,bust,20,0,19,189,0.529100529,0.068783069,0.608465608,3,0.993665715
270,137,20046,11,7,0,0,0,18,4,2,3,1,9,19,nowin,loss,beat,dlwin,0,10,18,194,0.417525773,0.046391753,0.536082474,1,0.276714602
271,96,20046,6,10,0,0,0,16,4,2,3,1,9,19,nowin,loss,beat,dlwin,0,10,16,190,0.468421053,0.057894737,0.584210526,3,0.897263354
272,59,20046,5,8,0,0,0,13,4,2,3,1,9,19,nowin,loss,beat,dlwin,0,10,13,228,0.429824561,0.048245614,0.543859649,1,0.287885446
273,79,20046,1,3,8,0,0,12,4,2,3,1,9,19,nowin,loss,beat,dlwin,0,10,4,211,0.436018957,0.028436019,0.672985782,2,0.650131054
274,7,20046,11,10,0,0,0,21,4,2,3,1,9,19,win,win,plwin,beat,25,0,21,183,0.442622951,0.06010929,0.62295082,2,0.619303341
275,64,20046,9,10,0,0,0,19,4,2,3,1,9,19,nowin,push,push,push,10,0,19,187,0.363636364,0.048128342,0.631016043,0,0.027594885
276,8,20047,10,10,0,0,0,20,10,10,0,0,0,20,nowin,push,push,push,10,0,20,181,0.44198895,0.071823204,0.596685083,2,0.599438402
277,7,20047,9,10,0,0,0,19,10,10,0,0,0,20,nowin,loss,beat,dlwin,0,10,19,183,0.442622951,0.06010929,0.62295082,2,0.619303341
278,45,20047,3,4,11,0,0,18,10,10,0,0,0,20,nowin,loss,beat,dlwin,0,10,7,196,0.428571429,0.051020408,0.612244898,2,0.598821767
279,21,20047,10,10,0,0,0,20,10,10,0,0,0,20,nowin,push,push,push,10,0,20,214,0.359813084,0.042056075,0.626168224,0,0.025263474
280,106,20047,8,5,0,10,0,23,10,10,0,0,0,20,nowin,loss,bust,plbust,0,10,13,192,0.411458333,0.026041667,0.557291667,0,0.023854304
281,70,20047,3,4,10,0,0,17,10,10,0,0,0,20,nowin,loss,beat,dlwin,0,10,7,228,0.385964912,0.039473684,0.557017544,0,0.016157125
282,124,20048,11,10,0,0,0,21,10,8,0,0,0,18,win,win,plwin,beat,25,0,21,202,0.47029703,0.064356436,0.584158416,3,0.899458193
283,25,20048,10,4,0,7,0,21,10,8,0,0,0,18,nowin,win,plwin,beat,20,0,14,190,0.463157895,0.063157895,0.536842105,1,0.304401563
284,26,20048,6,10,0,3,0,19,10,8,0,0,0,18,nowin,win,plwin,beat,20,0,16,203,0.463054187,0.0591133,0.541871921,1,0.306802864
285,76,20048,10,10,0,0,0,20,10,8,0,0,0,18,nowin,win,plwin,beat,20,0,20,189,0.534391534,0.079365079,0.608465608,3,1
286,100,20048,4,11,6,0,0,21,10,8,0,0,0,18,nowin,win,plwin,beat,20,0,15,190,0.452631579,0.036842105,0.594736842,3,0.888671154
287,107,20048,7,8,0,1,10,26,10,8,0,0,0,18,nowin,loss,bust,plbust,0,10,15,218,0.444954128,0.073394495,0.600917431,2,0.605210014
288,94,20049,6,10,0,0,0,16,6,10,2,0,0,18,nowin,loss,beat,dlwin,0,10,16,183,0.43715847,0.043715847,0.540983607,1,0.290866892
289,133,20049,10,10,0,0,0,20,6,10,2,0,0,18,nowin,win,plwin,beat,20,0,20,201,0.47761194,0.064676617,0.611940299,3,0.935428111
290,39,20049,9,4,0,0,0,13,6,10,2,0,0,18,nowin,loss,beat,dlwin,0,10,13,191,0.429319372,0.062827225,0.57591623,0,0.033760763
291,98,20049,6,7,0,0,0,13,6,10,2,0,0,18,nowin,loss,beat,dlwin,0,10,13,220,0.422727273,0.054545455,0.55,1,0.28664435
292,51,20049,10,3,0,0,0,13,6,10,2,0,0,18,nowin,loss,beat,dlwin,0,10,13,189,0.529100529,0.068783069,0.608465608,3,0.993665715
293,2,20049,10,10,0,0,0,20,6,10,2,0,0,18,nowin,win,plwin,beat,20,0,20,200,0.445,0.035,0.64,2,0.633962549
294,75,20050,10,8,0,0,0,18,10,4,7,0,0,21,nowin,loss,beat,dlwin,0,10,18,191,0.418848168,0.052356021,0.570680628,0,0.029344702
295,84,20050,7,4,10,0,0,21,10,4,7,0,0,21,nowin,push,push,push,10,0,11,195,0.379487179,0.056410256,0.569230769,0,0.017209119
296,108,20050,11,4,6,0,0,21,10,4,7,0,0,21,nowin,push,push,push,10,0,15,193,0.435233161,0.056994819,0.559585492,1,0.298824795
297,47,20050,8,2,10,0,0,20,10,4,7,0,0,21,nowin,loss,beat,dlwin,0,10,10,210,0.438095238,0.057142857,0.623809524,2,0.615868808
298,133,20050,9,11,0,0,0,20,10,4,7,0,0,21,nowin,loss,beat,dlwin,0,10,20,201,0.47761194,0.064676617,0.611940299,3,0.935428111
299,58,20050,10,2,0,3,6,21,10,4,7,0,0,21,nowin,push,push,push,10,0,12,195,0.430769231,0.041025641,0.584615385,2,0.580497586
300,144,20051,5,10,0,0,0,15,2,10,4,1,0,17,nowin,loss,beat,dlwin,0,10,15,202,0.386138614,0.054455446,0.564356436,0,0.018006244
301,30,20051,2,7,10,0,0,19,2,10,4,1,0,17,nowin,win,plwin,beat,20,0,9,206,0.393203883,0.033980583,0.601941748,0,0.029324648
302,67,20051,8,5,0,0,0,13,2,10,4,1,0,17,nowin,loss,beat,dlwin,0,10,13,195,0.369230769,0.041025641,0.569230769,0,0.014139427
303,125,20051,10,3,0,0,0,13,2,10,4,1,0,17,nowin,loss,beat,dlwin,0,10,13,219,0.438356164,0.050228311,0.575342466,1,0.308411257
304,48,20051,10,3,0,0,0,13,2,10,4,1,0,17,nowin,loss,beat,dlwin,0,10,13,203,0.413793103,0.019704433,0.600985222,2,0.577280801
305,70,20051,7,11,0,0,0,18,2,10,4,1,0,17,nowin,win,plwin,beat,20,0,18,228,0.385964912,0.039473684,0.557017544,0,0.016157125
306,78,20052,11,10,0,0,0,21,9,9,0,0,0,18,win,win,plwin,beat,25,0,21,201,0.517412935,0.034825871,0.587064677,3,0.95871112
307,15,20052,11,10,0,0,0,21,9,9,0,0,0,18,win,win,plwin,beat,25,0,21,212,0.410377358,0.051886792,0.561320755,0,0.024517408
308,59,20052,10,9,0,0,0,19,9,9,0,0,0,18,nowin,win,plwin,beat,20,0,19,228,0.429824561,0.048245614,0.543859649,1,0.287885446
309,86,20052,4,11,2,0,0,17,9,9,0,0,0,18,nowin,loss,beat,dlwin,0,10,15,196,0.454081633,0.040816327,0.591836735,3,0.887566443
310,99,20052,11,9,0,0,0,20,9,9,0,0,0,18,nowin,win,plwin,beat,20,0,20,207,0.47826087,0.062801932,0.637681159,3,0.961418446
311,146,20052,7,2,10,0,0,19,9,9,0,0,0,18,nowin,win,plwin,beat,20,0,9,221,0.43438914,0.040723982,0.542986425,1,0.290190091
312,104,20053,8,10,0,0,0,18,8,8,10,0,0,26,nowin,win,dlbust,bust,20,0,18,209,0.363636364,0.052631579,0.593301435,0,0.018359419
313,94,20053,10,2,0,9,0,21,8,8,10,0,0,26,nowin,win,dlbust,bust,20,0,12,183,0.43715847,0.043715847,0.540983607,1,0.290866892
314,133,20053,10,5,0,3,0,18,8,8,10,0,0,26,nowin,win,dlbust,bust,20,0,15,201,0.47761194,0.064676617,0.611940299,3,0.935428111
315,120,20053,9,7,0,1,0,17,8,8,10,0,0,26,nowin,win,dlbust,bust,20,0,16,202,0.440594059,0.034653465,0.618811881,2,0.614441029
316,150,20053,6,7,0,5,0,18,8,8,10,0,0,26,nowin,win,dlbust,bust,20,0,13,192,0.401041667,0.036458333,0.567708333,0,0.023287458
317,59,20053,7,5,0,2,10,24,8,8,10,0,0,26,nowin,loss,bust,plbust,0,10,12,228,0.429824561,0.048245614,0.543859649,1,0.287885446
318,131,20054,6,6,0,9,0,21,11,10,0,0,0,21,nowin,push,push,push,10,0,12,217,0.410138249,0.069124424,0.543778802,0,0.02015021
319,52,20054,3,10,0,1,10,24,11,10,0,0,0,21,nowin,loss,bust,plbust,0,10,13,217,0.414746544,0.02764977,0.599078341,2,0.576736024
320,106,20054,7,8,0,7,0,22,11,10,0,0,0,21,nowin,loss,bust,plbust,0,10,15,192,0.411458333,0.026041667,0.557291667,0,0.023854304
321,43,20054,11,10,0,0,0,21,11,10,0,0,0,21,win,push,push,push,10,0,21,192,0.40625,0.041666667,0.609375,2,0.576671372
322,132,20054,2,6,5,6,0,19,11,10,0,0,0,21,nowin,loss,beat,dlwin,0,10,8,194,0.412371134,0.036082474,0.649484536,2,0.611633238
323,24,20054,4,3,10,0,0,17,11,10,0,0,0,21,nowin,loss,beat,dlwin,0,10,7,207,0.458937198,0.048309179,0.570048309,1,0.318138014
324,122,20055,6,2,9,0,0,17,10,2,8,0,0,20,nowin,loss,beat,dlwin,0,10,8,210,0.347619048,0.052380952,0.59047619,0,0.012873677
325,119,20055,9,8,0,0,0,17,10,2,8,0,0,20,nowin,loss,beat,dlwin,0,10,17,190,0.405263158,0.068421053,0.515789474,0,0.011837158
326,44,20055,8,7,0,10,0,25,10,2,8,0,0,20,nowin,loss,bust,plbust,0,10,15,219,0.433789954,0.050228311,0.534246575,1,0.285551035
327,92,20055,2,7,10,0,0,19,10,2,8,0,0,20,nowin,loss,beat,dlwin,0,10,9,186,0.446236559,0.059139785,0.564516129,1,0.307826125
328,59,20055,8,7,0,9,0,24,10,2,8,0,0,20,nowin,loss,bust,plbust,0,10,15,228,0.429824561,0.048245614,0.543859649,1,0.287885446
329,125,20055,3,2,10,9,0,24,10,2,8,0,0,20,nowin,loss,bust,plbust,0,10,5,219,0.438356164,0.050228311,0.575342466,1,0.308411257
330,42,20056,2,10,0,9,0,21,10,5,3,0,0,18,nowin,win,plwin,beat,20,0,12,212,0.443396226,0.051886792,0.570754717,1,0.309181312
331,110,20056,7,2,2,4,3,18,10,5,3,0,0,18,nowin,push,push,push,10,0,9,192,0.416666667,0.046875,0.557291667,0,0.025413132
332,13,20056,5,10,0,2,0,17,10,5,3,0,0,18,nowin,loss,beat,dlwin,0,10,15,206,0.417475728,0.063106796,0.621359223,2,0.59555479
333,131,20056,10,9,0,0,0,19,10,5,3,0,0,18,nowin,win,plwin,beat,20,0,19,217,0.410138249,0.069124424,0.543778802,0,0.02015021
334,53,20056,4,10,0,2,10,26,10,5,3,0,0,18,nowin,loss,bust,plbust,0,10,14,250,0.372,0.064,0.564,0,0.013687345
335,130,20056,7,3,3,10,0,23,10,5,3,0,0,18,nowin,loss,bust,plbust,0,10,10,219,0.410958904,0.03652968,0.566210046,0,0.025888739
336,80,20057,5,4,10,0,0,19,10,7,0,0,0,17,nowin,win,plwin,beat,20,0,9,186,0.419354839,0.059139785,0.623655914,2,0.59892924
337,62,20057,11,1,9,0,0,21,10,7,0,0,0,17,nowin,win,plwin,beat,20,0,12,178,0.370786517,0.028089888,0.54494382,0,0.008657722
338,73,20057,6,10,0,7,0,23,10,7,0,0,0,17,nowin,loss,bust,plbust,0,10,16,181,0.375690608,0.011049724,0.596685083,0,0.022795773
339,21,20057,11,9,0,0,0,20,10,7,0,0,0,17,nowin,win,plwin,beat,20,0,20,214,0.359813084,0.042056075,0.626168224,0,0.025263474
340,114,20057,8,6,0,10,0,24,10,7,0,0,0,17,nowin,loss,bust,plbust,0,10,14,198,0.47979798,0.025252525,0.611111111,3,0.937232995
341,56,20057,9,10,0,0,0,19,10,7,0,0,0,17,nowin,win,plwin,beat,20,0,19,175,0.4,0.057142857,0.582857143,0,0.026685297
342,69,20058,7,11,0,0,0,18,3,6,4,1,10,24,nowin,win,dlbust,bust,20,0,18,194,0.365979381,0.030927835,0.515463918,0,0
343,143,20058,7,2,10,0,0,19,3,6,4,1,10,24,nowin,win,dlbust,bust,20,0,9,203,0.463054187,0.044334975,0.57635468,3,0.883143365
344,132,20058,7,10,0,0,0,17,3,6,4,1,10,24,nowin,win,dlbust,bust,20,0,17,194,0.412371134,0.036082474,0.649484536,2,0.611633238
345,12,20058,3,7,3,0,0,13,3,6,4,1,10,24,nowin,win,dlbust,bust,20,0,10,189,0.470899471,0.015873016,0.613756614,3,0.929171178
346,121,20058,7,10,0,0,0,17,3,6,4,1,10,24,nowin,win,dlbust,bust,20,0,17,195,0.456410256,0.025641026,0.512820513,1,0.288597791
347,82,20058,1,6,9,0,0,16,3,6,4,1,10,24,nowin,win,dlbust,bust,20,0,7,225,0.408888889,0.075555556,0.577777778,0,0.028101874
348,126,20059,5,9,0,8,0,22,8,3,10,0,0,21,nowin,loss,bust,plbust,0,10,14,188,0.457446809,0.074468085,0.60106383,3,0.900633203
349,38,20059,4,2,11,0,0,17,8,3,10,0,0,21,nowin,loss,beat,dlwin,0,10,6,202,0.361386139,0.03960396,0.564356436,0,0.010597953
350,113,20059,3,5,10,0,0,18,8,3,10,0,0,21,nowin,loss,beat,dlwin,0,10,8,199,0.407035176,0.055276382,0.668341709,2,0.620695264
351,69,20059,8,10,0,0,0,18,8,3,10,0,0,21,nowin,loss,beat,dlwin,0,10,18,194,0.365979381,0.030927835,0.515463918,0,0
352,83,20059,4,6,10,0,0,20,8,3,10,0,0,21,nowin,loss,beat,dlwin,0,10,10,193,0.424870466,0.051813472,0.678756477,2,0.644360335
353,52,20059,4,5,10,0,0,19,8,3,10,0,0,21,nowin,loss,beat,dlwin,0,10,9,217,0.414746544,0.02764977,0.599078341,2,0.576736024
354,57,20060,9,7,0,7,0,23,7,10,0,0,0,17,nowin,loss,bust,plbust,0,10,16,192,0.46875,0.052083333,0.59375,3,0.907001181
355,97,20060,10,8,0,0,0,18,7,10,0,0,0,17,nowin,win,plwin,beat,20,0,18,182,0.450549451,0.06043956,0.692307692,2,0.677372279
356,3,20060,2,10,0,9,0,21,7,10,0,0,0,17,nowin,win,plwin,beat,20,0,12,190,0.431578947,0.026315789,0.542105263,1,0.288076384
357,10,20060,7,2,10,0,0,19,7,10,0,0,0,17,nowin,win,plwin,beat,20,0,9,191,0.413612565,0.057591623,0.596858639,2,0.574087175
358,21,20060,3,6,10,0,0,19,7,10,0,0,0,17,nowin,win,plwin,beat,20,0,9,214,0.359813084,0.042056075,0.626168224,0,0.025263474
359,60,20060,2,10,0,8,0,20,7,10,0,0,0,17,nowin,win,plwin,beat,20,0,12,227,0.418502203,0.022026432,0.559471366,0,0.026496258
360,97,20061,10,8,0,0,0,18,10,9,0,0,0,19,nowin,loss,beat,dlwin,0,10,18,182,0.450549451,0.06043956,0.692307692,2,0.677372279
361,148,20061,11,6,3,0,0,20,10,9,0,0,0,19,nowin,win,plwin,beat,20,0,17,204,0.401960784,0.078431373,0.593137255,0,0.029789521
362,74,20061,3,8,7,0,0,18,10,9,0,0,0,19,nowin,loss,beat,dlwin,0,10,11,209,0.411483254,0.04784689,0.531100478,0,0.017448125
363,95,20061,10,6,0,10,0,26,10,9,0,0,0,19,nowin,loss,bust,plbust,0,10,16,218,0.412844037,0.04587156,0.559633028,0,0.024842385
364,72,20061,10,6,0,4,0,20,10,9,0,0,0,19,nowin,win,plwin,beat,20,0,16,185,0.394594595,0.032432432,0.508108108,0,0.006763115
365,112,20061,3,10,0,10,0,23,10,9,0,0,0,19,nowin,loss,bust,plbust,0,10,13,203,0.448275862,0.054187192,0.600985222,3,0.889576933
366,46,20062,8,4,0,6,0,18,2,10,6,0,0,18,nowin,push,push,push,10,0,12,186,0.403225806,0.048387097,0.591397849,0,0.029742194
367,68,20062,10,11,0,0,0,21,2,10,6,0,0,18,win,win,plwin,beat,25,0,21,205,0.434146341,0.029268293,0.6,2,0.59483189
368,146,20062,8,8,0,0,0,16,2,10,6,0,0,18,nowin,loss,beat,dlwin,0,10,16,221,0.43438914,0.040723982,0.542986425,1,0.290190091
369,59,20062,4,11,3,0,0,18,2,10,6,0,0,18,nowin,push,push,push,10,0,15,228,0.429824561,0.048245614,0.543859649,1,0.287885446
370,108,20062,7,10,0,0,0,17,2,10,6,0,0,18,nowin,loss,beat,dlwin,0,10,17,193,0.435233161,0.056994819,0.559585492,1,0.298824795
371,50,20062,2,9,5,0,0,16,2,10,6,0,0,18,nowin,loss,beat,dlwin,0,10,11,202,0.405940594,0.04950495,0.54950495,0,0.020296079
372,64,20063,8,3,4,0,0,15,5,2,11,0,0,18,nowin,loss,beat,dlwin,0,10,11,187,0.363636364,0.048128342,0.631016043,0,0.027594885
373,146,20063,6,6,0,0,0,12,5,2,11,0,0,18,nowin,loss,beat,dlwin,0,10,12,221,0.43438914,0.040723982,0.542986425,1,0.290190091
374,107,20063,6,10,0,0,0,16,5,2,11,0,0,18,nowin,loss,beat,dlwin,0,10,16,218,0.444954128,0.073394495,0.600917431,2,0.605210014
375,115,20063,5,1,9,0,0,15,5,2,11,0,0,18,nowin,loss,beat,dlwin,0,10,6,194,0.427835052,0.041237113,0.592783505,2,0.583863602
376,135,20063,10,2,0,0,0,12,5,2,11,0,0,18,nowin,loss,beat,dlwin,0,10,12,179,0.391061453,0.067039106,0.586592179,0,0.024924662
377,127,20063,11,10,0,0,0,21,5,2,11,0,0,18,win,win,plwin,beat,25,0,21,201,0.402985075,0.029850746,0.60199005,0,0.032263937
378,69,20064,2,8,11,0,0,21,11,10,0,0,0,21,nowin,push,push,push,10,0,10,194,0.365979381,0.030927835,0.515463918,0,0
379,37,20064,10,10,0,0,0,20,11,10,0,0,0,21,nowin,loss,beat,dlwin,0,10,20,208,0.394230769,0.038461538,0.581730769,0,0.024682772
380,130,20064,7,10,0,0,0,17,11,10,0,0,0,21,nowin,loss,beat,dlwin,0,10,17,219,0.410958904,0.03652968,0.566210046,0,0.025888739
381,34,20064,5,4,3,7,0,19,11,10,0,0,0,21,nowin,loss,beat,dlwin,0,10,9,202,0.5,0.079207921,0.618811881,3,0.968961434
382,112,20064,9,4,0,1,2,16,11,10,0,0,0,21,nowin,loss,beat,dlwin,0,10,13,203,0.448275862,0.054187192,0.600985222,3,0.889576933
383,127,20064,2,10,0,6,0,18,11,10,0,0,0,21,nowin,loss,beat,dlwin,0,10,12,201,0.402985075,0.029850746,0.60199005,0,0.032263937
384,130,20065,10,4,0,3,0,17,1,2,10,9,0,22,nowin,win,dlbust,bust,20,0,14,219,0.410958904,0.03652968,0.566210046,0,0.025888739
385,150,20065,6,4,10,0,0,20,1,2,10,9,0,22,nowin,win,dlbust,bust,20,0,10,192,0.401041667,0.036458333,0.567708333,0,0.023287458
386,79,20065,3,5,10,0,0,18,1,2,10,9,0,22,nowin,win,dlbust,bust,20,0,8,211,0.436018957,0.028436019,0.672985782,2,0.650131054
387,56,20065,4,8,0,10,0,22,1,2,10,9,0,22,nowin,loss,bust,plbust,0,10,12,175,0.4,0.057142857,0.582857143,0,0.026685297
388,66,20065,2,10,0,4,1,17,1,2,10,9,0,22,nowin,win,dlbust,bust,20,0,12,217,0.456221198,0.064516129,0.626728111,3,0.924304367
389,137,20065,9,6,0,8,0,23,1,2,10,9,0,22,nowin,loss,bust,plbust,0,10,15,194,0.417525773,0.046391753,0.536082474,1,0.276714602
390,146,20066,3,10,0,8,0,21,7,3,10,0,0,20,nowin,win,plwin,beat,20,0,13,221,0.43438914,0.040723982,0.542986425,1,0.290190091
391,12,20066,6,1,8,7,0,22,7,3,10,0,0,20,nowin,loss,bust,plbust,0,10,7,189,0.470899471,0.015873016,0.613756614,3,0.929171178
392,142,20066,9,10,0,0,0,19,7,3,10,0,0,20,nowin,loss,beat,dlwin,0,10,19,211,0.417061611,0.047393365,0.526066351,1,0.271531309
393,101,20066,11,2,5,0,0,18,7,3,10,0,0,20,nowin,loss,beat,dlwin,0,10,13,205,0.424390244,0.068292683,0.63902439,2,0.614740646
394,75,20066,4,6,4,10,0,24,7,3,10,0,0,20,nowin,loss,bust,plbust,0,10,10,191,0.418848168,0.052356021,0.570680628,0,0.029344702
395,106,20066,2,4,2,3,5,16,7,3,10,0,0,20,nowin,loss,beat,dlwin,0,10,6,192,0.411458333,0.026041667,0.557291667,0,0.023854304
396,25,20067,2,3,10,5,0,20,10,5,7,0,0,22,nowin,win,dlbust,bust,20,0,5,190,0.463157895,0.063157895,0.536842105,1,0.304401563
397,67,20067,9,10,0,0,0,19,10,5,7,0,0,22,nowin,win,dlbust,bust,20,0,19,195,0.369230769,0.041025641,0.569230769,0,0.014139427
398,5,20067,5,4,6,6,0,21,10,5,7,0,0,22,nowin,win,dlbust,bust,20,0,9,203,0.42364532,0.02955665,0.596059113,2,0.582508076
399,134,20067,9,9,0,0,0,18,10,5,7,0,0,22,nowin,win,dlbust,bust,20,0,18,185,0.443243243,0.021621622,0.545945946,1,0.296939509
400,134,20067,10,2,0,7,0,19,10,5,7,0,0,22,nowin,win,dlbust,bust,20,0,12,185,0.443243243,0.021621622,0.545945946,1,0.296939509
401,110,20067,8,9,0,0,0,17,10,5,7,0,0,22,nowin,win,dlbust,bust,20,0,17,192,0.416666667,0.046875,0.557291667,0,0.025413132
402,52,20068,10,5,0,5,0,20,10,6,10,0,0,26,nowin,win,dlbust,bust,20,0,15,217,0.414746544,0.02764977,0.599078341,2,0.576736024
403,42,20068,10,9,0,0,0,19,10,6,10,0,0,26,nowin,win,dlbust,bust,20,0,19,212,0.443396226,0.051886792,0.570754717,1,0.309181312
404,121,20068,10,10,0,0,0,20,10,6,10,0,0,26,nowin,win,dlbust,bust,20,0,20,195,0.456410256,0.025641026,0.512820513,1,0.288597791
405,53,20068,8,4,0,7,0,19,10,6,10,0,0,26,nowin,win,dlbust,bust,20,0,12,250,0.372,0.064,0.564,0,0.013687345
406,39,20068,10,2,0,4,1,17,10,6,10,0,0,26,nowin,win,dlbust,bust,20,0,12,191,0.429319372,0.062827225,0.57591623,0,0.033760763
407,2,20068,9,7,0,1,0,17,10,6,10,0,0,26,nowin,win,dlbust,bust,20,0,16,200,0.445,0.035,0.64,2,0.633962549
408,92,20069,5,11,5,0,0,21,6,10,6,0,0,22,nowin,win,dlbust,bust,20,0,16,186,0.446236559,0.059139785,0.564516129,1,0.307826125
409,89,20069,1,2,10,0,0,13,6,10,6,0,0,22,nowin,win,dlbust,bust,20,0,3,212,0.537735849,0.047169811,0.594339623,3,0.990167191
410,24,20069,7,3,6,0,0,16,6,10,6,0,0,22,nowin,win,dlbust,bust,20,0,10,207,0.458937198,0.048309179,0.570048309,1,0.318138014
411,82,20069,3,4,11,0,0,18,6,10,6,0,0,22,nowin,win,dlbust,bust,20,0,7,225,0.408888889,0.075555556,0.577777778,0,0.028101874
412,118,20069,11,8,0,0,0,19,6,10,6,0,0,22,nowin,win,dlbust,bust,20,0,19,216,0.393518519,0.037037037,0.555555556,0,0.018059873
413,42,20069,5,8,0,0,0,13,6,10,6,0,0,22,nowin,win,dlbust,bust,20,0,13,212,0.443396226,0.051886792,0.570754717,1,0.309181312
414,33,20070,4,5,8,0,0,17,11,7,0,0,0,18,nowin,loss,beat,dlwin,0,10,9,192,0.4375,0.057291667,0.625,2,0.616208916
415,18,20070,3,9,0,9,0,21,11,7,0,0,0,18,nowin,win,plwin,beat,20,0,12,182,0.461538462,0.043956044,0.587912088,3,0.892649374
416,104,20070,10,9,0,0,0,19,11,7,0,0,0,18,nowin,win,plwin,beat,20,0,19,209,0.363636364,0.052631579,0.593301435,0,0.018359419
417,35,20070,2,3,3,5,6,19,11,7,0,0,0,18,nowin,win,plwin,beat,20,0,5,202,0.410891089,0.044554455,0.633663366,2,0.598681573
418,95,20070,10,10,0,0,0,20,11,7,0,0,0,18,nowin,win,plwin,beat,20,0,20,218,0.412844037,0.04587156,0.559633028,0,0.024842385
419,48,20070,10,2,0,3,5,20,11,7,0,0,0,18,nowin,win,plwin,beat,20,0,12,203,0.413793103,0.019704433,0.600985222,2,0.577280801
420,92,20071,2,8,5,5,0,20,10,2,1,10,0,23,nowin,win,dlbust,bust,20,0,10,186,0.446236559,0.059139785,0.564516129,1,0.307826125
421,62,20071,7,10,0,0,0,17,10,2,1,10,0,23,nowin,win,dlbust,bust,20,0,17,178,0.370786517,0.028089888,0.54494382,0,0.008657722
422,73,20071,3,9,0,9,0,21,10,2,1,10,0,23,nowin,win,dlbust,bust,20,0,12,181,0.375690608,0.011049724,0.596685083,0,0.022795773
423,18,20071,10,10,0,0,0,20,10,2,1,10,0,23,nowin,win,dlbust,bust,20,0,20,182,0.461538462,0.043956044,0.587912088,3,0.892649374
424,133,20071,7,10,0,0,0,17,10,2,1,10,0,23,nowin,win,dlbust,bust,20,0,17,201,0.47761194,0.064676617,0.611940299,3,0.935428111
425,61,20071,2,10,0,3,10,25,10,2,1,10,0,23,nowin,loss,bust,plbust,0,10,12,194,0.427835052,0.077319588,0.603092784,2,0.591437139
426,145,20072,10,11,0,0,0,21,10,7,0,0,0,17,win,win,plwin,beat,25,0,21,188,0.441489362,0.031914894,0.622340426,2,0.617837093
427,126,20072,2,2,10,3,0,17,10,7,0,0,0,17,nowin,push,push,push,10,0,4,188,0.457446809,0.074468085,0.60106383,3,0.900633203
428,62,20072,2,8,11,0,0,21,10,7,0,0,0,17,nowin,win,plwin,beat,20,0,10,178,0.370786517,0.028089888,0.54494382,0,0.008657722
429,14,20072,9,10,0,0,0,19,10,7,0,0,0,17,nowin,win,plwin,beat,20,0,19,202,0.391089109,0.01980198,0.628712871,2,0.577264877
430,134,20072,10,10,0,0,0,20,10,7,0,0,0,17,nowin,win,plwin,beat,20,0,20,185,0.443243243,0.021621622,0.545945946,1,0.296939509
431,136,20072,6,3,8,0,0,17,10,7,0,0,0,17,nowin,push,push,push,10,0,9,194,0.396907216,0.025773196,0.597938144,0,0.029452644
432,50,20073,2,6,11,0,0,19,5,9,10,0,0,24,nowin,win,dlbust,bust,20,0,8,202,0.405940594,0.04950495,0.54950495,0,0.020296079
433,34,20073,4,5,10,0,0,19,5,9,10,0,0,24,nowin,win,dlbust,bust,20,0,9,202,0.5,0.079207921,0.618811881,3,0.968961434
434,113,20073,7,9,0,0,0,16,5,9,10,0,0,24,nowin,win,dlbust,bust,20,0,16,199,0.407035176,0.055276382,0.668341709,2,0.620695264
435,144,20073,2,8,8,0,0,18,5,9,10,0,0,24,nowin,win,dlbust,bust,20,0,10,202,0.386138614,0.054455446,0.564356436,0,0.018006244
436,74,20073,4,10,0,0,0,14,5,9,10,0,0,24,nowin,win,dlbust,bust,20,0,14,209,0.411483254,0.04784689,0.531100478,0,0.017448125
437,109,20073,10,3,0,0,0,13,5,9,10,0,0,24,nowin,win,dlbust,bust,20,0,13,221,0.461538462,0.058823529,0.597285068,3,0.901830309
438,138,20074,5,4,4,4,0,17,9,8,0,0,0,17,nowin,push,push,push,10,0,9,190,0.442105263,0.047368421,0.610526316,2,0.609711065
439,106,20074,5,8,0,7,0,20,9,8,0,0,0,17,nowin,win,plwin,beat,20,0,13,192,0.411458333,0.026041667,0.557291667,0,0.023854304
440,96,20074,7,11,0,0,0,18,9,8,0,0,0,17,nowin,win,plwin,beat,20,0,18,190,0.468421053,0.057894737,0.584210526,3,0.897263354
441,106,20074,4,3,10,0,0,17,9,8,0,0,0,17,nowin,push,push,push,10,0,7,192,0.411458333,0.026041667,0.557291667,0,0.023854304
442,119,20074,10,10,0,0,0,20,9,8,0,0,0,17,nowin,win,plwin,beat,20,0,20,190,0.405263158,0.068421053,0.515789474,0,0.011837158
443,100,20074,4,3,5,5,0,17,9,8,0,0,0,17,nowin,push,push,push,10,0,7,190,0.452631579,0.036842105,0.594736842,3,0.888671154
444,74,20075,4,10,0,0,0,14,5,10,7,0,0,22,nowin,win,dlbust,bust,20,0,14,209,0.411483254,0.04784689,0.531100478,0,0.017448125
445,52,20075,5,6,4,0,0,15,5,10,7,0,0,22,nowin,win,dlbust,bust,20,0,11,217,0.414746544,0.02764977,0.599078341,2,0.576736024
446,73,20075,7,10,0,0,0,17,5,10,7,0,0,22,nowin,win,dlbust,bust,20,0,17,181,0.375690608,0.011049724,0.596685083,0,0.022795773
447,51,20075,3,10,0,0,0,13,5,10,7,0,0,22,nowin,win,dlbust,bust,20,0,13,189,0.529100529,0.068783069,0.608465608,3,0.993665715
448,27,20075,7,11,0,0,0,18,5,10,7,0,0,22,nowin,win,dlbust,bust,20,0,18,178,0.370786517,0.016853933,0.573033708,0,0.015536309
449,72,20075,7,7,0,0,0,14,5,10,7,0,0,22,nowin,win,dlbust,bust,20,0,14,185,0.394594595,0.032432432,0.508108108,0,0.006763115
450,41,20076,3,4,9,8,0,24,1,5,10,7,0,23,nowin,loss,bust,plbust,0,10,7,192,0.364583333,0.036458333,0.520833333,0,0.00089702
451,131,20076,10,10,0,0,0,20,1,5,10,7,0,23,nowin,win,dlbust,bust,20,0,20,217,0.410138249,0.069124424,0.543778802,0,0.02015021
452,68,20076,4,7,10,0,0,21,1,5,10,7,0,23,nowin,win,dlbust,bust,20,0,11,205,0.434146341,0.029268293,0.6,2,0.59483189
453,39,20076,10,9,0,0,0,19,1,5,10,7,0,23,nowin,win,dlbust,bust,20,0,19,191,0.429319372,0.062827225,0.57591623,0,0.033760763
454,111,20076,9,2,5,8,0,24,1,5,10,7,0,23,nowin,loss,bust,plbust,0,10,11,180,0.433333333,0.055555556,0.611111111,2,0.602264492
455,124,20076,4,10,0,6,0,20,1,5,10,7,0,23,nowin,win,dlbust,bust,20,0,14,202,0.47029703,0.064356436,0.584158416,3,0.899458193
456,73,20077,9,10,0,0,0,19,2,8,2,2,6,20,nowin,loss,beat,dlwin,0,10,19,181,0.375690608,0.011049724,0.596685083,0,0.022795773
457,2,20077,10,6,0,0,0,16,2,8,2,2,6,20,nowin,loss,beat,dlwin,0,10,16,200,0.445,0.035,0.64,2,0.633962549
458,70,20077,10,5,0,0,0,15,2,8,2,2,6,20,nowin,loss,beat,dlwin,0,10,15,228,0.385964912,0.039473684,0.557017544,0,0.016157125
459,19,20077,7,10,0,0,0,17,2,8,2,2,6,20,nowin,loss,beat,dlwin,0,10,17,237,0.41350211,0.054852321,0.628691983,2,0.597373826
460,130,20077,3,10,0,0,0,13,2,8,2,2,6,20,nowin,loss,beat,dlwin,0,10,13,219,0.410958904,0.03652968,0.566210046,0,0.025888739
461,55,20077,6,10,0,0,0,16,2,8,2,2,6,20,nowin,loss,beat,dlwin,0,10,16,191,0.371727749,0.057591623,0.54973822,0,0.01011347
462,31,20078,5,10,0,0,0,15,5,3,10,0,0,18,nowin,loss,beat,dlwin,0,10,15,188,0.473404255,0.058510638,0.515957447,1,0.300306557
463,55,20078,7,6,0,0,0,13,5,3,10,0,0,18,nowin,loss,beat,dlwin,0,10,13,191,0.371727749,0.057591623,0.54973822,0,0.01011347
464,112,20078,6,2,8,0,0,16,5,3,10,0,0,18,nowin,loss,beat,dlwin,0,10,8,203,0.448275862,0.054187192,0.600985222,3,0.889576933
465,40,20078,3,2,10,0,0,15,5,3,10,0,0,18,nowin,loss,beat,dlwin,0,10,5,196,0.367346939,0.030612245,0.617346939,0,0.025358183
466,18,20078,11,1,8,0,0,20,5,3,10,0,0,18,nowin,win,plwin,beat,20,0,12,182,0.461538462,0.043956044,0.587912088,3,0.892649374
467,114,20078,9,10,0,0,0,19,5,3,10,0,0,18,nowin,win,plwin,beat,20,0,19,198,0.47979798,0.025252525,0.611111111,3,0.937232995
468,61,20079,8,5,0,0,0,13,3,2,11,9,0,25,nowin,win,dlbust,bust,20,0,13,194,0.427835052,0.077319588,0.603092784,2,0.591437139
469,134,20079,3,10,0,0,0,13,3,2,11,9,0,25,nowin,win,dlbust,bust,20,0,13,185,0.443243243,0.021621622,0.545945946,1,0.296939509
470,5,20079,11,7,0,0,0,18,3,2,11,9,0,25,nowin,win,dlbust,bust,20,0,18,203,0.42364532,0.02955665,0.596059113,2,0.582508076
471,34,20079,10,7,0,0,0,17,3,2,11,9,0,25,nowin,win,dlbust,bust,20,0,17,202,0.5,0.079207921,0.618811881,3,0.968961434
472,115,20079,10,5,0,0,0,15,3,2,11,9,0,25,nowin,win,dlbust,bust,20,0,15,194,0.427835052,0.041237113,0.592783505,2,0.583863602
473,115,20079,9,10,0,0,0,19,3,2,11,9,0,25,nowin,win,dlbust,bust,20,0,19,194,0.427835052,0.041237113,0.592783505,2,0.583863602
474,82,20080,2,10,0,10,0,22,11,5,4,0,0,20,nowin,loss,bust,plbust,0,10,12,225,0.408888889,0.075555556,0.577777778,0,0.028101874
475,60,20080,6,3,10,0,0,19,11,5,4,0,0,20,nowin,loss,beat,dlwin,0,10,9,227,0.418502203,0.022026432,0.559471366,0,0.026496258
476,70,20080,8,9,0,0,0,17,11,5,4,0,0,20,nowin,loss,beat,dlwin,0,10,17,228,0.385964912,0.039473684,0.557017544,0,0.016157125
477,145,20080,4,2,8,5,0,19,11,5,4,0,0,20,nowin,loss,beat,dlwin,0,10,6,188,0.441489362,0.031914894,0.622340426,2,0.617837093
478,53,20080,10,5,0,6,0,21,11,5,4,0,0,20,nowin,win,plwin,beat,20,0,15,250,0.372,0.064,0.564,0,0.013687345
479,42,20080,10,10,0,0,0,20,11,5,4,0,0,20,nowin,push,push,push,10,0,20,212,0.443396226,0.051886792,0.570754717,1,0.309181312
480,34,20081,7,4,10,0,0,21,7,9,3,0,0,19,nowin,win,plwin,beat,20,0,11,202,0.5,0.079207921,0.618811881,3,0.968961434
481,145,20081,2,11,6,0,0,19,7,9,3,0,0,19,nowin,push,push,push,10,0,13,188,0.441489362,0.031914894,0.622340426,2,0.617837093
482,104,20081,5,10,0,10,0,25,7,9,3,0,0,19,nowin,loss,bust,plbust,0,10,15,209,0.363636364,0.052631579,0.593301435,0,0.018359419
483,122,20081,10,8,0,0,0,18,7,9,3,0,0,19,nowin,loss,beat,dlwin,0,10,18,210,0.347619048,0.052380952,0.59047619,0,0.012873677
484,95,20081,11,7,0,0,0,18,7,9,3,0,0,19,nowin,loss,beat,dlwin,0,10,18,218,0.412844037,0.04587156,0.559633028,0,0.024842385
485,11,20081,10,10,0,0,0,20,7,9,3,0,0,19,nowin,win,plwin,beat,20,0,20,236,0.457627119,0.016949153,0.588983051,3,0.889015813
486,103,20082,9,9,0,0,0,18,2,4,10,10,0,26,nowin,win,dlbust,bust,20,0,18,203,0.379310345,0.064039409,0.551724138,0,0.012869209
487,116,20082,10,10,0,0,0,20,2,4,10,10,0,26,nowin,win,dlbust,bust,20,0,20,195,0.425641026,0.056410256,0.538461538,1,0.28273747
488,99,20082,3,8,8,0,0,19,2,4,10,10,0,26,nowin,win,dlbust,bust,20,0,11,207,0.47826087,0.062801932,0.637681159,3,0.961418446
489,81,20082,10,10,0,0,0,20,2,4,10,10,0,26,nowin,win,dlbust,bust,20,0,20,182,0.395604396,0.043956044,0.60989011,2,0.567491261
490,146,20082,3,10,0,0,0,13,2,4,10,10,0,26,nowin,win,dlbust,bust,20,0,13,221,0.43438914,0.040723982,0.542986425,1,0.290190091
491,6,20082,6,2,2,7,0,17,2,4,10,10,0,26,nowin,win,dlbust,bust,20,0,8,191,0.439790576,0.047120419,0.581151832,1,0.31211505
492,14,20083,11,9,0,0,0,20,10,5,3,0,0,18,nowin,win,plwin,beat,20,0,20,202,0.391089109,0.01980198,0.628712871,2,0.577264877
493,112,20083,9,4,0,10,0,23,10,5,3,0,0,18,nowin,loss,bust,plbust,0,10,13,203,0.448275862,0.054187192,0.600985222,3,0.889576933
494,79,20083,10,9,0,0,0,19,10,5,3,0,0,18,nowin,win,plwin,beat,20,0,19,211,0.436018957,0.028436019,0.672985782,2,0.650131054
495,111,20083,7,3,5,5,0,20,10,5,3,0,0,18,nowin,win,plwin,beat,20,0,10,180,0.433333333,0.055555556,0.611111111,2,0.602264492
496,24,20083,10,10,0,0,0,20,10,5,3,0,0,18,nowin,win,plwin,beat,20,0,20,207,0.458937198,0.048309179,0.570048309,1,0.318138014
497,94,20083,10,10,0,0,0,20,10,5,3,0,0,18,nowin,win,plwin,beat,20,0,20,183,0.43715847,0.043715847,0.540983607,1,0.290866892
498,130,20084,2,7,7,9,0,25,10,5,10,0,0,25,nowin,loss,bust,plbust,0,10,9,219,0.410958904,0.03652968,0.566210046,0,0.025888739
499,23,20084,3,8,9,0,0,20,10,5,10,0,0,25,nowin,win,dlbust,bust,20,0,11,208,0.427884615,0.0625,0.552884615,1,0.29114424
500,73,20084,3,10,0,10,0,23,10,5,10,0,0,25,nowin,loss,bust,plbust,0,10,13,181,0.375690608,0.011049724,0.596685083,0,0.022795773
501,124,20084,11,8,0,0,0,19,10,5,10,0,0,25,nowin,win,dlbust,bust,20,0,19,202,0.47029703,0.064356436,0.584158416,3,0.899458193
502,142,20084,2,9,3,10,0,24,10,5,10,0,0,25,nowin,loss,bust,plbust,0,10,11,211,0.417061611,0.047393365,0.526066351,1,0.271531309
503,109,20084,7,11,0,0,0,18,10,5,10,0,0,25,nowin,win,dlbust,bust,20,0,18,221,0.461538462,0.058823529,0.597285068,3,0.901830309
504,148,20085,5,10,0,1,10,26,9,10,0,0,0,19,nowin,loss,bust,plbust,0,10,15,204,0.401960784,0.078431373,0.593137255,0,0.029789521
505,1,20085,7,10,0,0,0,17,9,10,0,0,0,19,nowin,loss,beat,dlwin,0,10,17,197,0.406091371,0.025380711,0.649746193,2,0.606186955
506,89,20085,5,5,10,0,0,20,9,10,0,0,0,19,nowin,win,plwin,beat,20,0,10,212,0.537735849,0.047169811,0.594339623,3,0.990167191
507,34,20085,2,6,6,10,0,24,9,10,0,0,0,19,nowin,loss,bust,plbust,0,10,8,202,0.5,0.079207921,0.618811881,3,0.968961434
508,1,20085,10,3,0,8,0,21,9,10,0,0,0,19,nowin,win,plwin,beat,20,0,13,197,0.406091371,0.025380711,0.649746193,2,0.606186955
509,60,20085,8,10,0,0,0,18,9,10,0,0,0,19,nowin,loss,beat,dlwin,0,10,18,227,0.418502203,0.022026432,0.559471366,0,0.026496258
510,1,20086,2,2,11,1,10,26,11,10,0,0,0,21,nowin,loss,bust,plbust,0,10,4,197,0.406091371,0.025380711,0.649746193,2,0.606186955
511,74,20086,10,4,0,9,0,23,11,10,0,0,0,21,nowin,loss,bust,plbust,0,10,14,209,0.411483254,0.04784689,0.531100478,0,0.017448125
512,36,20086,6,10,0,10,0,26,11,10,0,0,0,21,nowin,loss,bust,plbust,0,10,16,229,0.445414847,0.056768559,0.655021834,2,0.645370571
513,14,20086,8,8,0,10,0,26,11,10,0,0,0,21,nowin,loss,bust,plbust,0,10,16,202,0.391089109,0.01980198,0.628712871,2,0.577264877
514,135,20086,3,8,5,10,0,26,11,10,0,0,0,21,nowin,loss,bust,plbust,0,10,11,179,0.391061453,0.067039106,0.586592179,0,0.024924662
515,30,20086,4,10,0,9,0,23,11,10,0,0,0,21,nowin,loss,bust,plbust,0,10,14,206,0.393203883,0.033980583,0.601941748,0,0.029324648
516,16,20087,10,9,0,0,0,19,10,10,0,0,0,20,nowin,loss,beat,dlwin,0,10,19,220,0.427272727,0.081818182,0.6,2,0.588660176
517,122,20087,10,10,0,0,0,20,10,10,0,0,0,20,nowin,push,push,push,10,0,20,210,0.347619048,0.052380952,0.59047619,0,0.012873677
518,83,20087,4,5,10,0,0,19,10,10,0,0,0,20,nowin,loss,beat,dlwin,0,10,9,193,0.424870466,0.051813472,0.678756477,2,0.644360335
519,39,20087,5,5,4,8,0,22,10,10,0,0,0,20,nowin,loss,bust,plbust,0,10,10,191,0.429319372,0.062827225,0.57591623,0,0.033760763
520,93,20087,4,10,0,9,0,23,10,10,0,0,0,20,nowin,loss,bust,plbust,0,10,14,175,0.485714286,0.051428571,0.548571429,1,0.323648091
521,33,20087,4,1,7,2,2,16,10,10,0,0,0,20,nowin,loss,beat,dlwin,0,10,5,192,0.4375,0.057291667,0.625,2,0.616208916
522,15,20088,9,10,0,0,0,19,6,11,0,0,0,17,nowin,win,plwin,beat,20,0,19,212,0.410377358,0.051886792,0.561320755,0,0.024517408
523,130,20088,11,1,2,0,0,14,6,11,0,0,0,17,nowin,loss,beat,dlwin,0,10,12,219,0.410958904,0.03652968,0.566210046,0,0.025888739
524,90,20088,6,9,0,0,0,15,6,11,0,0,0,17,nowin,loss,beat,dlwin,0,10,15,201,0.447761194,0.049751244,0.60199005,3,0.889945023
525,97,20088,10,2,0,0,0,12,6,11,0,0,0,17,nowin,loss,beat,dlwin,0,10,12,182,0.450549451,0.06043956,0.692307692,2,0.677372279
526,19,20088,10,4,0,0,0,14,6,11,0,0,0,17,nowin,loss,beat,dlwin,0,10,14,237,0.41350211,0.054852321,0.628691983,2,0.597373826
527,142,20088,4,10,0,0,0,14,6,11,0,0,0,17,nowin,loss,beat,dlwin,0,10,14,211,0.417061611,0.047393365,0.526066351,1,0.271531309
528,111,20089,9,4,0,0,0,13,5,10,6,0,0,21,nowin,loss,beat,dlwin,0,10,13,180,0.433333333,0.055555556,0.611111111,2,0.602264492
529,63,20089,8,3,3,0,0,14,5,10,6,0,0,21,nowin,loss,beat,dlwin,0,10,11,216,0.467592593,0.037037037,0.62037037,3,0.931690496
530,73,20089,3,10,0,0,0,13,5,10,6,0,0,21,nowin,loss,beat,dlwin,0,10,13,181,0.375690608,0.011049724,0.596685083,0,0.022795773
531,141,20089,10,5,0,0,0,15,5,10,6,0,0,21,nowin,loss,beat,dlwin,0,10,15,202,0.420792079,0.074257426,0.564356436,0,0.028377851
532,95,20089,3,2,7,0,0,12,5,10,6,0,0,21,nowin,loss,beat,dlwin,0,10,5,218,0.412844037,0.04587156,0.559633028,0,0.024842385
533,116,20089,3,7,3,0,0,13,5,10,6,0,0,21,nowin,loss,beat,dlwin,0,10,10,195,0.425641026,0.056410256,0.538461538,1,0.28273747
534,120,20090,2,5,8,10,0,25,10,2,10,0,0,22,nowin,loss,bust,plbust,0,10,7,202,0.440594059,0.034653465,0.618811881,2,0.614441029
535,69,20090,2,10,0,2,4,18,10,2,10,0,0,22,nowin,win,dlbust,bust,20,0,12,194,0.365979381,0.030927835,0.515463918,0,0
536,24,20090,4,3,4,4,10,25,10,2,10,0,0,22,nowin,loss,bust,plbust,0,10,7,207,0.458937198,0.048309179,0.570048309,1,0.318138014
537,71,20090,10,10,0,0,0,20,10,2,10,0,0,22,nowin,win,dlbust,bust,20,0,20,193,0.352331606,0.046632124,0.585492228,0,0.013063661
538,111,20090,10,9,0,0,0,19,10,2,10,0,0,22,nowin,win,dlbust,bust,20,0,19,180,0.433333333,0.055555556,0.611111111,2,0.602264492
539,34,20090,10,5,0,2,0,17,10,2,10,0,0,22,nowin,win,dlbust,bust,20,0,15,202,0.5,0.079207921,0.618811881,3,0.968961434
540,51,20091,2,10,0,4,4,20,9,10,0,0,0,19,nowin,win,plwin,beat,20,0,12,189,0.529100529,0.068783069,0.608465608,3,0.993665715
541,148,20091,10,10,0,0,0,20,9,10,0,0,0,19,nowin,win,plwin,beat,20,0,20,204,0.401960784,0.078431373,0.593137255,0,0.029789521
542,69,20091,6,4,2,5,0,17,9,10,0,0,0,19,nowin,loss,beat,dlwin,0,10,10,194,0.365979381,0.030927835,0.515463918,0,0
543,17,20091,7,10,0,0,0,17,9,10,0,0,0,19,nowin,loss,beat,dlwin,0,10,17,171,0.444444444,0.070175439,0.555555556,1,0.302364894
544,21,20091,6,1,10,0,0,17,9,10,0,0,0,19,nowin,loss,beat,dlwin,0,10,7,214,0.359813084,0.042056075,0.626168224,0,0.025263474
545,11,20091,6,8,0,2,6,22,9,10,0,0,0,19,nowin,loss,bust,plbust,0,10,14,236,0.457627119,0.016949153,0.588983051,3,0.889015813
546,147,20092,9,9,0,0,0,18,10,6,8,0,0,24,nowin,win,dlbust,bust,20,0,18,205,0.380487805,0.014634146,0.536585366,0,0.00951447
547,11,20092,5,1,10,6,0,22,10,6,8,0,0,24,nowin,loss,bust,plbust,0,10,6,236,0.457627119,0.016949153,0.588983051,3,0.889015813
548,93,20092,5,6,4,3,0,18,10,6,8,0,0,24,nowin,win,dlbust,bust,20,0,11,175,0.485714286,0.051428571,0.548571429,1,0.323648091
549,4,20092,9,7,0,2,0,18,10,6,8,0,0,24,nowin,win,dlbust,bust,20,0,16,217,0.460829493,0.036866359,0.562211982,1,0.315432839
550,143,20092,8,7,0,10,0,25,10,6,8,0,0,24,nowin,loss,bust,plbust,0,10,15,203,0.463054187,0.044334975,0.57635468,3,0.883143365
551,127,20092,3,5,10,0,0,18,10,6,8,0,0,24,nowin,win,dlbust,bust,20,0,8,201,0.402985075,0.029850746,0.60199005,0,0.032263937
552,12,20093,11,7,0,0,0,18,10,7,0,0,0,17,nowin,win,plwin,beat,20,0,18,189,0.470899471,0.015873016,0.613756614,3,0.929171178
553,5,20093,4,6,4,10,0,24,10,7,0,0,0,17,nowin,loss,bust,plbust,0,10,10,203,0.42364532,0.02955665,0.596059113,2,0.582508076
554,27,20093,9,6,0,8,0,23,10,7,0,0,0,17,nowin,loss,bust,plbust,0,10,15,178,0.370786517,0.016853933,0.573033708,0,0.015536309
555,119,20093,4,10,0,2,2,18,10,7,0,0,0,17,nowin,win,plwin,beat,20,0,14,190,0.405263158,0.068421053,0.515789474,0,0.011837158
556,37,20093,11,2,2,6,0,21,10,7,0,0,0,17,nowin,win,plwin,beat,20,0,13,208,0.394230769,0.038461538,0.581730769,0,0.024682772
557,45,20093,5,10,0,1,10,26,10,7,0,0,0,17,nowin,loss,bust,plbust,0,10,15,196,0.428571429,0.051020408,0.612244898,2,0.598821767
558,3,20094,9,6,0,10,0,25,10,10,0,0,0,20,nowin,loss,bust,plbust,0,10,15,190,0.431578947,0.026315789,0.542105263,1,0.288076384
559,116,20094,11,7,0,0,0,18,10,10,0,0,0,20,nowin,loss,beat,dlwin,0,10,18,195,0.425641026,0.056410256,0.538461538,1,0.28273747
560,85,20094,7,10,0,0,0,17,10,10,0,0,0,20,nowin,loss,beat,dlwin,0,10,17,195,0.41025641,0.066666667,0.594871795,0,0.03269711
561,52,20094,5,10,0,3,0,18,10,10,0,0,0,20,nowin,loss,beat,dlwin,0,10,15,217,0.414746544,0.02764977,0.599078341,2,0.576736024
562,35,20094,8,9,0,0,0,17,10,10,0,0,0,20,nowin,loss,beat,dlwin,0,10,17,202,0.410891089,0.044554455,0.633663366,2,0.598681573
563,131,20094,3,7,9,0,0,19,10,10,0,0,0,20,nowin,loss,beat,dlwin,0,10,10,217,0.410138249,0.069124424,0.543778802,0,0.02015021
564,4,20095,5,10,0,0,0,15,3,10,1,3,0,17,nowin,loss,beat,dlwin,0,10,15,217,0.460829493,0.036866359,0.562211982,1,0.315432839
565,115,20095,10,10,0,0,0,20,3,10,1,3,0,17,nowin,win,plwin,beat,20,0,20,194,0.427835052,0.041237113,0.592783505,2,0.583863602
566,53,20095,8,8,0,0,0,16,3,10,1,3,0,17,nowin,loss,beat,dlwin,0,10,16,250,0.372,0.064,0.564,0,0.013687345
567,83,20095,3,9,0,10,0,22,3,10,1,3,0,17,nowin,loss,bust,plbust,0,10,12,193,0.424870466,0.051813472,0.678756477,2,0.644360335
568,60,20095,2,10,0,1,0,13,3,10,1,3,0,17,nowin,loss,beat,dlwin,0,10,12,227,0.418502203,0.022026432,0.559471366,0,0.026496258
569,92,20095,4,2,10,0,0,16,3,10,1,3,0,17,nowin,loss,beat,dlwin,0,10,6,186,0.446236559,0.059139785,0.564516129,1,0.307826125
570,118,20096,4,9,0,7,0,20,8,10,0,0,0,18,nowin,win,plwin,beat,20,0,13,216,0.393518519,0.037037037,0.555555556,0,0.018059873
571,144,20096,2,2,5,7,10,26,8,10,0,0,0,18,nowin,loss,bust,plbust,0,10,4,202,0.386138614,0.054455446,0.564356436,0,0.018006244
572,15,20096,10,9,0,0,0,19,8,10,0,0,0,18,nowin,win,plwin,beat,20,0,19,212,0.410377358,0.051886792,0.561320755,0,0.024517408
573,21,20096,10,6,0,2,0,18,8,10,0,0,0,18,nowin,push,push,push,10,0,16,214,0.359813084,0.042056075,0.626168224,0,0.025263474
574,90,20096,8,8,0,2,0,18,8,10,0,0,0,18,nowin,push,push,push,10,0,16,201,0.447761194,0.049751244,0.60199005,3,0.889945023
575,140,20096,10,11,0,0,0,21,8,10,0,0,0,18,win,win,plwin,beat,25,0,21,210,0.466666667,0.023809524,0.604761905,3,0.915293335
576,149,20097,2,9,10,0,0,21,8,7,7,0,0,22,nowin,win,dlbust,bust,20,0,11,225,0.457777778,0.057777778,0.648888889,2,0.651965595
577,26,20097,5,10,0,10,0,25,8,7,7,0,0,22,nowin,loss,bust,plbust,0,10,15,203,0.463054187,0.0591133,0.541871921,1,0.306802864
578,141,20097,9,11,0,0,0,20,8,7,7,0,0,22,nowin,win,dlbust,bust,20,0,20,202,0.420792079,0.074257426,0.564356436,0,0.028377851
579,2,20097,10,10,0,0,0,20,8,7,7,0,0,22,nowin,win,dlbust,bust,20,0,20,200,0.445,0.035,0.64,2,0.633962549
580,92,20097,4,9,0,10,0,23,8,7,7,0,0,22,nowin,loss,bust,plbust,0,10,13,186,0.446236559,0.059139785,0.564516129,1,0.307826125
581,5,20097,11,9,0,0,0,20,8,7,7,0,0,22,nowin,win,dlbust,bust,20,0,20,203,0.42364532,0.02955665,0.596059113,2,0.582508076
582,148,20098,10,7,0,0,0,17,10,11,0,0,0,21,nowin,loss,beat,dlwin,0,10,17,204,0.401960784,0.078431373,0.593137255,0,0.029789521
583,69,20098,6,8,0,2,10,26,10,11,0,0,0,21,nowin,loss,bust,plbust,0,10,14,194,0.365979381,0.030927835,0.515463918,0,0
584,141,20098,10,6,0,10,0,26,10,11,0,0,0,21,nowin,loss,bust,plbust,0,10,16,202,0.420792079,0.074257426,0.564356436,0,0.028377851
585,97,20098,11,8,0,0,0,19,10,11,0,0,0,21,nowin,loss,beat,dlwin,0,10,19,182,0.450549451,0.06043956,0.692307692,2,0.677372279
586,24,20098,10,9,0,0,0,19,10,11,0,0,0,21,nowin,loss,beat,dlwin,0,10,19,207,0.458937198,0.048309179,0.570048309,1,0.318138014
587,89,20098,3,10,0,3,7,23,10,11,0,0,0,21,nowin,loss,bust,plbust,0,10,13,212,0.537735849,0.047169811,0.594339623,3,0.990167191
588,17,20099,4,3,9,0,0,16,3,9,10,0,0,22,nowin,win,dlbust,bust,20,0,7,171,0.444444444,0.070175439,0.555555556,1,0.302364894
589,37,20099,10,10,0,0,0,20,3,9,10,0,0,22,nowin,win,dlbust,bust,20,0,20,208,0.394230769,0.038461538,0.581730769,0,0.024682772
590,23,20099,4,11,6,0,0,21,3,9,10,0,0,22,nowin,win,dlbust,bust,20,0,15,208,0.427884615,0.0625,0.552884615,1,0.29114424
591,19,20099,10,9,0,0,0,19,3,9,10,0,0,22,nowin,win,dlbust,bust,20,0,19,237,0.41350211,0.054852321,0.628691983,2,0.597373826
592,107,20099,5,4,8,0,0,17,3,9,10,0,0,22,nowin,win,dlbust,bust,20,0,9,218,0.444954128,0.073394495,0.600917431,2,0.605210014
593,44,20099,9,11,0,0,0,20,3,9,10,0,0,22,nowin,win,dlbust,bust,20,0,20,219,0.433789954,0.050228311,0.534246575,1,0.285551035
594,15,20100,10,7,0,0,0,17,10,2,10,0,0,22,nowin,win,dlbust,bust,20,0,17,212,0.410377358,0.051886792,0.561320755,0,0.024517408
595,11,20100,2,4,3,4,8,21,10,2,10,0,0,22,nowin,win,dlbust,bust,20,0,6,236,0.457627119,0.016949153,0.588983051,3,0.889015813
596,132,20100,4,7,10,0,0,21,10,2,10,0,0,22,nowin,win,dlbust,bust,20,0,11,194,0.412371134,0.036082474,0.649484536,2,0.611633238
597,49,20100,5,2,11,0,0,18,10,2,10,0,0,22,nowin,win,dlbust,bust,20,0,7,207,0.396135266,0.053140097,0.594202899,0,0.028306925
598,23,20100,3,2,3,3,10,21,10,2,10,0,0,22,nowin,win,dlbust,bust,20,0,5,208,0.427884615,0.0625,0.552884615,1,0.29114424
599,144,20100,11,10,0,0,0,21,10,2,10,0,0,22,win,win,dlbust,bust,25,0,21,202,0.386138614,0.054455446,0.564356436,0,0.018006244
600,148,20101,9,9,0,0,0,18,1,4,10,10,0,25,nowin,win,dlbust,bust,20,0,18,204,0.401960784,0.078431373,0.593137255,0,0.029789521
601,69,20101,9,11,0,0,0,20,1,4,10,10,0,25,nowin,win,dlbust,bust,20,0,20,194,0.365979381,0.030927835,0.515463918,0,0
602,97,20101,8,10,0,0,0,18,1,4,10,10,0,25,nowin,win,dlbust,bust,20,0,18,182,0.450549451,0.06043956,0.692307692,2,0.677372279
603,4,20101,11,7,0,0,0,18,1,4,10,10,0,25,nowin,win,dlbust,bust,20,0,18,217,0.460829493,0.036866359,0.562211982,1,0.315432839
604,123,20101,6,1,10,0,0,17,1,4,10,10,0,25,nowin,win,dlbust,bust,20,0,7,205,0.43902439,0.034146341,0.614634146,2,0.609962544
605,83,20101,2,11,2,4,0,19,1,4,10,10,0,25,nowin,win,dlbust,bust,20,0,13,193,0.424870466,0.051813472,0.678756477,2,0.644360335
606,112,20102,8,11,0,0,0,19,10,6,4,0,0,20,nowin,loss,beat,dlwin,0,10,19,203,0.448275862,0.054187192,0.600985222,3,0.889576933
607,67,20102,2,10,0,5,0,17,10,6,4,0,0,20,nowin,loss,beat,dlwin,0,10,12,195,0.369230769,0.041025641,0.569230769,0,0.014139427
608,82,20102,6,9,0,10,0,25,10,6,4,0,0,20,nowin,loss,bust,plbust,0,10,15,225,0.408888889,0.075555556,0.577777778,0,0.028101874
609,69,20102,8,8,0,6,0,22,10,6,4,0,0,20,nowin,loss,bust,plbust,0,10,16,194,0.365979381,0.030927835,0.515463918,0,0
610,101,20102,2,2,10,8,0,22,10,6,4,0,0,20,nowin,loss,bust,plbust,0,10,4,205,0.424390244,0.068292683,0.63902439,2,0.614740646
611,50,20102,7,10,0,0,0,17,10,6,4,0,0,20,nowin,loss,beat,dlwin,0,10,17,202,0.405940594,0.04950495,0.54950495,0,0.020296079
612,149,20103,5,2,10,0,0,17,10,5,8,0,0,23,nowin,win,dlbust,bust,20,0,7,225,0.457777778,0.057777778,0.648888889,2,0.651965595
613,94,20103,6,3,7,8,0,24,10,5,8,0,0,23,nowin,loss,bust,plbust,0,10,9,183,0.43715847,0.043715847,0.540983607,1,0.290866892
614,147,20103,4,10,0,4,0,18,10,5,8,0,0,23,nowin,win,dlbust,bust,20,0,14,205,0.380487805,0.014634146,0.536585366,0,0.00951447
615,68,20103,10,8,0,0,0,18,10,5,8,0,0,23,nowin,win,dlbust,bust,20,0,18,205,0.434146341,0.029268293,0.6,2,0.59483189
616,59,20103,10,10,0,0,0,20,10,5,8,0,0,23,nowin,win,dlbust,bust,20,0,20,228,0.429824561,0.048245614,0.543859649,1,0.287885446
617,85,20103,10,11,0,0,0,21,10,5,8,0,0,23,win,win,dlbust,bust,25,0,21,195,0.41025641,0.066666667,0.594871795,0,0.03269711
618,114,20104,10,10,0,0,0,20,9,10,0,0,0,19,nowin,win,plwin,beat,20,0,20,198,0.47979798,0.025252525,0.611111111,3,0.937232995
619,5,20104,5,10,0,3,0,18,9,10,0,0,0,19,nowin,loss,beat,dlwin,0,10,15,203,0.42364532,0.02955665,0.596059113,2,0.582508076
620,40,20104,10,5,0,4,0,19,9,10,0,0,0,19,nowin,push,push,push,10,0,15,196,0.367346939,0.030612245,0.617346939,0,0.025358183
621,102,20104,11,1,6,0,0,18,9,10,0,0,0,19,nowin,loss,beat,dlwin,0,10,12,192,0.338541667,0.046875,0.5625,0,0.003306118
622,13,20104,7,11,0,0,0,18,9,10,0,0,0,19,nowin,loss,beat,dlwin,0,10,18,206,0.417475728,0.063106796,0.621359223,2,0.59555479
623,148,20104,10,10,0,0,0,20,9,10,0,0,0,19,nowin,win,plwin,beat,20,0,20,204,0.401960784,0.078431373,0.593137255,0,0.029789521
624,142,20105,10,10,0,0,0,20,8,3,9,0,0,20,nowin,push,push,push,10,0,20,211,0.417061611,0.047393365,0.526066351,1,0.271531309
625,57,20105,7,6,0,10,0,23,8,3,9,0,0,20,nowin,loss,bust,plbust,0,10,13,192,0.46875,0.052083333,0.59375,3,0.907001181
626,126,20105,7,9,0,10,0,26,8,3,9,0,0,20,nowin,loss,bust,plbust,0,10,16,188,0.457446809,0.074468085,0.60106383,3,0.900633203
627,114,20105,2,11,2,6,0,21,8,3,9,0,0,20,nowin,win,plwin,beat,20,0,13,198,0.47979798,0.025252525,0.611111111,3,0.937232995
628,21,20105,10,10,0,0,0,20,8,3,9,0,0,20,nowin,push,push,push,10,0,20,214,0.359813084,0.042056075,0.626168224,0,0.025263474
629,88,20105,2,10,0,7,0,19,8,3,9,0,0,20,nowin,loss,beat,dlwin,0,10,12,206,0.466019417,0.033980583,0.54368932,1,0.309467903
630,100,20106,10,7,0,0,0,17,5,8,10,0,0,23,nowin,win,dlbust,bust,20,0,17,190,0.452631579,0.036842105,0.594736842,3,0.888671154
631,122,20106,10,2,0,0,0,12,5,8,10,0,0,23,nowin,win,dlbust,bust,20,0,12,210,0.347619048,0.052380952,0.59047619,0,0.012873677
632,13,20106,10,4,0,0,0,14,5,8,10,0,0,23,nowin,win,dlbust,bust,20,0,14,206,0.417475728,0.063106796,0.621359223,2,0.59555479
633,45,20106,6,1,10,0,0,17,5,8,10,0,0,23,nowin,win,dlbust,bust,20,0,7,196,0.428571429,0.051020408,0.612244898,2,0.598821767
634,86,20106,10,4,0,0,0,14,5,8,10,0,0,23,nowin,win,dlbust,bust,20,0,14,196,0.454081633,0.040816327,0.591836735,3,0.887566443
635,55,20106,8,10,0,0,0,18,5,8,10,0,0,23,nowin,win,dlbust,bust,20,0,18,191,0.371727749,0.057591623,0.54973822,0,0.01011347
636,75,20107,5,2,4,5,10,26,9,9,0,0,0,18,nowin,loss,bust,plbust,0,10,7,191,0.418848168,0.052356021,0.570680628,0,0.029344702
637,104,20107,4,10,0,10,0,24,9,9,0,0,0,18,nowin,loss,bust,plbust,0,10,14,209,0.363636364,0.052631579,0.593301435,0,0.018359419
638,106,20107,9,11,0,0,0,20,9,9,0,0,0,18,nowin,win,plwin,beat,20,0,20,192,0.411458333,0.026041667,0.557291667,0,0.023854304
639,90,20107,11,1,5,0,0,17,9,9,0,0,0,18,nowin,loss,beat,dlwin,0,10,12,201,0.447761194,0.049751244,0.60199005,3,0.889945023
640,7,20107,4,5,9,0,0,18,9,9,0,0,0,18,nowin,push,push,push,10,0,9,183,0.442622951,0.06010929,0.62295082,2,0.619303341
641,53,20107,8,10,0,0,0,18,9,9,0,0,0,18,nowin,push,push,push,10,0,18,250,0.372,0.064,0.564,0,0.013687345
642,14,20108,4,8,0,0,0,12,4,7,3,9,0,23,nowin,win,dlbust,bust,20,0,12,202,0.391089109,0.01980198,0.628712871,2,0.577264877
643,130,20108,9,4,0,0,0,13,4,7,3,9,0,23,nowin,win,dlbust,bust,20,0,13,219,0.410958904,0.03652968,0.566210046,0,0.025888739
644,41,20108,6,10,0,0,0,16,4,7,3,9,0,23,nowin,win,dlbust,bust,20,0,16,192,0.364583333,0.036458333,0.520833333,0,0.00089702
645,55,20108,11,3,6,0,0,20,4,7,3,9,0,23,nowin,win,dlbust,bust,20,0,14,191,0.371727749,0.057591623,0.54973822,0,0.01011347
646,13,20108,10,10,0,0,0,20,4,7,3,9,0,23,nowin,win,dlbust,bust,20,0,20,206,0.417475728,0.063106796,0.621359223,2,0.59555479
647,115,20108,10,10,0,0,0,20,4,7,3,9,0,23,nowin,win,dlbust,bust,20,0,20,194,0.427835052,0.041237113,0.592783505,2,0.583863602
648,45,20109,10,3,0,0,0,13,6,11,0,0,0,17,nowin,loss,beat,dlwin,0,10,13,196,0.428571429,0.051020408,0.612244898,2,0.598821767
649,108,20109,10,2,0,0,0,12,6,11,0,0,0,17,nowin,loss,beat,dlwin,0,10,12,193,0.435233161,0.056994819,0.559585492,1,0.298824795
650,47,20109,3,3,5,10,0,21,6,11,0,0,0,17,nowin,win,plwin,beat,20,0,6,210,0.438095238,0.057142857,0.623809524,2,0.615868808
651,16,20109,3,9,0,0,0,12,6,11,0,0,0,17,nowin,loss,beat,dlwin,0,10,12,220,0.427272727,0.081818182,0.6,2,0.588660176
652,147,20109,9,11,0,0,0,20,6,11,0,0,0,17,nowin,win,plwin,beat,20,0,20,205,0.380487805,0.014634146,0.536585366,0,0.00951447
653,130,20109,10,2,0,0,0,12,6,11,0,0,0,17,nowin,loss,beat,dlwin,0,10,12,219,0.410958904,0.03652968,0.566210046,0,0.025888739
654,121,20110,10,10,0,0,0,20,10,5,9,0,0,24,nowin,win,dlbust,bust,20,0,20,195,0.456410256,0.025641026,0.512820513,1,0.288597791
655,150,20110,11,10,0,0,0,21,10,5,9,0,0,24,win,win,dlbust,bust,25,0,21,192,0.401041667,0.036458333,0.567708333,0,0.023287458
656,60,20110,10,10,0,0,0,20,10,5,9,0,0,24,nowin,win,dlbust,bust,20,0,20,227,0.418502203,0.022026432,0.559471366,0,0.026496258
657,13,20110,10,10,0,0,0,20,10,5,9,0,0,24,nowin,win,dlbust,bust,20,0,20,206,0.417475728,0.063106796,0.621359223,2,0.59555479
658,107,20110,11,1,5,0,0,17,10,5,9,0,0,24,nowin,win,dlbust,bust,20,0,12,218,0.444954128,0.073394495,0.600917431,2,0.605210014
659,119,20110,6,10,0,10,0,26,10,5,9,0,0,24,nowin,loss,bust,plbust,0,10,16,190,0.405263158,0.068421053,0.515789474,0,0.011837158
660,138,20111,5,2,5,0,0,12,6,11,0,0,0,17,nowin,loss,beat,dlwin,0,10,7,190,0.442105263,0.047368421,0.610526316,2,0.609711065
661,54,20111,4,3,3,3,0,13,6,11,0,0,0,17,nowin,loss,beat,dlwin,0,10,7,185,0.437837838,0.032432432,0.556756757,1,0.29899854
662,92,20111,8,8,0,0,0,16,6,11,0,0,0,17,nowin,loss,beat,dlwin,0,10,16,186,0.446236559,0.059139785,0.564516129,1,0.307826125
663,144,20111,1,4,9,0,0,14,6,11,0,0,0,17,nowin,loss,beat,dlwin,0,10,5,202,0.386138614,0.054455446,0.564356436,0,0.018006244
664,85,20111,10,10,0,0,0,20,6,11,0,0,0,17,nowin,win,plwin,beat,20,0,20,195,0.41025641,0.066666667,0.594871795,0,0.03269711
665,141,20111,4,10,0,0,0,14,6,11,0,0,0,17,nowin,loss,beat,dlwin,0,10,14,202,0.420792079,0.074257426,0.564356436,0,0.028377851
666,38,20112,6,6,0,0,0,12,5,7,7,0,0,19,nowin,loss,beat,dlwin,0,10,12,202,0.361386139,0.03960396,0.564356436,0,0.010597953
667,120,20112,3,10,0,0,0,13,5,7,7,0,0,19,nowin,loss,beat,dlwin,0,10,13,202,0.440594059,0.034653465,0.618811881,2,0.614441029
668,67,20112,3,4,11,0,0,18,5,7,7,0,0,19,nowin,loss,beat,dlwin,0,10,7,195,0.369230769,0.041025641,0.569230769,0,0.014139427
669,46,20112,4,10,0,0,0,14,5,7,7,0,0,19,nowin,loss,beat,dlwin,0,10,14,186,0.403225806,0.048387097,0.591397849,0,0.029742194
670,30,20112,8,10,0,0,0,18,5,7,7,0,0,19,nowin,loss,beat,dlwin,0,10,18,206,0.393203883,0.033980583,0.601941748,0,0.029324648
671,57,20112,6,1,10,0,0,17,5,7,7,0,0,19,nowin,loss,beat,dlwin,0,10,7,192,0.46875,0.052083333,0.59375,3,0.907001181
672,123,20113,2,10,0,4,8,24,8,7,6,0,0,21,nowin,loss,bust,plbust,0,10,12,205,0.43902439,0.034146341,0.614634146,2,0.609962544
673,6,20113,3,8,10,0,0,21,8,7,6,0,0,21,nowin,push,push,push,10,0,11,191,0.439790576,0.047120419,0.581151832,1,0.31211505
674,102,20113,4,2,3,2,3,14,8,7,6,0,0,21,nowin,loss,beat,dlwin,0,10,6,192,0.338541667,0.046875,0.5625,0,0.003306118
675,3,20113,7,4,10,0,0,21,8,7,6,0,0,21,nowin,push,push,push,10,0,11,190,0.431578947,0.026315789,0.542105263,1,0.288076384
676,37,20113,8,10,0,0,0,18,8,7,6,0,0,21,nowin,loss,beat,dlwin,0,10,18,208,0.394230769,0.038461538,0.581730769,0,0.024682772
677,114,20113,1,6,10,0,0,17,8,7,6,0,0,21,nowin,loss,beat,dlwin,0,10,7,198,0.47979798,0.025252525,0.611111111,3,0.937232995
678,81,20114,4,10,0,0,0,14,6,8,7,0,0,21,nowin,loss,beat,dlwin,0,10,14,182,0.395604396,0.043956044,0.60989011,2,0.567491261
679,1,20114,2,5,7,0,0,14,6,8,7,0,0,21,nowin,loss,beat,dlwin,0,10,7,197,0.406091371,0.025380711,0.649746193,2,0.606186955
680,12,20114,11,6,3,0,0,20,6,8,7,0,0,21,nowin,loss,beat,dlwin,0,10,17,189,0.470899471,0.015873016,0.613756614,3,0.929171178
681,28,20114,6,10,0,0,0,16,6,8,7,0,0,21,nowin,loss,beat,dlwin,0,10,16,199,0.422110553,0.045226131,0.542713568,1,0.282706618
682,91,20114,9,7,0,0,0,16,6,8,7,0,0,21,nowin,loss,beat,dlwin,0,10,16,194,0.417525773,0.046391753,0.515463918,1,0.266616552
683,124,20114,5,2,7,0,0,14,6,8,7,0,0,21,nowin,loss,beat,dlwin,0,10,7,202,0.47029703,0.064356436,0.584158416,3,0.899458193
684,47,20115,7,11,0,0,0,18,11,2,4,0,0,17,nowin,win,plwin,beat,20,0,18,210,0.438095238,0.057142857,0.623809524,2,0.615868808
685,121,20115,6,1,7,9,0,23,11,2,4,0,0,17,nowin,loss,bust,plbust,0,10,7,195,0.456410256,0.025641026,0.512820513,1,0.288597791
686,142,20115,8,3,9,0,0,20,11,2,4,0,0,17,nowin,win,plwin,beat,20,0,11,211,0.417061611,0.047393365,0.526066351,1,0.271531309
687,52,20115,10,10,0,0,0,20,11,2,4,0,0,17,nowin,win,plwin,beat,20,0,20,217,0.414746544,0.02764977,0.599078341,2,0.576736024
688,119,20115,9,10,0,0,0,19,11,2,4,0,0,17,nowin,win,plwin,beat,20,0,19,190,0.405263158,0.068421053,0.515789474,0,0.011837158
689,63,20115,9,6,0,10,0,25,11,2,4,0,0,17,nowin,loss,bust,plbust,0,10,15,216,0.467592593,0.037037037,0.62037037,3,0.931690496
690,28,20116,4,10,0,10,0,24,10,6,9,0,0,25,nowin,loss,bust,plbust,0,10,14,199,0.422110553,0.045226131,0.542713568,1,0.282706618
691,9,20116,10,11,0,0,0,21,10,6,9,0,0,25,win,win,dlbust,bust,25,0,21,194,0.37628866,0.015463918,0.541237113,0,0.009396796
692,101,20116,11,10,0,0,0,21,10,6,9,0,0,25,win,win,dlbust,bust,25,0,21,205,0.424390244,0.068292683,0.63902439,2,0.614740646
693,21,20116,10,10,0,0,0,20,10,6,9,0,0,25,nowin,win,dlbust,bust,20,0,20,214,0.359813084,0.042056075,0.626168224,0,0.025263474
694,55,20116,10,3,0,7,0,20,10,6,9,0,0,25,nowin,win,dlbust,bust,20,0,13,191,0.371727749,0.057591623,0.54973822,0,0.01011347
695,107,20116,4,2,2,1,5,14,10,6,9,0,0,25,nowin,win,dlbust,bust,20,0,6,218,0.444954128,0.073394495,0.600917431,2,0.605210014
696,129,20117,7,3,5,0,0,15,4,10,10,0,0,24,nowin,win,dlbust,bust,20,0,10,201,0.422885572,0.064676617,0.55721393,0,0.027255383
697,145,20117,10,10,0,0,0,20,4,10,10,0,0,24,nowin,win,dlbust,bust,20,0,20,188,0.441489362,0.031914894,0.622340426,2,0.617837093
698,11,20117,7,7,0,0,0,14,4,10,10,0,0,24,nowin,win,dlbust,bust,20,0,14,236,0.457627119,0.016949153,0.588983051,3,0.889015813
699,58,20117,9,2,2,0,0,13,4,10,10,0,0,24,nowin,win,dlbust,bust,20,0,11,195,0.430769231,0.041025641,0.584615385,2,0.580497586
700,138,20117,9,8,0,0,0,17,4,10,10,0,0,24,nowin,win,dlbust,bust,20,0,17,190,0.442105263,0.047368421,0.610526316,2,0.609711065
701,22,20117,11,10,0,0,0,21,4,10,10,0,0,24,win,win,dlbust,bust,25,0,21,187,0.481283422,0.042780749,0.577540107,3,0.906128176
702,72,20118,2,10,0,1,10,23,10,10,0,0,0,20,nowin,loss,bust,plbust,0,10,12,185,0.394594595,0.032432432,0.508108108,0,0.006763115
703,67,20118,10,10,0,0,0,20,10,10,0,0,0,20,nowin,push,push,push,10,0,20,195,0.369230769,0.041025641,0.569230769,0,0.014139427
704,23,20118,10,10,0,0,0,20,10,10,0,0,0,20,nowin,push,push,push,10,0,20,208,0.427884615,0.0625,0.552884615,1,0.29114424
705,35,20118,7,10,0,0,0,17,10,10,0,0,0,20,nowin,loss,beat,dlwin,0,10,17,202,0.410891089,0.044554455,0.633663366,2,0.598681573
706,130,20118,10,3,0,1,7,21,10,10,0,0,0,20,nowin,win,plwin,beat,20,0,13,219,0.410958904,0.03652968,0.566210046,0,0.025888739
707,135,20118,9,10,0,0,0,19,10,10,0,0,0,20,nowin,loss,beat,dlwin,0,10,19,179,0.391061453,0.067039106,0.586592179,0,0.024924662
708,14,20119,7,3,5,10,0,25,10,5,6,0,0,21,nowin,loss,bust,plbust,0,10,10,202,0.391089109,0.01980198,0.628712871,2,0.577264877
709,123,20119,4,4,2,1,8,19,10,5,6,0,0,21,nowin,loss,beat,dlwin,0,10,8,205,0.43902439,0.034146341,0.614634146,2,0.609962544
710,49,20119,10,11,0,0,0,21,10,5,6,0,0,21,win,push,push,push,10,0,21,207,0.396135266,0.053140097,0.594202899,0,0.028306925
711,138,20119,5,8,0,8,0,21,10,5,6,0,0,21,nowin,push,push,push,10,0,13,190,0.442105263,0.047368421,0.610526316,2,0.609711065
712,100,20119,8,2,11,0,0,21,10,5,6,0,0,21,nowin,push,push,push,10,0,10,190,0.452631579,0.036842105,0.594736842,3,0.888671154
713,135,20119,10,3,0,8,0,21,10,5,6,0,0,21,nowin,push,push,push,10,0,13,179,0.391061453,0.067039106,0.586592179,0,0.024924662
714,53,20120,4,11,3,0,0,18,6,6,10,0,0,22,nowin,win,dlbust,bust,20,0,15,250,0.372,0.064,0.564,0,0.013687345
715,98,20120,10,10,0,0,0,20,6,6,10,0,0,22,nowin,win,dlbust,bust,20,0,20,220,0.422727273,0.054545455,0.55,1,0.28664435
716,11,20120,6,6,0,0,0,12,6,6,10,0,0,22,nowin,win,dlbust,bust,20,0,12,236,0.457627119,0.016949153,0.588983051,3,0.889015813
717,10,20120,10,3,0,0,0,13,6,6,10,0,0,22,nowin,win,dlbust,bust,20,0,13,191,0.413612565,0.057591623,0.596858639,2,0.574087175
718,11,20120,7,6,0,0,0,13,6,6,10,0,0,22,nowin,win,dlbust,bust,20,0,13,236,0.457627119,0.016949153,0.588983051,3,0.889015813
719,2,20120,7,10,0,0,0,17,6,6,10,0,0,22,nowin,win,dlbust,bust,20,0,17,200,0.445,0.035,0.64,2,0.633962549
720,145,20121,2,5,5,10,0,22,3,7,10,0,0,20,nowin,loss,bust,plbust,0,10,7,188,0.441489362,0.031914894,0.622340426,2,0.617837093
721,142,20121,10,9,0,0,0,19,3,7,10,0,0,20,nowin,loss,beat,dlwin,0,10,19,211,0.417061611,0.047393365,0.526066351,1,0.271531309
722,49,20121,3,10,0,0,0,13,3,7,10,0,0,20,nowin,loss,beat,dlwin,0,10,13,207,0.396135266,0.053140097,0.594202899,0,0.028306925
723,56,20121,6,6,0,10,0,22,3,7,10,0,0,20,nowin,loss,bust,plbust,0,10,12,175,0.4,0.057142857,0.582857143,0,0.026685297
724,100,20121,10,10,0,0,0,20,3,7,10,0,0,20,nowin,push,push,push,10,0,20,190,0.452631579,0.036842105,0.594736842,3,0.888671154
725,73,20121,5,5,8,0,0,18,3,7,10,0,0,20,nowin,loss,beat,dlwin,0,10,10,181,0.375690608,0.011049724,0.596685083,0,0.022795773
726,104,20122,7,5,0,0,0,12,5,6,5,2,0,18,nowin,loss,beat,dlwin,0,10,12,209,0.363636364,0.052631579,0.593301435,0,0.018359419
727,139,20122,10,6,0,0,0,16,5,6,5,2,0,18,nowin,loss,beat,dlwin,0,10,16,192,0.380208333,0.036458333,0.59375,0,0.023429169
728,88,20122,8,5,0,0,0,13,5,6,5,2,0,18,nowin,loss,beat,dlwin,0,10,13,206,0.466019417,0.033980583,0.54368932,1,0.309467903
729,46,20122,3,8,1,0,0,12,5,6,5,2,0,18,nowin,loss,beat,dlwin,0,10,11,186,0.403225806,0.048387097,0.591397849,0,0.029742194
730,148,20122,3,10,0,0,0,13,5,6,5,2,0,18,nowin,loss,beat,dlwin,0,10,13,204,0.401960784,0.078431373,0.593137255,0,0.029789521
731,29,20122,3,6,7,0,0,16,5,6,5,2,0,18,nowin,loss,beat,dlwin,0,10,9,189,0.44973545,0.058201058,0.544973545,1,0.300349439
732,133,20123,10,6,0,3,0,19,11,7,0,0,0,18,nowin,win,plwin,beat,20,0,16,201,0.47761194,0.064676617,0.611940299,3,0.935428111
733,95,20123,10,8,0,0,0,18,11,7,0,0,0,18,nowin,push,push,push,10,0,18,218,0.412844037,0.04587156,0.559633028,0,0.024842385
734,28,20123,3,4,10,0,0,17,11,7,0,0,0,18,nowin,loss,beat,dlwin,0,10,7,199,0.422110553,0.045226131,0.542713568,1,0.282706618
735,33,20123,6,2,4,6,0,18,11,7,0,0,0,18,nowin,push,push,push,10,0,8,192,0.4375,0.057291667,0.625,2,0.616208916
736,22,20123,4,3,7,10,0,24,11,7,0,0,0,18,nowin,loss,bust,plbust,0,10,7,187,0.481283422,0.042780749,0.577540107,3,0.906128176
737,119,20123,3,9,0,10,0,22,11,7,0,0,0,18,nowin,loss,bust,plbust,0,10,12,190,0.405263158,0.068421053,0.515789474,0,0.011837158
738,73,20124,3,3,10,9,0,25,10,10,0,0,0,20,nowin,loss,bust,plbust,0,10,6,181,0.375690608,0.011049724,0.596685083,0,0.022795773
739,126,20124,3,5,9,0,0,17,10,10,0,0,0,20,nowin,loss,beat,dlwin,0,10,8,188,0.457446809,0.074468085,0.60106383,3,0.900633203
740,118,20124,8,7,0,9,0,24,10,10,0,0,0,20,nowin,loss,bust,plbust,0,10,15,216,0.393518519,0.037037037,0.555555556,0,0.018059873
741,88,20124,10,5,0,6,0,21,10,10,0,0,0,20,nowin,win,plwin,beat,20,0,15,206,0.466019417,0.033980583,0.54368932,1,0.309467903
742,96,20124,5,6,10,0,0,21,10,10,0,0,0,20,nowin,win,plwin,beat,20,0,11,190,0.468421053,0.057894737,0.584210526,3,0.897263354
743,84,20124,2,11,6,0,0,19,10,10,0,0,0,20,nowin,loss,beat,dlwin,0,10,13,195,0.379487179,0.056410256,0.569230769,0,0.017209119
744,68,20125,10,10,0,0,0,20,10,6,1,0,0,17,nowin,win,plwin,beat,20,0,20,205,0.434146341,0.029268293,0.6,2,0.59483189
745,64,20125,11,3,4,0,0,18,10,6,1,0,0,17,nowin,win,plwin,beat,20,0,14,187,0.363636364,0.048128342,0.631016043,0,0.027594885
746,15,20125,10,3,0,4,0,17,10,6,1,0,0,17,nowin,push,push,push,10,0,13,212,0.410377358,0.051886792,0.561320755,0,0.024517408
747,129,20125,7,7,0,2,2,18,10,6,1,0,0,17,nowin,win,plwin,beat,20,0,14,201,0.422885572,0.064676617,0.55721393,0,0.027255383
748,148,20125,9,10,0,0,0,19,10,6,1,0,0,17,nowin,win,plwin,beat,20,0,19,204,0.401960784,0.078431373,0.593137255,0,0.029789521
749,109,20125,4,4,5,10,0,23,10,6,1,0,0,17,nowin,loss,bust,plbust,0,10,8,221,0.461538462,0.058823529,0.597285068,3,0.901830309
750,19,20126,2,8,10,0,0,20,4,2,4,10,0,20,nowin,push,push,push,10,0,10,237,0.41350211,0.054852321,0.628691983,2,0.597373826
751,85,20126,5,4,4,0,0,13,4,2,4,10,0,20,nowin,loss,beat,dlwin,0,10,9,195,0.41025641,0.066666667,0.594871795,0,0.03269711
752,45,20126,4,8,0,0,0,12,4,2,4,10,0,20,nowin,loss,beat,dlwin,0,10,12,196,0.428571429,0.051020408,0.612244898,2,0.598821767
753,95,20126,8,11,0,0,0,19,4,2,4,10,0,20,nowin,loss,beat,dlwin,0,10,19,218,0.412844037,0.04587156,0.559633028,0,0.024842385
754,13,20126,5,8,0,0,0,13,4,2,4,10,0,20,nowin,loss,beat,dlwin,0,10,13,206,0.417475728,0.063106796,0.621359223,2,0.59555479
755,60,20126,10,10,0,0,0,20,4,2,4,10,0,20,nowin,push,push,push,10,0,20,227,0.418502203,0.022026432,0.559471366,0,0.026496258
756,36,20127,2,10,0,7,0,19,10,3,10,0,0,23,nowin,win,dlbust,bust,20,0,12,229,0.445414847,0.056768559,0.655021834,2,0.645370571
757,119,20127,11,10,0,0,0,21,10,3,10,0,0,23,win,win,dlbust,bust,25,0,21,190,0.405263158,0.068421053,0.515789474,0,0.011837158
758,109,20127,7,7,0,3,0,17,10,3,10,0,0,23,nowin,win,dlbust,bust,20,0,14,221,0.461538462,0.058823529,0.597285068,3,0.901830309
759,19,20127,7,4,10,0,0,21,10,3,10,0,0,23,nowin,win,dlbust,bust,20,0,11,237,0.41350211,0.054852321,0.628691983,2,0.597373826
760,76,20127,11,2,6,0,0,19,10,3,10,0,0,23,nowin,win,dlbust,bust,20,0,13,189,0.534391534,0.079365079,0.608465608,3,1
761,79,20127,9,9,0,0,0,18,10,3,10,0,0,23,nowin,win,dlbust,bust,20,0,18,211,0.436018957,0.028436019,0.672985782,2,0.650131054
762,29,20128,9,9,0,0,0,18,8,9,0,0,0,17,nowin,win,plwin,beat,20,0,18,189,0.44973545,0.058201058,0.544973545,1,0.300349439
763,92,20128,11,10,0,0,0,21,8,9,0,0,0,17,win,win,plwin,beat,25,0,21,186,0.446236559,0.059139785,0.564516129,1,0.307826125
764,70,20128,9,11,0,0,0,20,8,9,0,0,0,17,nowin,win,plwin,beat,20,0,20,228,0.385964912,0.039473684,0.557017544,0,0.016157125
765,45,20128,9,9,0,0,0,18,8,9,0,0,0,17,nowin,win,plwin,beat,20,0,18,196,0.428571429,0.051020408,0.612244898,2,0.598821767
766,68,20128,2,4,10,6,0,22,8,9,0,0,0,17,nowin,loss,bust,plbust,0,10,6,205,0.434146341,0.029268293,0.6,2,0.59483189
767,30,20128,10,2,0,10,0,22,8,9,0,0,0,17,nowin,loss,bust,plbust,0,10,12,206,0.393203883,0.033980583,0.601941748,0,0.029324648
768,75,20129,10,10,0,0,0,20,10,11,0,0,0,21,nowin,loss,beat,dlwin,0,10,20,191,0.418848168,0.052356021,0.570680628,0,0.029344702
769,15,20129,3,9,0,9,0,21,10,11,0,0,0,21,nowin,push,push,push,10,0,12,212,0.410377358,0.051886792,0.561320755,0,0.024517408
770,130,20129,11,8,0,0,0,19,10,11,0,0,0,21,nowin,loss,beat,dlwin,0,10,19,219,0.410958904,0.03652968,0.566210046,0,0.025888739
771,40,20129,9,10,0,0,0,19,10,11,0,0,0,21,nowin,loss,beat,dlwin,0,10,19,196,0.367346939,0.030612245,0.617346939,0,0.025358183
772,9,20129,2,2,3,5,8,20,10,11,0,0,0,21,nowin,loss,beat,dlwin,0,10,4,194,0.37628866,0.015463918,0.541237113,0,0.009396796
773,44,20129,4,1,10,7,0,22,10,11,0,0,0,21,nowin,loss,bust,plbust,0,10,5,219,0.433789954,0.050228311,0.534246575,1,0.285551035
774,144,20130,6,5,6,0,0,17,2,10,3,2,0,17,nowin,push,push,push,10,0,11,202,0.386138614,0.054455446,0.564356436,0,0.018006244
775,13,20130,5,2,7,0,0,14,2,10,3,2,0,17,nowin,loss,beat,dlwin,0,10,7,206,0.417475728,0.063106796,0.621359223,2,0.59555479
776,22,20130,8,8,0,0,0,16,2,10,3,2,0,17,nowin,loss,beat,dlwin,0,10,16,187,0.481283422,0.042780749,0.577540107,3,0.906128176
777,52,20130,10,11,0,0,0,21,2,10,3,2,0,17,win,win,plwin,beat,25,0,21,217,0.414746544,0.02764977,0.599078341,2,0.576736024
778,135,20130,10,7,0,0,0,17,2,10,3,2,0,17,nowin,push,push,push,10,0,17,179,0.391061453,0.067039106,0.586592179,0,0.024924662
779,116,20130,8,9,0,0,0,17,2,10,3,2,0,17,nowin,push,push,push,10,0,17,195,0.425641026,0.056410256,0.538461538,1,0.28273747
780,24,20131,8,7,0,3,0,18,11,10,0,0,0,21,nowin,loss,beat,dlwin,0,10,15,207,0.458937198,0.048309179,0.570048309,1,0.318138014
781,25,20131,10,10,0,0,0,20,11,10,0,0,0,21,nowin,loss,beat,dlwin,0,10,20,190,0.463157895,0.063157895,0.536842105,1,0.304401563
782,107,20131,6,9,0,9,0,24,11,10,0,0,0,21,nowin,loss,bust,plbust,0,10,15,218,0.444954128,0.073394495,0.600917431,2,0.605210014
783,127,20131,8,9,0,0,0,17,11,10,0,0,0,21,nowin,loss,beat,dlwin,0,10,17,201,0.402985075,0.029850746,0.60199005,0,0.032263937
784,49,20131,10,4,0,9,0,23,11,10,0,0,0,21,nowin,loss,bust,plbust,0,10,14,207,0.396135266,0.053140097,0.594202899,0,0.028306925
785,36,20131,2,8,3,9,0,22,11,10,0,0,0,21,nowin,loss,bust,plbust,0,10,10,229,0.445414847,0.056768559,0.655021834,2,0.645370571
786,96,20132,10,11,0,0,0,21,2,8,10,0,0,20,win,win,plwin,beat,25,0,21,190,0.468421053,0.057894737,0.584210526,3,0.897263354
787,137,20132,8,3,7,0,0,18,2,8,10,0,0,20,nowin,loss,beat,dlwin,0,10,11,194,0.417525773,0.046391753,0.536082474,1,0.276714602
788,143,20132,10,11,0,0,0,21,2,8,10,0,0,20,win,win,plwin,beat,25,0,21,203,0.463054187,0.044334975,0.57635468,3,0.883143365
789,137,20132,10,10,0,0,0,20,2,8,10,0,0,20,nowin,push,push,push,10,0,20,194,0.417525773,0.046391753,0.536082474,1,0.276714602
790,149,20132,11,10,0,0,0,21,2,8,10,0,0,20,win,win,plwin,beat,25,0,21,225,0.457777778,0.057777778,0.648888889,2,0.651965595
791,118,20132,2,5,10,0,0,17,2,8,10,0,0,20,nowin,loss,beat,dlwin,0,10,7,216,0.393518519,0.037037037,0.555555556,0,0.018059873
792,120,20133,9,10,0,0,0,19,3,10,7,0,0,20,nowin,loss,beat,dlwin,0,10,19,202,0.440594059,0.034653465,0.618811881,2,0.614441029
793,131,20133,4,2,9,0,0,15,3,10,7,0,0,20,nowin,loss,beat,dlwin,0,10,6,217,0.410138249,0.069124424,0.543778802,0,0.02015021
794,128,20133,7,3,7,0,0,17,3,10,7,0,0,20,nowin,loss,beat,dlwin,0,10,10,227,0.356828194,0.052863436,0.577092511,0,0.012352564
795,20,20133,4,10,0,0,0,14,3,10,7,0,0,20,nowin,loss,beat,dlwin,0,10,14,186,0.456989247,0.037634409,0.537634409,1,0.301097108
796,118,20133,9,11,0,0,0,20,3,10,7,0,0,20,nowin,push,push,push,10,0,20,216,0.393518519,0.037037037,0.555555556,0,0.018059873
797,70,20133,4,10,0,0,0,14,3,10,7,0,0,20,nowin,loss,beat,dlwin,0,10,14,228,0.385964912,0.039473684,0.557017544,0,0.016157125
798,107,20134,7,11,0,0,0,18,10,8,0,0,0,18,nowin,push,push,push,10,0,18,218,0.444954128,0.073394495,0.600917431,2,0.605210014
799,18,20134,10,10,0,0,0,20,10,8,0,0,0,18,nowin,win,plwin,beat,20,0,20,182,0.461538462,0.043956044,0.587912088,3,0.892649374
800,131,20134,4,3,9,5,0,21,10,8,0,0,0,18,nowin,win,plwin,beat,20,0,7,217,0.410138249,0.069124424,0.543778802,0,0.02015021
801,102,20134,3,8,8,0,0,19,10,8,0,0,0,18,nowin,win,plwin,beat,20,0,11,192,0.338541667,0.046875,0.5625,0,0.003306118
802,47,20134,7,10,0,0,0,17,10,8,0,0,0,18,nowin,loss,beat,dlwin,0,10,17,210,0.438095238,0.057142857,0.623809524,2,0.615868808
803,142,20134,5,6,10,0,0,21,10,8,0,0,0,18,nowin,win,plwin,beat,20,0,11,211,0.417061611,0.047393365,0.526066351,1,0.271531309
804,37,20135,6,6,0,0,0,12,6,10,3,0,0,19,nowin,loss,beat,dlwin,0,10,12,208,0.394230769,0.038461538,0.581730769,0,0.024682772
805,84,20135,2,8,3,0,0,13,6,10,3,0,0,19,nowin,loss,beat,dlwin,0,10,10,195,0.379487179,0.056410256,0.569230769,0,0.017209119
806,80,20135,6,9,0,0,0,15,6,10,3,0,0,19,nowin,loss,beat,dlwin,0,10,15,186,0.419354839,0.059139785,0.623655914,2,0.59892924
807,137,20135,10,3,0,0,0,13,6,10,3,0,0,19,nowin,loss,beat,dlwin,0,10,13,194,0.417525773,0.046391753,0.536082474,1,0.276714602
808,134,20135,10,11,0,0,0,21,6,10,3,0,0,19,win,win,plwin,beat,25,0,21,185,0.443243243,0.021621622,0.545945946,1,0.296939509
809,1,20135,10,4,0,0,0,14,6,10,3,0,0,19,nowin,loss,beat,dlwin,0,10,14,197,0.406091371,0.025380711,0.649746193,2,0.606186955
810,32,20136,6,8,0,9,0,23,10,5,6,0,0,21,nowin,loss,bust,plbust,0,10,14,189,0.391534392,0.037037037,0.53968254,0,0.013579086
811,3,20136,5,1,10,1,0,17,10,5,6,0,0,21,nowin,loss,beat,dlwin,0,10,6,190,0.431578947,0.026315789,0.542105263,1,0.288076384
812,149,20136,3,5,11,0,0,19,10,5,6,0,0,21,nowin,loss,beat,dlwin,0,10,8,225,0.457777778,0.057777778,0.648888889,2,0.651965595
813,29,20136,4,9,0,10,0,23,10,5,6,0,0,21,nowin,loss,bust,plbust,0,10,13,189,0.44973545,0.058201058,0.544973545,1,0.300349439
814,80,20136,2,10,0,10,0,22,10,5,6,0,0,21,nowin,loss,bust,plbust,0,10,12,186,0.419354839,0.059139785,0.623655914,2,0.59892924
815,98,20136,10,11,0,0,0,21,10,5,6,0,0,21,win,push,push,push,10,0,21,220,0.422727273,0.054545455,0.55,1,0.28664435
816,102,20137,8,5,0,0,0,13,3,5,8,10,0,26,nowin,win,dlbust,bust,20,0,13,192,0.338541667,0.046875,0.5625,0,0.003306118
817,138,20137,10,8,0,0,0,18,3,5,8,10,0,26,nowin,win,dlbust,bust,20,0,18,190,0.442105263,0.047368421,0.610526316,2,0.609711065
818,109,20137,10,7,0,0,0,17,3,5,8,10,0,26,nowin,win,dlbust,bust,20,0,17,221,0.461538462,0.058823529,0.597285068,3,0.901830309
819,131,20137,8,11,0,0,0,19,3,5,8,10,0,26,nowin,win,dlbust,bust,20,0,19,217,0.410138249,0.069124424,0.543778802,0,0.02015021
820,14,20137,10,10,0,0,0,20,3,5,8,10,0,26,nowin,win,dlbust,bust,20,0,20,202,0.391089109,0.01980198,0.628712871,2,0.577264877
821,59,20137,10,3,0,0,0,13,3,5,8,10,0,26,nowin,win,dlbust,bust,20,0,13,228,0.429824561,0.048245614,0.543859649,1,0.287885446
822,20,20138,10,3,0,7,0,20,8,5,2,2,0,17,nowin,win,plwin,beat,20,0,13,186,0.456989247,0.037634409,0.537634409,1,0.301097108
823,116,20138,10,5,0,5,0,20,8,5,2,2,0,17,nowin,win,plwin,beat,20,0,15,195,0.425641026,0.056410256,0.538461538,1,0.28273747
824,125,20138,10,6,0,9,0,25,8,5,2,2,0,17,nowin,loss,bust,plbust,0,10,16,219,0.438356164,0.050228311,0.575342466,1,0.308411257
825,88,20138,10,4,0,7,0,21,8,5,2,2,0,17,nowin,win,plwin,beat,20,0,14,206,0.466019417,0.033980583,0.54368932,1,0.309467903
826,98,20138,11,2,2,7,0,22,8,5,2,2,0,17,nowin,loss,bust,plbust,0,10,13,220,0.422727273,0.054545455,0.55,1,0.28664435
827,129,20138,9,6,0,10,0,25,8,5,2,2,0,17,nowin,loss,bust,plbust,0,10,15,201,0.422885572,0.064676617,0.55721393,0,0.027255383
828,115,20139,3,8,3,4,0,18,10,9,0,0,0,19,nowin,loss,beat,dlwin,0,10,11,194,0.427835052,0.041237113,0.592783505,2,0.583863602
829,45,20139,2,11,2,9,0,24,10,9,0,0,0,19,nowin,loss,bust,plbust,0,10,13,196,0.428571429,0.051020408,0.612244898,2,0.598821767
830,74,20139,2,2,11,10,0,25,10,9,0,0,0,19,nowin,loss,bust,plbust,0,10,4,209,0.411483254,0.04784689,0.531100478,0,0.017448125
831,128,20139,8,7,0,3,0,18,10,9,0,0,0,19,nowin,loss,beat,dlwin,0,10,15,227,0.356828194,0.052863436,0.577092511,0,0.012352564
832,85,20139,11,10,0,0,0,21,10,9,0,0,0,19,win,win,plwin,beat,25,0,21,195,0.41025641,0.066666667,0.594871795,0,0.03269711
833,141,20139,10,2,0,6,0,18,10,9,0,0,0,19,nowin,loss,beat,dlwin,0,10,12,202,0.420792079,0.074257426,0.564356436,0,0.028377851
834,118,20140,10,11,0,0,0,21,1,5,10,6,0,22,win,win,dlbust,bust,25,0,21,216,0.393518519,0.037037037,0.555555556,0,0.018059873
835,22,20140,10,5,0,7,0,22,1,5,10,6,0,22,nowin,loss,bust,plbust,0,10,15,187,0.481283422,0.042780749,0.577540107,3,0.906128176
836,128,20140,9,10,0,0,0,19,1,5,10,6,0,22,nowin,win,dlbust,bust,20,0,19,227,0.356828194,0.052863436,0.577092511,0,0.012352564
837,123,20140,11,10,0,0,0,21,1,5,10,6,0,22,win,win,dlbust,bust,25,0,21,205,0.43902439,0.034146341,0.614634146,2,0.609962544
838,67,20140,6,8,0,10,0,24,1,5,10,6,0,22,nowin,loss,bust,plbust,0,10,14,195,0.369230769,0.041025641,0.569230769,0,0.014139427
839,75,20140,10,9,0,0,0,19,1,5,10,6,0,22,nowin,win,dlbust,bust,20,0,19,191,0.418848168,0.052356021,0.570680628,0,0.029344702
840,74,20141,6,10,0,0,0,16,3,10,10,0,0,23,nowin,win,dlbust,bust,20,0,16,209,0.411483254,0.04784689,0.531100478,0,0.017448125
841,119,20141,5,6,5,0,0,16,3,10,10,0,0,23,nowin,win,dlbust,bust,20,0,11,190,0.405263158,0.068421053,0.515789474,0,0.011837158
842,49,20141,9,2,5,0,0,16,3,10,10,0,0,23,nowin,win,dlbust,bust,20,0,11,207,0.396135266,0.053140097,0.594202899,0,0.028306925
843,136,20141,6,9,0,0,0,15,3,10,10,0,0,23,nowin,win,dlbust,bust,20,0,15,194,0.396907216,0.025773196,0.597938144,0,0.029452644
844,105,20141,10,2,0,3,0,15,3,10,10,0,0,23,nowin,win,dlbust,bust,20,0,12,198,0.414141414,0.070707071,0.590909091,0,0.032889494
845,140,20141,7,9,0,0,0,16,3,10,10,0,0,23,nowin,win,dlbust,bust,20,0,16,210,0.466666667,0.023809524,0.604761905,3,0.915293335
846,39,20142,11,10,0,0,0,21,3,2,10,6,0,21,win,push,push,push,10,0,21,191,0.429319372,0.062827225,0.57591623,0,0.033760763
847,83,20142,2,10,0,1,0,13,3,2,10,6,0,21,nowin,loss,beat,dlwin,0,10,12,193,0.424870466,0.051813472,0.678756477,2,0.644360335
848,77,20142,2,10,0,2,0,14,3,2,10,6,0,21,nowin,loss,beat,dlwin,0,10,12,200,0.455,0.04,0.62,3,0.916252116
849,107,20142,8,11,0,0,0,19,3,2,10,6,0,21,nowin,loss,beat,dlwin,0,10,19,218,0.444954128,0.073394495,0.600917431,2,0.605210014
850,117,20142,7,5,0,10,0,22,3,2,10,6,0,21,nowin,loss,bust,plbust,0,10,12,173,0.410404624,0.069364162,0.606936416,2,0.578610282
851,131,20142,9,8,0,0,0,17,3,2,10,6,0,21,nowin,loss,beat,dlwin,0,10,17,217,0.410138249,0.069124424,0.543778802,0,0.02015021
852,128,20143,10,8,0,0,0,18,2,4,3,7,1,17,nowin,win,plwin,beat,20,0,18,227,0.356828194,0.052863436,0.577092511,0,0.012352564
853,96,20143,7,2,5,0,0,14,2,4,3,7,1,17,nowin,loss,beat,dlwin,0,10,9,190,0.468421053,0.057894737,0.584210526,3,0.897263354
854,102,20143,4,10,0,0,0,14,2,4,3,7,1,17,nowin,loss,beat,dlwin,0,10,14,192,0.338541667,0.046875,0.5625,0,0.003306118
855,66,20143,10,7,0,0,0,17,2,4,3,7,1,17,nowin,push,push,push,10,0,17,217,0.456221198,0.064516129,0.626728111,3,0.924304367
856,148,20143,10,6,0,0,0,16,2,4,3,7,1,17,nowin,loss,beat,dlwin,0,10,16,204,0.401960784,0.078431373,0.593137255,0,0.029789521
857,22,20143,9,11,0,0,0,20,2,4,3,7,1,17,nowin,win,plwin,beat,20,0,20,187,0.481283422,0.042780749,0.577540107,3,0.906128176
858,141,20144,6,11,3,0,0,20,7,7,10,0,0,24,nowin,win,dlbust,bust,20,0,17,202,0.420792079,0.074257426,0.564356436,0,0.028377851
859,115,20144,9,6,0,10,0,25,7,7,10,0,0,24,nowin,loss,bust,plbust,0,10,15,194,0.427835052,0.041237113,0.592783505,2,0.583863602
860,4,20144,10,10,0,0,0,20,7,7,10,0,0,24,nowin,win,dlbust,bust,20,0,20,217,0.460829493,0.036866359,0.562211982,1,0.315432839
861,134,20144,4,4,10,0,0,18,7,7,10,0,0,24,nowin,win,dlbust,bust,20,0,8,185,0.443243243,0.021621622,0.545945946,1,0.296939509
862,95,20144,1,6,9,10,0,26,7,7,10,0,0,24,nowin,loss,bust,plbust,0,10,7,218,0.412844037,0.04587156,0.559633028,0,0.024842385
863,142,20144,10,3,0,3,1,17,7,7,10,0,0,24,nowin,win,dlbust,bust,20,0,13,211,0.417061611,0.047393365,0.526066351,1,0.271531309
864,109,20145,10,5,0,10,0,25,10,11,0,0,0,21,nowin,loss,bust,plbust,0,10,15,221,0.461538462,0.058823529,0.597285068,3,0.901830309
865,49,20145,5,10,0,5,0,20,10,11,0,0,0,21,nowin,loss,beat,dlwin,0,10,15,207,0.396135266,0.053140097,0.594202899,0,0.028306925
866,63,20145,10,5,0,9,0,24,10,11,0,0,0,21,nowin,loss,bust,plbust,0,10,15,216,0.467592593,0.037037037,0.62037037,3,0.931690496
867,86,20145,10,11,0,0,0,21,10,11,0,0,0,21,win,push,push,push,10,0,21,196,0.454081633,0.040816327,0.591836735,3,0.887566443
868,122,20145,9,3,0,4,5,21,10,11,0,0,0,21,nowin,push,push,push,10,0,12,210,0.347619048,0.052380952,0.59047619,0,0.012873677
869,47,20145,5,10,0,10,0,25,10,11,0,0,0,21,nowin,loss,bust,plbust,0,10,15,210,0.438095238,0.057142857,0.623809524,2,0.615868808
870,114,20146,8,10,0,0,0,18,2,4,7,10,0,23,nowin,win,dlbust,bust,20,0,18,198,0.47979798,0.025252525,0.611111111,3,0.937232995
871,20,20146,10,7,0,0,0,17,2,4,7,10,0,23,nowin,win,dlbust,bust,20,0,17,186,0.456989247,0.037634409,0.537634409,1,0.301097108
872,142,20146,5,3,7,0,0,15,2,4,7,10,0,23,nowin,win,dlbust,bust,20,0,8,211,0.417061611,0.047393365,0.526066351,1,0.271531309
873,67,20146,3,9,0,10,0,22,2,4,7,10,0,23,nowin,loss,bust,plbust,0,10,12,195,0.369230769,0.041025641,0.569230769,0,0.014139427
874,63,20146,6,8,0,0,0,14,2,4,7,10,0,23,nowin,win,dlbust,bust,20,0,14,216,0.467592593,0.037037037,0.62037037,3,0.931690496
875,128,20146,10,2,0,1,0,13,2,4,7,10,0,23,nowin,win,dlbust,bust,20,0,12,227,0.356828194,0.052863436,0.577092511,0,0.012352564
876,130,20147,10,10,0,0,0,20,10,4,10,0,0,24,nowin,win,dlbust,bust,20,0,20,219,0.410958904,0.03652968,0.566210046,0,0.025888739
877,55,20147,7,3,11,0,0,21,10,4,10,0,0,24,nowin,win,dlbust,bust,20,0,10,191,0.371727749,0.057591623,0.54973822,0,0.01011347
878,38,20147,4,3,4,3,5,19,10,4,10,0,0,24,nowin,win,dlbust,bust,20,0,7,202,0.361386139,0.03960396,0.564356436,0,0.010597953
879,106,20147,6,3,4,1,10,24,10,4,10,0,0,24,nowin,loss,bust,plbust,0,10,9,192,0.411458333,0.026041667,0.557291667,0,0.023854304
880,89,20147,10,9,0,0,0,19,10,4,10,0,0,24,nowin,win,dlbust,bust,20,0,19,212,0.537735849,0.047169811,0.594339623,3,0.990167191
881,47,20147,11,9,0,0,0,20,10,4,10,0,0,24,nowin,win,dlbust,bust,20,0,20,210,0.438095238,0.057142857,0.623809524,2,0.615868808
882,112,20148,10,3,0,6,0,19,1,2,10,10,0,23,nowin,win,dlbust,bust,20,0,13,203,0.448275862,0.054187192,0.600985222,3,0.889576933
883,14,20148,4,10,0,9,0,23,1,2,10,10,0,23,nowin,loss,bust,plbust,0,10,14,202,0.391089109,0.01980198,0.628712871,2,0.577264877
884,126,20148,10,10,0,0,0,20,1,2,10,10,0,23,nowin,win,dlbust,bust,20,0,20,188,0.457446809,0.074468085,0.60106383,3,0.900633203
885,36,20148,10,10,0,0,0,20,1,2,10,10,0,23,nowin,win,dlbust,bust,20,0,20,229,0.445414847,0.056768559,0.655021834,2,0.645370571
886,137,20148,5,6,1,4,10,26,1,2,10,10,0,23,nowin,loss,bust,plbust,0,10,11,194,0.417525773,0.046391753,0.536082474,1,0.276714602
887,53,20148,1,6,8,4,0,19,1,2,10,10,0,23,nowin,win,dlbust,bust,20,0,7,250,0.372,0.064,0.564,0,0.013687345
888,107,20149,10,9,0,0,0,19,7,10,0,0,0,17,nowin,win,plwin,beat,20,0,19,218,0.444954128,0.073394495,0.600917431,2,0.605210014
889,146,20149,11,9,0,0,0,20,7,10,0,0,0,17,nowin,win,plwin,beat,20,0,20,221,0.43438914,0.040723982,0.542986425,1,0.290190091
890,105,20149,10,5,0,10,0,25,7,10,0,0,0,17,nowin,loss,bust,plbust,0,10,15,198,0.414141414,0.070707071,0.590909091,0,0.032889494
891,100,20149,2,4,10,9,0,25,7,10,0,0,0,17,nowin,loss,bust,plbust,0,10,6,190,0.452631579,0.036842105,0.594736842,3,0.888671154
892,108,20149,6,7,0,9,0,22,7,10,0,0,0,17,nowin,loss,bust,plbust,0,10,13,193,0.435233161,0.056994819,0.559585492,1,0.298824795
893,103,20149,4,1,8,10,0,23,7,10,0,0,0,17,nowin,loss,bust,plbust,0,10,5,203,0.379310345,0.064039409,0.551724138,0,0.012869209
894,65,20150,10,5,0,0,0,15,4,2,4,8,0,18,nowin,loss,beat,dlwin,0,10,15,203,0.492610837,0.054187192,0.571428571,3,0.913702814
895,2,20150,7,10,0,0,0,17,4,2,4,8,0,18,nowin,loss,beat,dlwin,0,10,17,200,0.445,0.035,0.64,2,0.633962549
896,143,20150,5,7,0,0,0,12,4,2,4,8,0,18,nowin,loss,beat,dlwin,0,10,12,203,0.463054187,0.044334975,0.57635468,3,0.883143365
897,126,20150,2,3,10,0,0,15,4,2,4,8,0,18,nowin,loss,beat,dlwin,0,10,5,188,0.457446809,0.074468085,0.60106383,3,0.900633203
898,55,20150,4,8,0,0,0,12,4,2,4,8,0,18,nowin,loss,beat,dlwin,0,10,12,191,0.371727749,0.057591623,0.54973822,0,0.01011347
899,57,20150,10,10,0,0,0,20,4,2,4,8,0,18,nowin,win,plwin,beat,20,0,20,192,0.46875,0.052083333,0.59375,3,0.907001181
900,44,20151,10,5,0,10,0,25,8,10,0,0,0,18,nowin,loss,bust,plbust,0,10,15,219,0.433789954,0.050228311,0.534246575,1,0.285551035
901,105,20151,2,10,0,3,10,25,8,10,0,0,0,18,nowin,loss,bust,plbust,0,10,12,198,0.414141414,0.070707071,0.590909091,0,0.032889494
902,34,20151,5,3,10,0,0,18,8,10,0,0,0,18,nowin,push,push,push,10,0,8,202,0.5,0.079207921,0.618811881,3,0.968961434
903,100,20151,6,9,0,5,0,20,8,10,0,0,0,18,nowin,win,plwin,beat,20,0,15,190,0.452631579,0.036842105,0.594736842,3,0.888671154
904,81,20151,10,2,0,5,0,17,8,10,0,0,0,18,nowin,loss,beat,dlwin,0,10,12,182,0.395604396,0.043956044,0.60989011,2,0.567491261
905,99,20151,7,11,0,0,0,18,8,10,0,0,0,18,nowin,push,push,push,10,0,18,207,0.47826087,0.062801932,0.637681159,3,0.961418446
906,88,20152,8,6,0,0,0,14,2,7,4,10,0,23,nowin,win,dlbust,bust,20,0,14,206,0.466019417,0.033980583,0.54368932,1,0.309467903
907,95,20152,1,6,9,0,0,16,2,7,4,10,0,23,nowin,win,dlbust,bust,20,0,7,218,0.412844037,0.04587156,0.559633028,0,0.024842385
908,139,20152,3,7,11,0,0,21,2,7,4,10,0,23,nowin,win,dlbust,bust,20,0,10,192,0.380208333,0.036458333,0.59375,0,0.023429169
909,133,20152,7,10,0,0,0,17,2,7,4,10,0,23,nowin,win,dlbust,bust,20,0,17,201,0.47761194,0.064676617,0.611940299,3,0.935428111
910,104,20152,2,10,0,1,0,13,2,7,4,10,0,23,nowin,win,dlbust,bust,20,0,12,209,0.363636364,0.052631579,0.593301435,0,0.018359419
911,64,20152,10,9,0,0,0,19,2,7,4,10,0,23,nowin,win,dlbust,bust,20,0,19,187,0.363636364,0.048128342,0.631016043,0,0.027594885
912,83,20153,10,10,0,0,0,20,10,10,0,0,0,20,nowin,push,push,push,10,0,20,193,0.424870466,0.051813472,0.678756477,2,0.644360335
913,23,20153,10,10,0,0,0,20,10,10,0,0,0,20,nowin,push,push,push,10,0,20,208,0.427884615,0.0625,0.552884615,1,0.29114424
914,66,20153,10,9,0,0,0,19,10,10,0,0,0,20,nowin,loss,beat,dlwin,0,10,19,217,0.456221198,0.064516129,0.626728111,3,0.924304367
915,38,20153,2,10,0,10,0,22,10,10,0,0,0,20,nowin,loss,bust,plbust,0,10,12,202,0.361386139,0.03960396,0.564356436,0,0.010597953
916,60,20153,6,7,0,2,8,23,10,10,0,0,0,20,nowin,loss,bust,plbust,0,10,13,227,0.418502203,0.022026432,0.559471366,0,0.026496258
917,65,20153,8,9,0,0,0,17,10,10,0,0,0,20,nowin,loss,beat,dlwin,0,10,17,203,0.492610837,0.054187192,0.571428571,3,0.913702814
918,127,20154,10,6,0,0,0,16,5,9,1,10,0,25,nowin,win,dlbust,bust,20,0,16,201,0.402985075,0.029850746,0.60199005,0,0.032263937
919,83,20154,6,10,0,0,0,16,5,9,1,10,0,25,nowin,win,dlbust,bust,20,0,16,193,0.424870466,0.051813472,0.678756477,2,0.644360335
920,141,20154,5,5,7,0,0,17,5,9,1,10,0,25,nowin,win,dlbust,bust,20,0,10,202,0.420792079,0.074257426,0.564356436,0,0.028377851
921,28,20154,10,6,0,0,0,16,5,9,1,10,0,25,nowin,win,dlbust,bust,20,0,16,199,0.422110553,0.045226131,0.542713568,1,0.282706618
922,147,20154,10,10,0,0,0,20,5,9,1,10,0,25,nowin,win,dlbust,bust,20,0,20,205,0.380487805,0.014634146,0.536585366,0,0.00951447
923,80,20154,7,10,0,0,0,17,5,9,1,10,0,25,nowin,win,dlbust,bust,20,0,17,186,0.419354839,0.059139785,0.623655914,2,0.59892924
924,72,20155,3,7,6,0,0,16,4,10,3,0,0,17,nowin,loss,beat,dlwin,0,10,10,185,0.394594595,0.032432432,0.508108108,0,0.006763115
925,25,20155,7,5,0,0,0,12,4,10,3,0,0,17,nowin,loss,beat,dlwin,0,10,12,190,0.463157895,0.063157895,0.536842105,1,0.304401563
926,61,20155,8,5,0,0,0,13,4,10,3,0,0,17,nowin,loss,beat,dlwin,0,10,13,194,0.427835052,0.077319588,0.603092784,2,0.591437139
927,120,20155,5,7,0,0,0,12,4,10,3,0,0,17,nowin,loss,beat,dlwin,0,10,12,202,0.440594059,0.034653465,0.618811881,2,0.614441029
928,13,20155,10,8,0,0,0,18,4,10,3,0,0,17,nowin,win,plwin,beat,20,0,18,206,0.417475728,0.063106796,0.621359223,2,0.59555479
929,142,20155,3,5,11,0,0,19,4,10,3,0,0,17,nowin,win,plwin,beat,20,0,8,211,0.417061611,0.047393365,0.526066351,1,0.271531309
930,40,20156,8,2,6,7,0,23,7,7,9,0,0,23,nowin,loss,bust,plbust,0,10,10,196,0.367346939,0.030612245,0.617346939,0,0.025358183
931,22,20156,10,10,0,0,0,20,7,7,9,0,0,23,nowin,win,dlbust,bust,20,0,20,187,0.481283422,0.042780749,0.577540107,3,0.906128176
932,107,20156,5,7,0,6,0,18,7,7,9,0,0,23,nowin,win,dlbust,bust,20,0,12,218,0.444954128,0.073394495,0.600917431,2,0.605210014
933,73,20156,10,4,0,6,0,20,7,7,9,0,0,23,nowin,win,dlbust,bust,20,0,14,181,0.375690608,0.011049724,0.596685083,0,0.022795773
934,44,20156,4,3,4,10,0,21,7,7,9,0,0,23,nowin,win,dlbust,bust,20,0,7,219,0.433789954,0.050228311,0.534246575,1,0.285551035
935,149,20156,6,11,1,0,0,18,7,7,9,0,0,23,nowin,win,dlbust,bust,20,0,17,225,0.457777778,0.057777778,0.648888889,2,0.651965595
936,125,20157,10,9,0,0,0,19,10,5,8,0,0,23,nowin,win,dlbust,bust,20,0,19,219,0.438356164,0.050228311,0.575342466,1,0.308411257
937,114,20157,6,8,0,10,0,24,10,5,8,0,0,23,nowin,loss,bust,plbust,0,10,14,198,0.47979798,0.025252525,0.611111111,3,0.937232995
938,148,20157,10,9,0,0,0,19,10,5,8,0,0,23,nowin,win,dlbust,bust,20,0,19,204,0.401960784,0.078431373,0.593137255,0,0.029789521
939,44,20157,5,1,10,6,0,22,10,5,8,0,0,23,nowin,loss,bust,plbust,0,10,6,219,0.433789954,0.050228311,0.534246575,1,0.285551035
940,63,20157,8,5,0,9,0,22,10,5,8,0,0,23,nowin,loss,bust,plbust,0,10,13,216,0.467592593,0.037037037,0.62037037,3,0.931690496
941,31,20157,4,7,10,0,0,21,10,5,8,0,0,23,nowin,win,dlbust,bust,20,0,11,188,0.473404255,0.058510638,0.515957447,1,0.300306557
942,45,20158,4,3,10,0,0,17,10,3,10,0,0,23,nowin,win,dlbust,bust,20,0,7,196,0.428571429,0.051020408,0.612244898,2,0.598821767
943,122,20158,6,1,5,7,0,19,10,3,10,0,0,23,nowin,win,dlbust,bust,20,0,7,210,0.347619048,0.052380952,0.59047619,0,0.012873677
944,117,20158,3,2,11,1,0,17,10,3,10,0,0,23,nowin,win,dlbust,bust,20,0,5,173,0.410404624,0.069364162,0.606936416,2,0.578610282
945,59,20158,10,11,0,0,0,21,10,3,10,0,0,23,win,win,dlbust,bust,25,0,21,228,0.429824561,0.048245614,0.543859649,1,0.287885446
946,14,20158,7,6,0,10,0,23,10,3,10,0,0,23,nowin,loss,bust,plbust,0,10,13,202,0.391089109,0.01980198,0.628712871,2,0.577264877
947,16,20158,10,3,0,10,0,23,10,3,10,0,0,23,nowin,loss,bust,plbust,0,10,13,220,0.427272727,0.081818182,0.6,2,0.588660176
948,89,20159,9,10,0,0,0,19,10,3,10,0,0,23,nowin,win,dlbust,bust,20,0,19,212,0.537735849,0.047169811,0.594339623,3,0.990167191
949,107,20159,1,5,10,8,0,24,10,3,10,0,0,23,nowin,loss,bust,plbust,0,10,6,218,0.444954128,0.073394495,0.600917431,2,0.605210014
950,82,20159,5,10,0,8,0,23,10,3,10,0,0,23,nowin,loss,bust,plbust,0,10,15,225,0.408888889,0.075555556,0.577777778,0,0.028101874
951,44,20159,2,2,7,6,0,17,10,3,10,0,0,23,nowin,win,dlbust,bust,20,0,4,219,0.433789954,0.050228311,0.534246575,1,0.285551035
952,149,20159,10,8,0,0,0,18,10,3,10,0,0,23,nowin,win,dlbust,bust,20,0,18,225,0.457777778,0.057777778,0.648888889,2,0.651965595
953,122,20159,4,4,3,4,10,25,10,3,10,0,0,23,nowin,loss,bust,plbust,0,10,8,210,0.347619048,0.052380952,0.59047619,0,0.012873677
954,82,20160,2,10,0,0,0,12,5,9,1,6,0,21,nowin,loss,beat,dlwin,0,10,12,225,0.408888889,0.075555556,0.577777778,0,0.028101874
955,13,20160,3,7,4,0,0,14,5,9,1,6,0,21,nowin,loss,beat,dlwin,0,10,10,206,0.417475728,0.063106796,0.621359223,2,0.59555479
956,1,20160,7,10,0,0,0,17,5,9,1,6,0,21,nowin,loss,beat,dlwin,0,10,17,197,0.406091371,0.025380711,0.649746193,2,0.606186955
957,97,20160,7,7,0,0,0,14,5,9,1,6,0,21,nowin,loss,beat,dlwin,0,10,14,182,0.450549451,0.06043956,0.692307692,2,0.677372279
958,29,20160,11,10,0,0,0,21,5,9,1,6,0,21,win,push,push,push,10,0,21,189,0.44973545,0.058201058,0.544973545,1,0.300349439
959,9,20160,6,5,9,0,0,20,5,9,1,6,0,21,nowin,loss,beat,dlwin,0,10,11,194,0.37628866,0.015463918,0.541237113,0,0.009396796
960,83,20161,2,5,9,10,0,26,7,11,0,0,0,18,nowin,loss,bust,plbust,0,10,7,193,0.424870466,0.051813472,0.678756477,2,0.644360335
961,80,20161,6,6,0,10,0,22,7,11,0,0,0,18,nowin,loss,bust,plbust,0,10,12,186,0.419354839,0.059139785,0.623655914,2,0.59892924
962,108,20161,8,7,0,10,0,25,7,11,0,0,0,18,nowin,loss,bust,plbust,0,10,15,193,0.435233161,0.056994819,0.559585492,1,0.298824795
963,69,20161,4,10,0,10,0,24,7,11,0,0,0,18,nowin,loss,bust,plbust,0,10,14,194,0.365979381,0.030927835,0.515463918,0,0
964,56,20161,10,10,0,0,0,20,7,11,0,0,0,18,nowin,win,plwin,beat,20,0,20,175,0.4,0.057142857,0.582857143,0,0.026685297
965,75,20161,8,10,0,0,0,18,7,11,0,0,0,18,nowin,push,push,push,10,0,18,191,0.418848168,0.052356021,0.570680628,0,0.029344702
966,116,20162,6,5,4,0,0,15,2,10,10,0,0,22,nowin,win,dlbust,bust,20,0,11,195,0.425641026,0.056410256,0.538461538,1,0.28273747
967,78,20162,11,8,0,0,0,19,2,10,10,0,0,22,nowin,win,dlbust,bust,20,0,19,201,0.517412935,0.034825871,0.587064677,3,0.95871112
968,98,20162,10,6,0,0,0,16,2,10,10,0,0,22,nowin,win,dlbust,bust,20,0,16,220,0.422727273,0.054545455,0.55,1,0.28664435
969,17,20162,10,9,0,0,0,19,2,10,10,0,0,22,nowin,win,dlbust,bust,20,0,19,171,0.444444444,0.070175439,0.555555556,1,0.302364894
970,52,20162,10,5,0,0,0,15,2,10,10,0,0,22,nowin,win,dlbust,bust,20,0,15,217,0.414746544,0.02764977,0.599078341,2,0.576736024
971,21,20162,10,9,0,0,0,19,2,10,10,0,0,22,nowin,win,dlbust,bust,20,0,19,214,0.359813084,0.042056075,0.626168224,0,0.025263474
972,59,20163,9,11,0,0,0,20,10,4,10,0,0,24,nowin,win,dlbust,bust,20,0,20,228,0.429824561,0.048245614,0.543859649,1,0.287885446
973,96,20163,2,10,0,3,3,18,10,4,10,0,0,24,nowin,win,dlbust,bust,20,0,12,190,0.468421053,0.057894737,0.584210526,3,0.897263354
974,98,20163,6,4,6,10,0,26,10,4,10,0,0,24,nowin,loss,bust,plbust,0,10,10,220,0.422727273,0.054545455,0.55,1,0.28664435
975,32,20163,7,2,10,0,0,19,10,4,10,0,0,24,nowin,win,dlbust,bust,20,0,9,189,0.391534392,0.037037037,0.53968254,0,0.013579086
976,5,20163,9,5,0,4,0,18,10,4,10,0,0,24,nowin,win,dlbust,bust,20,0,14,203,0.42364532,0.02955665,0.596059113,2,0.582508076
977,74,20163,10,9,0,0,0,19,10,4,10,0,0,24,nowin,win,dlbust,bust,20,0,19,209,0.411483254,0.04784689,0.531100478,0,0.017448125
978,114,20164,4,9,0,0,0,13,3,10,6,0,0,19,nowin,loss,beat,dlwin,0,10,13,198,0.47979798,0.025252525,0.611111111,3,0.937232995
979,74,20164,10,10,0,0,0,20,3,10,6,0,0,19,nowin,win,plwin,beat,20,0,20,209,0.411483254,0.04784689,0.531100478,0,0.017448125
980,87,20164,10,3,0,0,0,13,3,10,6,0,0,19,nowin,loss,beat,dlwin,0,10,13,202,0.405940594,0.054455446,0.628712871,2,0.590599801
981,101,20164,10,11,0,0,0,21,3,10,6,0,0,19,win,win,plwin,beat,25,0,21,205,0.424390244,0.068292683,0.63902439,2,0.614740646
982,5,20164,5,10,0,0,0,15,3,10,6,0,0,19,nowin,loss,beat,dlwin,0,10,15,203,0.42364532,0.02955665,0.596059113,2,0.582508076
983,18,20164,7,9,0,0,0,16,3,10,6,0,0,19,nowin,loss,beat,dlwin,0,10,16,182,0.461538462,0.043956044,0.587912088,3,0.892649374
984,85,20165,10,7,0,0,0,17,2,2,2,10,10,26,nowin,win,dlbust,bust,20,0,17,195,0.41025641,0.066666667,0.594871795,0,0.03269711
985,15,20165,4,11,4,0,0,19,2,2,2,10,10,26,nowin,win,dlbust,bust,20,0,15,212,0.410377358,0.051886792,0.561320755,0,0.024517408
986,42,20165,8,10,0,0,0,18,2,2,2,10,10,26,nowin,win,dlbust,bust,20,0,18,212,0.443396226,0.051886792,0.570754717,1,0.309181312
987,61,20165,3,4,6,0,0,13,2,2,2,10,10,26,nowin,win,dlbust,bust,20,0,7,194,0.427835052,0.077319588,0.603092784,2,0.591437139
988,6,20165,1,3,10,0,0,14,2,2,2,10,10,26,nowin,win,dlbust,bust,20,0,4,191,0.439790576,0.047120419,0.581151832,1,0.31211505
989,50,20165,2,3,5,10,0,20,2,2,2,10,10,26,nowin,win,dlbust,bust,20,0,5,202,0.405940594,0.04950495,0.54950495,0,0.020296079
990,27,20166,5,2,10,0,0,17,10,5,9,0,0,24,nowin,win,dlbust,bust,20,0,7,178,0.370786517,0.016853933,0.573033708,0,0.015536309
991,129,20166,8,4,0,2,8,22,10,5,9,0,0,24,nowin,loss,bust,plbust,0,10,12,201,0.422885572,0.064676617,0.55721393,0,0.027255383
992,126,20166,1,5,10,8,0,24,10,5,9,0,0,24,nowin,loss,bust,plbust,0,10,6,188,0.457446809,0.074468085,0.60106383,3,0.900633203
993,69,20166,6,10,0,6,0,22,10,5,9,0,0,24,nowin,loss,bust,plbust,0,10,16,194,0.365979381,0.030927835,0.515463918,0,0
994,116,20166,2,7,9,0,0,18,10,5,9,0,0,24,nowin,win,dlbust,bust,20,0,9,195,0.425641026,0.056410256,0.538461538,1,0.28273747
995,52,20166,2,4,10,4,0,20,10,5,9,0,0,24,nowin,win,dlbust,bust,20,0,6,217,0.414746544,0.02764977,0.599078341,2,0.576736024
996,137,20167,10,10,0,0,0,20,9,10,0,0,0,19,nowin,win,plwin,beat,20,0,20,194,0.417525773,0.046391753,0.536082474,1,0.276714602
997,14,20167,3,7,5,6,0,21,9,10,0,0,0,19,nowin,win,plwin,beat,20,0,10,202,0.391089109,0.01980198,0.628712871,2,0.577264877
998,113,20167,9,10,0,0,0,19,9,10,0,0,0,19,nowin,push,push,push,10,0,19,199,0.407035176,0.055276382,0.668341709,2,0.620695264
999,19,20167,10,10,0,0,0,20,9,10,0,0,0,19,nowin,win,plwin,beat,20,0,20,237,0.41350211,0.054852321,0.628691983,2,0.597373826
1000,16,20167,5,8,0,3,10,26,9,10,0,0,0,19,nowin,loss,bust,plbust,0,10,13,220,0.427272727,0.081818182,0.6,2,0.588660176
1001,92,20167,10,6,0,6,0,22,9,10,0,0,0,19,nowin,loss,bust,plbust,0,10,16,186,0.446236559,0.059139785,0.564516129,1,0.307826125
1002,4,20168,8,10,0,0,0,18,4,7,6,0,0,17,nowin,win,plwin,beat,20,0,18,217,0.460829493,0.036866359,0.562211982,1,0.315432839
1003,141,20168,10,11,0,0,0,21,4,7,6,0,0,17,win,win,plwin,beat,25,0,21,202,0.420792079,0.074257426,0.564356436,0,0.028377851
1004,145,20168,4,8,0,0,0,12,4,7,6,0,0,17,nowin,loss,beat,dlwin,0,10,12,188,0.441489362,0.031914894,0.622340426,2,0.617837093
1005,130,20168,6,4,10,0,0,20,4,7,6,0,0,17,nowin,win,plwin,beat,20,0,10,219,0.410958904,0.03652968,0.566210046,0,0.025888739
1006,55,20168,3,10,0,0,0,13,4,7,6,0,0,17,nowin,loss,beat,dlwin,0,10,13,191,0.371727749,0.057591623,0.54973822,0,0.01011347
1007,8,20168,9,9,0,0,0,18,4,7,6,0,0,17,nowin,win,plwin,beat,20,0,18,181,0.44198895,0.071823204,0.596685083,2,0.599438402
1008,38,20169,10,11,0,0,0,21,10,9,0,0,0,19,win,win,plwin,beat,25,0,21,202,0.361386139,0.03960396,0.564356436,0,0.010597953
1009,13,20169,10,11,0,0,0,21,10,9,0,0,0,19,win,win,plwin,beat,25,0,21,206,0.417475728,0.063106796,0.621359223,2,0.59555479
1010,66,20169,10,6,0,10,0,26,10,9,0,0,0,19,nowin,loss,bust,plbust,0,10,16,217,0.456221198,0.064516129,0.626728111,3,0.924304367
1011,55,20169,5,2,10,0,0,17,10,9,0,0,0,19,nowin,loss,beat,dlwin,0,10,7,191,0.371727749,0.057591623,0.54973822,0,0.01011347
1012,19,20169,4,10,0,7,0,21,10,9,0,0,0,19,nowin,win,plwin,beat,20,0,14,237,0.41350211,0.054852321,0.628691983,2,0.597373826
1013,33,20169,1,5,6,10,0,22,10,9,0,0,0,19,nowin,loss,bust,plbust,0,10,6,192,0.4375,0.057291667,0.625,2,0.616208916
1014,50,20170,10,7,0,0,0,17,10,2,10,0,0,22,nowin,win,dlbust,bust,20,0,17,202,0.405940594,0.04950495,0.54950495,0,0.020296079
1015,135,20170,1,6,7,1,10,25,10,2,10,0,0,22,nowin,loss,bust,plbust,0,10,7,179,0.391061453,0.067039106,0.586592179,0,0.024924662
1016,103,20170,7,6,0,4,0,17,10,2,10,0,0,22,nowin,win,dlbust,bust,20,0,13,203,0.379310345,0.064039409,0.551724138,0,0.012869209
1017,68,20170,5,10,0,4,0,19,10,2,10,0,0,22,nowin,win,dlbust,bust,20,0,15,205,0.434146341,0.029268293,0.6,2,0.59483189
1018,25,20170,8,7,0,4,0,19,10,2,10,0,0,22,nowin,win,dlbust,bust,20,0,15,190,0.463157895,0.063157895,0.536842105,1,0.304401563
1019,2,20170,4,8,0,8,0,20,10,2,10,0,0,22,nowin,win,dlbust,bust,20,0,12,200,0.445,0.035,0.64,2,0.633962549
1020,47,20171,9,10,0,0,0,19,10,10,0,0,0,20,nowin,loss,beat,dlwin,0,10,19,210,0.438095238,0.057142857,0.623809524,2,0.615868808
1021,8,20171,2,10,0,5,0,17,10,10,0,0,0,20,nowin,loss,beat,dlwin,0,10,12,181,0.44198895,0.071823204,0.596685083,2,0.599438402
1022,85,20171,3,10,0,10,0,23,10,10,0,0,0,20,nowin,loss,bust,plbust,0,10,13,195,0.41025641,0.066666667,0.594871795,0,0.03269711
1023,35,20171,4,4,7,9,0,24,10,10,0,0,0,20,nowin,loss,bust,plbust,0,10,8,202,0.410891089,0.044554455,0.633663366,2,0.598681573
1024,138,20171,10,7,0,0,0,17,10,10,0,0,0,20,nowin,loss,beat,dlwin,0,10,17,190,0.442105263,0.047368421,0.610526316,2,0.609711065
1025,73,20171,6,8,0,8,0,22,10,10,0,0,0,20,nowin,loss,bust,plbust,0,10,14,181,0.375690608,0.011049724,0.596685083,0,0.022795773
1026,19,20172,3,8,10,0,0,21,10,10,0,0,0,20,nowin,win,plwin,beat,20,0,11,237,0.41350211,0.054852321,0.628691983,2,0.597373826
1027,48,20172,10,5,0,8,0,23,10,10,0,0,0,20,nowin,loss,bust,plbust,0,10,15,203,0.413793103,0.019704433,0.600985222,2,0.577280801
1028,22,20172,10,10,0,0,0,20,10,10,0,0,0,20,nowin,push,push,push,10,0,20,187,0.481283422,0.042780749,0.577540107,3,0.906128176
1029,18,20172,3,2,9,8,0,22,10,10,0,0,0,20,nowin,loss,bust,plbust,0,10,5,182,0.461538462,0.043956044,0.587912088,3,0.892649374
1030,128,20172,10,11,0,0,0,21,10,10,0,0,0,20,win,win,plwin,beat,25,0,21,227,0.356828194,0.052863436,0.577092511,0,0.012352564
1031,130,20172,10,7,0,0,0,17,10,10,0,0,0,20,nowin,loss,beat,dlwin,0,10,17,219,0.410958904,0.03652968,0.566210046,0,0.025888739
1032,31,20173,8,3,10,0,0,21,10,10,0,0,0,20,nowin,win,plwin,beat,20,0,11,188,0.473404255,0.058510638,0.515957447,1,0.300306557
1033,143,20173,2,10,0,10,0,22,10,10,0,0,0,20,nowin,loss,bust,plbust,0,10,12,203,0.463054187,0.044334975,0.57635468,3,0.883143365
1034,81,20173,4,1,9,3,0,17,10,10,0,0,0,20,nowin,loss,beat,dlwin,0,10,5,182,0.395604396,0.043956044,0.60989011,2,0.567491261
1035,111,20173,3,5,8,10,0,26,10,10,0,0,0,20,nowin,loss,bust,plbust,0,10,8,180,0.433333333,0.055555556,0.611111111,2,0.602264492
1036,11,20173,10,10,0,0,0,20,10,10,0,0,0,20,nowin,push,push,push,10,0,20,236,0.457627119,0.016949153,0.588983051,3,0.889015813
1037,53,20173,2,4,2,10,0,18,10,10,0,0,0,20,nowin,loss,beat,dlwin,0,10,6,250,0.372,0.064,0.564,0,0.013687345
1038,3,20174,2,10,0,6,0,18,9,2,10,0,0,21,nowin,loss,beat,dlwin,0,10,12,190,0.431578947,0.026315789,0.542105263,1,0.288076384
1039,22,20174,10,7,0,0,0,17,9,2,10,0,0,21,nowin,loss,beat,dlwin,0,10,17,187,0.481283422,0.042780749,0.577540107,3,0.906128176
1040,26,20174,5,9,0,5,0,19,9,2,10,0,0,21,nowin,loss,beat,dlwin,0,10,14,203,0.463054187,0.0591133,0.541871921,1,0.306802864
1041,33,20174,11,10,0,0,0,21,9,2,10,0,0,21,win,push,push,push,10,0,21,192,0.4375,0.057291667,0.625,2,0.616208916
1042,31,20174,10,10,0,0,0,20,9,2,10,0,0,21,nowin,loss,beat,dlwin,0,10,20,188,0.473404255,0.058510638,0.515957447,1,0.300306557
1043,55,20174,10,10,0,0,0,20,9,2,10,0,0,21,nowin,loss,beat,dlwin,0,10,20,191,0.371727749,0.057591623,0.54973822,0,0.01011347
1044,60,20175,5,10,0,5,0,20,10,5,10,0,0,25,nowin,win,dlbust,bust,20,0,15,227,0.418502203,0.022026432,0.559471366,0,0.026496258
1045,14,20175,4,9,0,10,0,23,10,5,10,0,0,25,nowin,loss,bust,plbust,0,10,13,202,0.391089109,0.01980198,0.628712871,2,0.577264877
1046,67,20175,4,5,10,0,0,19,10,5,10,0,0,25,nowin,win,dlbust,bust,20,0,9,195,0.369230769,0.041025641,0.569230769,0,0.014139427
1047,75,20175,10,10,0,0,0,20,10,5,10,0,0,25,nowin,win,dlbust,bust,20,0,20,191,0.418848168,0.052356021,0.570680628,0,0.029344702
1048,141,20175,6,5,4,7,0,22,10,5,10,0,0,25,nowin,loss,bust,plbust,0,10,11,202,0.420792079,0.074257426,0.564356436,0,0.028377851
1049,20,20175,3,10,0,8,0,21,10,5,10,0,0,25,nowin,win,dlbust,bust,20,0,13,186,0.456989247,0.037634409,0.537634409,1,0.301097108
1050,54,20176,10,5,0,4,0,19,10,10,0,0,0,20,nowin,loss,beat,dlwin,0,10,15,185,0.437837838,0.032432432,0.556756757,1,0.29899854
1051,10,20176,6,5,9,0,0,20,10,10,0,0,0,20,nowin,push,push,push,10,0,11,191,0.413612565,0.057591623,0.596858639,2,0.574087175
1052,42,20176,11,4,3,0,0,18,10,10,0,0,0,20,nowin,loss,beat,dlwin,0,10,15,212,0.443396226,0.051886792,0.570754717,1,0.309181312
1053,95,20176,10,6,0,4,0,20,10,10,0,0,0,20,nowin,push,push,push,10,0,16,218,0.412844037,0.04587156,0.559633028,0,0.024842385
1054,126,20176,9,8,0,0,0,17,10,10,0,0,0,20,nowin,loss,beat,dlwin,0,10,17,188,0.457446809,0.074468085,0.60106383,3,0.900633203
1055,84,20176,6,7,0,7,0,20,10,10,0,0,0,20,nowin,push,push,push,10,0,13,195,0.379487179,0.056410256,0.569230769,0,0.017209119
1056,29,20177,5,5,2,10,0,22,11,10,0,0,0,21,nowin,loss,bust,plbust,0,10,10,189,0.44973545,0.058201058,0.544973545,1,0.300349439
1057,144,20177,10,6,0,5,0,21,11,10,0,0,0,21,nowin,push,push,push,10,0,16,202,0.386138614,0.054455446,0.564356436,0,0.018006244
1058,81,20177,10,5,0,9,0,24,11,10,0,0,0,21,nowin,loss,bust,plbust,0,10,15,182,0.395604396,0.043956044,0.60989011,2,0.567491261
1059,79,20177,10,10,0,0,0,20,11,10,0,0,0,21,nowin,loss,beat,dlwin,0,10,20,211,0.436018957,0.028436019,0.672985782,2,0.650131054
1060,90,20177,3,4,2,6,3,18,11,10,0,0,0,21,nowin,loss,beat,dlwin,0,10,7,201,0.447761194,0.049751244,0.60199005,3,0.889945023
1061,64,20177,8,10,0,0,0,18,11,10,0,0,0,21,nowin,loss,beat,dlwin,0,10,18,187,0.363636364,0.048128342,0.631016043,0,0.027594885
1062,90,20178,2,6,10,0,0,18,10,8,0,0,0,18,nowin,push,push,push,10,0,8,201,0.447761194,0.049751244,0.60199005,3,0.889945023
1063,122,20178,4,3,10,0,0,17,10,8,0,0,0,18,nowin,loss,beat,dlwin,0,10,7,210,0.347619048,0.052380952,0.59047619,0,0.012873677
1064,78,20178,5,4,8,0,0,17,10,8,0,0,0,18,nowin,loss,beat,dlwin,0,10,9,201,0.517412935,0.034825871,0.587064677,3,0.95871112
1065,58,20178,6,10,0,9,0,25,10,8,0,0,0,18,nowin,loss,bust,plbust,0,10,16,195,0.430769231,0.041025641,0.584615385,2,0.580497586
1066,71,20178,9,10,0,0,0,19,10,8,0,0,0,18,nowin,win,plwin,beat,20,0,19,193,0.352331606,0.046632124,0.585492228,0,0.013063661
1067,51,20178,9,7,0,5,0,21,10,8,0,0,0,18,nowin,win,plwin,beat,20,0,16,189,0.529100529,0.068783069,0.608465608,3,0.993665715
1068,58,20179,10,8,0,0,0,18,2,6,7,2,0,17,nowin,win,plwin,beat,20,0,18,195,0.430769231,0.041025641,0.584615385,2,0.580497586
1069,61,20179,5,10,0,0,0,15,2,6,7,2,0,17,nowin,loss,beat,dlwin,0,10,15,194,0.427835052,0.077319588,0.603092784,2,0.591437139
1070,11,20179,5,10,0,0,0,15,2,6,7,2,0,17,nowin,loss,beat,dlwin,0,10,15,236,0.457627119,0.016949153,0.588983051,3,0.889015813
1071,98,20179,9,11,0,0,0,20,2,6,7,2,0,17,nowin,win,plwin,beat,20,0,20,220,0.422727273,0.054545455,0.55,1,0.28664435
1072,110,20179,1,2,10,0,0,13,2,6,7,2,0,17,nowin,loss,beat,dlwin,0,10,3,192,0.416666667,0.046875,0.557291667,0,0.025413132
1073,121,20179,10,5,0,0,0,15,2,6,7,2,0,17,nowin,loss,beat,dlwin,0,10,15,195,0.456410256,0.025641026,0.512820513,1,0.288597791
1074,73,20180,10,5,0,0,0,15,4,10,10,0,0,24,nowin,win,dlbust,bust,20,0,15,181,0.375690608,0.011049724,0.596685083,0,0.022795773
1075,87,20180,5,7,0,0,0,12,4,10,10,0,0,24,nowin,win,dlbust,bust,20,0,12,202,0.405940594,0.054455446,0.628712871,2,0.590599801
1076,66,20180,10,6,0,0,0,16,4,10,10,0,0,24,nowin,win,dlbust,bust,20,0,16,217,0.456221198,0.064516129,0.626728111,3,0.924304367
1077,123,20180,6,8,0,0,0,14,4,10,10,0,0,24,nowin,win,dlbust,bust,20,0,14,205,0.43902439,0.034146341,0.614634146,2,0.609962544
1078,125,20180,10,10,0,0,0,20,4,10,10,0,0,24,nowin,win,dlbust,bust,20,0,20,219,0.438356164,0.050228311,0.575342466,1,0.308411257
1079,41,20180,4,5,5,0,0,14,4,10,10,0,0,24,nowin,win,dlbust,bust,20,0,9,192,0.364583333,0.036458333,0.520833333,0,0.00089702
1080,32,20181,3,10,0,0,0,13,2,9,10,0,0,21,nowin,loss,beat,dlwin,0,10,13,189,0.391534392,0.037037037,0.53968254,0,0.013579086
1081,86,20181,11,1,9,0,0,21,2,9,10,0,0,21,nowin,push,push,push,10,0,12,196,0.454081633,0.040816327,0.591836735,3,0.887566443
1082,93,20181,10,11,0,0,0,21,2,9,10,0,0,21,win,push,push,push,10,0,21,175,0.485714286,0.051428571,0.548571429,1,0.323648091
1083,102,20181,10,10,0,0,0,20,2,9,10,0,0,21,nowin,loss,beat,dlwin,0,10,20,192,0.338541667,0.046875,0.5625,0,0.003306118
1084,39,20181,10,4,0,0,0,14,2,9,10,0,0,21,nowin,loss,beat,dlwin,0,10,14,191,0.429319372,0.062827225,0.57591623,0,0.033760763
1085,89,20181,10,6,0,0,0,16,2,9,10,0,0,21,nowin,loss,beat,dlwin,0,10,16,212,0.537735849,0.047169811,0.594339623,3,0.990167191
1086,32,20182,9,2,10,0,0,21,10,5,5,0,0,20,nowin,win,plwin,beat,20,0,11,189,0.391534392,0.037037037,0.53968254,0,0.013579086
1087,40,20182,6,7,0,10,0,23,10,5,5,0,0,20,nowin,loss,bust,plbust,0,10,13,196,0.367346939,0.030612245,0.617346939,0,0.025358183
1088,73,20182,6,10,0,5,0,21,10,5,5,0,0,20,nowin,win,plwin,beat,20,0,16,181,0.375690608,0.011049724,0.596685083,0,0.022795773
1089,112,20182,8,2,3,10,0,23,10,5,5,0,0,20,nowin,loss,bust,plbust,0,10,10,203,0.448275862,0.054187192,0.600985222,3,0.889576933
1090,125,20182,9,4,0,10,0,23,10,5,5,0,0,20,nowin,loss,bust,plbust,0,10,13,219,0.438356164,0.050228311,0.575342466,1,0.308411257
1091,123,20182,9,9,0,0,0,18,10,5,5,0,0,20,nowin,loss,beat,dlwin,0,10,18,205,0.43902439,0.034146341,0.614634146,2,0.609962544
1092,43,20183,7,4,10,0,0,21,10,3,10,0,0,23,nowin,win,dlbust,bust,20,0,11,192,0.40625,0.041666667,0.609375,2,0.576671372
1093,76,20183,10,9,0,0,0,19,10,3,10,0,0,23,nowin,win,dlbust,bust,20,0,19,189,0.534391534,0.079365079,0.608465608,3,1
1094,128,20183,10,10,0,0,0,20,10,3,10,0,0,23,nowin,win,dlbust,bust,20,0,20,227,0.356828194,0.052863436,0.577092511,0,0.012352564
1095,105,20183,10,4,0,8,0,22,10,3,10,0,0,23,nowin,loss,bust,plbust,0,10,14,198,0.414141414,0.070707071,0.590909091,0,0.032889494
1096,30,20183,7,7,0,7,0,21,10,3,10,0,0,23,nowin,win,dlbust,bust,20,0,14,206,0.393203883,0.033980583,0.601941748,0,0.029324648
1097,126,20183,2,9,1,10,0,22,10,3,10,0,0,23,nowin,loss,bust,plbust,0,10,11,188,0.457446809,0.074468085,0.60106383,3,0.900633203
1098,138,20184,11,10,0,0,0,21,4,1,10,1,8,24,win,win,dlbust,bust,25,0,21,190,0.442105263,0.047368421,0.610526316,2,0.609711065
1099,94,20184,2,4,6,0,0,12,4,1,10,1,8,24,nowin,win,dlbust,bust,20,0,6,183,0.43715847,0.043715847,0.540983607,1,0.290866892
1100,48,20184,10,5,0,0,0,15,4,1,10,1,8,24,nowin,win,dlbust,bust,20,0,15,203,0.413793103,0.019704433,0.600985222,2,0.577280801
1101,48,20184,5,8,0,0,0,13,4,1,10,1,8,24,nowin,win,dlbust,bust,20,0,13,203,0.413793103,0.019704433,0.600985222,2,0.577280801
1102,80,20184,10,2,0,0,0,12,4,1,10,1,8,24,nowin,win,dlbust,bust,20,0,12,186,0.419354839,0.059139785,0.623655914,2,0.59892924
1103,89,20184,10,6,0,0,0,16,4,1,10,1,8,24,nowin,win,dlbust,bust,20,0,16,212,0.537735849,0.047169811,0.594339623,3,0.990167191
1104,41,20185,8,4,0,2,5,19,8,6,8,0,0,22,nowin,win,dlbust,bust,20,0,12,192,0.364583333,0.036458333,0.520833333,0,0.00089702
1105,65,20185,6,10,0,7,0,23,8,6,8,0,0,22,nowin,loss,bust,plbust,0,10,16,203,0.492610837,0.054187192,0.571428571,3,0.913702814
1106,59,20185,6,10,0,3,0,19,8,6,8,0,0,22,nowin,win,dlbust,bust,20,0,16,228,0.429824561,0.048245614,0.543859649,1,0.287885446
1107,9,20185,10,6,0,10,0,26,8,6,8,0,0,22,nowin,loss,bust,plbust,0,10,16,194,0.37628866,0.015463918,0.541237113,0,0.009396796
1108,25,20185,3,8,7,0,0,18,8,6,8,0,0,22,nowin,win,dlbust,bust,20,0,11,190,0.463157895,0.063157895,0.536842105,1,0.304401563
1109,94,20185,10,10,0,0,0,20,8,6,8,0,0,22,nowin,win,dlbust,bust,20,0,20,183,0.43715847,0.043715847,0.540983607,1,0.290866892
1110,88,20186,3,3,9,8,0,23,8,11,0,0,0,19,nowin,loss,bust,plbust,0,10,6,206,0.466019417,0.033980583,0.54368932,1,0.309467903
1111,106,20186,4,11,2,0,0,17,8,11,0,0,0,19,nowin,loss,beat,dlwin,0,10,15,192,0.411458333,0.026041667,0.557291667,0,0.023854304
1112,68,20186,5,9,0,10,0,24,8,11,0,0,0,19,nowin,loss,bust,plbust,0,10,14,205,0.434146341,0.029268293,0.6,2,0.59483189
1113,57,20186,5,1,10,1,0,17,8,11,0,0,0,19,nowin,loss,beat,dlwin,0,10,6,192,0.46875,0.052083333,0.59375,3,0.907001181
1114,66,20186,1,3,10,5,0,19,8,11,0,0,0,19,nowin,push,push,push,10,0,4,217,0.456221198,0.064516129,0.626728111,3,0.924304367
1115,28,20186,10,10,0,0,0,20,8,11,0,0,0,19,nowin,win,plwin,beat,20,0,20,199,0.422110553,0.045226131,0.542713568,1,0.282706618
1116,144,20187,3,9,0,3,5,20,7,3,10,0,0,20,nowin,push,push,push,10,0,12,202,0.386138614,0.054455446,0.564356436,0,0.018006244
1117,45,20187,9,10,0,0,0,19,7,3,10,0,0,20,nowin,loss,beat,dlwin,0,10,19,196,0.428571429,0.051020408,0.612244898,2,0.598821767
1118,20,20187,10,7,0,0,0,17,7,3,10,0,0,20,nowin,loss,beat,dlwin,0,10,17,186,0.456989247,0.037634409,0.537634409,1,0.301097108
1119,141,20187,1,3,10,9,0,23,7,3,10,0,0,20,nowin,loss,bust,plbust,0,10,4,202,0.420792079,0.074257426,0.564356436,0,0.028377851
1120,39,20187,7,8,0,10,0,25,7,3,10,0,0,20,nowin,loss,bust,plbust,0,10,15,191,0.429319372,0.062827225,0.57591623,0,0.033760763
1121,130,20187,2,10,0,10,0,22,7,3,10,0,0,20,nowin,loss,bust,plbust,0,10,12,219,0.410958904,0.03652968,0.566210046,0,0.025888739
1122,40,20188,1,6,10,0,0,17,9,2,10,0,0,21,nowin,loss,beat,dlwin,0,10,7,196,0.367346939,0.030612245,0.617346939,0,0.025358183
1123,59,20188,8,10,0,0,0,18,9,2,10,0,0,21,nowin,loss,beat,dlwin,0,10,18,228,0.429824561,0.048245614,0.543859649,1,0.287885446
1124,107,20188,2,8,10,0,0,20,9,2,10,0,0,21,nowin,loss,beat,dlwin,0,10,10,218,0.444954128,0.073394495,0.600917431,2,0.605210014
1125,64,20188,4,2,8,2,9,25,9,2,10,0,0,21,nowin,loss,bust,plbust,0,10,6,187,0.363636364,0.048128342,0.631016043,0,0.027594885
1126,22,20188,8,5,0,2,10,25,9,2,10,0,0,21,nowin,loss,bust,plbust,0,10,13,187,0.481283422,0.042780749,0.577540107,3,0.906128176
1127,6,20188,3,10,0,7,0,20,9,2,10,0,0,21,nowin,loss,beat,dlwin,0,10,13,191,0.439790576,0.047120419,0.581151832,1,0.31211505
1128,98,20189,3,2,7,10,0,22,2,2,11,10,0,25,nowin,loss,bust,plbust,0,10,5,220,0.422727273,0.054545455,0.55,1,0.28664435
1129,115,20189,5,3,5,0,0,13,2,2,11,10,0,25,nowin,win,dlbust,bust,20,0,8,194,0.427835052,0.041237113,0.592783505,2,0.583863602
1130,28,20189,3,4,10,0,0,17,2,2,11,10,0,25,nowin,win,dlbust,bust,20,0,7,199,0.422110553,0.045226131,0.542713568,1,0.282706618
1131,17,20189,9,7,0,0,0,16,2,2,11,10,0,25,nowin,win,dlbust,bust,20,0,16,171,0.444444444,0.070175439,0.555555556,1,0.302364894
1132,79,20189,3,4,10,0,0,17,2,2,11,10,0,25,nowin,win,dlbust,bust,20,0,7,211,0.436018957,0.028436019,0.672985782,2,0.650131054
1133,149,20189,8,3,4,0,0,15,2,2,11,10,0,25,nowin,win,dlbust,bust,20,0,11,225,0.457777778,0.057777778,0.648888889,2,0.651965595
1134,44,20190,11,1,1,0,0,13,2,6,10,0,0,18,nowin,loss,beat,dlwin,0,10,12,219,0.433789954,0.050228311,0.534246575,1,0.285551035
1135,16,20190,10,11,0,0,0,21,2,6,10,0,0,18,win,win,plwin,beat,25,0,21,220,0.427272727,0.081818182,0.6,2,0.588660176
1136,150,20190,3,7,8,0,0,18,2,6,10,0,0,18,nowin,push,push,push,10,0,10,192,0.401041667,0.036458333,0.567708333,0,0.023287458
1137,78,20190,11,8,0,0,0,19,2,6,10,0,0,18,nowin,win,plwin,beat,20,0,19,201,0.517412935,0.034825871,0.587064677,3,0.95871112
1138,16,20190,2,10,0,6,0,18,2,6,10,0,0,18,nowin,push,push,push,10,0,12,220,0.427272727,0.081818182,0.6,2,0.588660176
1139,41,20190,6,10,0,0,0,16,2,6,10,0,0,18,nowin,loss,beat,dlwin,0,10,16,192,0.364583333,0.036458333,0.520833333,0,0.00089702
1140,14,20191,11,1,7,0,0,19,5,1,8,5,0,19,nowin,push,push,push,10,0,12,202,0.391089109,0.01980198,0.628712871,2,0.577264877
1141,74,20191,10,8,0,0,0,18,5,1,8,5,0,19,nowin,loss,beat,dlwin,0,10,18,209,0.411483254,0.04784689,0.531100478,0,0.017448125
1142,39,20191,10,10,0,0,0,20,5,1,8,5,0,19,nowin,win,plwin,beat,20,0,20,191,0.429319372,0.062827225,0.57591623,0,0.033760763
1143,110,20191,10,3,0,0,0,13,5,1,8,5,0,19,nowin,loss,beat,dlwin,0,10,13,192,0.416666667,0.046875,0.557291667,0,0.025413132
1144,33,20191,10,7,0,0,0,17,5,1,8,5,0,19,nowin,loss,beat,dlwin,0,10,17,192,0.4375,0.057291667,0.625,2,0.616208916
1145,147,20191,10,9,0,0,0,19,5,1,8,5,0,19,nowin,push,push,push,10,0,19,205,0.380487805,0.014634146,0.536585366,0,0.00951447
1146,55,20192,2,1,9,7,0,19,2,4,6,10,0,22,nowin,win,dlbust,bust,20,0,3,191,0.371727749,0.057591623,0.54973822,0,0.01011347
1147,147,20192,10,6,0,0,0,16,2,4,6,10,0,22,nowin,win,dlbust,bust,20,0,16,205,0.380487805,0.014634146,0.536585366,0,0.00951447
1148,75,20192,1,5,10,0,0,16,2,4,6,10,0,22,nowin,win,dlbust,bust,20,0,6,191,0.418848168,0.052356021,0.570680628,0,0.029344702
1149,42,20192,10,3,0,0,0,13,2,4,6,10,0,22,nowin,win,dlbust,bust,20,0,13,212,0.443396226,0.051886792,0.570754717,1,0.309181312
1150,114,20192,9,4,0,0,0,13,2,4,6,10,0,22,nowin,win,dlbust,bust,20,0,13,198,0.47979798,0.025252525,0.611111111,3,0.937232995
1151,49,20192,2,10,0,2,0,14,2,4,6,10,0,22,nowin,win,dlbust,bust,20,0,12,207,0.396135266,0.053140097,0.594202899,0,0.028306925
1152,101,20193,7,9,0,6,0,22,10,10,0,0,0,20,nowin,loss,bust,plbust,0,10,16,205,0.424390244,0.068292683,0.63902439,2,0.614740646
1153,77,20193,10,10,0,0,0,20,10,10,0,0,0,20,nowin,push,push,push,10,0,20,200,0.455,0.04,0.62,3,0.916252116
1154,56,20193,10,10,0,0,0,20,10,10,0,0,0,20,nowin,push,push,push,10,0,20,175,0.4,0.057142857,0.582857143,0,0.026685297
1155,84,20193,11,2,5,0,0,18,10,10,0,0,0,20,nowin,loss,beat,dlwin,0,10,13,195,0.379487179,0.056410256,0.569230769,0,0.017209119
1156,125,20193,5,10,0,3,0,18,10,10,0,0,0,20,nowin,loss,beat,dlwin,0,10,15,219,0.438356164,0.050228311,0.575342466,1,0.308411257
1157,125,20193,10,7,0,0,0,17,10,10,0,0,0,20,nowin,loss,beat,dlwin,0,10,17,219,0.438356164,0.050228311,0.575342466,1,0.308411257
1158,77,20194,10,10,0,0,0,20,8,8,1,0,0,17,nowin,win,plwin,beat,20,0,20,200,0.455,0.04,0.62,3,0.916252116
1159,38,20194,5,10,0,7,0,22,8,8,1,0,0,17,nowin,loss,bust,plbust,0,10,15,202,0.361386139,0.03960396,0.564356436,0,0.010597953
1160,136,20194,3,10,0,6,0,19,8,8,1,0,0,17,nowin,win,plwin,beat,20,0,13,194,0.396907216,0.025773196,0.597938144,0,0.029452644
1161,120,20194,4,3,11,0,0,18,8,8,1,0,0,17,nowin,win,plwin,beat,20,0,7,202,0.440594059,0.034653465,0.618811881,2,0.614441029
1162,77,20194,10,10,0,0,0,20,8,8,1,0,0,17,nowin,win,plwin,beat,20,0,20,200,0.455,0.04,0.62,3,0.916252116
1163,112,20194,3,10,0,1,4,18,8,8,1,0,0,17,nowin,win,plwin,beat,20,0,13,203,0.448275862,0.054187192,0.600985222,3,0.889576933
1164,138,20195,7,7,0,6,0,20,1,5,10,10,0,26,nowin,win,dlbust,bust,20,0,14,190,0.442105263,0.047368421,0.610526316,2,0.609711065
1165,132,20195,1,5,10,4,0,20,1,5,10,10,0,26,nowin,win,dlbust,bust,20,0,6,194,0.412371134,0.036082474,0.649484536,2,0.611633238
1166,139,20195,11,6,3,0,0,20,1,5,10,10,0,26,nowin,win,dlbust,bust,20,0,17,192,0.380208333,0.036458333,0.59375,0,0.023429169
1167,125,20195,10,11,0,0,0,21,1,5,10,10,0,26,win,win,dlbust,bust,25,0,21,219,0.438356164,0.050228311,0.575342466,1,0.308411257
1168,8,20195,2,9,10,0,0,21,1,5,10,10,0,26,nowin,win,dlbust,bust,20,0,11,181,0.44198895,0.071823204,0.596685083,2,0.599438402
1169,47,20195,10,10,0,0,0,20,1,5,10,10,0,26,nowin,win,dlbust,bust,20,0,20,210,0.438095238,0.057142857,0.623809524,2,0.615868808
1170,13,20196,3,10,0,6,0,19,8,5,1,10,0,24,nowin,win,dlbust,bust,20,0,13,206,0.417475728,0.063106796,0.621359223,2,0.59555479
1171,121,20196,3,10,0,2,1,16,8,5,1,10,0,24,nowin,win,dlbust,bust,20,0,13,195,0.456410256,0.025641026,0.512820513,1,0.288597791
1172,67,20196,9,10,0,0,0,19,8,5,1,10,0,24,nowin,win,dlbust,bust,20,0,19,195,0.369230769,0.041025641,0.569230769,0,0.014139427
1173,119,20196,9,10,0,0,0,19,8,5,1,10,0,24,nowin,win,dlbust,bust,20,0,19,190,0.405263158,0.068421053,0.515789474,0,0.011837158
1174,103,20196,7,2,3,10,0,22,8,5,1,10,0,24,nowin,loss,bust,plbust,0,10,9,203,0.379310345,0.064039409,0.551724138,0,0.012869209
1175,56,20196,6,8,0,8,0,22,8,5,1,10,0,24,nowin,loss,bust,plbust,0,10,14,175,0.4,0.057142857,0.582857143,0,0.026685297
1176,76,20197,10,10,0,0,0,20,5,6,1,1,10,23,nowin,win,dlbust,bust,20,0,20,189,0.534391534,0.079365079,0.608465608,3,1
1177,123,20197,10,3,0,0,0,13,5,6,1,1,10,23,nowin,win,dlbust,bust,20,0,13,205,0.43902439,0.034146341,0.614634146,2,0.609962544
1178,111,20197,8,8,0,0,0,16,5,6,1,1,10,23,nowin,win,dlbust,bust,20,0,16,180,0.433333333,0.055555556,0.611111111,2,0.602264492
1179,1,20197,5,11,2,0,0,18,5,6,1,1,10,23,nowin,win,dlbust,bust,20,0,16,197,0.406091371,0.025380711,0.649746193,2,0.606186955
1180,58,20197,11,9,0,0,0,20,5,6,1,1,10,23,nowin,win,dlbust,bust,20,0,20,195,0.430769231,0.041025641,0.584615385,2,0.580497586
1181,20,20197,7,8,0,0,0,15,5,6,1,1,10,23,nowin,win,dlbust,bust,20,0,15,186,0.456989247,0.037634409,0.537634409,1,0.301097108
1182,42,20198,8,4,0,0,0,12,6,7,9,0,0,22,nowin,win,dlbust,bust,20,0,12,212,0.443396226,0.051886792,0.570754717,1,0.309181312
1183,97,20198,10,10,0,0,0,20,6,7,9,0,0,22,nowin,win,dlbust,bust,20,0,20,182,0.450549451,0.06043956,0.692307692,2,0.677372279
1184,82,20198,10,10,0,0,0,20,6,7,9,0,0,22,nowin,win,dlbust,bust,20,0,20,225,0.408888889,0.075555556,0.577777778,0,0.028101874
1185,15,20198,7,10,0,0,0,17,6,7,9,0,0,22,nowin,win,dlbust,bust,20,0,17,212,0.410377358,0.051886792,0.561320755,0,0.024517408
1186,113,20198,11,4,4,0,0,19,6,7,9,0,0,22,nowin,win,dlbust,bust,20,0,15,199,0.407035176,0.055276382,0.668341709,2,0.620695264
1187,73,20198,1,5,8,0,0,14,6,7,9,0,0,22,nowin,win,dlbust,bust,20,0,6,181,0.375690608,0.011049724,0.596685083,0,0.022795773
1188,72,20199,4,10,0,9,0,23,7,7,2,3,0,19,nowin,loss,bust,plbust,0,10,14,185,0.394594595,0.032432432,0.508108108,0,0.006763115
1189,111,20199,4,9,0,10,0,23,7,7,2,3,0,19,nowin,loss,bust,plbust,0,10,13,180,0.433333333,0.055555556,0.611111111,2,0.602264492
1190,128,20199,10,11,0,0,0,21,7,7,2,3,0,19,win,win,plwin,beat,25,0,21,227,0.356828194,0.052863436,0.577092511,0,0.012352564
1191,61,20199,10,10,0,0,0,20,7,7,2,3,0,19,nowin,win,plwin,beat,20,0,20,194,0.427835052,0.077319588,0.603092784,2,0.591437139
1192,131,20199,3,4,10,0,0,17,7,7,2,3,0,19,nowin,loss,beat,dlwin,0,10,7,217,0.410138249,0.069124424,0.543778802,0,0.02015021
1193,17,20199,8,9,0,0,0,17,7,7,2,3,0,19,nowin,loss,beat,dlwin,0,10,17,171,0.444444444,0.070175439,0.555555556,1,0.302364894
1194,117,20200,9,2,2,4,0,17,10,5,6,0,0,21,nowin,loss,beat,dlwin,0,10,11,173,0.410404624,0.069364162,0.606936416,2,0.578610282
1195,38,20200,3,7,10,0,0,20,10,5,6,0,0,21,nowin,loss,beat,dlwin,0,10,10,202,0.361386139,0.03960396,0.564356436,0,0.010597953
1196,83,20200,10,11,0,0,0,21,10,5,6,0,0,21,win,push,push,push,10,0,21,193,0.424870466,0.051813472,0.678756477,2,0.644360335
1197,11,20200,10,7,0,0,0,17,10,5,6,0,0,21,nowin,loss,beat,dlwin,0,10,17,236,0.457627119,0.016949153,0.588983051,3,0.889015813
1198,5,20200,10,5,0,1,3,19,10,5,6,0,0,21,nowin,loss,beat,dlwin,0,10,15,203,0.42364532,0.02955665,0.596059113,2,0.582508076
1199,131,20200,6,10,0,7,0,23,10,5,6,0,0,21,nowin,loss,bust,plbust,0,10,16,217,0.410138249,0.069124424,0.543778802,0,0.02015021
1200,148,20201,6,10,0,9,0,25,7,4,10,0,0,21,nowin,loss,bust,plbust,0,10,16,204,0.401960784,0.078431373,0.593137255,0,0.029789521
1201,147,20201,7,10,0,0,0,17,7,4,10,0,0,21,nowin,loss,beat,dlwin,0,10,17,205,0.380487805,0.014634146,0.536585366,0,0.00951447
1202,23,20201,10,4,0,6,0,20,7,4,10,0,0,21,nowin,loss,beat,dlwin,0,10,14,208,0.427884615,0.0625,0.552884615,1,0.29114424
1203,130,20201,2,10,0,8,0,20,7,4,10,0,0,21,nowin,loss,beat,dlwin,0,10,12,219,0.410958904,0.03652968,0.566210046,0,0.025888739
1204,17,20201,8,2,3,10,0,23,7,4,10,0,0,21,nowin,loss,bust,plbust,0,10,10,171,0.444444444,0.070175439,0.555555556,1,0.302364894
1205,21,20201,2,9,6,0,0,17,7,4,10,0,0,21,nowin,loss,beat,dlwin,0,10,11,214,0.359813084,0.042056075,0.626168224,0,0.025263474
1206,93,20202,10,4,0,1,3,18,9,10,0,0,0,19,nowin,loss,beat,dlwin,0,10,14,175,0.485714286,0.051428571,0.548571429,1,0.323648091
1207,6,20202,5,10,0,10,0,25,9,10,0,0,0,19,nowin,loss,bust,plbust,0,10,15,191,0.439790576,0.047120419,0.581151832,1,0.31211505
1208,43,20202,9,2,6,0,0,17,9,10,0,0,0,19,nowin,loss,beat,dlwin,0,10,11,192,0.40625,0.041666667,0.609375,2,0.576671372
1209,24,20202,10,10,0,0,0,20,9,10,0,0,0,19,nowin,win,plwin,beat,20,0,20,207,0.458937198,0.048309179,0.570048309,1,0.318138014
1210,134,20202,5,5,5,10,0,25,9,10,0,0,0,19,nowin,loss,bust,plbust,0,10,10,185,0.443243243,0.021621622,0.545945946,1,0.296939509
1211,85,20202,7,2,10,0,0,19,9,10,0,0,0,19,nowin,push,push,push,10,0,9,195,0.41025641,0.066666667,0.594871795,0,0.03269711
1212,150,20203,6,5,5,0,0,16,2,10,5,0,0,17,nowin,loss,beat,dlwin,0,10,11,192,0.401041667,0.036458333,0.567708333,0,0.023287458
1213,9,20203,4,3,3,9,0,19,2,10,5,0,0,17,nowin,win,plwin,beat,20,0,7,194,0.37628866,0.015463918,0.541237113,0,0.009396796
1214,141,20203,10,5,0,0,0,15,2,10,5,0,0,17,nowin,loss,beat,dlwin,0,10,15,202,0.420792079,0.074257426,0.564356436,0,0.028377851
1215,78,20203,10,11,0,0,0,21,2,10,5,0,0,17,win,win,plwin,beat,25,0,21,201,0.517412935,0.034825871,0.587064677,3,0.95871112
1216,67,20203,3,10,0,0,0,13,2,10,5,0,0,17,nowin,loss,beat,dlwin,0,10,13,195,0.369230769,0.041025641,0.569230769,0,0.014139427
1217,26,20203,7,10,0,0,0,17,2,10,5,0,0,17,nowin,push,push,push,10,0,17,203,0.463054187,0.0591133,0.541871921,1,0.306802864
1218,2,20204,4,5,8,0,0,17,10,11,0,0,0,21,nowin,loss,beat,dlwin,0,10,9,200,0.445,0.035,0.64,2,0.633962549
1219,130,20204,10,10,0,0,0,20,10,11,0,0,0,21,nowin,loss,beat,dlwin,0,10,20,219,0.410958904,0.03652968,0.566210046,0,0.025888739
1220,57,20204,11,10,0,0,0,21,10,11,0,0,0,21,win,push,push,push,10,0,21,192,0.46875,0.052083333,0.59375,3,0.907001181
1221,14,20204,4,7,3,10,0,24,10,11,0,0,0,21,nowin,loss,bust,plbust,0,10,11,202,0.391089109,0.01980198,0.628712871,2,0.577264877
1222,23,20204,2,3,10,5,0,20,10,11,0,0,0,21,nowin,loss,beat,dlwin,0,10,5,208,0.427884615,0.0625,0.552884615,1,0.29114424
1223,41,20204,10,9,0,0,0,19,10,11,0,0,0,21,nowin,loss,beat,dlwin,0,10,19,192,0.364583333,0.036458333,0.520833333,0,0.00089702
1224,77,20205,11,5,1,0,0,17,5,10,9,0,0,24,nowin,win,dlbust,bust,20,0,16,200,0.455,0.04,0.62,3,0.916252116
1225,73,20205,3,7,10,0,0,20,5,10,9,0,0,24,nowin,win,dlbust,bust,20,0,10,181,0.375690608,0.011049724,0.596685083,0,0.022795773
1226,53,20205,8,10,0,0,0,18,5,10,9,0,0,24,nowin,win,dlbust,bust,20,0,18,250,0.372,0.064,0.564,0,0.013687345
1227,30,20205,5,10,0,0,0,15,5,10,9,0,0,24,nowin,win,dlbust,bust,20,0,15,206,0.393203883,0.033980583,0.601941748,0,0.029324648
1228,39,20205,3,10,0,0,0,13,5,10,9,0,0,24,nowin,win,dlbust,bust,20,0,13,191,0.429319372,0.062827225,0.57591623,0,0.033760763
1229,120,20205,9,5,0,0,0,14,5,10,9,0,0,24,nowin,win,dlbust,bust,20,0,14,202,0.440594059,0.034653465,0.618811881,2,0.614441029
1230,117,20206,10,11,0,0,0,21,2,9,6,0,0,17,win,win,plwin,beat,25,0,21,173,0.410404624,0.069364162,0.606936416,2,0.578610282
1231,5,20206,8,10,0,0,0,18,2,9,6,0,0,17,nowin,win,plwin,beat,20,0,18,203,0.42364532,0.02955665,0.596059113,2,0.582508076
1232,127,20206,10,5,0,0,0,15,2,9,6,0,0,17,nowin,loss,beat,dlwin,0,10,15,201,0.402985075,0.029850746,0.60199005,0,0.032263937
1233,129,20206,10,4,0,0,0,14,2,9,6,0,0,17,nowin,loss,beat,dlwin,0,10,14,201,0.422885572,0.064676617,0.55721393,0,0.027255383
1234,52,20206,10,2,0,7,0,19,2,9,6,0,0,17,nowin,win,plwin,beat,20,0,12,217,0.414746544,0.02764977,0.599078341,2,0.576736024
1235,111,20206,9,6,0,0,0,15,2,9,6,0,0,17,nowin,loss,beat,dlwin,0,10,15,180,0.433333333,0.055555556,0.611111111,2,0.602264492
1236,150,20207,10,10,0,0,0,20,11,6,0,0,0,17,nowin,win,plwin,beat,20,0,20,192,0.401041667,0.036458333,0.567708333,0,0.023287458
1237,39,20207,10,8,0,0,0,18,11,6,0,0,0,17,nowin,win,plwin,beat,20,0,18,191,0.429319372,0.062827225,0.57591623,0,0.033760763
1238,103,20207,10,3,0,7,0,20,11,6,0,0,0,17,nowin,win,plwin,beat,20,0,13,203,0.379310345,0.064039409,0.551724138,0,0.012869209
1239,120,20207,10,10,0,0,0,20,11,6,0,0,0,17,nowin,win,plwin,beat,20,0,20,202,0.440594059,0.034653465,0.618811881,2,0.614441029
1240,72,20207,1,5,6,2,10,24,11,6,0,0,0,17,nowin,loss,bust,plbust,0,10,6,185,0.394594595,0.032432432,0.508108108,0,0.006763115
1241,44,20207,11,10,0,0,0,21,11,6,0,0,0,17,win,win,plwin,beat,25,0,21,219,0.433789954,0.050228311,0.534246575,1,0.285551035
1242,110,20208,5,7,0,2,0,14,3,3,10,10,0,26,nowin,win,dlbust,bust,20,0,12,192,0.416666667,0.046875,0.557291667,0,0.025413132
1243,25,20208,10,10,0,0,0,20,3,3,10,10,0,26,nowin,win,dlbust,bust,20,0,20,190,0.463157895,0.063157895,0.536842105,1,0.304401563
1244,137,20208,5,1,8,0,0,14,3,3,10,10,0,26,nowin,win,dlbust,bust,20,0,6,194,0.417525773,0.046391753,0.536082474,1,0.276714602
1245,8,20208,4,5,4,0,0,13,3,3,10,10,0,26,nowin,win,dlbust,bust,20,0,9,181,0.44198895,0.071823204,0.596685083,2,0.599438402
1246,54,20208,3,11,7,0,0,21,3,3,10,10,0,26,nowin,win,dlbust,bust,20,0,14,185,0.437837838,0.032432432,0.556756757,1,0.29899854
1247,27,20208,9,6,0,0,0,15,3,3,10,10,0,26,nowin,win,dlbust,bust,20,0,15,178,0.370786517,0.016853933,0.573033708,0,0.015536309
1248,44,20209,9,2,5,7,0,23,9,10,0,0,0,19,nowin,loss,bust,plbust,0,10,11,219,0.433789954,0.050228311,0.534246575,1,0.285551035
1249,15,20209,7,6,0,10,0,23,9,10,0,0,0,19,nowin,loss,bust,plbust,0,10,13,212,0.410377358,0.051886792,0.561320755,0,0.024517408
1250,18,20209,10,10,0,0,0,20,9,10,0,0,0,19,nowin,win,plwin,beat,20,0,20,182,0.461538462,0.043956044,0.587912088,3,0.892649374
1251,30,20209,10,8,0,0,0,18,9,10,0,0,0,19,nowin,loss,beat,dlwin,0,10,18,206,0.393203883,0.033980583,0.601941748,0,0.029324648
1252,53,20209,8,4,0,4,10,26,9,10,0,0,0,19,nowin,loss,bust,plbust,0,10,12,250,0.372,0.064,0.564,0,0.013687345
1253,113,20209,10,6,0,1,0,17,9,10,0,0,0,19,nowin,loss,beat,dlwin,0,10,16,199,0.407035176,0.055276382,0.668341709,2,0.620695264
1254,37,20210,10,10,0,0,0,20,2,6,3,9,0,20,nowin,push,push,push,10,0,20,208,0.394230769,0.038461538,0.581730769,0,0.024682772
1255,25,20210,11,9,0,0,0,20,2,6,3,9,0,20,nowin,push,push,push,10,0,20,190,0.463157895,0.063157895,0.536842105,1,0.304401563
1256,125,20210,8,10,0,0,0,18,2,6,3,9,0,20,nowin,loss,beat,dlwin,0,10,18,219,0.438356164,0.050228311,0.575342466,1,0.308411257
1257,45,20210,10,10,0,0,0,20,2,6,3,9,0,20,nowin,push,push,push,10,0,20,196,0.428571429,0.051020408,0.612244898,2,0.598821767
1258,116,20210,10,6,0,0,0,16,2,6,3,9,0,20,nowin,loss,beat,dlwin,0,10,16,195,0.425641026,0.056410256,0.538461538,1,0.28273747
1259,28,20210,6,7,0,0,0,13,2,6,3,9,0,20,nowin,loss,beat,dlwin,0,10,13,199,0.422110553,0.045226131,0.542713568,1,0.282706618
1260,102,20211,10,9,0,0,0,19,5,1,10,1,0,17,nowin,win,plwin,beat,20,0,19,192,0.338541667,0.046875,0.5625,0,0.003306118
1261,112,20211,7,9,0,0,0,16,5,1,10,1,0,17,nowin,loss,beat,dlwin,0,10,16,203,0.448275862,0.054187192,0.600985222,3,0.889576933
1262,143,20211,6,8,0,0,0,14,5,1,10,1,0,17,nowin,loss,beat,dlwin,0,10,14,203,0.463054187,0.044334975,0.57635468,3,0.883143365
1263,19,20211,5,5,3,0,0,13,5,1,10,1,0,17,nowin,loss,beat,dlwin,0,10,10,237,0.41350211,0.054852321,0.628691983,2,0.597373826
1264,126,20211,4,9,0,0,0,13,5,1,10,1,0,17,nowin,loss,beat,dlwin,0,10,13,188,0.457446809,0.074468085,0.60106383,3,0.900633203
1265,121,20211,10,7,0,0,0,17,5,1,10,1,0,17,nowin,push,push,push,10,0,17,195,0.456410256,0.025641026,0.512820513,1,0.288597791
1266,132,20212,1,3,9,7,0,20,9,10,0,0,0,19,nowin,win,plwin,beat,20,0,4,194,0.412371134,0.036082474,0.649484536,2,0.611633238
1267,89,20212,2,5,11,0,0,18,9,10,0,0,0,19,nowin,loss,beat,dlwin,0,10,7,212,0.537735849,0.047169811,0.594339623,3,0.990167191
1268,78,20212,5,6,5,4,0,20,9,10,0,0,0,19,nowin,win,plwin,beat,20,0,11,201,0.517412935,0.034825871,0.587064677,3,0.95871112
1269,101,20212,6,3,6,10,0,25,9,10,0,0,0,19,nowin,loss,bust,plbust,0,10,9,205,0.424390244,0.068292683,0.63902439,2,0.614740646
1270,86,20212,1,6,8,6,0,21,9,10,0,0,0,19,nowin,win,plwin,beat,20,0,7,196,0.454081633,0.040816327,0.591836735,3,0.887566443
1271,17,20212,4,10,0,8,0,22,9,10,0,0,0,19,nowin,loss,bust,plbust,0,10,14,171,0.444444444,0.070175439,0.555555556,1,0.302364894
1272,27,20213,5,2,7,0,0,14,4,6,9,0,0,19,nowin,loss,beat,dlwin,0,10,7,178,0.370786517,0.016853933,0.573033708,0,0.015536309
1273,131,20213,3,7,2,0,0,12,4,6,9,0,0,19,nowin,loss,beat,dlwin,0,10,10,217,0.410138249,0.069124424,0.543778802,0,0.02015021
1274,90,20213,7,9,0,0,0,16,4,6,9,0,0,19,nowin,loss,beat,dlwin,0,10,16,201,0.447761194,0.049751244,0.60199005,3,0.889945023
1275,84,20213,2,9,7,0,0,18,4,6,9,0,0,19,nowin,loss,beat,dlwin,0,10,11,195,0.379487179,0.056410256,0.569230769,0,0.017209119
1276,24,20213,9,7,0,0,0,16,4,6,9,0,0,19,nowin,loss,beat,dlwin,0,10,16,207,0.458937198,0.048309179,0.570048309,1,0.318138014
1277,71,20213,8,7,0,0,0,15,4,6,9,0,0,19,nowin,loss,beat,dlwin,0,10,15,193,0.352331606,0.046632124,0.585492228,0,0.013063661
1278,128,20214,11,10,0,0,0,21,6,10,5,0,0,21,win,push,push,push,10,0,21,227,0.356828194,0.052863436,0.577092511,0,0.012352564
1279,70,20214,2,8,7,0,0,17,6,10,5,0,0,21,nowin,loss,beat,dlwin,0,10,10,228,0.385964912,0.039473684,0.557017544,0,0.016157125
1280,69,20214,4,10,0,0,0,14,6,10,5,0,0,21,nowin,loss,beat,dlwin,0,10,14,194,0.365979381,0.030927835,0.515463918,0,0
1281,141,20214,10,10,0,0,0,20,6,10,5,0,0,21,nowin,loss,beat,dlwin,0,10,20,202,0.420792079,0.074257426,0.564356436,0,0.028377851
1282,140,20214,3,10,0,0,0,13,6,10,5,0,0,21,nowin,loss,beat,dlwin,0,10,13,210,0.466666667,0.023809524,0.604761905,3,0.915293335
1283,31,20214,8,10,0,0,0,18,6,10,5,0,0,21,nowin,loss,beat,dlwin,0,10,18,188,0.473404255,0.058510638,0.515957447,1,0.300306557
1284,3,20215,2,6,3,9,0,20,2,10,8,0,0,20,nowin,push,push,push,10,0,8,190,0.431578947,0.026315789,0.542105263,1,0.288076384
1285,65,20215,10,7,0,0,0,17,2,10,8,0,0,20,nowin,loss,beat,dlwin,0,10,17,203,0.492610837,0.054187192,0.571428571,3,0.913702814
1286,68,20215,1,2,10,0,0,13,2,10,8,0,0,20,nowin,loss,beat,dlwin,0,10,3,205,0.434146341,0.029268293,0.6,2,0.59483189
1287,145,20215,11,3,2,0,0,16,2,10,8,0,0,20,nowin,loss,beat,dlwin,0,10,14,188,0.441489362,0.031914894,0.622340426,2,0.617837093
1288,146,20215,10,5,0,0,0,15,2,10,8,0,0,20,nowin,loss,beat,dlwin,0,10,15,221,0.43438914,0.040723982,0.542986425,1,0.290190091
1289,89,20215,4,1,10,0,0,15,2,10,8,0,0,20,nowin,loss,beat,dlwin,0,10,5,212,0.537735849,0.047169811,0.594339623,3,0.990167191
1290,98,20216,1,6,6,10,0,23,8,10,0,0,0,18,nowin,loss,bust,plbust,0,10,7,220,0.422727273,0.054545455,0.55,1,0.28664435
1291,83,20216,1,1,10,3,10,25,8,10,0,0,0,18,nowin,loss,bust,plbust,0,10,2,193,0.424870466,0.051813472,0.678756477,2,0.644360335
1292,98,20216,10,3,0,9,0,22,8,10,0,0,0,18,nowin,loss,bust,plbust,0,10,13,220,0.422727273,0.054545455,0.55,1,0.28664435
1293,139,20216,2,5,10,0,0,17,8,10,0,0,0,18,nowin,loss,beat,dlwin,0,10,7,192,0.380208333,0.036458333,0.59375,0,0.023429169
1294,32,20216,4,4,5,4,0,17,8,10,0,0,0,18,nowin,loss,beat,dlwin,0,10,8,189,0.391534392,0.037037037,0.53968254,0,0.013579086
1295,61,20216,9,10,0,0,0,19,8,10,0,0,0,18,nowin,win,plwin,beat,20,0,19,194,0.427835052,0.077319588,0.603092784,2,0.591437139
1296,97,20217,3,6,9,0,0,18,10,3,5,0,0,18,nowin,push,push,push,10,0,9,182,0.450549451,0.06043956,0.692307692,2,0.677372279
1297,88,20217,5,10,0,4,0,19,10,3,5,0,0,18,nowin,win,plwin,beat,20,0,15,206,0.466019417,0.033980583,0.54368932,1,0.309467903
1298,72,20217,2,1,10,9,0,22,10,3,5,0,0,18,nowin,loss,bust,plbust,0,10,3,185,0.394594595,0.032432432,0.508108108,0,0.006763115
1299,107,20217,7,11,0,0,0,18,10,3,5,0,0,18,nowin,push,push,push,10,0,18,218,0.444954128,0.073394495,0.600917431,2,0.605210014
1300,23,20217,5,8,0,3,9,25,10,3,5,0,0,18,nowin,loss,bust,plbust,0,10,13,208,0.427884615,0.0625,0.552884615,1,0.29114424
1301,91,20217,10,2,0,4,10,26,10,3,5,0,0,18,nowin,loss,bust,plbust,0,10,12,194,0.417525773,0.046391753,0.515463918,1,0.266616552
1302,22,20218,2,10,0,2,6,20,10,6,2,0,0,18,nowin,win,plwin,beat,20,0,12,187,0.481283422,0.042780749,0.577540107,3,0.906128176
1303,87,20218,11,10,0,0,0,21,10,6,2,0,0,18,win,win,plwin,beat,25,0,21,202,0.405940594,0.054455446,0.628712871,2,0.590599801
1304,147,20218,6,10,0,7,0,23,10,6,2,0,0,18,nowin,loss,bust,plbust,0,10,16,205,0.380487805,0.014634146,0.536585366,0,0.00951447
1305,29,20218,11,10,0,0,0,21,10,6,2,0,0,18,win,win,plwin,beat,25,0,21,189,0.44973545,0.058201058,0.544973545,1,0.300349439
1306,7,20218,8,9,0,0,0,17,10,6,2,0,0,18,nowin,loss,beat,dlwin,0,10,17,183,0.442622951,0.06010929,0.62295082,2,0.619303341
1307,71,20218,6,10,0,10,0,26,10,6,2,0,0,18,nowin,loss,bust,plbust,0,10,16,193,0.352331606,0.046632124,0.585492228,0,0.013063661
1308,126,20219,10,10,0,0,0,20,10,6,10,0,0,26,nowin,win,dlbust,bust,20,0,20,188,0.457446809,0.074468085,0.60106383,3,0.900633203
1309,123,20219,6,7,0,8,0,21,10,6,10,0,0,26,nowin,win,dlbust,bust,20,0,13,205,0.43902439,0.034146341,0.614634146,2,0.609962544
1310,97,20219,10,5,0,3,0,18,10,6,10,0,0,26,nowin,win,dlbust,bust,20,0,15,182,0.450549451,0.06043956,0.692307692,2,0.677372279
1311,146,20219,3,10,0,4,0,17,10,6,10,0,0,26,nowin,win,dlbust,bust,20,0,13,221,0.43438914,0.040723982,0.542986425,1,0.290190091
1312,23,20219,6,10,0,6,0,22,10,6,10,0,0,26,nowin,loss,bust,plbust,0,10,16,208,0.427884615,0.0625,0.552884615,1,0.29114424
1313,76,20219,5,10,0,7,0,22,10,6,10,0,0,26,nowin,loss,bust,plbust,0,10,15,189,0.534391534,0.079365079,0.608465608,3,1
1314,74,20220,7,10,0,0,0,17,9,10,0,0,0,19,nowin,loss,beat,dlwin,0,10,17,209,0.411483254,0.04784689,0.531100478,0,0.017448125
1315,34,20220,2,10,0,9,0,21,9,10,0,0,0,19,nowin,win,plwin,beat,20,0,12,202,0.5,0.079207921,0.618811881,3,0.968961434
1316,53,20220,7,2,3,10,0,22,9,10,0,0,0,19,nowin,loss,bust,plbust,0,10,9,250,0.372,0.064,0.564,0,0.013687345
1317,117,20220,6,4,6,1,0,17,9,10,0,0,0,19,nowin,loss,beat,dlwin,0,10,10,173,0.410404624,0.069364162,0.606936416,2,0.578610282
1318,107,20220,3,11,4,0,0,18,9,10,0,0,0,19,nowin,loss,beat,dlwin,0,10,14,218,0.444954128,0.073394495,0.600917431,2,0.605210014
1319,128,20220,11,9,0,0,0,20,9,10,0,0,0,19,nowin,win,plwin,beat,20,0,20,227,0.356828194,0.052863436,0.577092511,0,0.012352564
1320,83,20221,6,2,10,0,0,18,4,6,9,0,0,19,nowin,loss,beat,dlwin,0,10,8,193,0.424870466,0.051813472,0.678756477,2,0.644360335
1321,1,20221,11,8,0,0,0,19,4,6,9,0,0,19,nowin,push,push,push,10,0,19,197,0.406091371,0.025380711,0.649746193,2,0.606186955
1322,63,20221,4,6,6,0,0,16,4,6,9,0,0,19,nowin,loss,beat,dlwin,0,10,10,216,0.467592593,0.037037037,0.62037037,3,0.931690496
1323,18,20221,5,5,4,0,0,14,4,6,9,0,0,19,nowin,loss,beat,dlwin,0,10,10,182,0.461538462,0.043956044,0.587912088,3,0.892649374
1324,142,20221,5,11,2,0,0,18,4,6,9,0,0,19,nowin,loss,beat,dlwin,0,10,16,211,0.417061611,0.047393365,0.526066351,1,0.271531309
1325,107,20221,10,4,0,0,0,14,4,6,9,0,0,19,nowin,loss,beat,dlwin,0,10,14,218,0.444954128,0.073394495,0.600917431,2,0.605210014
1326,109,20222,7,5,0,10,0,22,9,10,0,0,0,19,nowin,loss,bust,plbust,0,10,12,221,0.461538462,0.058823529,0.597285068,3,0.901830309
1327,102,20222,6,10,0,8,0,24,9,10,0,0,0,19,nowin,loss,bust,plbust,0,10,16,192,0.338541667,0.046875,0.5625,0,0.003306118
1328,31,20222,11,10,0,0,0,21,9,10,0,0,0,19,win,win,plwin,beat,25,0,21,188,0.473404255,0.058510638,0.515957447,1,0.300306557
1329,30,20222,2,10,0,7,0,19,9,10,0,0,0,19,nowin,push,push,push,10,0,12,206,0.393203883,0.033980583,0.601941748,0,0.029324648
1330,75,20222,10,4,0,3,0,17,9,10,0,0,0,19,nowin,loss,beat,dlwin,0,10,14,191,0.418848168,0.052356021,0.570680628,0,0.029344702
1331,10,20222,10,9,0,0,0,19,9,10,0,0,0,19,nowin,push,push,push,10,0,19,191,0.413612565,0.057591623,0.596858639,2,0.574087175
1332,12,20223,10,10,0,0,0,20,10,10,0,0,0,20,nowin,push,push,push,10,0,20,189,0.470899471,0.015873016,0.613756614,3,0.929171178
1333,72,20223,2,2,8,5,0,17,10,10,0,0,0,20,nowin,loss,beat,dlwin,0,10,4,185,0.394594595,0.032432432,0.508108108,0,0.006763115
1334,15,20223,4,10,0,10,0,24,10,10,0,0,0,20,nowin,loss,bust,plbust,0,10,14,212,0.410377358,0.051886792,0.561320755,0,0.024517408
1335,148,20223,1,6,5,10,0,22,10,10,0,0,0,20,nowin,loss,bust,plbust,0,10,7,204,0.401960784,0.078431373,0.593137255,0,0.029789521
1336,28,20223,10,3,0,2,7,22,10,10,0,0,0,20,nowin,loss,bust,plbust,0,10,13,199,0.422110553,0.045226131,0.542713568,1,0.282706618
1337,18,20223,10,6,0,9,0,25,10,10,0,0,0,20,nowin,loss,bust,plbust,0,10,16,182,0.461538462,0.043956044,0.587912088,3,0.892649374
1338,148,20224,6,7,0,0,0,13,6,11,0,0,0,17,nowin,loss,beat,dlwin,0,10,13,204,0.401960784,0.078431373,0.593137255,0,0.029789521
1339,82,20224,11,10,0,0,0,21,6,11,0,0,0,17,win,win,plwin,beat,25,0,21,225,0.408888889,0.075555556,0.577777778,0,0.028101874
1340,131,20224,7,11,0,0,0,18,6,11,0,0,0,17,nowin,win,plwin,beat,20,0,18,217,0.410138249,0.069124424,0.543778802,0,0.02015021
1341,4,20224,2,10,0,0,0,12,6,11,0,0,0,17,nowin,loss,beat,dlwin,0,10,12,217,0.460829493,0.036866359,0.562211982,1,0.315432839
1342,31,20224,8,6,0,0,0,14,6,11,0,0,0,17,nowin,loss,beat,dlwin,0,10,14,188,0.473404255,0.058510638,0.515957447,1,0.300306557
1343,73,20224,11,7,0,0,0,18,6,11,0,0,0,17,nowin,win,plwin,beat,20,0,18,181,0.375690608,0.011049724,0.596685083,0,0.022795773
1344,71,20225,8,8,0,0,0,16,4,9,1,3,0,17,nowin,loss,beat,dlwin,0,10,16,193,0.352331606,0.046632124,0.585492228,0,0.013063661
1345,72,20225,10,10,0,0,0,20,4,9,1,3,0,17,nowin,win,plwin,beat,20,0,20,185,0.394594595,0.032432432,0.508108108,0,0.006763115
1346,47,20225,10,9,0,0,0,19,4,9,1,3,0,17,nowin,win,plwin,beat,20,0,19,210,0.438095238,0.057142857,0.623809524,2,0.615868808
1347,45,20225,10,9,0,0,0,19,4,9,1,3,0,17,nowin,win,plwin,beat,20,0,19,196,0.428571429,0.051020408,0.612244898,2,0.598821767
1348,131,20225,8,2,5,0,0,15,4,9,1,3,0,17,nowin,loss,beat,dlwin,0,10,10,217,0.410138249,0.069124424,0.543778802,0,0.02015021
1349,46,20225,9,7,0,0,0,16,4,9,1,3,0,17,nowin,loss,beat,dlwin,0,10,16,186,0.403225806,0.048387097,0.591397849,0,0.029742194
1350,91,20226,5,6,8,0,0,19,5,10,10,0,0,25,nowin,win,dlbust,bust,20,0,11,194,0.417525773,0.046391753,0.515463918,1,0.266616552
1351,68,20226,8,9,0,0,0,17,5,10,10,0,0,25,nowin,win,dlbust,bust,20,0,17,205,0.434146341,0.029268293,0.6,2,0.59483189
1352,70,20226,9,5,0,0,0,14,5,10,10,0,0,25,nowin,win,dlbust,bust,20,0,14,228,0.385964912,0.039473684,0.557017544,0,0.016157125
1353,10,20226,4,8,0,0,0,12,5,10,10,0,0,25,nowin,win,dlbust,bust,20,0,12,191,0.413612565,0.057591623,0.596858639,2,0.574087175
1354,60,20226,10,5,0,0,0,15,5,10,10,0,0,25,nowin,win,dlbust,bust,20,0,15,227,0.418502203,0.022026432,0.559471366,0,0.026496258
1355,127,20226,8,11,0,0,0,19,5,10,10,0,0,25,nowin,win,dlbust,bust,20,0,19,201,0.402985075,0.029850746,0.60199005,0,0.032263937
1356,150,20227,3,11,6,0,0,20,2,9,8,0,0,19,nowin,win,plwin,beat,20,0,14,192,0.401041667,0.036458333,0.567708333,0,0.023287458
1357,98,20227,10,8,0,0,0,18,2,9,8,0,0,19,nowin,loss,beat,dlwin,0,10,18,220,0.422727273,0.054545455,0.55,1,0.28664435
1358,37,20227,10,5,0,0,0,15,2,9,8,0,0,19,nowin,loss,beat,dlwin,0,10,15,208,0.394230769,0.038461538,0.581730769,0,0.024682772
1359,29,20227,10,6,0,0,0,16,2,9,8,0,0,19,nowin,loss,beat,dlwin,0,10,16,189,0.44973545,0.058201058,0.544973545,1,0.300349439
1360,134,20227,6,10,0,0,0,16,2,9,8,0,0,19,nowin,loss,beat,dlwin,0,10,16,185,0.443243243,0.021621622,0.545945946,1,0.296939509
1361,61,20227,8,11,0,0,0,19,2,9,8,0,0,19,nowin,push,push,push,10,0,19,194,0.427835052,0.077319588,0.603092784,2,0.591437139
1362,42,20228,10,10,0,0,0,20,8,2,10,0,0,20,nowin,push,push,push,10,0,20,212,0.443396226,0.051886792,0.570754717,1,0.309181312
1363,99,20228,9,4,0,2,2,17,8,2,10,0,0,20,nowin,loss,beat,dlwin,0,10,13,207,0.47826087,0.062801932,0.637681159,3,0.961418446
1364,62,20228,7,7,0,2,10,26,8,2,10,0,0,20,nowin,loss,bust,plbust,0,10,14,178,0.370786517,0.028089888,0.54494382,0,0.008657722
1365,40,20228,10,7,0,0,0,17,8,2,10,0,0,20,nowin,loss,beat,dlwin,0,10,17,196,0.367346939,0.030612245,0.617346939,0,0.025358183
1366,66,20228,2,8,3,10,0,23,8,2,10,0,0,20,nowin,loss,bust,plbust,0,10,10,217,0.456221198,0.064516129,0.626728111,3,0.924304367
1367,100,20228,3,6,6,8,0,23,8,2,10,0,0,20,nowin,loss,bust,plbust,0,10,9,190,0.452631579,0.036842105,0.594736842,3,0.888671154
1368,87,20229,4,10,0,4,0,18,11,7,0,0,0,18,nowin,push,push,push,10,0,14,202,0.405940594,0.054455446,0.628712871,2,0.590599801
1369,22,20229,8,10,0,0,0,18,11,7,0,0,0,18,nowin,push,push,push,10,0,18,187,0.481283422,0.042780749,0.577540107,3,0.906128176
1370,70,20229,7,4,10,0,0,21,11,7,0,0,0,18,nowin,win,plwin,beat,20,0,11,228,0.385964912,0.039473684,0.557017544,0,0.016157125
1371,127,20229,2,3,8,2,9,24,11,7,0,0,0,18,nowin,loss,bust,plbust,0,10,5,201,0.402985075,0.029850746,0.60199005,0,0.032263937
1372,21,20229,7,6,0,9,0,22,11,7,0,0,0,18,nowin,loss,bust,plbust,0,10,13,214,0.359813084,0.042056075,0.626168224,0,0.025263474
1373,13,20229,10,4,0,2,10,26,11,7,0,0,0,18,nowin,loss,bust,plbust,0,10,14,206,0.417475728,0.063106796,0.621359223,2,0.59555479
1374,44,20230,8,10,0,0,0,18,7,6,6,0,0,19,nowin,loss,beat,dlwin,0,10,18,219,0.433789954,0.050228311,0.534246575,1,0.285551035
1375,63,20230,9,4,0,3,10,26,7,6,6,0,0,19,nowin,loss,bust,plbust,0,10,13,216,0.467592593,0.037037037,0.62037037,3,0.931690496
1376,149,20230,3,4,10,0,0,17,7,6,6,0,0,19,nowin,loss,beat,dlwin,0,10,7,225,0.457777778,0.057777778,0.648888889,2,0.651965595
1377,34,20230,11,10,0,0,0,21,7,6,6,0,0,19,win,win,plwin,beat,25,0,21,202,0.5,0.079207921,0.618811881,3,0.968961434
1378,70,20230,11,3,2,6,0,22,7,6,6,0,0,19,nowin,loss,bust,plbust,0,10,14,228,0.385964912,0.039473684,0.557017544,0,0.016157125
1379,111,20230,10,10,0,0,0,20,7,6,6,0,0,19,nowin,win,plwin,beat,20,0,20,180,0.433333333,0.055555556,0.611111111,2,0.602264492
1380,11,20231,2,2,3,10,0,17,5,5,7,0,0,17,nowin,push,push,push,10,0,4,236,0.457627119,0.016949153,0.588983051,3,0.889015813
1381,77,20231,5,1,7,0,0,13,5,5,7,0,0,17,nowin,loss,beat,dlwin,0,10,6,200,0.455,0.04,0.62,3,0.916252116
1382,107,20231,10,8,0,0,0,18,5,5,7,0,0,17,nowin,win,plwin,beat,20,0,18,218,0.444954128,0.073394495,0.600917431,2,0.605210014
1383,101,20231,4,4,10,0,0,18,5,5,7,0,0,17,nowin,win,plwin,beat,20,0,8,205,0.424390244,0.068292683,0.63902439,2,0.614740646
1384,54,20231,3,10,0,0,0,13,5,5,7,0,0,17,nowin,loss,beat,dlwin,0,10,13,185,0.437837838,0.032432432,0.556756757,1,0.29899854
1385,20,20231,11,2,5,0,0,18,5,5,7,0,0,17,nowin,win,plwin,beat,20,0,13,186,0.456989247,0.037634409,0.537634409,1,0.301097108
1386,76,20232,10,10,0,0,0,20,5,4,6,10,0,25,nowin,win,dlbust,bust,20,0,20,189,0.534391534,0.079365079,0.608465608,3,1
1387,126,20232,5,10,0,0,0,15,5,4,6,10,0,25,nowin,win,dlbust,bust,20,0,15,188,0.457446809,0.074468085,0.60106383,3,0.900633203
1388,69,20232,10,6,0,0,0,16,5,4,6,10,0,25,nowin,win,dlbust,bust,20,0,16,194,0.365979381,0.030927835,0.515463918,0,0
1389,130,20232,4,10,0,0,0,14,5,4,6,10,0,25,nowin,win,dlbust,bust,20,0,14,219,0.410958904,0.03652968,0.566210046,0,0.025888739
1390,36,20232,10,11,0,0,0,21,5,4,6,10,0,25,win,win,dlbust,bust,25,0,21,229,0.445414847,0.056768559,0.655021834,2,0.645370571
1391,117,20232,6,6,0,0,0,12,5,4,6,10,0,25,nowin,win,dlbust,bust,20,0,12,173,0.410404624,0.069364162,0.606936416,2,0.578610282
1392,45,20233,3,4,10,0,0,17,3,11,3,0,0,17,nowin,push,push,push,10,0,7,196,0.428571429,0.051020408,0.612244898,2,0.598821767
1393,38,20233,10,2,0,8,0,20,3,11,3,0,0,17,nowin,win,plwin,beat,20,0,12,202,0.361386139,0.03960396,0.564356436,0,0.010597953
1394,12,20233,10,2,0,9,0,21,3,11,3,0,0,17,nowin,win,plwin,beat,20,0,12,189,0.470899471,0.015873016,0.613756614,3,0.929171178
1395,137,20233,7,7,0,0,0,14,3,11,3,0,0,17,nowin,loss,beat,dlwin,0,10,14,194,0.417525773,0.046391753,0.536082474,1,0.276714602
1396,107,20233,5,8,0,0,0,13,3,11,3,0,0,17,nowin,loss,beat,dlwin,0,10,13,218,0.444954128,0.073394495,0.600917431,2,0.605210014
1397,76,20233,10,4,0,0,0,14,3,11,3,0,0,17,nowin,loss,beat,dlwin,0,10,14,189,0.534391534,0.079365079,0.608465608,3,1
1398,98,20234,11,10,0,0,0,21,6,11,0,0,0,17,win,win,plwin,beat,25,0,21,220,0.422727273,0.054545455,0.55,1,0.28664435
1399,132,20234,10,2,0,0,0,12,6,11,0,0,0,17,nowin,loss,beat,dlwin,0,10,12,194,0.412371134,0.036082474,0.649484536,2,0.611633238
1400,122,20234,10,9,0,0,0,19,6,11,0,0,0,17,nowin,win,plwin,beat,20,0,19,210,0.347619048,0.052380952,0.59047619,0,0.012873677
1401,65,20234,9,7,0,0,0,16,6,11,0,0,0,17,nowin,loss,beat,dlwin,0,10,16,203,0.492610837,0.054187192,0.571428571,3,0.913702814
1402,45,20234,2,11,2,0,0,15,6,11,0,0,0,17,nowin,loss,beat,dlwin,0,10,13,196,0.428571429,0.051020408,0.612244898,2,0.598821767
1403,70,20234,8,6,0,0,0,14,6,11,0,0,0,17,nowin,loss,beat,dlwin,0,10,14,228,0.385964912,0.039473684,0.557017544,0,0.016157125
1404,100,20235,8,10,0,0,0,18,3,1,10,7,0,21,nowin,loss,beat,dlwin,0,10,18,190,0.452631579,0.036842105,0.594736842,3,0.888671154
1405,102,20235,10,2,0,8,0,20,3,1,10,7,0,21,nowin,loss,beat,dlwin,0,10,12,192,0.338541667,0.046875,0.5625,0,0.003306118
1406,61,20235,6,2,2,7,0,17,3,1,10,7,0,21,nowin,loss,beat,dlwin,0,10,8,194,0.427835052,0.077319588,0.603092784,2,0.591437139
1407,84,20235,10,2,0,7,0,19,3,1,10,7,0,21,nowin,loss,beat,dlwin,0,10,12,195,0.379487179,0.056410256,0.569230769,0,0.017209119
1408,89,20235,10,8,0,0,0,18,3,1,10,7,0,21,nowin,loss,beat,dlwin,0,10,18,212,0.537735849,0.047169811,0.594339623,3,0.990167191
1409,103,20235,8,9,0,0,0,17,3,1,10,7,0,21,nowin,loss,beat,dlwin,0,10,17,203,0.379310345,0.064039409,0.551724138,0,0.012869209
1410,71,20236,4,3,10,0,0,17,11,6,0,0,0,17,nowin,push,push,push,10,0,7,193,0.352331606,0.046632124,0.585492228,0,0.013063661
1411,111,20236,5,8,0,5,0,18,11,6,0,0,0,17,nowin,win,plwin,beat,20,0,13,180,0.433333333,0.055555556,0.611111111,2,0.602264492
1412,135,20236,10,4,0,2,7,23,11,6,0,0,0,17,nowin,loss,bust,plbust,0,10,14,179,0.391061453,0.067039106,0.586592179,0,0.024924662
1413,80,20236,10,11,0,0,0,21,11,6,0,0,0,17,win,win,plwin,beat,25,0,21,186,0.419354839,0.059139785,0.623655914,2,0.59892924
1414,136,20236,8,10,0,0,0,18,11,6,0,0,0,17,nowin,win,plwin,beat,20,0,18,194,0.396907216,0.025773196,0.597938144,0,0.029452644
1415,128,20236,3,2,8,3,6,22,11,6,0,0,0,17,nowin,loss,bust,plbust,0,10,5,227,0.356828194,0.052863436,0.577092511,0,0.012352564
1416,52,20237,10,10,0,0,0,20,9,9,0,0,0,18,nowin,win,plwin,beat,20,0,20,217,0.414746544,0.02764977,0.599078341,2,0.576736024
1417,23,20237,8,5,0,8,0,21,9,9,0,0,0,18,nowin,win,plwin,beat,20,0,13,208,0.427884615,0.0625,0.552884615,1,0.29114424
1418,109,20237,10,7,0,0,0,17,9,9,0,0,0,18,nowin,loss,beat,dlwin,0,10,17,221,0.461538462,0.058823529,0.597285068,3,0.901830309
1419,112,20237,10,4,0,3,0,17,9,9,0,0,0,18,nowin,loss,beat,dlwin,0,10,14,203,0.448275862,0.054187192,0.600985222,3,0.889576933
1420,99,20237,9,3,0,10,0,22,9,9,0,0,0,18,nowin,loss,bust,plbust,0,10,12,207,0.47826087,0.062801932,0.637681159,3,0.961418446
1421,20,20237,7,4,3,4,0,18,9,9,0,0,0,18,nowin,push,push,push,10,0,11,186,0.456989247,0.037634409,0.537634409,1,0.301097108
1422,139,20238,6,9,0,2,0,17,10,10,0,0,0,20,nowin,loss,beat,dlwin,0,10,15,192,0.380208333,0.036458333,0.59375,0,0.023429169
1423,104,20238,6,11,2,0,0,19,10,10,0,0,0,20,nowin,loss,beat,dlwin,0,10,17,209,0.363636364,0.052631579,0.593301435,0,0.018359419
1424,107,20238,10,8,0,0,0,18,10,10,0,0,0,20,nowin,loss,beat,dlwin,0,10,18,218,0.444954128,0.073394495,0.600917431,2,0.605210014
1425,83,20238,2,10,0,1,10,23,10,10,0,0,0,20,nowin,loss,bust,plbust,0,10,12,193,0.424870466,0.051813472,0.678756477,2,0.644360335
1426,124,20238,3,9,0,10,0,22,10,10,0,0,0,20,nowin,loss,bust,plbust,0,10,12,202,0.47029703,0.064356436,0.584158416,3,0.899458193
1427,15,20238,4,10,0,7,0,21,10,10,0,0,0,20,nowin,win,plwin,beat,20,0,14,212,0.410377358,0.051886792,0.561320755,0,0.024517408
1428,128,20239,8,5,0,7,0,20,10,10,0,0,0,20,nowin,push,push,push,10,0,13,227,0.356828194,0.052863436,0.577092511,0,0.012352564
1429,46,20239,7,10,0,0,0,17,10,10,0,0,0,20,nowin,loss,beat,dlwin,0,10,17,186,0.403225806,0.048387097,0.591397849,0,0.029742194
1430,135,20239,6,8,0,10,0,24,10,10,0,0,0,20,nowin,loss,bust,plbust,0,10,14,179,0.391061453,0.067039106,0.586592179,0,0.024924662
1431,43,20239,8,10,0,0,0,18,10,10,0,0,0,20,nowin,loss,beat,dlwin,0,10,18,192,0.40625,0.041666667,0.609375,2,0.576671372
1432,69,20239,10,10,0,0,0,20,10,10,0,0,0,20,nowin,push,push,push,10,0,20,194,0.365979381,0.030927835,0.515463918,0,0
1433,132,20239,9,4,0,8,0,21,10,10,0,0,0,20,nowin,win,plwin,beat,20,0,13,194,0.412371134,0.036082474,0.649484536,2,0.611633238
1434,1,20240,10,10,0,0,0,20,10,10,0,0,0,20,nowin,push,push,push,10,0,20,197,0.406091371,0.025380711,0.649746193,2,0.606186955
1435,39,20240,9,7,0,1,0,17,10,10,0,0,0,20,nowin,loss,beat,dlwin,0,10,16,191,0.429319372,0.062827225,0.57591623,0,0.033760763
1436,9,20240,10,10,0,0,0,20,10,10,0,0,0,20,nowin,push,push,push,10,0,20,194,0.37628866,0.015463918,0.541237113,0,0.009396796
1437,78,20240,9,10,0,0,0,19,10,10,0,0,0,20,nowin,loss,beat,dlwin,0,10,19,201,0.517412935,0.034825871,0.587064677,3,0.95871112
1438,146,20240,6,9,0,4,0,19,10,10,0,0,0,20,nowin,loss,beat,dlwin,0,10,15,221,0.43438914,0.040723982,0.542986425,1,0.290190091
1439,33,20240,10,10,0,0,0,20,10,10,0,0,0,20,nowin,push,push,push,10,0,20,192,0.4375,0.057291667,0.625,2,0.616208916
1440,2,20241,8,9,0,0,0,17,2,7,6,2,0,17,nowin,push,push,push,10,0,17,200,0.445,0.035,0.64,2,0.633962549
1441,52,20241,10,10,0,0,0,20,2,7,6,2,0,17,nowin,win,plwin,beat,20,0,20,217,0.414746544,0.02764977,0.599078341,2,0.576736024
1442,79,20241,8,10,0,0,0,18,2,7,6,2,0,17,nowin,win,plwin,beat,20,0,18,211,0.436018957,0.028436019,0.672985782,2,0.650131054
1443,120,20241,5,9,0,0,0,14,2,7,6,2,0,17,nowin,loss,beat,dlwin,0,10,14,202,0.440594059,0.034653465,0.618811881,2,0.614441029
1444,118,20241,7,4,2,0,0,13,2,7,6,2,0,17,nowin,loss,beat,dlwin,0,10,11,216,0.393518519,0.037037037,0.555555556,0,0.018059873
1445,42,20241,4,10,0,0,0,14,2,7,6,2,0,17,nowin,loss,beat,dlwin,0,10,14,212,0.443396226,0.051886792,0.570754717,1,0.309181312
1446,143,20242,10,10,0,0,0,20,7,2,3,4,6,22,nowin,win,dlbust,bust,20,0,20,203,0.463054187,0.044334975,0.57635468,3,0.883143365
1447,82,20242,10,3,0,9,0,22,7,2,3,4,6,22,nowin,loss,bust,plbust,0,10,13,225,0.408888889,0.075555556,0.577777778,0,0.028101874
1448,73,20242,9,2,4,8,0,23,7,2,3,4,6,22,nowin,loss,bust,plbust,0,10,11,181,0.375690608,0.011049724,0.596685083,0,0.022795773
1449,54,20242,8,5,0,10,0,23,7,2,3,4,6,22,nowin,loss,bust,plbust,0,10,13,185,0.437837838,0.032432432,0.556756757,1,0.29899854
1450,89,20242,11,1,7,0,0,19,7,2,3,4,6,22,nowin,win,dlbust,bust,20,0,12,212,0.537735849,0.047169811,0.594339623,3,0.990167191
1451,31,20242,10,10,0,0,0,20,7,2,3,4,6,22,nowin,win,dlbust,bust,20,0,20,188,0.473404255,0.058510638,0.515957447,1,0.300306557
1452,28,20243,6,11,4,0,0,21,6,8,6,0,0,20,nowin,win,plwin,beat,20,0,17,199,0.422110553,0.045226131,0.542713568,1,0.282706618
1453,134,20243,7,7,0,0,0,14,6,8,6,0,0,20,nowin,loss,beat,dlwin,0,10,14,185,0.443243243,0.021621622,0.545945946,1,0.296939509
1454,49,20243,3,4,10,0,0,17,6,8,6,0,0,20,nowin,loss,beat,dlwin,0,10,7,207,0.396135266,0.053140097,0.594202899,0,0.028306925
1455,92,20243,5,10,0,0,0,15,6,8,6,0,0,20,nowin,loss,beat,dlwin,0,10,15,186,0.446236559,0.059139785,0.564516129,1,0.307826125
1456,72,20243,9,6,0,0,0,15,6,8,6,0,0,20,nowin,loss,beat,dlwin,0,10,15,185,0.394594595,0.032432432,0.508108108,0,0.006763115
1457,71,20243,1,3,10,0,0,14,6,8,6,0,0,20,nowin,loss,beat,dlwin,0,10,4,193,0.352331606,0.046632124,0.585492228,0,0.013063661
1458,74,20244,10,4,0,0,0,14,4,3,2,8,0,17,nowin,loss,beat,dlwin,0,10,14,209,0.411483254,0.04784689,0.531100478,0,0.017448125
1459,43,20244,1,3,10,0,0,14,4,3,2,8,0,17,nowin,loss,beat,dlwin,0,10,4,192,0.40625,0.041666667,0.609375,2,0.576671372
1460,94,20244,10,4,0,0,0,14,4,3,2,8,0,17,nowin,loss,beat,dlwin,0,10,14,183,0.43715847,0.043715847,0.540983607,1,0.290866892
1461,115,20244,7,10,0,0,0,17,4,3,2,8,0,17,nowin,push,push,push,10,0,17,194,0.427835052,0.041237113,0.592783505,2,0.583863602
1462,3,20244,10,5,0,0,0,15,4,3,2,8,0,17,nowin,loss,beat,dlwin,0,10,15,190,0.431578947,0.026315789,0.542105263,1,0.288076384
1463,6,20244,8,5,0,0,0,13,4,3,2,8,0,17,nowin,loss,beat,dlwin,0,10,13,191,0.439790576,0.047120419,0.581151832,1,0.31211505
1464,139,20245,10,3,0,0,0,13,4,3,8,2,0,17,nowin,loss,beat,dlwin,0,10,13,192,0.380208333,0.036458333,0.59375,0,0.023429169
1465,111,20245,3,10,0,0,0,13,4,3,8,2,0,17,nowin,loss,beat,dlwin,0,10,13,180,0.433333333,0.055555556,0.611111111,2,0.602264492
1466,69,20245,4,10,0,0,0,14,4,3,8,2,0,17,nowin,loss,beat,dlwin,0,10,14,194,0.365979381,0.030927835,0.515463918,0,0
1467,55,20245,5,2,10,0,0,17,4,3,8,2,0,17,nowin,push,push,push,10,0,7,191,0.371727749,0.057591623,0.54973822,0,0.01011347
1468,124,20245,4,7,10,0,0,21,4,3,8,2,0,17,nowin,win,plwin,beat,20,0,11,202,0.47029703,0.064356436,0.584158416,3,0.899458193
1469,96,20245,7,3,10,0,0,20,4,3,8,2,0,17,nowin,win,plwin,beat,20,0,10,190,0.468421053,0.057894737,0.584210526,3,0.897263354
1470,20,20246,6,8,0,0,0,14,5,10,3,0,0,18,nowin,loss,beat,dlwin,0,10,14,186,0.456989247,0.037634409,0.537634409,1,0.301097108
1471,73,20246,11,8,0,0,0,19,5,10,3,0,0,18,nowin,win,plwin,beat,20,0,19,181,0.375690608,0.011049724,0.596685083,0,0.022795773
1472,128,20246,10,10,0,0,0,20,5,10,3,0,0,18,nowin,win,plwin,beat,20,0,20,227,0.356828194,0.052863436,0.577092511,0,0.012352564
1473,65,20246,6,10,0,0,0,16,5,10,3,0,0,18,nowin,loss,beat,dlwin,0,10,16,203,0.492610837,0.054187192,0.571428571,3,0.913702814
1474,126,20246,5,7,0,0,0,12,5,10,3,0,0,18,nowin,loss,beat,dlwin,0,10,12,188,0.457446809,0.074468085,0.60106383,3,0.900633203
1475,115,20246,6,6,0,0,0,12,5,10,3,0,0,18,nowin,loss,beat,dlwin,0,10,12,194,0.427835052,0.041237113,0.592783505,2,0.583863602
1476,128,20247,10,6,0,10,0,26,11,7,0,0,0,18,nowin,loss,bust,plbust,0,10,16,227,0.356828194,0.052863436,0.577092511,0,0.012352564
1477,45,20247,2,3,9,9,0,23,11,7,0,0,0,18,nowin,loss,bust,plbust,0,10,5,196,0.428571429,0.051020408,0.612244898,2,0.598821767
1478,32,20247,2,3,2,10,0,17,11,7,0,0,0,18,nowin,loss,beat,dlwin,0,10,5,189,0.391534392,0.037037037,0.53968254,0,0.013579086
1479,46,20247,7,10,0,0,0,17,11,7,0,0,0,18,nowin,loss,beat,dlwin,0,10,17,186,0.403225806,0.048387097,0.591397849,0,0.029742194
1480,78,20247,5,7,0,7,0,19,11,7,0,0,0,18,nowin,win,plwin,beat,20,0,12,201,0.517412935,0.034825871,0.587064677,3,0.95871112
1481,99,20247,10,11,0,0,0,21,11,7,0,0,0,18,win,win,plwin,beat,25,0,21,207,0.47826087,0.062801932,0.637681159,3,0.961418446
1482,65,20248,10,10,0,0,0,20,10,7,0,0,0,17,nowin,win,plwin,beat,20,0,20,203,0.492610837,0.054187192,0.571428571,3,0.913702814
1483,135,20248,7,7,0,3,0,17,10,7,0,0,0,17,nowin,push,push,push,10,0,14,179,0.391061453,0.067039106,0.586592179,0,0.024924662
1484,35,20248,4,5,7,5,0,21,10,7,0,0,0,17,nowin,win,plwin,beat,20,0,9,202,0.410891089,0.044554455,0.633663366,2,0.598681573
1485,119,20248,10,4,0,8,0,22,10,7,0,0,0,17,nowin,loss,bust,plbust,0,10,14,190,0.405263158,0.068421053,0.515789474,0,0.011837158
1486,57,20248,2,4,9,6,0,21,10,7,0,0,0,17,nowin,win,plwin,beat,20,0,6,192,0.46875,0.052083333,0.59375,3,0.907001181
1487,42,20248,3,2,11,9,0,25,10,7,0,0,0,17,nowin,loss,bust,plbust,0,10,5,212,0.443396226,0.051886792,0.570754717,1,0.309181312
1488,77,20249,5,9,0,6,0,20,10,10,0,0,0,20,nowin,push,push,push,10,0,14,200,0.455,0.04,0.62,3,0.916252116
1489,136,20249,11,7,0,0,0,18,10,10,0,0,0,20,nowin,loss,beat,dlwin,0,10,18,194,0.396907216,0.025773196,0.597938144,0,0.029452644
1490,37,20249,4,2,10,2,0,18,10,10,0,0,0,20,nowin,loss,beat,dlwin,0,10,6,208,0.394230769,0.038461538,0.581730769,0,0.024682772
1491,50,20249,3,1,10,1,5,20,10,10,0,0,0,20,nowin,push,push,push,10,0,4,202,0.405940594,0.04950495,0.54950495,0,0.020296079
1492,7,20249,10,4,0,3,0,17,10,10,0,0,0,20,nowin,loss,beat,dlwin,0,10,14,183,0.442622951,0.06010929,0.62295082,2,0.619303341
1493,57,20249,4,10,0,2,10,26,10,10,0,0,0,20,nowin,loss,bust,plbust,0,10,14,192,0.46875,0.052083333,0.59375,3,0.907001181
1494,64,20250,3,5,10,0,0,18,9,11,0,0,0,20,nowin,loss,beat,dlwin,0,10,8,187,0.363636364,0.048128342,0.631016043,0,0.027594885
1495,26,20250,10,5,0,3,0,18,9,11,0,0,0,20,nowin,loss,beat,dlwin,0,10,15,203,0.463054187,0.0591133,0.541871921,1,0.306802864
1496,87,20250,10,10,0,0,0,20,9,11,0,0,0,20,nowin,push,push,push,10,0,20,202,0.405940594,0.054455446,0.628712871,2,0.590599801
1497,22,20250,6,7,0,10,0,23,9,11,0,0,0,20,nowin,loss,bust,plbust,0,10,13,187,0.481283422,0.042780749,0.577540107,3,0.906128176
1498,48,20250,8,10,0,0,0,18,9,11,0,0,0,20,nowin,loss,beat,dlwin,0,10,18,203,0.413793103,0.019704433,0.600985222,2,0.577280801
1499,141,20250,10,11,0,0,0,21,9,11,0,0,0,20,win,win,plwin,beat,25,0,21,202,0.420792079,0.074257426,0.564356436,0,0.028377851
1500,46,20251,8,11,0,0,0,19,9,10,0,0,0,19,nowin,push,push,push,10,0,19,186,0.403225806,0.048387097,0.591397849,0,0.029742194
1501,121,20251,3,6,11,0,0,20,9,10,0,0,0,19,nowin,win,plwin,beat,20,0,9,195,0.456410256,0.025641026,0.512820513,1,0.288597791
1502,65,20251,11,10,0,0,0,21,9,10,0,0,0,19,win,win,plwin,beat,25,0,21,203,0.492610837,0.054187192,0.571428571,3,0.913702814
1503,19,20251,10,3,0,10,0,23,9,10,0,0,0,19,nowin,loss,bust,plbust,0,10,13,237,0.41350211,0.054852321,0.628691983,2,0.597373826
1504,147,20251,10,10,0,0,0,20,9,10,0,0,0,19,nowin,win,plwin,beat,20,0,20,205,0.380487805,0.014634146,0.536585366,0,0.00951447
1505,105,20251,10,10,0,0,0,20,9,10,0,0,0,19,nowin,win,plwin,beat,20,0,20,198,0.414141414,0.070707071,0.590909091,0,0.032889494
1506,43,20252,10,8,0,0,0,18,11,8,0,0,0,19,nowin,loss,beat,dlwin,0,10,18,192,0.40625,0.041666667,0.609375,2,0.576671372
1507,24,20252,5,7,0,5,0,17,11,8,0,0,0,19,nowin,loss,beat,dlwin,0,10,12,207,0.458937198,0.048309179,0.570048309,1,0.318138014
1508,11,20252,5,6,9,0,0,20,11,8,0,0,0,19,nowin,win,plwin,beat,20,0,11,236,0.457627119,0.016949153,0.588983051,3,0.889015813
1509,89,20252,5,2,10,0,0,17,11,8,0,0,0,19,nowin,loss,beat,dlwin,0,10,7,212,0.537735849,0.047169811,0.594339623,3,0.990167191
1510,115,20252,10,5,0,10,0,25,11,8,0,0,0,19,nowin,loss,bust,plbust,0,10,15,194,0.427835052,0.041237113,0.592783505,2,0.583863602
1511,32,20252,10,5,0,8,0,23,11,8,0,0,0,19,nowin,loss,bust,plbust,0,10,15,189,0.391534392,0.037037037,0.53968254,0,0.013579086
1512,116,20253,10,3,0,7,0,20,10,9,0,0,0,19,nowin,win,plwin,beat,20,0,13,195,0.425641026,0.056410256,0.538461538,1,0.28273747
1513,121,20253,10,2,0,9,0,21,10,9,0,0,0,19,nowin,win,plwin,beat,20,0,12,195,0.456410256,0.025641026,0.512820513,1,0.288597791
1514,144,20253,3,10,0,9,0,22,10,9,0,0,0,19,nowin,loss,bust,plbust,0,10,13,202,0.386138614,0.054455446,0.564356436,0,0.018006244
1515,104,20253,4,10,0,9,0,23,10,9,0,0,0,19,nowin,loss,bust,plbust,0,10,14,209,0.363636364,0.052631579,0.593301435,0,0.018359419
1516,27,20253,10,7,0,0,0,17,10,9,0,0,0,19,nowin,loss,beat,dlwin,0,10,17,178,0.370786517,0.016853933,0.573033708,0,0.015536309
1517,101,20253,10,10,0,0,0,20,10,9,0,0,0,19,nowin,win,plwin,beat,20,0,20,205,0.424390244,0.068292683,0.63902439,2,0.614740646
1518,28,20254,10,9,0,0,0,19,2,3,10,7,0,22,nowin,win,dlbust,bust,20,0,19,199,0.422110553,0.045226131,0.542713568,1,0.282706618
1519,74,20254,6,6,0,7,0,19,2,3,10,7,0,22,nowin,win,dlbust,bust,20,0,12,209,0.411483254,0.04784689,0.531100478,0,0.017448125
1520,63,20254,3,5,10,0,0,18,2,3,10,7,0,22,nowin,win,dlbust,bust,20,0,8,216,0.467592593,0.037037037,0.62037037,3,0.931690496
1521,14,20254,10,8,0,0,0,18,2,3,10,7,0,22,nowin,win,dlbust,bust,20,0,18,202,0.391089109,0.01980198,0.628712871,2,0.577264877
1522,35,20254,10,10,0,0,0,20,2,3,10,7,0,22,nowin,win,dlbust,bust,20,0,20,202,0.410891089,0.044554455,0.633663366,2,0.598681573
1523,144,20254,10,10,0,0,0,20,2,3,10,7,0,22,nowin,win,dlbust,bust,20,0,20,202,0.386138614,0.054455446,0.564356436,0,0.018006244
1524,66,20255,10,10,0,0,0,20,11,5,4,0,0,20,nowin,push,push,push,10,0,20,217,0.456221198,0.064516129,0.626728111,3,0.924304367
1525,99,20255,3,1,10,10,0,24,11,5,4,0,0,20,nowin,loss,bust,plbust,0,10,4,207,0.47826087,0.062801932,0.637681159,3,0.961418446
1526,91,20255,9,10,0,0,0,19,11,5,4,0,0,20,nowin,loss,beat,dlwin,0,10,19,194,0.417525773,0.046391753,0.515463918,1,0.266616552
1527,65,20255,10,11,0,0,0,21,11,5,4,0,0,20,win,win,plwin,beat,25,0,21,203,0.492610837,0.054187192,0.571428571,3,0.913702814
1528,133,20255,5,1,8,6,0,20,11,5,4,0,0,20,nowin,push,push,push,10,0,6,201,0.47761194,0.064676617,0.611940299,3,0.935428111
1529,19,20255,5,10,0,8,0,23,11,5,4,0,0,20,nowin,loss,bust,plbust,0,10,15,237,0.41350211,0.054852321,0.628691983,2,0.597373826
1530,144,20256,10,9,0,0,0,19,3,3,5,3,1,15,nowin,win,plwin,beat,20,0,19,202,0.386138614,0.054455446,0.564356436,0,0.018006244
1531,22,20256,4,4,11,0,0,19,3,3,5,3,1,15,nowin,win,plwin,beat,20,0,8,187,0.481283422,0.042780749,0.577540107,3,0.906128176
1532,127,20256,8,6,0,0,0,14,3,3,5,3,1,15,nowin,loss,beat,dlwin,0,10,14,201,0.402985075,0.029850746,0.60199005,0,0.032263937
1533,86,20256,9,10,0,0,0,19,3,3,5,3,1,15,nowin,win,plwin,beat,20,0,19,196,0.454081633,0.040816327,0.591836735,3,0.887566443
1534,147,20256,10,10,0,0,0,20,3,3,5,3,1,15,nowin,win,plwin,beat,20,0,20,205,0.380487805,0.014634146,0.536585366,0,0.00951447
1535,5,20256,10,4,0,0,0,14,3,3,5,3,1,15,nowin,loss,beat,dlwin,0,10,14,203,0.42364532,0.02955665,0.596059113,2,0.582508076
1536,11,20257,10,8,0,0,0,18,8,3,2,10,0,23,nowin,win,dlbust,bust,20,0,18,236,0.457627119,0.016949153,0.588983051,3,0.889015813
1537,81,20257,2,7,6,5,0,20,8,3,2,10,0,23,nowin,win,dlbust,bust,20,0,9,182,0.395604396,0.043956044,0.60989011,2,0.567491261
1538,112,20257,5,2,10,0,0,17,8,3,2,10,0,23,nowin,win,dlbust,bust,20,0,7,203,0.448275862,0.054187192,0.600985222,3,0.889576933
1539,8,20257,10,5,0,10,0,25,8,3,2,10,0,23,nowin,loss,bust,plbust,0,10,15,181,0.44198895,0.071823204,0.596685083,2,0.599438402
1540,100,20257,8,3,10,0,0,21,8,3,2,10,0,23,nowin,win,dlbust,bust,20,0,11,190,0.452631579,0.036842105,0.594736842,3,0.888671154
1541,3,20257,4,3,10,0,0,17,8,3,2,10,0,23,nowin,win,dlbust,bust,20,0,7,190,0.431578947,0.026315789,0.542105263,1,0.288076384
1542,141,20258,10,6,0,4,0,20,10,10,0,0,0,20,nowin,push,push,push,10,0,16,202,0.420792079,0.074257426,0.564356436,0,0.028377851
1543,33,20258,4,10,0,1,7,22,10,10,0,0,0,20,nowin,loss,bust,plbust,0,10,14,192,0.4375,0.057291667,0.625,2,0.616208916
1544,72,20258,10,5,0,3,0,18,10,10,0,0,0,20,nowin,loss,beat,dlwin,0,10,15,185,0.394594595,0.032432432,0.508108108,0,0.006763115
1545,50,20258,8,7,0,1,10,26,10,10,0,0,0,20,nowin,loss,bust,plbust,0,10,15,202,0.405940594,0.04950495,0.54950495,0,0.020296079
1546,103,20258,11,7,0,0,0,18,10,10,0,0,0,20,nowin,loss,beat,dlwin,0,10,18,203,0.379310345,0.064039409,0.551724138,0,0.012869209
1547,82,20258,5,1,9,10,0,25,10,10,0,0,0,20,nowin,loss,bust,plbust,0,10,6,225,0.408888889,0.075555556,0.577777778,0,0.028101874
1548,96,20259,10,3,0,1,3,17,10,10,0,0,0,20,nowin,loss,beat,dlwin,0,10,13,190,0.468421053,0.057894737,0.584210526,3,0.897263354
1549,21,20259,11,10,0,0,0,21,10,10,0,0,0,20,win,win,plwin,beat,25,0,21,214,0.359813084,0.042056075,0.626168224,0,0.025263474
1550,129,20259,6,10,0,2,0,18,10,10,0,0,0,20,nowin,loss,beat,dlwin,0,10,16,201,0.422885572,0.064676617,0.55721393,0,0.027255383
1551,122,20259,11,1,9,0,0,21,10,10,0,0,0,20,nowin,win,plwin,beat,20,0,12,210,0.347619048,0.052380952,0.59047619,0,0.012873677
1552,43,20259,9,10,0,0,0,19,10,10,0,0,0,20,nowin,loss,beat,dlwin,0,10,19,192,0.40625,0.041666667,0.609375,2,0.576671372
1553,38,20259,4,10,0,10,0,24,10,10,0,0,0,20,nowin,loss,bust,plbust,0,10,14,202,0.361386139,0.03960396,0.564356436,0,0.010597953
1554,19,20260,9,4,0,10,0,23,10,5,4,0,0,19,nowin,loss,bust,plbust,0,10,13,237,0.41350211,0.054852321,0.628691983,2,0.597373826
1555,17,20260,5,5,8,0,0,18,10,5,4,0,0,19,nowin,loss,beat,dlwin,0,10,10,171,0.444444444,0.070175439,0.555555556,1,0.302364894
1556,4,20260,10,10,0,0,0,20,10,5,4,0,0,19,nowin,win,plwin,beat,20,0,20,217,0.460829493,0.036866359,0.562211982,1,0.315432839
1557,71,20260,5,11,2,0,0,18,10,5,4,0,0,19,nowin,loss,beat,dlwin,0,10,16,193,0.352331606,0.046632124,0.585492228,0,0.013063661
1558,110,20260,9,4,0,9,0,22,10,5,4,0,0,19,nowin,loss,bust,plbust,0,10,13,192,0.416666667,0.046875,0.557291667,0,0.025413132
1559,131,20260,2,3,10,6,0,21,10,5,4,0,0,19,nowin,win,plwin,beat,20,0,5,217,0.410138249,0.069124424,0.543778802,0,0.02015021
1560,82,20261,11,2,8,0,0,21,6,11,0,0,0,17,nowin,win,plwin,beat,20,0,13,225,0.408888889,0.075555556,0.577777778,0,0.028101874
1561,124,20261,4,2,5,1,0,12,6,11,0,0,0,17,nowin,loss,beat,dlwin,0,10,6,202,0.47029703,0.064356436,0.584158416,3,0.899458193
1562,137,20261,1,6,7,0,0,14,6,11,0,0,0,17,nowin,loss,beat,dlwin,0,10,7,194,0.417525773,0.046391753,0.536082474,1,0.276714602
1563,32,20261,5,10,0,0,0,15,6,11,0,0,0,17,nowin,loss,beat,dlwin,0,10,15,189,0.391534392,0.037037037,0.53968254,0,0.013579086
1564,11,20261,3,10,0,0,0,13,6,11,0,0,0,17,nowin,loss,beat,dlwin,0,10,13,236,0.457627119,0.016949153,0.588983051,3,0.889015813
1565,22,20261,9,9,0,0,0,18,6,11,0,0,0,17,nowin,win,plwin,beat,20,0,18,187,0.481283422,0.042780749,0.577540107,3,0.906128176
1566,83,20262,7,4,10,0,0,21,9,10,0,0,0,19,nowin,win,plwin,beat,20,0,11,193,0.424870466,0.051813472,0.678756477,2,0.644360335
1567,13,20262,1,6,10,0,0,17,9,10,0,0,0,19,nowin,loss,beat,dlwin,0,10,7,206,0.417475728,0.063106796,0.621359223,2,0.59555479
1568,66,20262,10,11,0,0,0,21,9,10,0,0,0,19,win,win,plwin,beat,25,0,21,217,0.456221198,0.064516129,0.626728111,3,0.924304367
1569,123,20262,1,2,10,10,0,23,9,10,0,0,0,19,nowin,loss,bust,plbust,0,10,3,205,0.43902439,0.034146341,0.614634146,2,0.609962544
1570,61,20262,5,10,0,4,0,19,9,10,0,0,0,19,nowin,push,push,push,10,0,15,194,0.427835052,0.077319588,0.603092784,2,0.591437139
1571,80,20262,8,10,0,0,0,18,9,10,0,0,0,19,nowin,loss,beat,dlwin,0,10,18,186,0.419354839,0.059139785,0.623655914,2,0.59892924
1572,45,20263,10,10,0,0,0,20,7,10,0,0,0,17,nowin,win,plwin,beat,20,0,20,196,0.428571429,0.051020408,0.612244898,2,0.598821767
1573,149,20263,6,10,0,10,0,26,7,10,0,0,0,17,nowin,loss,bust,plbust,0,10,16,225,0.457777778,0.057777778,0.648888889,2,0.651965595
1574,135,20263,9,10,0,0,0,19,7,10,0,0,0,17,nowin,win,plwin,beat,20,0,19,179,0.391061453,0.067039106,0.586592179,0,0.024924662
1575,58,20263,3,2,10,10,0,25,7,10,0,0,0,17,nowin,loss,bust,plbust,0,10,5,195,0.430769231,0.041025641,0.584615385,2,0.580497586
1576,148,20263,6,6,0,9,0,21,7,10,0,0,0,17,nowin,win,plwin,beat,20,0,12,204,0.401960784,0.078431373,0.593137255,0,0.029789521
1577,19,20263,10,10,0,0,0,20,7,10,0,0,0,17,nowin,win,plwin,beat,20,0,20,237,0.41350211,0.054852321,0.628691983,2,0.597373826
1578,77,20264,9,10,0,0,0,19,10,5,10,0,0,25,nowin,win,dlbust,bust,20,0,19,200,0.455,0.04,0.62,3,0.916252116
1579,11,20264,4,4,10,0,0,18,10,5,10,0,0,25,nowin,win,dlbust,bust,20,0,8,236,0.457627119,0.016949153,0.588983051,3,0.889015813
1580,91,20264,3,10,0,5,0,18,10,5,10,0,0,25,nowin,win,dlbust,bust,20,0,13,194,0.417525773,0.046391753,0.515463918,1,0.266616552
1581,150,20264,8,3,7,0,0,18,10,5,10,0,0,25,nowin,win,dlbust,bust,20,0,11,192,0.401041667,0.036458333,0.567708333,0,0.023287458
1582,26,20264,7,10,0,0,0,17,10,5,10,0,0,25,nowin,win,dlbust,bust,20,0,17,203,0.463054187,0.0591133,0.541871921,1,0.306802864
1583,70,20264,10,8,0,0,0,18,10,5,10,0,0,25,nowin,win,dlbust,bust,20,0,18,228,0.385964912,0.039473684,0.557017544,0,0.016157125
1584,18,20265,1,2,9,8,0,20,2,3,10,10,0,25,nowin,win,dlbust,bust,20,0,3,182,0.461538462,0.043956044,0.587912088,3,0.892649374
1585,66,20265,10,10,0,0,0,20,2,3,10,10,0,25,nowin,win,dlbust,bust,20,0,20,217,0.456221198,0.064516129,0.626728111,3,0.924304367
1586,66,20265,9,8,0,0,0,17,2,3,10,10,0,25,nowin,win,dlbust,bust,20,0,17,217,0.456221198,0.064516129,0.626728111,3,0.924304367
1587,123,20265,1,2,9,10,0,22,2,3,10,10,0,25,nowin,loss,bust,plbust,0,10,3,205,0.43902439,0.034146341,0.614634146,2,0.609962544
1588,30,20265,4,10,0,0,0,14,2,3,10,10,0,25,nowin,win,dlbust,bust,20,0,14,206,0.393203883,0.033980583,0.601941748,0,0.029324648
1589,57,20265,6,6,0,5,0,17,2,3,10,10,0,25,nowin,win,dlbust,bust,20,0,12,192,0.46875,0.052083333,0.59375,3,0.907001181
1590,21,20266,9,10,0,0,0,19,10,10,0,0,0,20,nowin,loss,beat,dlwin,0,10,19,214,0.359813084,0.042056075,0.626168224,0,0.025263474
1591,64,20266,5,6,5,6,0,22,10,10,0,0,0,20,nowin,loss,bust,plbust,0,10,11,187,0.363636364,0.048128342,0.631016043,0,0.027594885
1592,9,20266,11,9,0,0,0,20,10,10,0,0,0,20,nowin,push,push,push,10,0,20,194,0.37628866,0.015463918,0.541237113,0,0.009396796
1593,23,20266,10,10,0,0,0,20,10,10,0,0,0,20,nowin,push,push,push,10,0,20,208,0.427884615,0.0625,0.552884615,1,0.29114424
1594,22,20266,6,11,4,0,0,21,10,10,0,0,0,20,nowin,win,plwin,beat,20,0,17,187,0.481283422,0.042780749,0.577540107,3,0.906128176
1595,74,20266,10,2,0,8,0,20,10,10,0,0,0,20,nowin,push,push,push,10,0,12,209,0.411483254,0.04784689,0.531100478,0,0.017448125
1596,41,20267,3,1,10,8,0,22,8,11,0,0,0,19,nowin,loss,bust,plbust,0,10,4,192,0.364583333,0.036458333,0.520833333,0,0.00089702
1597,83,20267,10,2,0,4,4,20,8,11,0,0,0,19,nowin,win,plwin,beat,20,0,12,193,0.424870466,0.051813472,0.678756477,2,0.644360335
1598,31,20267,10,3,0,2,3,18,8,11,0,0,0,19,nowin,loss,beat,dlwin,0,10,13,188,0.473404255,0.058510638,0.515957447,1,0.300306557
1599,25,20267,6,3,11,0,0,20,8,11,0,0,0,19,nowin,win,plwin,beat,20,0,9,190,0.463157895,0.063157895,0.536842105,1,0.304401563
1600,10,20267,8,7,0,6,0,21,8,11,0,0,0,19,nowin,win,plwin,beat,20,0,15,191,0.413612565,0.057591623,0.596858639,2,0.574087175
1601,88,20267,10,7,0,0,0,17,8,11,0,0,0,19,nowin,loss,beat,dlwin,0,10,17,206,0.466019417,0.033980583,0.54368932,1,0.309467903
1602,63,20268,10,2,0,9,0,21,2,9,5,5,0,21,nowin,push,push,push,10,0,12,216,0.467592593,0.037037037,0.62037037,3,0.931690496
1603,150,20268,5,10,0,0,0,15,2,9,5,5,0,21,nowin,loss,beat,dlwin,0,10,15,192,0.401041667,0.036458333,0.567708333,0,0.023287458
1604,97,20268,6,1,10,0,0,17,2,9,5,5,0,21,nowin,loss,beat,dlwin,0,10,7,182,0.450549451,0.06043956,0.692307692,2,0.677372279
1605,140,20268,9,2,10,0,0,21,2,9,5,5,0,21,nowin,push,push,push,10,0,11,210,0.466666667,0.023809524,0.604761905,3,0.915293335
1606,135,20268,10,6,0,0,0,16,2,9,5,5,0,21,nowin,loss,beat,dlwin,0,10,16,179,0.391061453,0.067039106,0.586592179,0,0.024924662
1607,21,20268,10,8,0,0,0,18,2,9,5,5,0,21,nowin,loss,beat,dlwin,0,10,18,214,0.359813084,0.042056075,0.626168224,0,0.025263474
1608,56,20269,6,2,10,0,0,18,10,6,6,0,0,22,nowin,win,dlbust,bust,20,0,8,175,0.4,0.057142857,0.582857143,0,0.026685297
1609,26,20269,10,11,0,0,0,21,10,6,6,0,0,22,win,win,dlbust,bust,25,0,21,203,0.463054187,0.0591133,0.541871921,1,0.306802864
1610,71,20269,10,3,0,10,0,23,10,6,6,0,0,22,nowin,loss,bust,plbust,0,10,13,193,0.352331606,0.046632124,0.585492228,0,0.013063661
1611,19,20269,8,9,0,0,0,17,10,6,6,0,0,22,nowin,win,dlbust,bust,20,0,17,237,0.41350211,0.054852321,0.628691983,2,0.597373826
1612,128,20269,7,11,0,0,0,18,10,6,6,0,0,22,nowin,win,dlbust,bust,20,0,18,227,0.356828194,0.052863436,0.577092511,0,0.012352564
1613,74,20269,4,6,4,10,0,24,10,6,6,0,0,22,nowin,loss,bust,plbust,0,10,10,209,0.411483254,0.04784689,0.531100478,0,0.017448125
1614,19,20270,10,6,0,7,0,23,10,4,10,0,0,24,nowin,loss,bust,plbust,0,10,16,237,0.41350211,0.054852321,0.628691983,2,0.597373826
1615,147,20270,5,10,0,5,0,20,10,4,10,0,0,24,nowin,win,dlbust,bust,20,0,15,205,0.380487805,0.014634146,0.536585366,0,0.00951447
1616,34,20270,8,2,8,0,0,18,10,4,10,0,0,24,nowin,win,dlbust,bust,20,0,10,202,0.5,0.079207921,0.618811881,3,0.968961434
1617,102,20270,10,2,0,10,0,22,10,4,10,0,0,24,nowin,loss,bust,plbust,0,10,12,192,0.338541667,0.046875,0.5625,0,0.003306118
1618,109,20270,10,4,0,6,0,20,10,4,10,0,0,24,nowin,win,dlbust,bust,20,0,14,221,0.461538462,0.058823529,0.597285068,3,0.901830309
1619,32,20270,10,6,0,10,0,26,10,4,10,0,0,24,nowin,loss,bust,plbust,0,10,16,189,0.391534392,0.037037037,0.53968254,0,0.013579086
1620,84,20271,10,7,0,0,0,17,2,6,5,5,0,18,nowin,loss,beat,dlwin,0,10,17,195,0.379487179,0.056410256,0.569230769,0,0.017209119
1621,10,20271,11,6,2,0,0,19,2,6,5,5,0,18,nowin,win,plwin,beat,20,0,17,191,0.413612565,0.057591623,0.596858639,2,0.574087175
1622,119,20271,7,7,0,0,0,14,2,6,5,5,0,18,nowin,loss,beat,dlwin,0,10,14,190,0.405263158,0.068421053,0.515789474,0,0.011837158
1623,19,20271,8,11,0,0,0,19,2,6,5,5,0,18,nowin,win,plwin,beat,20,0,19,237,0.41350211,0.054852321,0.628691983,2,0.597373826
1624,2,20271,11,1,5,0,0,17,2,6,5,5,0,18,nowin,loss,beat,dlwin,0,10,12,200,0.445,0.035,0.64,2,0.633962549
1625,130,20271,10,6,0,0,0,16,2,6,5,5,0,18,nowin,loss,beat,dlwin,0,10,16,219,0.410958904,0.03652968,0.566210046,0,0.025888739
1626,87,20272,2,8,10,0,0,20,5,5,3,4,0,17,nowin,win,plwin,beat,20,0,10,202,0.405940594,0.054455446,0.628712871,2,0.590599801
1627,94,20272,10,10,0,0,0,20,5,5,3,4,0,17,nowin,win,plwin,beat,20,0,20,183,0.43715847,0.043715847,0.540983607,1,0.290866892
1628,105,20272,4,4,10,0,0,18,5,5,3,4,0,17,nowin,win,plwin,beat,20,0,8,198,0.414141414,0.070707071,0.590909091,0,0.032889494
1629,67,20272,10,7,0,0,0,17,5,5,3,4,0,17,nowin,push,push,push,10,0,17,195,0.369230769,0.041025641,0.569230769,0,0.014139427
1630,99,20272,11,8,0,0,0,19,5,5,3,4,0,17,nowin,win,plwin,beat,20,0,19,207,0.47826087,0.062801932,0.637681159,3,0.961418446
1631,150,20272,8,9,0,0,0,17,5,5,3,4,0,17,nowin,push,push,push,10,0,17,192,0.401041667,0.036458333,0.567708333,0,0.023287458
1632,99,20273,5,6,10,0,0,21,7,10,0,0,0,17,nowin,win,plwin,beat,20,0,11,207,0.47826087,0.062801932,0.637681159,3,0.961418446
1633,79,20273,5,2,10,0,0,17,7,10,0,0,0,17,nowin,push,push,push,10,0,7,211,0.436018957,0.028436019,0.672985782,2,0.650131054
1634,149,20273,1,4,9,3,0,17,7,10,0,0,0,17,nowin,push,push,push,10,0,5,225,0.457777778,0.057777778,0.648888889,2,0.651965595
1635,135,20273,10,2,0,4,5,21,7,10,0,0,0,17,nowin,win,plwin,beat,20,0,12,179,0.391061453,0.067039106,0.586592179,0,0.024924662
1636,123,20273,10,10,0,0,0,20,7,10,0,0,0,17,nowin,win,plwin,beat,20,0,20,205,0.43902439,0.034146341,0.614634146,2,0.609962544
1637,79,20273,9,3,0,10,0,22,7,10,0,0,0,17,nowin,loss,bust,plbust,0,10,12,211,0.436018957,0.028436019,0.672985782,2,0.650131054
1638,146,20274,10,10,0,0,0,20,2,3,5,2,2,14,nowin,win,plwin,beat,20,0,20,221,0.43438914,0.040723982,0.542986425,1,0.290190091
1639,45,20274,5,8,0,0,0,13,2,3,5,2,2,14,nowin,loss,beat,dlwin,0,10,13,196,0.428571429,0.051020408,0.612244898,2,0.598821767
1640,20,20274,10,2,0,9,0,21,2,3,5,2,2,14,nowin,win,plwin,beat,20,0,12,186,0.456989247,0.037634409,0.537634409,1,0.301097108
1641,4,20274,10,10,0,0,0,20,2,3,5,2,2,14,nowin,win,plwin,beat,20,0,20,217,0.460829493,0.036866359,0.562211982,1,0.315432839
1642,126,20274,6,10,0,0,0,16,2,3,5,2,2,14,nowin,win,plwin,beat,20,0,16,188,0.457446809,0.074468085,0.60106383,3,0.900633203
1643,19,20274,10,11,0,0,0,21,2,3,5,2,2,14,win,win,plwin,beat,25,0,21,237,0.41350211,0.054852321,0.628691983,2,0.597373826
1644,18,20275,4,3,6,2,6,21,9,11,0,0,0,20,nowin,win,plwin,beat,20,0,7,182,0.461538462,0.043956044,0.587912088,3,0.892649374
1645,140,20275,2,5,2,2,4,15,9,11,0,0,0,20,nowin,loss,beat,dlwin,0,10,7,210,0.466666667,0.023809524,0.604761905,3,0.915293335
1646,96,20275,6,2,5,10,0,23,9,11,0,0,0,20,nowin,loss,bust,plbust,0,10,8,190,0.468421053,0.057894737,0.584210526,3,0.897263354
1647,104,20275,10,2,0,10,0,22,9,11,0,0,0,20,nowin,loss,bust,plbust,0,10,12,209,0.363636364,0.052631579,0.593301435,0,0.018359419
1648,6,20275,7,3,8,0,0,18,9,11,0,0,0,20,nowin,loss,beat,dlwin,0,10,10,191,0.439790576,0.047120419,0.581151832,1,0.31211505
1649,60,20275,10,4,0,9,0,23,9,11,0,0,0,20,nowin,loss,bust,plbust,0,10,14,227,0.418502203,0.022026432,0.559471366,0,0.026496258
1650,127,20276,1,2,10,2,10,25,1,4,7,5,0,17,nowin,loss,bust,plbust,0,10,3,201,0.402985075,0.029850746,0.60199005,0,0.032263937
1651,41,20276,10,10,0,0,0,20,1,4,7,5,0,17,nowin,win,plwin,beat,20,0,20,192,0.364583333,0.036458333,0.520833333,0,0.00089702
1652,66,20276,11,1,8,0,0,20,1,4,7,5,0,17,nowin,win,plwin,beat,20,0,12,217,0.456221198,0.064516129,0.626728111,3,0.924304367
1653,30,20276,6,8,0,10,0,24,1,4,7,5,0,17,nowin,loss,bust,plbust,0,10,14,206,0.393203883,0.033980583,0.601941748,0,0.029324648
1654,49,20276,8,10,0,0,0,18,1,4,7,5,0,17,nowin,win,plwin,beat,20,0,18,207,0.396135266,0.053140097,0.594202899,0,0.028306925
1655,123,20276,11,10,0,0,0,21,1,4,7,5,0,17,win,win,plwin,beat,25,0,21,205,0.43902439,0.034146341,0.614634146,2,0.609962544
1656,77,20277,10,4,0,0,0,14,4,9,7,0,0,20,nowin,loss,beat,dlwin,0,10,14,200,0.455,0.04,0.62,3,0.916252116
1657,142,20277,8,2,11,0,0,21,4,9,7,0,0,20,nowin,win,plwin,beat,20,0,10,211,0.417061611,0.047393365,0.526066351,1,0.271531309
1658,70,20277,5,10,0,0,0,15,4,9,7,0,0,20,nowin,loss,beat,dlwin,0,10,15,228,0.385964912,0.039473684,0.557017544,0,0.016157125
1659,85,20277,3,11,7,0,0,21,4,9,7,0,0,20,nowin,win,plwin,beat,20,0,14,195,0.41025641,0.066666667,0.594871795,0,0.03269711
1660,48,20277,10,10,0,0,0,20,4,9,7,0,0,20,nowin,push,push,push,10,0,20,203,0.413793103,0.019704433,0.600985222,2,0.577280801
1661,103,20277,8,8,0,0,0,16,4,9,7,0,0,20,nowin,loss,beat,dlwin,0,10,16,203,0.379310345,0.064039409,0.551724138,0,0.012869209
1662,147,20278,3,2,10,2,0,17,8,3,6,0,0,17,nowin,push,push,push,10,0,5,205,0.380487805,0.014634146,0.536585366,0,0.00951447
1663,127,20278,6,7,0,1,8,22,8,3,6,0,0,17,nowin,loss,bust,plbust,0,10,13,201,0.402985075,0.029850746,0.60199005,0,0.032263937
1664,146,20278,11,10,0,0,0,21,8,3,6,0,0,17,win,win,plwin,beat,25,0,21,221,0.43438914,0.040723982,0.542986425,1,0.290190091
1665,52,20278,1,5,10,3,0,19,8,3,6,0,0,17,nowin,win,plwin,beat,20,0,6,217,0.414746544,0.02764977,0.599078341,2,0.576736024
1666,98,20278,10,8,0,0,0,18,8,3,6,0,0,17,nowin,win,plwin,beat,20,0,18,220,0.422727273,0.054545455,0.55,1,0.28664435
1667,143,20278,4,5,10,0,0,19,8,3,6,0,0,17,nowin,win,plwin,beat,20,0,9,203,0.463054187,0.044334975,0.57635468,3,0.883143365
1668,112,20279,4,6,10,0,0,20,2,4,6,6,0,18,nowin,win,plwin,beat,20,0,10,203,0.448275862,0.054187192,0.600985222,3,0.889576933
1669,115,20279,6,4,6,0,0,16,2,4,6,6,0,18,nowin,loss,beat,dlwin,0,10,10,194,0.427835052,0.041237113,0.592783505,2,0.583863602
1670,127,20279,4,10,0,0,0,14,2,4,6,6,0,18,nowin,loss,beat,dlwin,0,10,14,201,0.402985075,0.029850746,0.60199005,0,0.032263937
1671,48,20279,5,7,0,10,0,22,2,4,6,6,0,18,nowin,loss,bust,plbust,0,10,12,203,0.413793103,0.019704433,0.600985222,2,0.577280801
1672,127,20279,10,10,0,0,0,20,2,4,6,6,0,18,nowin,win,plwin,beat,20,0,20,201,0.402985075,0.029850746,0.60199005,0,0.032263937
1673,49,20279,10,5,0,0,0,15,2,4,6,6,0,18,nowin,loss,beat,dlwin,0,10,15,207,0.396135266,0.053140097,0.594202899,0,0.028306925
1674,52,20280,5,4,11,0,0,20,5,7,6,0,0,18,nowin,win,plwin,beat,20,0,9,217,0.414746544,0.02764977,0.599078341,2,0.576736024
1675,149,20280,4,4,8,0,0,16,5,7,6,0,0,18,nowin,loss,beat,dlwin,0,10,8,225,0.457777778,0.057777778,0.648888889,2,0.651965595
1676,72,20280,10,7,0,0,0,17,5,7,6,0,0,18,nowin,loss,beat,dlwin,0,10,17,185,0.394594595,0.032432432,0.508108108,0,0.006763115
1677,119,20280,10,4,0,0,0,14,5,7,6,0,0,18,nowin,loss,beat,dlwin,0,10,14,190,0.405263158,0.068421053,0.515789474,0,0.011837158
1678,40,20280,7,10,0,0,0,17,5,7,6,0,0,18,nowin,loss,beat,dlwin,0,10,17,196,0.367346939,0.030612245,0.617346939,0,0.025358183
1679,74,20280,3,6,10,0,0,19,5,7,6,0,0,18,nowin,win,plwin,beat,20,0,9,209,0.411483254,0.04784689,0.531100478,0,0.017448125
1680,77,20281,5,1,9,10,0,25,7,2,11,0,0,20,nowin,loss,bust,plbust,0,10,6,200,0.455,0.04,0.62,3,0.916252116
1681,10,20281,9,7,0,10,0,26,7,2,11,0,0,20,nowin,loss,bust,plbust,0,10,16,191,0.413612565,0.057591623,0.596858639,2,0.574087175
1682,54,20281,5,1,7,8,0,21,7,2,11,0,0,20,nowin,win,plwin,beat,20,0,6,185,0.437837838,0.032432432,0.556756757,1,0.29899854
1683,36,20281,7,7,0,3,0,17,7,2,11,0,0,20,nowin,loss,beat,dlwin,0,10,14,229,0.445414847,0.056768559,0.655021834,2,0.645370571
1684,134,20281,5,2,10,0,0,17,7,2,11,0,0,20,nowin,loss,beat,dlwin,0,10,7,185,0.443243243,0.021621622,0.545945946,1,0.296939509
1685,75,20281,2,5,10,0,0,17,7,2,11,0,0,20,nowin,loss,beat,dlwin,0,10,7,191,0.418848168,0.052356021,0.570680628,0,0.029344702
1686,77,20282,10,10,0,0,0,20,4,10,5,0,0,19,nowin,win,plwin,beat,20,0,20,200,0.455,0.04,0.62,3,0.916252116
1687,143,20282,5,9,0,0,0,14,4,10,5,0,0,19,nowin,loss,beat,dlwin,0,10,14,203,0.463054187,0.044334975,0.57635468,3,0.883143365
1688,143,20282,10,2,0,0,0,12,4,10,5,0,0,19,nowin,loss,beat,dlwin,0,10,12,203,0.463054187,0.044334975,0.57635468,3,0.883143365
1689,114,20282,2,9,10,0,0,21,4,10,5,0,0,19,nowin,win,plwin,beat,20,0,11,198,0.47979798,0.025252525,0.611111111,3,0.937232995
1690,35,20282,11,1,1,0,0,13,4,10,5,0,0,19,nowin,loss,beat,dlwin,0,10,12,202,0.410891089,0.044554455,0.633663366,2,0.598681573
1691,59,20282,9,3,0,0,0,12,4,10,5,0,0,19,nowin,loss,beat,dlwin,0,10,12,228,0.429824561,0.048245614,0.543859649,1,0.287885446
1692,139,20283,8,4,0,0,0,12,6,7,10,0,0,23,nowin,win,dlbust,bust,20,0,12,192,0.380208333,0.036458333,0.59375,0,0.023429169
1693,80,20283,2,1,10,0,0,13,6,7,10,0,0,23,nowin,win,dlbust,bust,20,0,3,186,0.419354839,0.059139785,0.623655914,2,0.59892924
1694,126,20283,6,8,0,0,0,14,6,7,10,0,0,23,nowin,win,dlbust,bust,20,0,14,188,0.457446809,0.074468085,0.60106383,3,0.900633203
1695,142,20283,7,11,0,0,0,18,6,7,10,0,0,23,nowin,win,dlbust,bust,20,0,18,211,0.417061611,0.047393365,0.526066351,1,0.271531309
1696,35,20283,4,7,10,0,0,21,6,7,10,0,0,23,nowin,win,dlbust,bust,20,0,11,202,0.410891089,0.044554455,0.633663366,2,0.598681573
1697,107,20283,7,7,0,0,0,14,6,7,10,0,0,23,nowin,win,dlbust,bust,20,0,14,218,0.444954128,0.073394495,0.600917431,2,0.605210014
1698,138,20284,10,9,0,0,0,19,3,6,4,5,0,18,nowin,win,plwin,beat,20,0,19,190,0.442105263,0.047368421,0.610526316,2,0.609711065
1699,35,20284,10,11,0,0,0,21,3,6,4,5,0,18,win,win,plwin,beat,25,0,21,202,0.410891089,0.044554455,0.633663366,2,0.598681573
1700,27,20284,10,2,0,1,0,13,3,6,4,5,0,18,nowin,loss,beat,dlwin,0,10,12,178,0.370786517,0.016853933,0.573033708,0,0.015536309
1701,34,20284,2,10,0,5,0,17,3,6,4,5,0,18,nowin,loss,beat,dlwin,0,10,12,202,0.5,0.079207921,0.618811881,3,0.968961434
1702,85,20284,6,4,3,0,0,13,3,6,4,5,0,18,nowin,loss,beat,dlwin,0,10,10,195,0.41025641,0.066666667,0.594871795,0,0.03269711
1703,44,20284,4,9,0,0,0,13,3,6,4,5,0,18,nowin,loss,beat,dlwin,0,10,13,219,0.433789954,0.050228311,0.534246575,1,0.285551035
1704,113,20285,4,10,0,4,0,18,10,10,0,0,0,20,nowin,loss,beat,dlwin,0,10,14,199,0.407035176,0.055276382,0.668341709,2,0.620695264
1705,136,20285,10,4,0,8,0,22,10,10,0,0,0,20,nowin,loss,bust,plbust,0,10,14,194,0.396907216,0.025773196,0.597938144,0,0.029452644
1706,149,20285,10,11,0,0,0,21,10,10,0,0,0,20,win,win,plwin,beat,25,0,21,225,0.457777778,0.057777778,0.648888889,2,0.651965595
1707,56,20285,10,8,0,0,0,18,10,10,0,0,0,20,nowin,loss,beat,dlwin,0,10,18,175,0.4,0.057142857,0.582857143,0,0.026685297
1708,116,20285,4,5,10,0,0,19,10,10,0,0,0,20,nowin,loss,beat,dlwin,0,10,9,195,0.425641026,0.056410256,0.538461538,1,0.28273747
1709,47,20285,10,5,0,10,0,25,10,10,0,0,0,20,nowin,loss,bust,plbust,0,10,15,210,0.438095238,0.057142857,0.623809524,2,0.615868808
1710,40,20286,8,8,0,1,0,17,10,10,0,0,0,20,nowin,loss,beat,dlwin,0,10,16,196,0.367346939,0.030612245,0.617346939,0,0.025358183
1711,5,20286,10,10,0,0,0,20,10,10,0,0,0,20,nowin,push,push,push,10,0,20,203,0.42364532,0.02955665,0.596059113,2,0.582508076
1712,141,20286,10,9,0,0,0,19,10,10,0,0,0,20,nowin,loss,beat,dlwin,0,10,19,202,0.420792079,0.074257426,0.564356436,0,0.028377851
1713,45,20286,10,5,0,10,0,25,10,10,0,0,0,20,nowin,loss,bust,plbust,0,10,15,196,0.428571429,0.051020408,0.612244898,2,0.598821767
1714,42,20286,10,9,0,0,0,19,10,10,0,0,0,20,nowin,loss,beat,dlwin,0,10,19,212,0.443396226,0.051886792,0.570754717,1,0.309181312
1715,39,20286,3,9,0,3,4,19,10,10,0,0,0,20,nowin,loss,beat,dlwin,0,10,12,191,0.429319372,0.062827225,0.57591623,0,0.033760763
1716,148,20287,10,10,0,0,0,20,10,7,0,0,0,17,nowin,win,plwin,beat,20,0,20,204,0.401960784,0.078431373,0.593137255,0,0.029789521
1717,80,20287,10,10,0,0,0,20,10,7,0,0,0,17,nowin,win,plwin,beat,20,0,20,186,0.419354839,0.059139785,0.623655914,2,0.59892924
1718,136,20287,6,2,6,1,10,25,10,7,0,0,0,17,nowin,loss,bust,plbust,0,10,8,194,0.396907216,0.025773196,0.597938144,0,0.029452644
1719,21,20287,8,4,0,10,0,22,10,7,0,0,0,17,nowin,loss,bust,plbust,0,10,12,214,0.359813084,0.042056075,0.626168224,0,0.025263474
1720,54,20287,9,10,0,0,0,19,10,7,0,0,0,17,nowin,win,plwin,beat,20,0,19,185,0.437837838,0.032432432,0.556756757,1,0.29899854
1721,139,20287,5,10,0,3,0,18,10,7,0,0,0,17,nowin,win,plwin,beat,20,0,15,192,0.380208333,0.036458333,0.59375,0,0.023429169
1722,10,20288,3,5,7,0,0,15,4,10,10,0,0,24,nowin,win,dlbust,bust,20,0,8,191,0.413612565,0.057591623,0.596858639,2,0.574087175
1723,24,20288,3,10,0,0,0,13,4,10,10,0,0,24,nowin,win,dlbust,bust,20,0,13,207,0.458937198,0.048309179,0.570048309,1,0.318138014
1724,36,20288,10,10,0,0,0,20,4,10,10,0,0,24,nowin,win,dlbust,bust,20,0,20,229,0.445414847,0.056768559,0.655021834,2,0.645370571
1725,29,20288,10,9,0,0,0,19,4,10,10,0,0,24,nowin,win,dlbust,bust,20,0,19,189,0.44973545,0.058201058,0.544973545,1,0.300349439
1726,92,20288,8,3,4,0,0,15,4,10,10,0,0,24,nowin,win,dlbust,bust,20,0,11,186,0.446236559,0.059139785,0.564516129,1,0.307826125
1727,21,20288,5,10,0,0,0,15,4,10,10,0,0,24,nowin,win,dlbust,bust,20,0,15,214,0.359813084,0.042056075,0.626168224,0,0.025263474
1728,20,20289,9,5,0,4,0,18,10,10,0,0,0,20,nowin,loss,beat,dlwin,0,10,14,186,0.456989247,0.037634409,0.537634409,1,0.301097108
1729,131,20289,10,11,0,0,0,21,10,10,0,0,0,20,win,win,plwin,beat,25,0,21,217,0.410138249,0.069124424,0.543778802,0,0.02015021
1730,34,20289,8,10,0,0,0,18,10,10,0,0,0,20,nowin,loss,beat,dlwin,0,10,18,202,0.5,0.079207921,0.618811881,3,0.968961434
1731,38,20289,10,3,0,10,0,23,10,10,0,0,0,20,nowin,loss,bust,plbust,0,10,13,202,0.361386139,0.03960396,0.564356436,0,0.010597953
1732,48,20289,10,5,0,10,0,25,10,10,0,0,0,20,nowin,loss,bust,plbust,0,10,15,203,0.413793103,0.019704433,0.600985222,2,0.577280801
1733,141,20289,7,11,0,0,0,18,10,10,0,0,0,20,nowin,loss,beat,dlwin,0,10,18,202,0.420792079,0.074257426,0.564356436,0,0.028377851
1734,101,20290,8,10,0,0,0,18,7,9,8,0,0,24,nowin,win,dlbust,bust,20,0,18,205,0.424390244,0.068292683,0.63902439,2,0.614740646
1735,35,20290,10,6,0,10,0,26,7,9,8,0,0,24,nowin,loss,bust,plbust,0,10,16,202,0.410891089,0.044554455,0.633663366,2,0.598681573
1736,14,20290,10,9,0,0,0,19,7,9,8,0,0,24,nowin,win,dlbust,bust,20,0,19,202,0.391089109,0.01980198,0.628712871,2,0.577264877
1737,52,20290,4,9,0,1,1,15,7,9,8,0,0,24,nowin,win,dlbust,bust,20,0,13,217,0.414746544,0.02764977,0.599078341,2,0.576736024
1738,86,20290,4,5,4,10,0,23,7,9,8,0,0,24,nowin,loss,bust,plbust,0,10,9,196,0.454081633,0.040816327,0.591836735,3,0.887566443
1739,20,20290,9,3,0,2,5,19,7,9,8,0,0,24,nowin,win,dlbust,bust,20,0,12,186,0.456989247,0.037634409,0.537634409,1,0.301097108
1740,68,20291,10,5,0,10,0,25,10,10,0,0,0,20,nowin,loss,bust,plbust,0,10,15,205,0.434146341,0.029268293,0.6,2,0.59483189
1741,145,20291,5,11,4,0,0,20,10,10,0,0,0,20,nowin,push,push,push,10,0,16,188,0.441489362,0.031914894,0.622340426,2,0.617837093
1742,32,20291,6,7,0,5,0,18,10,10,0,0,0,20,nowin,loss,beat,dlwin,0,10,13,189,0.391534392,0.037037037,0.53968254,0,0.013579086
1743,115,20291,7,2,2,8,0,19,10,10,0,0,0,20,nowin,loss,beat,dlwin,0,10,9,194,0.427835052,0.041237113,0.592783505,2,0.583863602
1744,34,20291,5,10,0,3,0,18,10,10,0,0,0,20,nowin,loss,beat,dlwin,0,10,15,202,0.5,0.079207921,0.618811881,3,0.968961434
1745,37,20291,8,5,0,6,0,19,10,10,0,0,0,20,nowin,loss,beat,dlwin,0,10,13,208,0.394230769,0.038461538,0.581730769,0,0.024682772
1746,129,20292,2,3,4,4,0,13,2,4,11,0,0,17,nowin,loss,beat,dlwin,0,10,5,201,0.422885572,0.064676617,0.55721393,0,0.027255383
1747,23,20292,5,6,6,0,0,17,2,4,11,0,0,17,nowin,push,push,push,10,0,11,208,0.427884615,0.0625,0.552884615,1,0.29114424
1748,85,20292,5,3,2,7,0,17,2,4,11,0,0,17,nowin,push,push,push,10,0,8,195,0.41025641,0.066666667,0.594871795,0,0.03269711
1749,42,20292,10,9,0,0,0,19,2,4,11,0,0,17,nowin,win,plwin,beat,20,0,19,212,0.443396226,0.051886792,0.570754717,1,0.309181312
1750,48,20292,10,8,0,0,0,18,2,4,11,0,0,17,nowin,win,plwin,beat,20,0,18,203,0.413793103,0.019704433,0.600985222,2,0.577280801
1751,56,20292,11,5,5,0,0,21,2,4,11,0,0,17,nowin,win,plwin,beat,20,0,16,175,0.4,0.057142857,0.582857143,0,0.026685297
1752,69,20293,10,2,0,10,0,22,8,9,0,0,0,17,nowin,loss,bust,plbust,0,10,12,194,0.365979381,0.030927835,0.515463918,0,0
1753,132,20293,10,3,0,5,0,18,8,9,0,0,0,17,nowin,win,plwin,beat,20,0,13,194,0.412371134,0.036082474,0.649484536,2,0.611633238
1754,81,20293,11,10,0,0,0,21,8,9,0,0,0,17,win,win,plwin,beat,25,0,21,182,0.395604396,0.043956044,0.60989011,2,0.567491261
1755,85,20293,10,6,0,3,0,19,8,9,0,0,0,17,nowin,win,plwin,beat,20,0,16,195,0.41025641,0.066666667,0.594871795,0,0.03269711
1756,77,20293,8,3,7,0,0,18,8,9,0,0,0,17,nowin,win,plwin,beat,20,0,11,200,0.455,0.04,0.62,3,0.916252116
1757,61,20293,10,10,0,0,0,20,8,9,0,0,0,17,nowin,win,plwin,beat,20,0,20,194,0.427835052,0.077319588,0.603092784,2,0.591437139
1758,56,20294,6,5,9,0,0,20,1,3,8,1,10,23,nowin,win,dlbust,bust,20,0,11,175,0.4,0.057142857,0.582857143,0,0.026685297
1759,33,20294,10,10,0,0,0,20,1,3,8,1,10,23,nowin,win,dlbust,bust,20,0,20,192,0.4375,0.057291667,0.625,2,0.616208916
1760,96,20294,11,7,0,0,0,18,1,3,8,1,10,23,nowin,win,dlbust,bust,20,0,18,190,0.468421053,0.057894737,0.584210526,3,0.897263354
1761,150,20294,10,11,0,0,0,21,1,3,8,1,10,23,win,win,dlbust,bust,25,0,21,192,0.401041667,0.036458333,0.567708333,0,0.023287458
1762,92,20294,3,3,10,8,0,24,1,3,8,1,10,23,nowin,loss,bust,plbust,0,10,6,186,0.446236559,0.059139785,0.564516129,1,0.307826125
1763,74,20294,10,2,0,1,1,14,1,3,8,1,10,23,nowin,win,dlbust,bust,20,0,12,209,0.411483254,0.04784689,0.531100478,0,0.017448125
1764,98,20295,6,10,0,10,0,26,10,10,0,0,0,20,nowin,loss,bust,plbust,0,10,16,220,0.422727273,0.054545455,0.55,1,0.28664435
1765,140,20295,10,9,0,0,0,19,10,10,0,0,0,20,nowin,loss,beat,dlwin,0,10,19,210,0.466666667,0.023809524,0.604761905,3,0.915293335
1766,25,20295,10,3,0,9,0,22,10,10,0,0,0,20,nowin,loss,bust,plbust,0,10,13,190,0.463157895,0.063157895,0.536842105,1,0.304401563
1767,125,20295,10,7,0,0,0,17,10,10,0,0,0,20,nowin,loss,beat,dlwin,0,10,17,219,0.438356164,0.050228311,0.575342466,1,0.308411257
1768,4,20295,6,7,0,10,0,23,10,10,0,0,0,20,nowin,loss,bust,plbust,0,10,13,217,0.460829493,0.036866359,0.562211982,1,0.315432839
1769,138,20295,10,4,0,9,0,23,10,10,0,0,0,20,nowin,loss,bust,plbust,0,10,14,190,0.442105263,0.047368421,0.610526316,2,0.609711065
1770,138,20296,8,7,0,6,0,21,10,8,0,0,0,18,nowin,win,plwin,beat,20,0,15,190,0.442105263,0.047368421,0.610526316,2,0.609711065
1771,66,20296,10,10,0,0,0,20,10,8,0,0,0,18,nowin,win,plwin,beat,20,0,20,217,0.456221198,0.064516129,0.626728111,3,0.924304367
1772,73,20296,10,10,0,0,0,20,10,8,0,0,0,18,nowin,win,plwin,beat,20,0,20,181,0.375690608,0.011049724,0.596685083,0,0.022795773
1773,128,20296,7,10,0,0,0,17,10,8,0,0,0,18,nowin,loss,beat,dlwin,0,10,17,227,0.356828194,0.052863436,0.577092511,0,0.012352564
1774,102,20296,9,11,0,0,0,20,10,8,0,0,0,18,nowin,win,plwin,beat,20,0,20,192,0.338541667,0.046875,0.5625,0,0.003306118
1775,85,20296,2,10,0,10,0,22,10,8,0,0,0,18,nowin,loss,bust,plbust,0,10,12,195,0.41025641,0.066666667,0.594871795,0,0.03269711
1776,88,20297,4,8,0,2,10,24,11,8,0,0,0,19,nowin,loss,bust,plbust,0,10,12,206,0.466019417,0.033980583,0.54368932,1,0.309467903
1777,25,20297,6,8,0,4,0,18,11,8,0,0,0,19,nowin,loss,beat,dlwin,0,10,14,190,0.463157895,0.063157895,0.536842105,1,0.304401563
1778,36,20297,4,10,0,6,0,20,11,8,0,0,0,19,nowin,win,plwin,beat,20,0,14,229,0.445414847,0.056768559,0.655021834,2,0.645370571
1779,28,20297,10,10,0,0,0,20,11,8,0,0,0,19,nowin,win,plwin,beat,20,0,20,199,0.422110553,0.045226131,0.542713568,1,0.282706618
1780,6,20297,9,4,0,4,0,17,11,8,0,0,0,19,nowin,loss,beat,dlwin,0,10,13,191,0.439790576,0.047120419,0.581151832,1,0.31211505
1781,117,20297,2,10,0,10,0,22,11,8,0,0,0,19,nowin,loss,bust,plbust,0,10,12,173,0.410404624,0.069364162,0.606936416,2,0.578610282
1782,150,20298,6,11,1,0,0,18,4,8,7,0,0,19,nowin,loss,beat,dlwin,0,10,17,192,0.401041667,0.036458333,0.567708333,0,0.023287458
1783,70,20298,10,4,0,0,0,14,4,8,7,0,0,19,nowin,loss,beat,dlwin,0,10,14,228,0.385964912,0.039473684,0.557017544,0,0.016157125
1784,19,20298,11,10,0,0,0,21,4,8,7,0,0,19,win,win,plwin,beat,25,0,21,237,0.41350211,0.054852321,0.628691983,2,0.597373826
1785,147,20298,5,7,0,0,0,12,4,8,7,0,0,19,nowin,loss,beat,dlwin,0,10,12,205,0.380487805,0.014634146,0.536585366,0,0.00951447
1786,11,20298,10,9,0,0,0,19,4,8,7,0,0,19,nowin,push,push,push,10,0,19,236,0.457627119,0.016949153,0.588983051,3,0.889015813
1787,138,20298,9,5,0,0,0,14,4,8,7,0,0,19,nowin,loss,beat,dlwin,0,10,14,190,0.442105263,0.047368421,0.610526316,2,0.609711065
1788,132,20299,7,3,8,0,0,18,10,9,0,0,0,19,nowin,loss,beat,dlwin,0,10,10,194,0.412371134,0.036082474,0.649484536,2,0.611633238
1789,124,20299,2,4,10,10,0,26,10,9,0,0,0,19,nowin,loss,bust,plbust,0,10,6,202,0.47029703,0.064356436,0.584158416,3,0.899458193
1790,3,20299,10,10,0,0,0,20,10,9,0,0,0,19,nowin,win,plwin,beat,20,0,20,190,0.431578947,0.026315789,0.542105263,1,0.288076384
1791,50,20299,2,3,5,7,0,17,10,9,0,0,0,19,nowin,loss,beat,dlwin,0,10,5,202,0.405940594,0.04950495,0.54950495,0,0.020296079
1792,98,20299,10,4,0,10,0,24,10,9,0,0,0,19,nowin,loss,bust,plbust,0,10,14,220,0.422727273,0.054545455,0.55,1,0.28664435
1793,149,20299,5,9,0,10,0,24,10,9,0,0,0,19,nowin,loss,bust,plbust,0,10,14,225,0.457777778,0.057777778,0.648888889,2,0.651965595
1794,68,20300,11,10,0,0,0,21,3,6,10,0,0,19,win,win,plwin,beat,25,0,21,205,0.434146341,0.029268293,0.6,2,0.59483189
1795,149,20300,8,9,0,0,0,17,3,6,10,0,0,19,nowin,loss,beat,dlwin,0,10,17,225,0.457777778,0.057777778,0.648888889,2,0.651965595
1796,28,20300,7,6,0,0,0,13,3,6,10,0,0,19,nowin,loss,beat,dlwin,0,10,13,199,0.422110553,0.045226131,0.542713568,1,0.282706618
1797,135,20300,3,3,6,4,0,16,3,6,10,0,0,19,nowin,loss,beat,dlwin,0,10,6,179,0.391061453,0.067039106,0.586592179,0,0.024924662
1798,55,20300,8,5,0,0,0,13,3,6,10,0,0,19,nowin,loss,beat,dlwin,0,10,13,191,0.371727749,0.057591623,0.54973822,0,0.01011347
1799,69,20300,11,9,0,0,0,20,3,6,10,0,0,19,nowin,win,plwin,beat,20,0,20,194,0.365979381,0.030927835,0.515463918,0,0
1800,12,20301,10,9,0,0,0,19,6,7,10,0,0,23,nowin,win,dlbust,bust,20,0,19,189,0.470899471,0.015873016,0.613756614,3,0.929171178
1801,25,20301,4,8,0,0,0,12,6,7,10,0,0,23,nowin,win,dlbust,bust,20,0,12,190,0.463157895,0.063157895,0.536842105,1,0.304401563
1802,75,20301,10,4,0,0,0,14,6,7,10,0,0,23,nowin,win,dlbust,bust,20,0,14,191,0.418848168,0.052356021,0.570680628,0,0.029344702
1803,46,20301,8,11,0,0,0,19,6,7,10,0,0,23,nowin,win,dlbust,bust,20,0,19,186,0.403225806,0.048387097,0.591397849,0,0.029742194
1804,84,20301,10,2,0,0,0,12,6,7,10,0,0,23,nowin,win,dlbust,bust,20,0,12,195,0.379487179,0.056410256,0.569230769,0,0.017209119
1805,137,20301,6,10,0,0,0,16,6,7,10,0,0,23,nowin,win,dlbust,bust,20,0,16,194,0.417525773,0.046391753,0.536082474,1,0.276714602
1806,98,20302,8,7,0,10,0,25,10,10,0,0,0,20,nowin,loss,bust,plbust,0,10,15,220,0.422727273,0.054545455,0.55,1,0.28664435
1807,55,20302,8,3,5,9,0,25,10,10,0,0,0,20,nowin,loss,bust,plbust,0,10,11,191,0.371727749,0.057591623,0.54973822,0,0.01011347
1808,32,20302,2,10,0,2,1,15,10,10,0,0,0,20,nowin,loss,beat,dlwin,0,10,12,189,0.391534392,0.037037037,0.53968254,0,0.013579086
1809,141,20302,10,10,0,0,0,20,10,10,0,0,0,20,nowin,push,push,push,10,0,20,202,0.420792079,0.074257426,0.564356436,0,0.028377851
1810,78,20302,5,8,0,8,0,21,10,10,0,0,0,20,nowin,win,plwin,beat,20,0,13,201,0.517412935,0.034825871,0.587064677,3,0.95871112
1811,78,20302,6,9,0,10,0,25,10,10,0,0,0,20,nowin,loss,bust,plbust,0,10,15,201,0.517412935,0.034825871,0.587064677,3,0.95871112
1812,75,20303,10,5,0,0,0,15,4,7,5,10,0,26,nowin,win,dlbust,bust,20,0,15,191,0.418848168,0.052356021,0.570680628,0,0.029344702
1813,134,20303,8,10,0,0,0,18,4,7,5,10,0,26,nowin,win,dlbust,bust,20,0,18,185,0.443243243,0.021621622,0.545945946,1,0.296939509
1814,130,20303,8,10,0,0,0,18,4,7,5,10,0,26,nowin,win,dlbust,bust,20,0,18,219,0.410958904,0.03652968,0.566210046,0,0.025888739
1815,48,20303,10,10,0,0,0,20,4,7,5,10,0,26,nowin,win,dlbust,bust,20,0,20,203,0.413793103,0.019704433,0.600985222,2,0.577280801
1816,118,20303,2,8,5,0,0,15,4,7,5,10,0,26,nowin,win,dlbust,bust,20,0,10,216,0.393518519,0.037037037,0.555555556,0,0.018059873
1817,55,20303,2,8,3,0,0,13,4,7,5,10,0,26,nowin,win,dlbust,bust,20,0,10,191,0.371727749,0.057591623,0.54973822,0,0.01011347
1818,118,20304,2,9,3,5,0,19,10,9,0,0,0,19,nowin,push,push,push,10,0,11,216,0.393518519,0.037037037,0.555555556,0,0.018059873
1819,148,20304,5,4,10,0,0,19,10,9,0,0,0,19,nowin,push,push,push,10,0,9,204,0.401960784,0.078431373,0.593137255,0,0.029789521
1820,147,20304,10,9,0,0,0,19,10,9,0,0,0,19,nowin,push,push,push,10,0,19,205,0.380487805,0.014634146,0.536585366,0,0.00951447
1821,69,20304,1,4,10,3,0,18,10,9,0,0,0,19,nowin,loss,beat,dlwin,0,10,5,194,0.365979381,0.030927835,0.515463918,0,0
1822,87,20304,3,8,1,1,10,23,10,9,0,0,0,19,nowin,loss,bust,plbust,0,10,11,202,0.405940594,0.054455446,0.628712871,2,0.590599801
1823,7,20304,5,10,0,6,0,21,10,9,0,0,0,19,nowin,win,plwin,beat,20,0,15,183,0.442622951,0.06010929,0.62295082,2,0.619303341
1824,141,20305,10,10,0,0,0,20,10,10,0,0,0,20,nowin,push,push,push,10,0,20,202,0.420792079,0.074257426,0.564356436,0,0.028377851
1825,63,20305,2,6,3,10,0,21,10,10,0,0,0,20,nowin,win,plwin,beat,20,0,8,216,0.467592593,0.037037037,0.62037037,3,0.931690496
1826,101,20305,6,10,0,3,0,19,10,10,0,0,0,20,nowin,loss,beat,dlwin,0,10,16,205,0.424390244,0.068292683,0.63902439,2,0.614740646
1827,135,20305,3,9,0,7,0,19,10,10,0,0,0,20,nowin,loss,beat,dlwin,0,10,12,179,0.391061453,0.067039106,0.586592179,0,0.024924662
1828,39,20305,11,1,5,0,0,17,10,10,0,0,0,20,nowin,loss,beat,dlwin,0,10,12,191,0.429319372,0.062827225,0.57591623,0,0.033760763
1829,51,20305,4,6,4,9,0,23,10,10,0,0,0,20,nowin,loss,bust,plbust,0,10,10,189,0.529100529,0.068783069,0.608465608,3,0.993665715
1830,142,20306,5,4,4,10,0,23,8,5,8,0,0,21,nowin,loss,bust,plbust,0,10,9,211,0.417061611,0.047393365,0.526066351,1,0.271531309
1831,9,20306,10,10,0,0,0,20,8,5,8,0,0,21,nowin,loss,beat,dlwin,0,10,20,194,0.37628866,0.015463918,0.541237113,0,0.009396796
1832,78,20306,10,10,0,0,0,20,8,5,8,0,0,21,nowin,loss,beat,dlwin,0,10,20,201,0.517412935,0.034825871,0.587064677,3,0.95871112
1833,68,20306,7,5,0,8,0,20,8,5,8,0,0,21,nowin,loss,beat,dlwin,0,10,12,205,0.434146341,0.029268293,0.6,2,0.59483189
1834,13,20306,6,7,0,6,0,19,8,5,8,0,0,21,nowin,loss,beat,dlwin,0,10,13,206,0.417475728,0.063106796,0.621359223,2,0.59555479
1835,132,20306,3,8,10,0,0,21,8,5,8,0,0,21,nowin,push,push,push,10,0,11,194,0.412371134,0.036082474,0.649484536,2,0.611633238
1836,149,20307,2,10,0,7,0,19,11,1,9,0,0,21,nowin,loss,beat,dlwin,0,10,12,225,0.457777778,0.057777778,0.648888889,2,0.651965595
1837,124,20307,6,9,0,2,0,17,11,1,9,0,0,21,nowin,loss,beat,dlwin,0,10,15,202,0.47029703,0.064356436,0.584158416,3,0.899458193
1838,92,20307,1,3,10,9,0,23,11,1,9,0,0,21,nowin,loss,bust,plbust,0,10,4,186,0.446236559,0.059139785,0.564516129,1,0.307826125
1839,109,20307,8,6,0,4,0,18,11,1,9,0,0,21,nowin,loss,beat,dlwin,0,10,14,221,0.461538462,0.058823529,0.597285068,3,0.901830309
1840,6,20307,10,7,0,0,0,17,11,1,9,0,0,21,nowin,loss,beat,dlwin,0,10,17,191,0.439790576,0.047120419,0.581151832,1,0.31211505
1841,148,20307,10,8,0,0,0,18,11,1,9,0,0,21,nowin,loss,beat,dlwin,0,10,18,204,0.401960784,0.078431373,0.593137255,0,0.029789521
1842,99,20308,10,10,0,0,0,20,2,5,6,10,0,23,nowin,win,dlbust,bust,20,0,20,207,0.47826087,0.062801932,0.637681159,3,0.961418446
1843,66,20308,2,10,0,10,0,22,2,5,6,10,0,23,nowin,loss,bust,plbust,0,10,12,217,0.456221198,0.064516129,0.626728111,3,0.924304367
1844,139,20308,3,8,1,6,0,18,2,5,6,10,0,23,nowin,win,dlbust,bust,20,0,11,192,0.380208333,0.036458333,0.59375,0,0.023429169
1845,147,20308,10,4,0,0,0,14,2,5,6,10,0,23,nowin,win,dlbust,bust,20,0,14,205,0.380487805,0.014634146,0.536585366,0,0.00951447
1846,57,20308,4,10,0,0,0,14,2,5,6,10,0,23,nowin,win,dlbust,bust,20,0,14,192,0.46875,0.052083333,0.59375,3,0.907001181
1847,34,20308,10,9,0,0,0,19,2,5,6,10,0,23,nowin,win,dlbust,bust,20,0,19,202,0.5,0.079207921,0.618811881,3,0.968961434
1848,72,20309,2,10,0,2,0,14,3,3,2,6,5,19,nowin,loss,beat,dlwin,0,10,12,185,0.394594595,0.032432432,0.508108108,0,0.006763115
1849,28,20309,2,2,10,0,0,14,3,3,2,6,5,19,nowin,loss,beat,dlwin,0,10,4,199,0.422110553,0.045226131,0.542713568,1,0.282706618
1850,102,20309,10,10,0,0,0,20,3,3,2,6,5,19,nowin,win,plwin,beat,20,0,20,192,0.338541667,0.046875,0.5625,0,0.003306118
1851,96,20309,3,7,10,0,0,20,3,3,2,6,5,19,nowin,win,plwin,beat,20,0,10,190,0.468421053,0.057894737,0.584210526,3,0.897263354
1852,142,20309,6,5,2,0,0,13,3,3,2,6,5,19,nowin,loss,beat,dlwin,0,10,11,211,0.417061611,0.047393365,0.526066351,1,0.271531309
1853,33,20309,10,11,0,0,0,21,3,3,2,6,5,19,win,win,plwin,beat,25,0,21,192,0.4375,0.057291667,0.625,2,0.616208916
1854,115,20310,8,10,0,0,0,18,10,2,2,2,2,18,nowin,push,push,push,10,0,18,194,0.427835052,0.041237113,0.592783505,2,0.583863602
1855,43,20310,8,10,0,0,0,18,10,2,2,2,2,18,nowin,push,push,push,10,0,18,192,0.40625,0.041666667,0.609375,2,0.576671372
1856,114,20310,3,10,0,10,0,23,10,2,2,2,2,18,nowin,loss,bust,plbust,0,10,13,198,0.47979798,0.025252525,0.611111111,3,0.937232995
1857,40,20310,9,4,0,1,8,22,10,2,2,2,2,18,nowin,loss,bust,plbust,0,10,13,196,0.367346939,0.030612245,0.617346939,0,0.025358183
1858,129,20310,2,1,10,10,0,23,10,2,2,2,2,18,nowin,loss,bust,plbust,0,10,3,201,0.422885572,0.064676617,0.55721393,0,0.027255383
1859,77,20310,10,3,0,2,8,23,10,2,2,2,2,18,nowin,loss,bust,plbust,0,10,13,200,0.455,0.04,0.62,3,0.916252116
1860,115,20311,4,8,0,10,0,22,2,9,10,0,0,21,nowin,loss,bust,plbust,0,10,12,194,0.427835052,0.041237113,0.592783505,2,0.583863602
1861,99,20311,2,10,0,5,0,17,2,9,10,0,0,21,nowin,loss,beat,dlwin,0,10,12,207,0.47826087,0.062801932,0.637681159,3,0.961418446
1862,126,20311,5,10,0,0,0,15,2,9,10,0,0,21,nowin,loss,beat,dlwin,0,10,15,188,0.457446809,0.074468085,0.60106383,3,0.900633203
1863,76,20311,3,6,9,0,0,18,2,9,10,0,0,21,nowin,loss,beat,dlwin,0,10,9,189,0.534391534,0.079365079,0.608465608,3,1
1864,118,20311,8,5,0,0,0,13,2,9,10,0,0,21,nowin,loss,beat,dlwin,0,10,13,216,0.393518519,0.037037037,0.555555556,0,0.018059873
1865,40,20311,6,9,0,0,0,15,2,9,10,0,0,21,nowin,loss,beat,dlwin,0,10,15,196,0.367346939,0.030612245,0.617346939,0,0.025358183
1866,83,20312,9,10,0,0,0,19,10,10,0,0,0,20,nowin,loss,beat,dlwin,0,10,19,193,0.424870466,0.051813472,0.678756477,2,0.644360335
1867,93,20312,6,4,9,0,0,19,10,10,0,0,0,20,nowin,loss,beat,dlwin,0,10,10,175,0.485714286,0.051428571,0.548571429,1,0.323648091
1868,58,20312,9,3,0,4,6,22,10,10,0,0,0,20,nowin,loss,bust,plbust,0,10,12,195,0.430769231,0.041025641,0.584615385,2,0.580497586
1869,84,20312,10,9,0,0,0,19,10,10,0,0,0,20,nowin,loss,beat,dlwin,0,10,19,195,0.379487179,0.056410256,0.569230769,0,0.017209119
1870,63,20312,7,11,0,0,0,18,10,10,0,0,0,20,nowin,loss,beat,dlwin,0,10,18,216,0.467592593,0.037037037,0.62037037,3,0.931690496
1871,37,20312,1,3,10,5,0,19,10,10,0,0,0,20,nowin,loss,beat,dlwin,0,10,4,208,0.394230769,0.038461538,0.581730769,0,0.024682772
1872,130,20313,5,4,10,0,0,19,10,10,0,0,0,20,nowin,loss,beat,dlwin,0,10,9,219,0.410958904,0.03652968,0.566210046,0,0.025888739
1873,97,20313,1,1,10,10,0,22,10,10,0,0,0,20,nowin,loss,bust,plbust,0,10,2,182,0.450549451,0.06043956,0.692307692,2,0.677372279
1874,56,20313,5,8,0,10,0,23,10,10,0,0,0,20,nowin,loss,bust,plbust,0,10,13,175,0.4,0.057142857,0.582857143,0,0.026685297
1875,83,20313,5,6,3,2,10,26,10,10,0,0,0,20,nowin,loss,bust,plbust,0,10,11,193,0.424870466,0.051813472,0.678756477,2,0.644360335
1876,13,20313,1,3,10,7,0,21,10,10,0,0,0,20,nowin,win,plwin,beat,20,0,4,206,0.417475728,0.063106796,0.621359223,2,0.59555479
1877,14,20313,11,5,3,0,0,19,10,10,0,0,0,20,nowin,loss,beat,dlwin,0,10,16,202,0.391089109,0.01980198,0.628712871,2,0.577264877
1878,88,20314,10,5,0,8,0,23,10,3,9,0,0,22,nowin,loss,bust,plbust,0,10,15,206,0.466019417,0.033980583,0.54368932,1,0.309467903
1879,25,20314,2,6,4,7,0,19,10,3,9,0,0,22,nowin,win,dlbust,bust,20,0,8,190,0.463157895,0.063157895,0.536842105,1,0.304401563
1880,50,20314,11,7,0,0,0,18,10,3,9,0,0,22,nowin,win,dlbust,bust,20,0,18,202,0.405940594,0.04950495,0.54950495,0,0.020296079
1881,21,20314,6,10,0,9,0,25,10,3,9,0,0,22,nowin,loss,bust,plbust,0,10,16,214,0.359813084,0.042056075,0.626168224,0,0.025263474
1882,78,20314,10,9,0,0,0,19,10,3,9,0,0,22,nowin,win,dlbust,bust,20,0,19,201,0.517412935,0.034825871,0.587064677,3,0.95871112
1883,70,20314,8,10,0,0,0,18,10,3,9,0,0,22,nowin,win,dlbust,bust,20,0,18,228,0.385964912,0.039473684,0.557017544,0,0.016157125
1884,88,20315,7,6,0,0,0,13,2,9,8,0,0,19,nowin,loss,beat,dlwin,0,10,13,206,0.466019417,0.033980583,0.54368932,1,0.309467903
1885,132,20315,10,7,0,0,0,17,2,9,8,0,0,19,nowin,loss,beat,dlwin,0,10,17,194,0.412371134,0.036082474,0.649484536,2,0.611633238
1886,141,20315,6,10,0,0,0,16,2,9,8,0,0,19,nowin,loss,beat,dlwin,0,10,16,202,0.420792079,0.074257426,0.564356436,0,0.028377851
1887,133,20315,11,9,0,0,0,20,2,9,8,0,0,19,nowin,win,plwin,beat,20,0,20,201,0.47761194,0.064676617,0.611940299,3,0.935428111
1888,138,20315,8,2,10,0,0,20,2,9,8,0,0,19,nowin,win,plwin,beat,20,0,10,190,0.442105263,0.047368421,0.610526316,2,0.609711065
1889,78,20315,7,10,0,0,0,17,2,9,8,0,0,19,nowin,loss,beat,dlwin,0,10,17,201,0.517412935,0.034825871,0.587064677,3,0.95871112
1890,83,20316,8,4,0,10,0,22,7,3,8,0,0,18,nowin,loss,bust,plbust,0,10,12,193,0.424870466,0.051813472,0.678756477,2,0.644360335
1891,90,20316,4,8,0,10,0,22,7,3,8,0,0,18,nowin,loss,bust,plbust,0,10,12,201,0.447761194,0.049751244,0.60199005,3,0.889945023
1892,54,20316,10,10,0,0,0,20,7,3,8,0,0,18,nowin,win,plwin,beat,20,0,20,185,0.437837838,0.032432432,0.556756757,1,0.29899854
1893,137,20316,7,11,0,0,0,18,7,3,8,0,0,18,nowin,push,push,push,10,0,18,194,0.417525773,0.046391753,0.536082474,1,0.276714602
1894,11,20316,8,10,0,0,0,18,7,3,8,0,0,18,nowin,push,push,push,10,0,18,236,0.457627119,0.016949153,0.588983051,3,0.889015813
1895,17,20316,6,3,4,5,0,18,7,3,8,0,0,18,nowin,push,push,push,10,0,9,171,0.444444444,0.070175439,0.555555556,1,0.302364894
1896,60,20317,9,8,0,0,0,17,3,9,1,2,3,18,nowin,loss,beat,dlwin,0,10,17,227,0.418502203,0.022026432,0.559471366,0,0.026496258
1897,145,20317,3,5,10,0,0,18,3,9,1,2,3,18,nowin,push,push,push,10,0,8,188,0.441489362,0.031914894,0.622340426,2,0.617837093
1898,107,20317,6,8,0,0,0,14,3,9,1,2,3,18,nowin,loss,beat,dlwin,0,10,14,218,0.444954128,0.073394495,0.600917431,2,0.605210014
1899,46,20317,3,9,0,10,0,22,3,9,1,2,3,18,nowin,loss,bust,plbust,0,10,12,186,0.403225806,0.048387097,0.591397849,0,0.029742194
1900,87,20317,10,10,0,0,0,20,3,9,1,2,3,18,nowin,win,plwin,beat,20,0,20,202,0.405940594,0.054455446,0.628712871,2,0.590599801
1901,129,20317,7,7,0,0,0,14,3,9,1,2,3,18,nowin,loss,beat,dlwin,0,10,14,201,0.422885572,0.064676617,0.55721393,0,0.027255383
1902,36,20318,10,2,0,10,0,22,3,2,2,3,6,16,nowin,loss,bust,plbust,0,10,12,229,0.445414847,0.056768559,0.655021834,2,0.645370571
1903,108,20318,10,5,0,0,0,15,3,2,2,3,6,16,nowin,loss,beat,dlwin,0,10,15,193,0.435233161,0.056994819,0.559585492,1,0.298824795
1904,149,20318,2,8,2,4,0,16,3,2,2,3,6,16,nowin,push,push,push,10,0,10,225,0.457777778,0.057777778,0.648888889,2,0.651965595
1905,1,20318,5,6,4,0,0,15,3,2,2,3,6,16,nowin,loss,beat,dlwin,0,10,11,197,0.406091371,0.025380711,0.649746193,2,0.606186955
1906,33,20318,9,10,0,0,0,19,3,2,2,3,6,16,nowin,win,plwin,beat,20,0,19,192,0.4375,0.057291667,0.625,2,0.616208916
1907,147,20318,2,10,0,2,0,14,3,2,2,3,6,16,nowin,loss,beat,dlwin,0,10,12,205,0.380487805,0.014634146,0.536585366,0,0.00951447
1908,132,20319,10,11,0,0,0,21,8,3,3,10,0,24,win,win,dlbust,bust,25,0,21,194,0.412371134,0.036082474,0.649484536,2,0.611633238
1909,30,20319,10,11,0,0,0,21,8,3,3,10,0,24,win,win,dlbust,bust,25,0,21,206,0.393203883,0.033980583,0.601941748,0,0.029324648
1910,17,20319,6,6,0,9,0,21,8,3,3,10,0,24,nowin,win,dlbust,bust,20,0,12,171,0.444444444,0.070175439,0.555555556,1,0.302364894
1911,95,20319,10,10,0,0,0,20,8,3,3,10,0,24,nowin,win,dlbust,bust,20,0,20,218,0.412844037,0.04587156,0.559633028,0,0.024842385
1912,11,20319,10,6,0,10,0,26,8,3,3,10,0,24,nowin,loss,bust,plbust,0,10,16,236,0.457627119,0.016949153,0.588983051,3,0.889015813
1913,134,20319,10,7,0,0,0,17,8,3,3,10,0,24,nowin,win,dlbust,bust,20,0,17,185,0.443243243,0.021621622,0.545945946,1,0.296939509
1914,41,20320,10,3,0,0,0,13,4,5,10,0,0,19,nowin,loss,beat,dlwin,0,10,13,192,0.364583333,0.036458333,0.520833333,0,0.00089702
1915,117,20320,10,10,0,0,0,20,4,5,10,0,0,19,nowin,win,plwin,beat,20,0,20,173,0.410404624,0.069364162,0.606936416,2,0.578610282
1916,87,20320,1,2,10,0,0,13,4,5,10,0,0,19,nowin,loss,beat,dlwin,0,10,3,202,0.405940594,0.054455446,0.628712871,2,0.590599801
1917,93,20320,5,5,2,0,0,12,4,5,10,0,0,19,nowin,loss,beat,dlwin,0,10,10,175,0.485714286,0.051428571,0.548571429,1,0.323648091
1918,99,20320,6,10,0,0,0,16,4,5,10,0,0,19,nowin,loss,beat,dlwin,0,10,16,207,0.47826087,0.062801932,0.637681159,3,0.961418446
1919,67,20320,10,3,0,0,0,13,4,5,10,0,0,19,nowin,loss,beat,dlwin,0,10,13,195,0.369230769,0.041025641,0.569230769,0,0.014139427
1920,116,20321,11,2,4,0,0,17,4,10,1,3,0,18,nowin,loss,beat,dlwin,0,10,13,195,0.425641026,0.056410256,0.538461538,1,0.28273747
1921,72,20321,10,8,0,0,0,18,4,10,1,3,0,18,nowin,push,push,push,10,0,18,185,0.394594595,0.032432432,0.508108108,0,0.006763115
1922,11,20321,2,10,0,0,0,12,4,10,1,3,0,18,nowin,loss,beat,dlwin,0,10,12,236,0.457627119,0.016949153,0.588983051,3,0.889015813
1923,122,20321,1,5,10,0,0,16,4,10,1,3,0,18,nowin,loss,beat,dlwin,0,10,6,210,0.347619048,0.052380952,0.59047619,0,0.012873677
1924,59,20321,11,10,0,0,0,21,4,10,1,3,0,18,win,win,plwin,beat,25,0,21,228,0.429824561,0.048245614,0.543859649,1,0.287885446
1925,10,20321,10,5,0,0,0,15,4,10,1,3,0,18,nowin,loss,beat,dlwin,0,10,15,191,0.413612565,0.057591623,0.596858639,2,0.574087175
1926,10,20322,6,6,0,10,0,22,7,3,10,0,0,20,nowin,loss,bust,plbust,0,10,12,191,0.413612565,0.057591623,0.596858639,2,0.574087175
1927,51,20322,8,10,0,0,0,18,7,3,10,0,0,20,nowin,loss,beat,dlwin,0,10,18,189,0.529100529,0.068783069,0.608465608,3,0.993665715
1928,49,20322,3,10,0,4,0,17,7,3,10,0,0,20,nowin,loss,beat,dlwin,0,10,13,207,0.396135266,0.053140097,0.594202899,0,0.028306925
1929,95,20322,4,11,5,0,0,20,7,3,10,0,0,20,nowin,push,push,push,10,0,15,218,0.412844037,0.04587156,0.559633028,0,0.024842385
1930,15,20322,5,1,10,10,0,26,7,3,10,0,0,20,nowin,loss,bust,plbust,0,10,6,212,0.410377358,0.051886792,0.561320755,0,0.024517408
1931,79,20322,9,10,0,0,0,19,7,3,10,0,0,20,nowin,loss,beat,dlwin,0,10,19,211,0.436018957,0.028436019,0.672985782,2,0.650131054
1932,44,20323,11,3,4,0,0,18,11,10,0,0,0,21,nowin,loss,beat,dlwin,0,10,14,219,0.433789954,0.050228311,0.534246575,1,0.285551035
1933,46,20323,1,6,6,9,0,22,11,10,0,0,0,21,nowin,loss,bust,plbust,0,10,7,186,0.403225806,0.048387097,0.591397849,0,0.029742194
1934,73,20323,10,3,0,8,0,21,11,10,0,0,0,21,nowin,push,push,push,10,0,13,181,0.375690608,0.011049724,0.596685083,0,0.022795773
1935,48,20323,10,6,0,1,0,17,11,10,0,0,0,21,nowin,loss,beat,dlwin,0,10,16,203,0.413793103,0.019704433,0.600985222,2,0.577280801
1936,116,20323,7,10,0,0,0,17,11,10,0,0,0,21,nowin,loss,beat,dlwin,0,10,17,195,0.425641026,0.056410256,0.538461538,1,0.28273747
1937,46,20323,8,11,0,0,0,19,11,10,0,0,0,21,nowin,loss,beat,dlwin,0,10,19,186,0.403225806,0.048387097,0.591397849,0,0.029742194
1938,105,20324,8,5,0,0,0,13,2,11,5,0,0,18,nowin,loss,beat,dlwin,0,10,13,198,0.414141414,0.070707071,0.590909091,0,0.032889494
1939,7,20324,10,10,0,0,0,20,2,11,5,0,0,18,nowin,win,plwin,beat,20,0,20,183,0.442622951,0.06010929,0.62295082,2,0.619303341
1940,147,20324,7,6,0,0,0,13,2,11,5,0,0,18,nowin,loss,beat,dlwin,0,10,13,205,0.380487805,0.014634146,0.536585366,0,0.00951447
1941,69,20324,8,4,0,9,0,21,2,11,5,0,0,18,nowin,win,plwin,beat,20,0,12,194,0.365979381,0.030927835,0.515463918,0,0
1942,99,20324,11,10,0,0,0,21,2,11,5,0,0,18,win,win,plwin,beat,25,0,21,207,0.47826087,0.062801932,0.637681159,3,0.961418446
1943,118,20324,6,7,0,0,0,13,2,11,5,0,0,18,nowin,loss,beat,dlwin,0,10,13,216,0.393518519,0.037037037,0.555555556,0,0.018059873
1944,72,20325,10,9,0,0,0,19,7,3,2,2,7,21,nowin,loss,beat,dlwin,0,10,19,185,0.394594595,0.032432432,0.508108108,0,0.006763115
1945,22,20325,10,2,0,4,10,26,7,3,2,2,7,21,nowin,loss,bust,plbust,0,10,12,187,0.481283422,0.042780749,0.577540107,3,0.906128176
1946,96,20325,11,7,0,0,0,18,7,3,2,2,7,21,nowin,loss,beat,dlwin,0,10,18,190,0.468421053,0.057894737,0.584210526,3,0.897263354
1947,81,20325,10,2,0,5,0,17,7,3,2,2,7,21,nowin,loss,beat,dlwin,0,10,12,182,0.395604396,0.043956044,0.60989011,2,0.567491261
1948,25,20325,3,10,0,9,0,22,7,3,2,2,7,21,nowin,loss,bust,plbust,0,10,13,190,0.463157895,0.063157895,0.536842105,1,0.304401563
1949,122,20325,11,10,0,0,0,21,7,3,2,2,7,21,win,push,push,push,10,0,21,210,0.347619048,0.052380952,0.59047619,0,0.012873677
1950,22,20326,10,11,0,0,0,21,10,10,0,0,0,20,win,win,plwin,beat,25,0,21,187,0.481283422,0.042780749,0.577540107,3,0.906128176
1951,136,20326,10,8,0,0,0,18,10,10,0,0,0,20,nowin,loss,beat,dlwin,0,10,18,194,0.396907216,0.025773196,0.597938144,0,0.029452644
1952,131,20326,10,5,0,2,0,17,10,10,0,0,0,20,nowin,loss,beat,dlwin,0,10,15,217,0.410138249,0.069124424,0.543778802,0,0.02015021
1953,132,20326,5,10,0,10,0,25,10,10,0,0,0,20,nowin,loss,bust,plbust,0,10,15,194,0.412371134,0.036082474,0.649484536,2,0.611633238
1954,123,20326,7,10,0,0,0,17,10,10,0,0,0,20,nowin,loss,beat,dlwin,0,10,17,205,0.43902439,0.034146341,0.614634146,2,0.609962544
1955,74,20326,2,9,6,0,0,17,10,10,0,0,0,20,nowin,loss,beat,dlwin,0,10,11,209,0.411483254,0.04784689,0.531100478,0,0.017448125
1956,108,20327,4,5,10,0,0,19,4,10,3,0,0,17,nowin,win,plwin,beat,20,0,9,193,0.435233161,0.056994819,0.559585492,1,0.298824795
1957,25,20327,10,8,0,0,0,18,4,10,3,0,0,17,nowin,win,plwin,beat,20,0,18,190,0.463157895,0.063157895,0.536842105,1,0.304401563
1958,63,20327,10,10,0,0,0,20,4,10,3,0,0,17,nowin,win,plwin,beat,20,0,20,216,0.467592593,0.037037037,0.62037037,3,0.931690496
1959,62,20327,10,3,0,0,0,13,4,10,3,0,0,17,nowin,loss,beat,dlwin,0,10,13,178,0.370786517,0.028089888,0.54494382,0,0.008657722
1960,25,20327,8,11,0,0,0,19,4,10,3,0,0,17,nowin,win,plwin,beat,20,0,19,190,0.463157895,0.063157895,0.536842105,1,0.304401563
1961,66,20327,2,10,0,0,0,12,4,10,3,0,0,17,nowin,loss,beat,dlwin,0,10,12,217,0.456221198,0.064516129,0.626728111,3,0.924304367
1962,78,20328,5,2,10,0,0,17,8,11,0,0,0,19,nowin,loss,beat,dlwin,0,10,7,201,0.517412935,0.034825871,0.587064677,3,0.95871112
1963,120,20328,5,8,0,5,0,18,8,11,0,0,0,19,nowin,loss,beat,dlwin,0,10,13,202,0.440594059,0.034653465,0.618811881,2,0.614441029
1964,146,20328,11,8,0,0,0,19,8,11,0,0,0,19,nowin,push,push,push,10,0,19,221,0.43438914,0.040723982,0.542986425,1,0.290190091
1965,87,20328,3,10,0,10,0,23,8,11,0,0,0,19,nowin,loss,bust,plbust,0,10,13,202,0.405940594,0.054455446,0.628712871,2,0.590599801
1966,70,20328,10,10,0,0,0,20,8,11,0,0,0,19,nowin,win,plwin,beat,20,0,20,228,0.385964912,0.039473684,0.557017544,0,0.016157125
1967,55,20328,3,10,0,10,0,23,8,11,0,0,0,19,nowin,loss,bust,plbust,0,10,13,191,0.371727749,0.057591623,0.54973822,0,0.01011347
1968,31,20329,2,4,10,0,0,16,6,6,10,0,0,22,nowin,win,dlbust,bust,20,0,6,188,0.473404255,0.058510638,0.515957447,1,0.300306557
1969,113,20329,9,10,0,0,0,19,6,6,10,0,0,22,nowin,win,dlbust,bust,20,0,19,199,0.407035176,0.055276382,0.668341709,2,0.620695264
1970,20,20329,7,8,0,0,0,15,6,6,10,0,0,22,nowin,win,dlbust,bust,20,0,15,186,0.456989247,0.037634409,0.537634409,1,0.301097108
1971,144,20329,10,7,0,0,0,17,6,6,10,0,0,22,nowin,win,dlbust,bust,20,0,17,202,0.386138614,0.054455446,0.564356436,0,0.018006244
1972,145,20329,5,2,11,0,0,18,6,6,10,0,0,22,nowin,win,dlbust,bust,20,0,7,188,0.441489362,0.031914894,0.622340426,2,0.617837093
1973,24,20329,9,8,0,0,0,17,6,6,10,0,0,22,nowin,win,dlbust,bust,20,0,17,207,0.458937198,0.048309179,0.570048309,1,0.318138014
1974,78,20330,7,3,7,0,0,17,7,2,4,9,0,22,nowin,win,dlbust,bust,20,0,10,201,0.517412935,0.034825871,0.587064677,3,0.95871112
1975,79,20330,3,10,0,10,0,23,7,2,4,9,0,22,nowin,loss,bust,plbust,0,10,13,211,0.436018957,0.028436019,0.672985782,2,0.650131054
1976,48,20330,1,3,10,2,10,26,7,2,4,9,0,22,nowin,loss,bust,plbust,0,10,4,203,0.413793103,0.019704433,0.600985222,2,0.577280801
1977,87,20330,8,11,0,0,0,19,7,2,4,9,0,22,nowin,win,dlbust,bust,20,0,19,202,0.405940594,0.054455446,0.628712871,2,0.590599801
1978,50,20330,10,5,0,10,0,25,7,2,4,9,0,22,nowin,loss,bust,plbust,0,10,15,202,0.405940594,0.04950495,0.54950495,0,0.020296079
1979,136,20330,3,2,9,7,0,21,7,2,4,9,0,22,nowin,win,dlbust,bust,20,0,5,194,0.396907216,0.025773196,0.597938144,0,0.029452644
1980,96,20331,3,4,10,0,0,17,6,10,1,0,0,17,nowin,push,push,push,10,0,7,190,0.468421053,0.057894737,0.584210526,3,0.897263354
1981,43,20331,3,10,0,0,0,13,6,10,1,0,0,17,nowin,loss,beat,dlwin,0,10,13,192,0.40625,0.041666667,0.609375,2,0.576671372
1982,8,20331,1,3,10,0,0,14,6,10,1,0,0,17,nowin,loss,beat,dlwin,0,10,4,181,0.44198895,0.071823204,0.596685083,2,0.599438402
1983,119,20331,11,5,5,0,0,21,6,10,1,0,0,17,nowin,win,plwin,beat,20,0,16,190,0.405263158,0.068421053,0.515789474,0,0.011837158
1984,10,20331,10,10,0,0,0,20,6,10,1,0,0,17,nowin,win,plwin,beat,20,0,20,191,0.413612565,0.057591623,0.596858639,2,0.574087175
1985,18,20331,3,4,5,0,0,12,6,10,1,0,0,17,nowin,loss,beat,dlwin,0,10,7,182,0.461538462,0.043956044,0.587912088,3,0.892649374
1986,68,20332,3,8,10,0,0,21,10,2,10,0,0,22,nowin,win,dlbust,bust,20,0,11,205,0.434146341,0.029268293,0.6,2,0.59483189
1987,66,20332,7,10,0,0,0,17,10,2,10,0,0,22,nowin,win,dlbust,bust,20,0,17,217,0.456221198,0.064516129,0.626728111,3,0.924304367
1988,94,20332,7,8,0,2,0,17,10,2,10,0,0,22,nowin,win,dlbust,bust,20,0,15,183,0.43715847,0.043715847,0.540983607,1,0.290866892
1989,53,20332,10,10,0,0,0,20,10,2,10,0,0,22,nowin,win,dlbust,bust,20,0,20,250,0.372,0.064,0.564,0,0.013687345
1990,83,20332,10,10,0,0,0,20,10,2,10,0,0,22,nowin,win,dlbust,bust,20,0,20,193,0.424870466,0.051813472,0.678756477,2,0.644360335
1991,40,20332,1,6,9,10,0,26,10,2,10,0,0,22,nowin,loss,bust,plbust,0,10,7,196,0.367346939,0.030612245,0.617346939,0,0.025358183
1992,150,20333,5,1,10,3,0,19,7,5,9,0,0,21,nowin,loss,beat,dlwin,0,10,6,192,0.401041667,0.036458333,0.567708333,0,0.023287458
1993,130,20333,10,2,0,7,0,19,7,5,9,0,0,21,nowin,loss,beat,dlwin,0,10,12,219,0.410958904,0.03652968,0.566210046,0,0.025888739
1994,55,20333,5,4,10,0,0,19,7,5,9,0,0,21,nowin,loss,beat,dlwin,0,10,9,191,0.371727749,0.057591623,0.54973822,0,0.01011347
1995,32,20333,9,6,0,7,0,22,7,5,9,0,0,21,nowin,loss,bust,plbust,0,10,15,189,0.391534392,0.037037037,0.53968254,0,0.013579086
1996,134,20333,4,7,4,9,0,24,7,5,9,0,0,21,nowin,loss,bust,plbust,0,10,11,185,0.443243243,0.021621622,0.545945946,1,0.296939509
1997,74,20333,8,8,0,3,0,19,7,5,9,0,0,21,nowin,loss,beat,dlwin,0,10,16,209,0.411483254,0.04784689,0.531100478,0,0.017448125
1998,150,20334,3,3,6,8,0,20,2,5,10,0,0,17,nowin,win,plwin,beat,20,0,6,192,0.401041667,0.036458333,0.567708333,0,0.023287458
1999,107,20334,10,10,0,0,0,20,2,5,10,0,0,17,nowin,win,plwin,beat,20,0,20,218,0.444954128,0.073394495,0.600917431,2,0.605210014
2000,54,20334,10,8,0,0,0,18,2,5,10,0,0,17,nowin,win,plwin,beat,20,0,18,185,0.437837838,0.032432432,0.556756757,1,0.29899854
2001,124,20334,10,10,0,0,0,20,2,5,10,0,0,17,nowin,win,plwin,beat,20,0,20,202,0.47029703,0.064356436,0.584158416,3,0.899458193
2002,92,20334,10,11,0,0,0,21,2,5,10,0,0,17,win,win,plwin,beat,25,0,21,186,0.446236559,0.059139785,0.564516129,1,0.307826125
2003,145,20334,10,6,0,0,0,16,2,5,10,0,0,17,nowin,loss,beat,dlwin,0,10,16,188,0.441489362,0.031914894,0.622340426,2,0.617837093
2004,66,20335,6,3,6,7,0,22,9,9,0,0,0,18,nowin,loss,bust,plbust,0,10,9,217,0.456221198,0.064516129,0.626728111,3,0.924304367
2005,91,20335,6,11,4,0,0,21,9,9,0,0,0,18,nowin,win,plwin,beat,20,0,17,194,0.417525773,0.046391753,0.515463918,1,0.266616552
2006,122,20335,2,1,10,10,0,23,9,9,0,0,0,18,nowin,loss,bust,plbust,0,10,3,210,0.347619048,0.052380952,0.59047619,0,0.012873677
2007,106,20335,9,10,0,0,0,19,9,9,0,0,0,18,nowin,win,plwin,beat,20,0,19,192,0.411458333,0.026041667,0.557291667,0,0.023854304
2008,122,20335,5,3,11,0,0,19,9,9,0,0,0,18,nowin,win,plwin,beat,20,0,8,210,0.347619048,0.052380952,0.59047619,0,0.012873677
2009,35,20335,4,8,0,1,3,16,9,9,0,0,0,18,nowin,loss,beat,dlwin,0,10,12,202,0.410891089,0.044554455,0.633663366,2,0.598681573
2010,28,20336,11,10,0,0,0,21,11,5,5,0,0,21,win,push,push,push,10,0,21,199,0.422110553,0.045226131,0.542713568,1,0.282706618
2011,107,20336,10,4,0,1,6,21,11,5,5,0,0,21,nowin,push,push,push,10,0,14,218,0.444954128,0.073394495,0.600917431,2,0.605210014
2012,13,20336,4,3,6,9,0,22,11,5,5,0,0,21,nowin,loss,bust,plbust,0,10,7,206,0.417475728,0.063106796,0.621359223,2,0.59555479
2013,28,20336,5,10,0,8,0,23,11,5,5,0,0,21,nowin,loss,bust,plbust,0,10,15,199,0.422110553,0.045226131,0.542713568,1,0.282706618
2014,66,20336,6,9,0,10,0,25,11,5,5,0,0,21,nowin,loss,bust,plbust,0,10,15,217,0.456221198,0.064516129,0.626728111,3,0.924304367
2015,33,20336,11,10,0,0,0,21,11,5,5,0,0,21,win,push,push,push,10,0,21,192,0.4375,0.057291667,0.625,2,0.616208916
2016,99,20337,11,10,0,0,0,21,10,5,10,0,0,25,win,win,dlbust,bust,25,0,21,207,0.47826087,0.062801932,0.637681159,3,0.961418446
2017,69,20337,5,10,0,7,0,22,10,5,10,0,0,25,nowin,loss,bust,plbust,0,10,15,194,0.365979381,0.030927835,0.515463918,0,0
2018,55,20337,6,5,10,0,0,21,10,5,10,0,0,25,nowin,win,dlbust,bust,20,0,11,191,0.371727749,0.057591623,0.54973822,0,0.01011347
2019,75,20337,3,10,0,5,0,18,10,5,10,0,0,25,nowin,win,dlbust,bust,20,0,13,191,0.418848168,0.052356021,0.570680628,0,0.029344702
2020,91,20337,8,8,0,3,0,19,10,5,10,0,0,25,nowin,win,dlbust,bust,20,0,16,194,0.417525773,0.046391753,0.515463918,1,0.266616552
2021,10,20337,4,4,10,0,0,18,10,5,10,0,0,25,nowin,win,dlbust,bust,20,0,8,191,0.413612565,0.057591623,0.596858639,2,0.574087175
2022,37,20338,2,9,9,0,0,20,3,1,10,5,0,19,nowin,win,plwin,beat,20,0,11,208,0.394230769,0.038461538,0.581730769,0,0.024682772
2023,123,20338,3,9,0,9,0,21,3,1,10,5,0,19,nowin,win,plwin,beat,20,0,12,205,0.43902439,0.034146341,0.614634146,2,0.609962544
2024,35,20338,4,10,0,0,0,14,3,1,10,5,0,19,nowin,loss,beat,dlwin,0,10,14,202,0.410891089,0.044554455,0.633663366,2,0.598681573
2025,13,20338,8,11,0,0,0,19,3,1,10,5,0,19,nowin,push,push,push,10,0,19,206,0.417475728,0.063106796,0.621359223,2,0.59555479
2026,48,20338,3,10,0,0,0,13,3,1,10,5,0,19,nowin,loss,beat,dlwin,0,10,13,203,0.413793103,0.019704433,0.600985222,2,0.577280801
2027,131,20338,6,9,0,0,0,15,3,1,10,5,0,19,nowin,loss,beat,dlwin,0,10,15,217,0.410138249,0.069124424,0.543778802,0,0.02015021
2028,63,20339,8,10,0,0,0,18,6,10,10,0,0,26,nowin,win,dlbust,bust,20,0,18,216,0.467592593,0.037037037,0.62037037,3,0.931690496
2029,112,20339,10,9,0,0,0,19,6,10,10,0,0,26,nowin,win,dlbust,bust,20,0,19,203,0.448275862,0.054187192,0.600985222,3,0.889576933
2030,76,20339,5,3,4,0,0,12,6,10,10,0,0,26,nowin,win,dlbust,bust,20,0,8,189,0.534391534,0.079365079,0.608465608,3,1
2031,120,20339,10,10,0,0,0,20,6,10,10,0,0,26,nowin,win,dlbust,bust,20,0,20,202,0.440594059,0.034653465,0.618811881,2,0.614441029
2032,64,20339,2,10,0,0,0,12,6,10,10,0,0,26,nowin,win,dlbust,bust,20,0,12,187,0.363636364,0.048128342,0.631016043,0,0.027594885
2033,136,20339,10,10,0,0,0,20,6,10,10,0,0,26,nowin,win,dlbust,bust,20,0,20,194,0.396907216,0.025773196,0.597938144,0,0.029452644
2034,131,20340,9,5,0,0,0,14,3,9,10,0,0,22,nowin,win,dlbust,bust,20,0,14,217,0.410138249,0.069124424,0.543778802,0,0.02015021
2035,122,20340,10,5,0,0,0,15,3,9,10,0,0,22,nowin,win,dlbust,bust,20,0,15,210,0.347619048,0.052380952,0.59047619,0,0.012873677
2036,52,20340,9,6,0,0,0,15,3,9,10,0,0,22,nowin,win,dlbust,bust,20,0,15,217,0.414746544,0.02764977,0.599078341,2,0.576736024
2037,149,20340,2,5,11,0,0,18,3,9,10,0,0,22,nowin,win,dlbust,bust,20,0,7,225,0.457777778,0.057777778,0.648888889,2,0.651965595
2038,117,20340,4,3,7,0,0,14,3,9,10,0,0,22,nowin,win,dlbust,bust,20,0,7,173,0.410404624,0.069364162,0.606936416,2,0.578610282
2039,59,20340,4,3,8,0,0,15,3,9,10,0,0,22,nowin,win,dlbust,bust,20,0,7,228,0.429824561,0.048245614,0.543859649,1,0.287885446
2040,19,20341,6,10,0,0,0,16,4,3,10,0,0,17,nowin,loss,beat,dlwin,0,10,16,237,0.41350211,0.054852321,0.628691983,2,0.597373826
2041,98,20341,10,10,0,0,0,20,4,3,10,0,0,17,nowin,win,plwin,beat,20,0,20,220,0.422727273,0.054545455,0.55,1,0.28664435
2042,35,20341,3,9,0,0,0,12,4,3,10,0,0,17,nowin,loss,beat,dlwin,0,10,12,202,0.410891089,0.044554455,0.633663366,2,0.598681573
2043,5,20341,10,4,0,0,0,14,4,3,10,0,0,17,nowin,loss,beat,dlwin,0,10,14,203,0.42364532,0.02955665,0.596059113,2,0.582508076
2044,55,20341,7,9,0,0,0,16,4,3,10,0,0,17,nowin,loss,beat,dlwin,0,10,16,191,0.371727749,0.057591623,0.54973822,0,0.01011347
2045,4,20341,4,3,8,0,0,15,4,3,10,0,0,17,nowin,loss,beat,dlwin,0,10,7,217,0.460829493,0.036866359,0.562211982,1,0.315432839
2046,130,20342,3,10,0,2,3,18,10,5,7,0,0,22,nowin,win,dlbust,bust,20,0,13,219,0.410958904,0.03652968,0.566210046,0,0.025888739
2047,57,20342,7,9,0,2,0,18,10,5,7,0,0,22,nowin,win,dlbust,bust,20,0,16,192,0.46875,0.052083333,0.59375,3,0.907001181
2048,129,20342,2,10,0,3,7,22,10,5,7,0,0,22,nowin,loss,bust,plbust,0,10,12,201,0.422885572,0.064676617,0.55721393,0,0.027255383
2049,39,20342,9,2,10,0,0,21,10,5,7,0,0,22,nowin,win,dlbust,bust,20,0,11,191,0.429319372,0.062827225,0.57591623,0,0.033760763
2050,45,20342,4,10,0,10,0,24,10,5,7,0,0,22,nowin,loss,bust,plbust,0,10,14,196,0.428571429,0.051020408,0.612244898,2,0.598821767
2051,150,20342,2,11,1,2,5,21,10,5,7,0,0,22,nowin,win,dlbust,bust,20,0,13,192,0.401041667,0.036458333,0.567708333,0,0.023287458
2052,49,20343,8,5,0,6,0,19,7,2,10,0,0,19,nowin,push,push,push,10,0,13,207,0.396135266,0.053140097,0.594202899,0,0.028306925
2053,68,20343,9,11,0,0,0,20,7,2,10,0,0,19,nowin,win,plwin,beat,20,0,20,205,0.434146341,0.029268293,0.6,2,0.59483189
2054,28,20343,10,3,0,6,0,19,7,2,10,0,0,19,nowin,push,push,push,10,0,13,199,0.422110553,0.045226131,0.542713568,1,0.282706618
2055,117,20343,4,10,0,10,0,24,7,2,10,0,0,19,nowin,loss,bust,plbust,0,10,14,173,0.410404624,0.069364162,0.606936416,2,0.578610282
2056,118,20343,4,1,10,10,0,25,7,2,10,0,0,19,nowin,loss,bust,plbust,0,10,5,216,0.393518519,0.037037037,0.555555556,0,0.018059873
2057,124,20343,10,10,0,0,0,20,7,2,10,0,0,19,nowin,win,plwin,beat,20,0,20,202,0.47029703,0.064356436,0.584158416,3,0.899458193
2058,145,20344,10,9,0,0,0,19,10,11,0,0,0,21,nowin,loss,beat,dlwin,0,10,19,188,0.441489362,0.031914894,0.622340426,2,0.617837093
2059,14,20344,3,10,0,7,0,20,10,11,0,0,0,21,nowin,loss,beat,dlwin,0,10,13,202,0.391089109,0.01980198,0.628712871,2,0.577264877
2060,139,20344,10,6,0,5,0,21,10,11,0,0,0,21,nowin,push,push,push,10,0,16,192,0.380208333,0.036458333,0.59375,0,0.023429169
2061,57,20344,7,4,4,4,0,19,10,11,0,0,0,21,nowin,loss,beat,dlwin,0,10,11,192,0.46875,0.052083333,0.59375,3,0.907001181
2062,97,20344,10,9,0,0,0,19,10,11,0,0,0,21,nowin,loss,beat,dlwin,0,10,19,182,0.450549451,0.06043956,0.692307692,2,0.677372279
2063,88,20344,6,9,0,10,0,25,10,11,0,0,0,21,nowin,loss,bust,plbust,0,10,15,206,0.466019417,0.033980583,0.54368932,1,0.309467903
2064,36,20345,2,8,6,3,0,19,10,6,4,0,0,20,nowin,loss,beat,dlwin,0,10,10,229,0.445414847,0.056768559,0.655021834,2,0.645370571
2065,106,20345,8,2,6,10,0,26,10,6,4,0,0,20,nowin,loss,bust,plbust,0,10,10,192,0.411458333,0.026041667,0.557291667,0,0.023854304
2066,4,20345,8,10,0,0,0,18,10,6,4,0,0,20,nowin,loss,beat,dlwin,0,10,18,217,0.460829493,0.036866359,0.562211982,1,0.315432839
2067,60,20345,4,7,7,0,0,18,10,6,4,0,0,20,nowin,loss,beat,dlwin,0,10,11,227,0.418502203,0.022026432,0.559471366,0,0.026496258
2068,125,20345,11,10,0,0,0,21,10,6,4,0,0,20,win,win,plwin,beat,25,0,21,219,0.438356164,0.050228311,0.575342466,1,0.308411257
2069,123,20345,6,9,0,9,0,24,10,6,4,0,0,20,nowin,loss,bust,plbust,0,10,15,205,0.43902439,0.034146341,0.614634146,2,0.609962544
2070,51,20346,4,2,10,3,0,19,8,10,0,0,0,18,nowin,win,plwin,beat,20,0,6,189,0.529100529,0.068783069,0.608465608,3,0.993665715
2071,106,20346,10,9,0,0,0,19,8,10,0,0,0,18,nowin,win,plwin,beat,20,0,19,192,0.411458333,0.026041667,0.557291667,0,0.023854304
2072,57,20346,4,7,4,10,0,25,8,10,0,0,0,18,nowin,loss,bust,plbust,0,10,11,192,0.46875,0.052083333,0.59375,3,0.907001181
2073,89,20346,9,4,0,10,0,23,8,10,0,0,0,18,nowin,loss,bust,plbust,0,10,13,212,0.537735849,0.047169811,0.594339623,3,0.990167191
2074,71,20346,10,3,0,1,7,21,8,10,0,0,0,18,nowin,win,plwin,beat,20,0,13,193,0.352331606,0.046632124,0.585492228,0,0.013063661
2075,62,20346,10,5,0,10,0,25,8,10,0,0,0,18,nowin,loss,bust,plbust,0,10,15,178,0.370786517,0.028089888,0.54494382,0,0.008657722
2076,36,20347,11,10,0,0,0,21,10,6,10,0,0,26,win,win,dlbust,bust,25,0,21,229,0.445414847,0.056768559,0.655021834,2,0.645370571
2077,87,20347,4,6,10,0,0,20,10,6,10,0,0,26,nowin,win,dlbust,bust,20,0,10,202,0.405940594,0.054455446,0.628712871,2,0.590599801
2078,88,20347,4,2,5,2,7,20,10,6,10,0,0,26,nowin,win,dlbust,bust,20,0,6,206,0.466019417,0.033980583,0.54368932,1,0.309467903
2079,39,20347,10,3,0,6,0,19,10,6,10,0,0,26,nowin,win,dlbust,bust,20,0,13,191,0.429319372,0.062827225,0.57591623,0,0.033760763
2080,50,20347,8,2,4,2,3,19,10,6,10,0,0,26,nowin,win,dlbust,bust,20,0,10,202,0.405940594,0.04950495,0.54950495,0,0.020296079
2081,2,20347,11,5,4,0,0,20,10,6,10,0,0,26,nowin,win,dlbust,bust,20,0,16,200,0.445,0.035,0.64,2,0.633962549
2082,31,20348,10,10,0,0,0,20,3,10,10,0,0,23,nowin,win,dlbust,bust,20,0,20,188,0.473404255,0.058510638,0.515957447,1,0.300306557
2083,15,20348,2,9,4,0,0,15,3,10,10,0,0,23,nowin,win,dlbust,bust,20,0,11,212,0.410377358,0.051886792,0.561320755,0,0.024517408
2084,123,20348,10,8,0,0,0,18,3,10,10,0,0,23,nowin,win,dlbust,bust,20,0,18,205,0.43902439,0.034146341,0.614634146,2,0.609962544
2085,120,20348,10,6,0,0,0,16,3,10,10,0,0,23,nowin,win,dlbust,bust,20,0,16,202,0.440594059,0.034653465,0.618811881,2,0.614441029
2086,95,20348,7,10,0,0,0,17,3,10,10,0,0,23,nowin,win,dlbust,bust,20,0,17,218,0.412844037,0.04587156,0.559633028,0,0.024842385
2087,42,20348,11,7,0,0,0,18,3,10,10,0,0,23,nowin,win,dlbust,bust,20,0,18,212,0.443396226,0.051886792,0.570754717,1,0.309181312
2088,143,20349,2,6,10,0,0,18,10,9,0,0,0,19,nowin,loss,beat,dlwin,0,10,8,203,0.463054187,0.044334975,0.57635468,3,0.883143365
2089,45,20349,5,4,2,10,0,21,10,9,0,0,0,19,nowin,win,plwin,beat,20,0,9,196,0.428571429,0.051020408,0.612244898,2,0.598821767
2090,138,20349,6,3,10,0,0,19,10,9,0,0,0,19,nowin,push,push,push,10,0,9,190,0.442105263,0.047368421,0.610526316,2,0.609711065
2091,21,20349,10,10,0,0,0,20,10,9,0,0,0,19,nowin,win,plwin,beat,20,0,20,214,0.359813084,0.042056075,0.626168224,0,0.025263474
2092,80,20349,10,3,0,10,0,23,10,9,0,0,0,19,nowin,loss,bust,plbust,0,10,13,186,0.419354839,0.059139785,0.623655914,2,0.59892924
2093,45,20349,10,4,0,2,10,26,10,9,0,0,0,19,nowin,loss,bust,plbust,0,10,14,196,0.428571429,0.051020408,0.612244898,2,0.598821767
2094,89,20350,2,5,8,4,0,19,11,6,0,0,0,17,nowin,win,plwin,beat,20,0,7,212,0.537735849,0.047169811,0.594339623,3,0.990167191
2095,20,20350,7,6,0,3,5,21,11,6,0,0,0,17,nowin,win,plwin,beat,20,0,13,186,0.456989247,0.037634409,0.537634409,1,0.301097108
2096,49,20350,7,2,10,0,0,19,11,6,0,0,0,17,nowin,win,plwin,beat,20,0,9,207,0.396135266,0.053140097,0.594202899,0,0.028306925
2097,113,20350,3,10,0,10,0,23,11,6,0,0,0,17,nowin,loss,bust,plbust,0,10,13,199,0.407035176,0.055276382,0.668341709,2,0.620695264
2098,14,20350,5,2,5,6,0,18,11,6,0,0,0,17,nowin,win,plwin,beat,20,0,7,202,0.391089109,0.01980198,0.628712871,2,0.577264877
2099,65,20350,10,10,0,0,0,20,11,6,0,0,0,17,nowin,win,plwin,beat,20,0,20,203,0.492610837,0.054187192,0.571428571,3,0.913702814
2100,4,20351,2,5,10,0,0,17,10,10,0,0,0,20,nowin,loss,beat,dlwin,0,10,7,217,0.460829493,0.036866359,0.562211982,1,0.315432839
2101,33,20351,9,6,0,1,9,25,10,10,0,0,0,20,nowin,loss,bust,plbust,0,10,15,192,0.4375,0.057291667,0.625,2,0.616208916
2102,72,20351,6,4,11,0,0,21,10,10,0,0,0,20,nowin,win,plwin,beat,20,0,10,185,0.394594595,0.032432432,0.508108108,0,0.006763115
2103,50,20351,10,10,0,0,0,20,10,10,0,0,0,20,nowin,push,push,push,10,0,20,202,0.405940594,0.04950495,0.54950495,0,0.020296079
2104,46,20351,8,3,6,0,0,17,10,10,0,0,0,20,nowin,loss,beat,dlwin,0,10,11,186,0.403225806,0.048387097,0.591397849,0,0.029742194
2105,124,20351,4,10,0,7,0,21,10,10,0,0,0,20,nowin,win,plwin,beat,20,0,14,202,0.47029703,0.064356436,0.584158416,3,0.899458193
2106,43,20352,10,8,0,0,0,18,10,10,0,0,0,20,nowin,loss,beat,dlwin,0,10,18,192,0.40625,0.041666667,0.609375,2,0.576671372
2107,140,20352,8,4,0,6,0,18,10,10,0,0,0,20,nowin,loss,beat,dlwin,0,10,12,210,0.466666667,0.023809524,0.604761905,3,0.915293335
2108,121,20352,10,8,0,0,0,18,10,10,0,0,0,20,nowin,loss,beat,dlwin,0,10,18,195,0.456410256,0.025641026,0.512820513,1,0.288597791
2109,146,20352,5,3,11,0,0,19,10,10,0,0,0,20,nowin,loss,beat,dlwin,0,10,8,221,0.43438914,0.040723982,0.542986425,1,0.290190091
2110,5,20352,5,8,0,10,0,23,10,10,0,0,0,20,nowin,loss,bust,plbust,0,10,13,203,0.42364532,0.02955665,0.596059113,2,0.582508076
2111,64,20352,7,10,0,0,0,17,10,10,0,0,0,20,nowin,loss,beat,dlwin,0,10,17,187,0.363636364,0.048128342,0.631016043,0,0.027594885
2112,37,20353,11,10,0,0,0,21,7,5,2,5,0,19,win,win,plwin,beat,25,0,21,208,0.394230769,0.038461538,0.581730769,0,0.024682772
2113,30,20353,5,1,8,10,0,24,7,5,2,5,0,19,nowin,loss,bust,plbust,0,10,6,206,0.393203883,0.033980583,0.601941748,0,0.029324648
2114,77,20353,7,3,7,0,0,17,7,5,2,5,0,19,nowin,loss,beat,dlwin,0,10,10,200,0.455,0.04,0.62,3,0.916252116
2115,7,20353,5,2,10,0,0,17,7,5,2,5,0,19,nowin,loss,beat,dlwin,0,10,7,183,0.442622951,0.06010929,0.62295082,2,0.619303341
2116,97,20353,10,6,0,6,0,22,7,5,2,5,0,19,nowin,loss,bust,plbust,0,10,16,182,0.450549451,0.06043956,0.692307692,2,0.677372279
2117,20,20353,6,4,6,10,0,26,7,5,2,5,0,19,nowin,loss,bust,plbust,0,10,10,186,0.456989247,0.037634409,0.537634409,1,0.301097108
2118,3,20354,10,10,0,0,0,20,10,10,0,0,0,20,nowin,push,push,push,10,0,20,190,0.431578947,0.026315789,0.542105263,1,0.288076384
2119,76,20354,9,2,9,0,0,20,10,10,0,0,0,20,nowin,push,push,push,10,0,11,189,0.534391534,0.079365079,0.608465608,3,1
2120,18,20354,7,2,3,6,0,18,10,10,0,0,0,20,nowin,loss,beat,dlwin,0,10,9,182,0.461538462,0.043956044,0.587912088,3,0.892649374
2121,108,20354,4,10,0,4,0,18,10,10,0,0,0,20,nowin,loss,beat,dlwin,0,10,14,193,0.435233161,0.056994819,0.559585492,1,0.298824795
2122,78,20354,10,8,0,0,0,18,10,10,0,0,0,20,nowin,loss,beat,dlwin,0,10,18,201,0.517412935,0.034825871,0.587064677,3,0.95871112
2123,141,20354,7,10,0,0,0,17,10,10,0,0,0,20,nowin,loss,beat,dlwin,0,10,17,202,0.420792079,0.074257426,0.564356436,0,0.028377851
2124,114,20355,9,10,0,0,0,19,6,6,6,0,0,18,nowin,win,plwin,beat,20,0,19,198,0.47979798,0.025252525,0.611111111,3,0.937232995
2125,33,20355,5,3,2,8,0,18,6,6,6,0,0,18,nowin,push,push,push,10,0,8,192,0.4375,0.057291667,0.625,2,0.616208916
2126,74,20355,10,3,0,0,0,13,6,6,6,0,0,18,nowin,loss,beat,dlwin,0,10,13,209,0.411483254,0.04784689,0.531100478,0,0.017448125
2127,80,20355,10,11,0,0,0,21,6,6,6,0,0,18,win,win,plwin,beat,25,0,21,186,0.419354839,0.059139785,0.623655914,2,0.59892924
2128,61,20355,7,7,0,0,0,14,6,6,6,0,0,18,nowin,loss,beat,dlwin,0,10,14,194,0.427835052,0.077319588,0.603092784,2,0.591437139
2129,16,20355,10,3,0,0,0,13,6,6,6,0,0,18,nowin,loss,beat,dlwin,0,10,13,220,0.427272727,0.081818182,0.6,2,0.588660176
2130,78,20356,5,10,0,0,0,15,2,10,1,7,0,20,nowin,loss,beat,dlwin,0,10,15,201,0.517412935,0.034825871,0.587064677,3,0.95871112
2131,16,20356,11,1,4,0,0,16,2,10,1,7,0,20,nowin,loss,beat,dlwin,0,10,12,220,0.427272727,0.081818182,0.6,2,0.588660176
2132,33,20356,10,5,0,0,0,15,2,10,1,7,0,20,nowin,loss,beat,dlwin,0,10,15,192,0.4375,0.057291667,0.625,2,0.616208916
2133,12,20356,2,6,2,10,0,20,2,10,1,7,0,20,nowin,push,push,push,10,0,8,189,0.470899471,0.015873016,0.613756614,3,0.929171178
2134,70,20356,2,5,10,0,0,17,2,10,1,7,0,20,nowin,loss,beat,dlwin,0,10,7,228,0.385964912,0.039473684,0.557017544,0,0.016157125
2135,16,20356,4,10,0,0,0,14,2,10,1,7,0,20,nowin,loss,beat,dlwin,0,10,14,220,0.427272727,0.081818182,0.6,2,0.588660176
2136,102,20357,10,9,0,0,0,19,3,2,8,3,5,21,nowin,loss,beat,dlwin,0,10,19,192,0.338541667,0.046875,0.5625,0,0.003306118
2137,112,20357,5,10,0,0,0,15,3,2,8,3,5,21,nowin,loss,beat,dlwin,0,10,15,203,0.448275862,0.054187192,0.600985222,3,0.889576933
2138,84,20357,10,6,0,0,0,16,3,2,8,3,5,21,nowin,loss,beat,dlwin,0,10,16,195,0.379487179,0.056410256,0.569230769,0,0.017209119
2139,81,20357,1,3,8,10,0,22,3,2,8,3,5,21,nowin,loss,bust,plbust,0,10,4,182,0.395604396,0.043956044,0.60989011,2,0.567491261
2140,43,20357,5,6,6,0,0,17,3,2,8,3,5,21,nowin,loss,beat,dlwin,0,10,11,192,0.40625,0.041666667,0.609375,2,0.576671372
2141,111,20357,5,8,0,0,0,13,3,2,8,3,5,21,nowin,loss,beat,dlwin,0,10,13,180,0.433333333,0.055555556,0.611111111,2,0.602264492
2142,64,20358,8,11,0,0,0,19,6,10,9,0,0,25,nowin,win,dlbust,bust,20,0,19,187,0.363636364,0.048128342,0.631016043,0,0.027594885
2143,113,20358,2,8,10,0,0,20,6,10,9,0,0,25,nowin,win,dlbust,bust,20,0,10,199,0.407035176,0.055276382,0.668341709,2,0.620695264
2144,64,20358,10,10,0,0,0,20,6,10,9,0,0,25,nowin,win,dlbust,bust,20,0,20,187,0.363636364,0.048128342,0.631016043,0,0.027594885
2145,29,20358,5,2,6,0,0,13,6,10,9,0,0,25,nowin,win,dlbust,bust,20,0,7,189,0.44973545,0.058201058,0.544973545,1,0.300349439
2146,44,20358,6,10,0,0,0,16,6,10,9,0,0,25,nowin,win,dlbust,bust,20,0,16,219,0.433789954,0.050228311,0.534246575,1,0.285551035
2147,15,20358,4,9,0,0,0,13,6,10,9,0,0,25,nowin,win,dlbust,bust,20,0,13,212,0.410377358,0.051886792,0.561320755,0,0.024517408
2148,34,20359,9,10,0,0,0,19,1,5,9,8,0,23,nowin,win,dlbust,bust,20,0,19,202,0.5,0.079207921,0.618811881,3,0.968961434
2149,109,20359,11,10,0,0,0,21,1,5,9,8,0,23,win,win,dlbust,bust,25,0,21,221,0.461538462,0.058823529,0.597285068,3,0.901830309
2150,110,20359,9,10,0,0,0,19,1,5,9,8,0,23,nowin,win,dlbust,bust,20,0,19,192,0.416666667,0.046875,0.557291667,0,0.025413132
2151,91,20359,5,2,11,0,0,18,1,5,9,8,0,23,nowin,win,dlbust,bust,20,0,7,194,0.417525773,0.046391753,0.515463918,1,0.266616552
2152,78,20359,5,2,2,9,0,18,1,5,9,8,0,23,nowin,win,dlbust,bust,20,0,7,201,0.517412935,0.034825871,0.587064677,3,0.95871112
2153,67,20359,6,8,0,6,0,20,1,5,9,8,0,23,nowin,win,dlbust,bust,20,0,14,195,0.369230769,0.041025641,0.569230769,0,0.014139427
2154,54,20360,10,2,0,8,0,20,2,4,8,1,9,24,nowin,win,dlbust,bust,20,0,12,185,0.437837838,0.032432432,0.556756757,1,0.29899854
2155,130,20360,3,4,10,0,0,17,2,4,8,1,9,24,nowin,win,dlbust,bust,20,0,7,219,0.410958904,0.03652968,0.566210046,0,0.025888739
2156,9,20360,11,3,2,0,0,16,2,4,8,1,9,24,nowin,win,dlbust,bust,20,0,14,194,0.37628866,0.015463918,0.541237113,0,0.009396796
2157,143,20360,10,10,0,0,0,20,2,4,8,1,9,24,nowin,win,dlbust,bust,20,0,20,203,0.463054187,0.044334975,0.57635468,3,0.883143365
2158,140,20360,2,4,4,4,0,14,2,4,8,1,9,24,nowin,win,dlbust,bust,20,0,6,210,0.466666667,0.023809524,0.604761905,3,0.915293335
2159,149,20360,10,10,0,0,0,20,2,4,8,1,9,24,nowin,win,dlbust,bust,20,0,20,225,0.457777778,0.057777778,0.648888889,2,0.651965595
2160,100,20361,8,5,0,0,0,13,6,11,0,0,0,17,nowin,loss,beat,dlwin,0,10,13,190,0.452631579,0.036842105,0.594736842,3,0.888671154
2161,82,20361,11,9,0,0,0,20,6,11,0,0,0,17,nowin,win,plwin,beat,20,0,20,225,0.408888889,0.075555556,0.577777778,0,0.028101874
2162,50,20361,10,10,0,0,0,20,6,11,0,0,0,17,nowin,win,plwin,beat,20,0,20,202,0.405940594,0.04950495,0.54950495,0,0.020296079
2163,29,20361,10,10,0,0,0,20,6,11,0,0,0,17,nowin,win,plwin,beat,20,0,20,189,0.44973545,0.058201058,0.544973545,1,0.300349439
2164,15,20361,4,2,9,0,0,15,6,11,0,0,0,17,nowin,loss,beat,dlwin,0,10,6,212,0.410377358,0.051886792,0.561320755,0,0.024517408
2165,14,20361,10,9,0,0,0,19,6,11,0,0,0,17,nowin,win,plwin,beat,20,0,19,202,0.391089109,0.01980198,0.628712871,2,0.577264877
2166,16,20362,4,10,0,7,0,21,8,2,6,10,0,26,nowin,win,dlbust,bust,20,0,14,220,0.427272727,0.081818182,0.6,2,0.588660176
2167,77,20362,10,6,0,9,0,25,8,2,6,10,0,26,nowin,loss,bust,plbust,0,10,16,200,0.455,0.04,0.62,3,0.916252116
2168,112,20362,2,7,7,1,0,17,8,2,6,10,0,26,nowin,win,dlbust,bust,20,0,9,203,0.448275862,0.054187192,0.600985222,3,0.889576933
2169,67,20362,6,7,0,4,0,17,8,2,6,10,0,26,nowin,win,dlbust,bust,20,0,13,195,0.369230769,0.041025641,0.569230769,0,0.014139427
2170,50,20362,4,10,0,7,0,21,8,2,6,10,0,26,nowin,win,dlbust,bust,20,0,14,202,0.405940594,0.04950495,0.54950495,0,0.020296079
2171,58,20362,11,8,0,0,0,19,8,2,6,10,0,26,nowin,win,dlbust,bust,20,0,19,195,0.430769231,0.041025641,0.584615385,2,0.580497586
2172,101,20363,10,10,0,0,0,20,9,10,0,0,0,19,nowin,win,plwin,beat,20,0,20,205,0.424390244,0.068292683,0.63902439,2,0.614740646
2173,109,20363,6,10,0,3,0,19,9,10,0,0,0,19,nowin,push,push,push,10,0,16,221,0.461538462,0.058823529,0.597285068,3,0.901830309
2174,110,20363,9,8,0,0,0,17,9,10,0,0,0,19,nowin,loss,beat,dlwin,0,10,17,192,0.416666667,0.046875,0.557291667,0,0.025413132
2175,141,20363,3,4,10,0,0,17,9,10,0,0,0,19,nowin,loss,beat,dlwin,0,10,7,202,0.420792079,0.074257426,0.564356436,0,0.028377851
2176,59,20363,9,10,0,0,0,19,9,10,0,0,0,19,nowin,push,push,push,10,0,19,228,0.429824561,0.048245614,0.543859649,1,0.287885446
2177,125,20363,2,10,0,10,0,22,9,10,0,0,0,19,nowin,loss,bust,plbust,0,10,12,219,0.438356164,0.050228311,0.575342466,1,0.308411257
2178,37,20364,10,3,0,8,0,21,10,6,10,0,0,26,nowin,win,dlbust,bust,20,0,13,208,0.394230769,0.038461538,0.581730769,0,0.024682772
2179,98,20364,10,10,0,0,0,20,10,6,10,0,0,26,nowin,win,dlbust,bust,20,0,20,220,0.422727273,0.054545455,0.55,1,0.28664435
2180,44,20364,5,10,0,8,0,23,10,6,10,0,0,26,nowin,loss,bust,plbust,0,10,15,219,0.433789954,0.050228311,0.534246575,1,0.285551035
2181,113,20364,2,3,5,10,0,20,10,6,10,0,0,26,nowin,win,dlbust,bust,20,0,5,199,0.407035176,0.055276382,0.668341709,2,0.620695264
2182,47,20364,3,3,3,8,0,17,10,6,10,0,0,26,nowin,win,dlbust,bust,20,0,6,210,0.438095238,0.057142857,0.623809524,2,0.615868808
2183,75,20364,6,10,0,5,0,21,10,6,10,0,0,26,nowin,win,dlbust,bust,20,0,16,191,0.418848168,0.052356021,0.570680628,0,0.029344702
2184,86,20365,8,5,0,6,0,19,10,11,0,0,0,21,nowin,loss,beat,dlwin,0,10,13,196,0.454081633,0.040816327,0.591836735,3,0.887566443
2185,133,20365,9,10,0,0,0,19,10,11,0,0,0,21,nowin,loss,beat,dlwin,0,10,19,201,0.47761194,0.064676617,0.611940299,3,0.935428111
2186,59,20365,8,5,0,5,0,18,10,11,0,0,0,21,nowin,loss,beat,dlwin,0,10,13,228,0.429824561,0.048245614,0.543859649,1,0.287885446
2187,32,20365,4,4,2,1,9,20,10,11,0,0,0,21,nowin,loss,beat,dlwin,0,10,8,189,0.391534392,0.037037037,0.53968254,0,0.013579086
2188,26,20365,5,8,0,1,4,18,10,11,0,0,0,21,nowin,loss,beat,dlwin,0,10,13,203,0.463054187,0.0591133,0.541871921,1,0.306802864
2189,117,20365,4,2,10,4,0,20,10,11,0,0,0,21,nowin,loss,beat,dlwin,0,10,6,173,0.410404624,0.069364162,0.606936416,2,0.578610282
2190,70,20366,3,8,7,0,0,18,6,10,3,0,0,19,nowin,loss,beat,dlwin,0,10,11,228,0.385964912,0.039473684,0.557017544,0,0.016157125
2191,121,20366,2,5,9,0,0,16,6,10,3,0,0,19,nowin,loss,beat,dlwin,0,10,7,195,0.456410256,0.025641026,0.512820513,1,0.288597791
2192,81,20366,4,10,0,0,0,14,6,10,3,0,0,19,nowin,loss,beat,dlwin,0,10,14,182,0.395604396,0.043956044,0.60989011,2,0.567491261
2193,148,20366,10,8,0,0,0,18,6,10,3,0,0,19,nowin,loss,beat,dlwin,0,10,18,204,0.401960784,0.078431373,0.593137255,0,0.029789521
2194,18,20366,6,2,3,5,0,16,6,10,3,0,0,19,nowin,loss,beat,dlwin,0,10,8,182,0.461538462,0.043956044,0.587912088,3,0.892649374
2195,25,20366,9,10,0,0,0,19,6,10,3,0,0,19,nowin,push,push,push,10,0,19,190,0.463157895,0.063157895,0.536842105,1,0.304401563
2196,97,20367,8,4,0,4,10,26,8,4,3,8,0,23,nowin,loss,bust,plbust,0,10,12,182,0.450549451,0.06043956,0.692307692,2,0.677372279
2197,61,20367,11,2,4,0,0,17,8,4,3,8,0,23,nowin,win,dlbust,bust,20,0,13,194,0.427835052,0.077319588,0.603092784,2,0.591437139
2198,18,20367,7,4,3,10,0,24,8,4,3,8,0,23,nowin,loss,bust,plbust,0,10,11,182,0.461538462,0.043956044,0.587912088,3,0.892649374
2199,38,20367,5,6,5,8,0,24,8,4,3,8,0,23,nowin,loss,bust,plbust,0,10,11,202,0.361386139,0.03960396,0.564356436,0,0.010597953
2200,38,20367,9,3,0,10,0,22,8,4,3,8,0,23,nowin,loss,bust,plbust,0,10,12,202,0.361386139,0.03960396,0.564356436,0,0.010597953
2201,38,20367,5,9,0,10,0,24,8,4,3,8,0,23,nowin,loss,bust,plbust,0,10,14,202,0.361386139,0.03960396,0.564356436,0,0.010597953
2202,9,20368,6,6,0,0,0,12,4,4,10,0,0,18,nowin,loss,beat,dlwin,0,10,12,194,0.37628866,0.015463918,0.541237113,0,0.009396796
2203,150,20368,9,5,0,0,0,14,4,4,10,0,0,18,nowin,loss,beat,dlwin,0,10,14,192,0.401041667,0.036458333,0.567708333,0,0.023287458
2204,19,20368,5,6,2,0,0,13,4,4,10,0,0,18,nowin,loss,beat,dlwin,0,10,11,237,0.41350211,0.054852321,0.628691983,2,0.597373826
2205,148,20368,10,6,0,0,0,16,4,4,10,0,0,18,nowin,loss,beat,dlwin,0,10,16,204,0.401960784,0.078431373,0.593137255,0,0.029789521
2206,119,20368,11,7,0,0,0,18,4,4,10,0,0,18,nowin,push,push,push,10,0,18,190,0.405263158,0.068421053,0.515789474,0,0.011837158
2207,41,20368,8,10,0,0,0,18,4,4,10,0,0,18,nowin,push,push,push,10,0,18,192,0.364583333,0.036458333,0.520833333,0,0.00089702
2208,97,20369,10,9,0,0,0,19,1,2,10,2,5,20,nowin,loss,beat,dlwin,0,10,19,182,0.450549451,0.06043956,0.692307692,2,0.677372279
2209,132,20369,5,10,0,7,0,22,1,2,10,2,5,20,nowin,loss,bust,plbust,0,10,15,194,0.412371134,0.036082474,0.649484536,2,0.611633238
2210,91,20369,10,10,0,0,0,20,1,2,10,2,5,20,nowin,push,push,push,10,0,20,194,0.417525773,0.046391753,0.515463918,1,0.266616552
2211,129,20369,2,10,0,7,0,19,1,2,10,2,5,20,nowin,loss,beat,dlwin,0,10,12,201,0.422885572,0.064676617,0.55721393,0,0.027255383
2212,55,20369,10,10,0,0,0,20,1,2,10,2,5,20,nowin,push,push,push,10,0,20,191,0.371727749,0.057591623,0.54973822,0,0.01011347
2213,115,20369,10,4,0,4,0,18,1,2,10,2,5,20,nowin,loss,beat,dlwin,0,10,14,194,0.427835052,0.041237113,0.592783505,2,0.583863602
2214,146,20370,10,9,0,0,0,19,10,7,0,0,0,17,nowin,win,plwin,beat,20,0,19,221,0.43438914,0.040723982,0.542986425,1,0.290190091
2215,148,20370,10,3,0,3,3,19,10,7,0,0,0,17,nowin,win,plwin,beat,20,0,13,204,0.401960784,0.078431373,0.593137255,0,0.029789521
2216,31,20370,6,11,2,0,0,19,10,7,0,0,0,17,nowin,win,plwin,beat,20,0,17,188,0.473404255,0.058510638,0.515957447,1,0.300306557
2217,110,20370,2,9,8,0,0,19,10,7,0,0,0,17,nowin,win,plwin,beat,20,0,11,192,0.416666667,0.046875,0.557291667,0,0.025413132
2218,128,20370,6,8,0,7,0,21,10,7,0,0,0,17,nowin,win,plwin,beat,20,0,14,227,0.356828194,0.052863436,0.577092511,0,0.012352564
2219,97,20370,10,10,0,0,0,20,10,7,0,0,0,17,nowin,win,plwin,beat,20,0,20,182,0.450549451,0.06043956,0.692307692,2,0.677372279
2220,68,20371,10,4,0,5,0,19,10,6,1,0,0,17,nowin,win,plwin,beat,20,0,14,205,0.434146341,0.029268293,0.6,2,0.59483189
2221,150,20371,10,2,0,5,0,17,10,6,1,0,0,17,nowin,push,push,push,10,0,12,192,0.401041667,0.036458333,0.567708333,0,0.023287458
2222,33,20371,6,10,0,10,0,26,10,6,1,0,0,17,nowin,loss,bust,plbust,0,10,16,192,0.4375,0.057291667,0.625,2,0.616208916
2223,60,20371,10,10,0,0,0,20,10,6,1,0,0,17,nowin,win,plwin,beat,20,0,20,227,0.418502203,0.022026432,0.559471366,0,0.026496258
2224,123,20371,7,2,2,8,0,19,10,6,1,0,0,17,nowin,win,plwin,beat,20,0,9,205,0.43902439,0.034146341,0.614634146,2,0.609962544
2225,131,20371,11,8,0,0,0,19,10,6,1,0,0,17,nowin,win,plwin,beat,20,0,19,217,0.410138249,0.069124424,0.543778802,0,0.02015021
2226,55,20372,10,5,0,7,0,22,11,10,0,0,0,21,nowin,loss,bust,plbust,0,10,15,191,0.371727749,0.057591623,0.54973822,0,0.01011347
2227,19,20372,4,10,0,10,0,24,11,10,0,0,0,21,nowin,loss,bust,plbust,0,10,14,237,0.41350211,0.054852321,0.628691983,2,0.597373826
2228,61,20372,5,5,2,4,10,26,11,10,0,0,0,21,nowin,loss,bust,plbust,0,10,10,194,0.427835052,0.077319588,0.603092784,2,0.591437139
2229,100,20372,7,11,0,0,0,18,11,10,0,0,0,21,nowin,loss,beat,dlwin,0,10,18,190,0.452631579,0.036842105,0.594736842,3,0.888671154
2230,45,20372,4,10,0,10,0,24,11,10,0,0,0,21,nowin,loss,bust,plbust,0,10,14,196,0.428571429,0.051020408,0.612244898,2,0.598821767
2231,115,20372,6,7,0,8,0,21,11,10,0,0,0,21,nowin,push,push,push,10,0,13,194,0.427835052,0.041237113,0.592783505,2,0.583863602
2232,86,20373,5,7,0,1,8,21,8,11,0,0,0,19,nowin,win,plwin,beat,20,0,12,196,0.454081633,0.040816327,0.591836735,3,0.887566443
2233,119,20373,6,2,10,0,0,18,8,11,0,0,0,19,nowin,loss,beat,dlwin,0,10,8,190,0.405263158,0.068421053,0.515789474,0,0.011837158
2234,9,20373,11,9,0,0,0,20,8,11,0,0,0,19,nowin,win,plwin,beat,20,0,20,194,0.37628866,0.015463918,0.541237113,0,0.009396796
2235,86,20373,2,10,0,9,0,21,8,11,0,0,0,19,nowin,win,plwin,beat,20,0,12,196,0.454081633,0.040816327,0.591836735,3,0.887566443
2236,10,20373,5,6,8,0,0,19,8,11,0,0,0,19,nowin,push,push,push,10,0,11,191,0.413612565,0.057591623,0.596858639,2,0.574087175
2237,113,20373,10,8,0,0,0,18,8,11,0,0,0,19,nowin,loss,beat,dlwin,0,10,18,199,0.407035176,0.055276382,0.668341709,2,0.620695264
2238,102,20374,5,2,4,10,0,21,1,4,10,6,0,21,nowin,push,push,push,10,0,7,192,0.338541667,0.046875,0.5625,0,0.003306118
2239,36,20374,10,8,0,0,0,18,1,4,10,6,0,21,nowin,loss,beat,dlwin,0,10,18,229,0.445414847,0.056768559,0.655021834,2,0.645370571
2240,150,20374,3,8,7,0,0,18,1,4,10,6,0,21,nowin,loss,beat,dlwin,0,10,11,192,0.401041667,0.036458333,0.567708333,0,0.023287458
2241,24,20374,10,3,0,3,7,23,1,4,10,6,0,21,nowin,loss,bust,plbust,0,10,13,207,0.458937198,0.048309179,0.570048309,1,0.318138014
2242,6,20374,2,10,0,10,0,22,1,4,10,6,0,21,nowin,loss,bust,plbust,0,10,12,191,0.439790576,0.047120419,0.581151832,1,0.31211505
2243,23,20374,7,10,0,0,0,17,1,4,10,6,0,21,nowin,loss,beat,dlwin,0,10,17,208,0.427884615,0.0625,0.552884615,1,0.29114424
2244,132,20375,10,7,0,0,0,17,10,3,9,0,0,22,nowin,win,dlbust,bust,20,0,17,194,0.412371134,0.036082474,0.649484536,2,0.611633238
2245,58,20375,1,4,10,8,0,23,10,3,9,0,0,22,nowin,loss,bust,plbust,0,10,5,195,0.430769231,0.041025641,0.584615385,2,0.580497586
2246,125,20375,9,7,0,7,0,23,10,3,9,0,0,22,nowin,loss,bust,plbust,0,10,16,219,0.438356164,0.050228311,0.575342466,1,0.308411257
2247,21,20375,8,6,0,2,10,26,10,3,9,0,0,22,nowin,loss,bust,plbust,0,10,14,214,0.359813084,0.042056075,0.626168224,0,0.025263474
2248,115,20375,9,10,0,0,0,19,10,3,9,0,0,22,nowin,win,dlbust,bust,20,0,19,194,0.427835052,0.041237113,0.592783505,2,0.583863602
2249,134,20375,2,11,4,0,0,17,10,3,9,0,0,22,nowin,win,dlbust,bust,20,0,13,185,0.443243243,0.021621622,0.545945946,1,0.296939509
2250,108,20376,6,2,10,0,0,18,4,8,10,0,0,22,nowin,win,dlbust,bust,20,0,8,193,0.435233161,0.056994819,0.559585492,1,0.298824795
2251,16,20376,7,10,0,0,0,17,4,8,10,0,0,22,nowin,win,dlbust,bust,20,0,17,220,0.427272727,0.081818182,0.6,2,0.588660176
2252,114,20376,11,8,0,0,0,19,4,8,10,0,0,22,nowin,win,dlbust,bust,20,0,19,198,0.47979798,0.025252525,0.611111111,3,0.937232995
2253,31,20376,10,3,0,0,0,13,4,8,10,0,0,22,nowin,win,dlbust,bust,20,0,13,188,0.473404255,0.058510638,0.515957447,1,0.300306557
2254,68,20376,3,4,5,0,0,12,4,8,10,0,0,22,nowin,win,dlbust,bust,20,0,7,205,0.434146341,0.029268293,0.6,2,0.59483189
2255,39,20376,4,1,9,0,0,14,4,8,10,0,0,22,nowin,win,dlbust,bust,20,0,5,191,0.429319372,0.062827225,0.57591623,0,0.033760763
2256,22,20377,3,10,0,9,0,22,10,10,0,0,0,20,nowin,loss,bust,plbust,0,10,13,187,0.481283422,0.042780749,0.577540107,3,0.906128176
2257,26,20377,5,10,0,2,0,17,10,10,0,0,0,20,nowin,loss,beat,dlwin,0,10,15,203,0.463054187,0.0591133,0.541871921,1,0.306802864
2258,98,20377,5,4,10,0,0,19,10,10,0,0,0,20,nowin,loss,beat,dlwin,0,10,9,220,0.422727273,0.054545455,0.55,1,0.28664435
2259,94,20377,9,10,0,0,0,19,10,10,0,0,0,20,nowin,loss,beat,dlwin,0,10,19,183,0.43715847,0.043715847,0.540983607,1,0.290866892
2260,112,20377,10,10,0,0,0,20,10,10,0,0,0,20,nowin,push,push,push,10,0,20,203,0.448275862,0.054187192,0.600985222,3,0.889576933
2261,29,20377,7,4,2,10,0,23,10,10,0,0,0,20,nowin,loss,bust,plbust,0,10,11,189,0.44973545,0.058201058,0.544973545,1,0.300349439
2262,57,20378,2,6,2,3,3,16,10,10,0,0,0,20,nowin,loss,beat,dlwin,0,10,8,192,0.46875,0.052083333,0.59375,3,0.907001181
2263,63,20378,10,11,0,0,0,21,10,10,0,0,0,20,win,win,plwin,beat,25,0,21,216,0.467592593,0.037037037,0.62037037,3,0.931690496
2264,22,20378,4,10,0,6,0,20,10,10,0,0,0,20,nowin,push,push,push,10,0,14,187,0.481283422,0.042780749,0.577540107,3,0.906128176
2265,21,20378,2,6,3,8,0,19,10,10,0,0,0,20,nowin,loss,beat,dlwin,0,10,8,214,0.359813084,0.042056075,0.626168224,0,0.025263474
2266,67,20378,9,6,0,10,0,25,10,10,0,0,0,20,nowin,loss,bust,plbust,0,10,15,195,0.369230769,0.041025641,0.569230769,0,0.014139427
2267,149,20378,10,2,0,10,0,22,10,10,0,0,0,20,nowin,loss,bust,plbust,0,10,12,225,0.457777778,0.057777778,0.648888889,2,0.651965595
2268,47,20379,11,3,4,0,0,18,3,7,5,10,0,25,nowin,win,dlbust,bust,20,0,14,210,0.438095238,0.057142857,0.623809524,2,0.615868808
2269,48,20379,7,9,0,0,0,16,3,7,5,10,0,25,nowin,win,dlbust,bust,20,0,16,203,0.413793103,0.019704433,0.600985222,2,0.577280801
2270,80,20379,4,7,2,0,0,13,3,7,5,10,0,25,nowin,win,dlbust,bust,20,0,11,186,0.419354839,0.059139785,0.623655914,2,0.59892924
2271,144,20379,4,7,1,10,0,22,3,7,5,10,0,25,nowin,loss,bust,plbust,0,10,11,202,0.386138614,0.054455446,0.564356436,0,0.018006244
2272,89,20379,10,10,0,0,0,20,3,7,5,10,0,25,nowin,win,dlbust,bust,20,0,20,212,0.537735849,0.047169811,0.594339623,3,0.990167191
2273,112,20379,10,10,0,0,0,20,3,7,5,10,0,25,nowin,win,dlbust,bust,20,0,20,203,0.448275862,0.054187192,0.600985222,3,0.889576933
2274,102,20380,8,10,0,0,0,18,4,10,10,0,0,24,nowin,win,dlbust,bust,20,0,18,192,0.338541667,0.046875,0.5625,0,0.003306118
2275,93,20380,10,10,0,0,0,20,4,10,10,0,0,24,nowin,win,dlbust,bust,20,0,20,175,0.485714286,0.051428571,0.548571429,1,0.323648091
2276,150,20380,6,6,0,0,0,12,4,10,10,0,0,24,nowin,win,dlbust,bust,20,0,12,192,0.401041667,0.036458333,0.567708333,0,0.023287458
2277,92,20380,3,10,0,0,0,13,4,10,10,0,0,24,nowin,win,dlbust,bust,20,0,13,186,0.446236559,0.059139785,0.564516129,1,0.307826125
2278,33,20380,6,10,0,0,0,16,4,10,10,0,0,24,nowin,win,dlbust,bust,20,0,16,192,0.4375,0.057291667,0.625,2,0.616208916
2279,105,20380,7,10,0,0,0,17,4,10,10,0,0,24,nowin,win,dlbust,bust,20,0,17,198,0.414141414,0.070707071,0.590909091,0,0.032889494
2280,80,20381,10,10,0,0,0,20,3,3,11,0,0,17,nowin,win,plwin,beat,20,0,20,186,0.419354839,0.059139785,0.623655914,2,0.59892924
2281,113,20381,8,10,0,0,0,18,3,3,11,0,0,17,nowin,win,plwin,beat,20,0,18,199,0.407035176,0.055276382,0.668341709,2,0.620695264
2282,73,20381,10,7,0,0,0,17,3,3,11,0,0,17,nowin,push,push,push,10,0,17,181,0.375690608,0.011049724,0.596685083,0,0.022795773
2283,46,20381,8,3,2,0,0,13,3,3,11,0,0,17,nowin,loss,beat,dlwin,0,10,11,186,0.403225806,0.048387097,0.591397849,0,0.029742194
2284,40,20381,2,9,8,0,0,19,3,3,11,0,0,17,nowin,win,plwin,beat,20,0,11,196,0.367346939,0.030612245,0.617346939,0,0.025358183
2285,101,20381,8,3,8,0,0,19,3,3,11,0,0,17,nowin,win,plwin,beat,20,0,11,205,0.424390244,0.068292683,0.63902439,2,0.614740646
2286,139,20382,3,3,4,7,0,17,2,6,10,0,0,18,nowin,loss,beat,dlwin,0,10,6,192,0.380208333,0.036458333,0.59375,0,0.023429169
2287,75,20382,6,5,7,0,0,18,2,6,10,0,0,18,nowin,push,push,push,10,0,11,191,0.418848168,0.052356021,0.570680628,0,0.029344702
2288,137,20382,11,7,0,0,0,18,2,6,10,0,0,18,nowin,push,push,push,10,0,18,194,0.417525773,0.046391753,0.536082474,1,0.276714602
2289,99,20382,8,6,0,0,0,14,2,6,10,0,0,18,nowin,loss,beat,dlwin,0,10,14,207,0.47826087,0.062801932,0.637681159,3,0.961418446
2290,37,20382,4,2,10,0,0,16,2,6,10,0,0,18,nowin,loss,beat,dlwin,0,10,6,208,0.394230769,0.038461538,0.581730769,0,0.024682772
2291,77,20382,5,8,0,0,0,13,2,6,10,0,0,18,nowin,loss,beat,dlwin,0,10,13,200,0.455,0.04,0.62,3,0.916252116
2292,145,20383,9,2,7,0,0,18,10,5,10,0,0,25,nowin,win,dlbust,bust,20,0,11,188,0.441489362,0.031914894,0.622340426,2,0.617837093
2293,100,20383,4,11,6,0,0,21,10,5,10,0,0,25,nowin,win,dlbust,bust,20,0,15,190,0.452631579,0.036842105,0.594736842,3,0.888671154
2294,6,20383,10,5,0,10,0,25,10,5,10,0,0,25,nowin,loss,bust,plbust,0,10,15,191,0.439790576,0.047120419,0.581151832,1,0.31211505
2295,133,20383,10,9,0,0,0,19,10,5,10,0,0,25,nowin,win,dlbust,bust,20,0,19,201,0.47761194,0.064676617,0.611940299,3,0.935428111
2296,149,20383,3,8,2,10,0,23,10,5,10,0,0,25,nowin,loss,bust,plbust,0,10,11,225,0.457777778,0.057777778,0.648888889,2,0.651965595
2297,136,20383,9,4,0,10,0,23,10,5,10,0,0,25,nowin,loss,bust,plbust,0,10,13,194,0.396907216,0.025773196,0.597938144,0,0.029452644
2298,137,20384,7,10,0,0,0,17,11,6,0,0,0,17,nowin,push,push,push,10,0,17,194,0.417525773,0.046391753,0.536082474,1,0.276714602
2299,12,20384,3,5,6,2,9,25,11,6,0,0,0,17,nowin,loss,bust,plbust,0,10,8,189,0.470899471,0.015873016,0.613756614,3,0.929171178
2300,11,20384,2,10,0,4,4,20,11,6,0,0,0,17,nowin,win,plwin,beat,20,0,12,236,0.457627119,0.016949153,0.588983051,3,0.889015813
2301,9,20384,10,11,0,0,0,21,11,6,0,0,0,17,win,win,plwin,beat,25,0,21,194,0.37628866,0.015463918,0.541237113,0,0.009396796
2302,138,20384,6,10,0,7,0,23,11,6,0,0,0,17,nowin,loss,bust,plbust,0,10,16,190,0.442105263,0.047368421,0.610526316,2,0.609711065
2303,15,20384,10,11,0,0,0,21,11,6,0,0,0,17,win,win,plwin,beat,25,0,21,212,0.410377358,0.051886792,0.561320755,0,0.024517408
2304,51,20385,5,8,0,0,0,13,6,10,2,0,0,18,nowin,loss,beat,dlwin,0,10,13,189,0.529100529,0.068783069,0.608465608,3,0.993665715
2305,64,20385,10,7,0,0,0,17,6,10,2,0,0,18,nowin,loss,beat,dlwin,0,10,17,187,0.363636364,0.048128342,0.631016043,0,0.027594885
2306,73,20385,6,10,0,0,0,16,6,10,2,0,0,18,nowin,loss,beat,dlwin,0,10,16,181,0.375690608,0.011049724,0.596685083,0,0.022795773
2307,4,20385,4,1,9,0,0,14,6,10,2,0,0,18,nowin,loss,beat,dlwin,0,10,5,217,0.460829493,0.036866359,0.562211982,1,0.315432839
2308,94,20385,3,2,2,10,0,17,6,10,2,0,0,18,nowin,loss,beat,dlwin,0,10,5,183,0.43715847,0.043715847,0.540983607,1,0.290866892
2309,19,20385,5,8,0,0,0,13,6,10,2,0,0,18,nowin,loss,beat,dlwin,0,10,13,237,0.41350211,0.054852321,0.628691983,2,0.597373826
2310,4,20386,9,2,1,9,0,21,11,10,0,0,0,21,nowin,push,push,push,10,0,11,217,0.460829493,0.036866359,0.562211982,1,0.315432839
2311,17,20386,9,3,0,3,1,16,11,10,0,0,0,21,nowin,loss,beat,dlwin,0,10,12,171,0.444444444,0.070175439,0.555555556,1,0.302364894
2312,4,20386,10,7,0,0,0,17,11,10,0,0,0,21,nowin,loss,beat,dlwin,0,10,17,217,0.460829493,0.036866359,0.562211982,1,0.315432839
2313,27,20386,7,10,0,0,0,17,11,10,0,0,0,21,nowin,loss,beat,dlwin,0,10,17,178,0.370786517,0.016853933,0.573033708,0,0.015536309
2314,16,20386,10,6,0,5,0,21,11,10,0,0,0,21,nowin,push,push,push,10,0,16,220,0.427272727,0.081818182,0.6,2,0.588660176
2315,60,20386,10,5,0,5,0,20,11,10,0,0,0,21,nowin,loss,beat,dlwin,0,10,15,227,0.418502203,0.022026432,0.559471366,0,0.026496258
2316,30,20387,1,6,7,0,0,14,4,10,6,0,0,20,nowin,loss,beat,dlwin,0,10,7,206,0.393203883,0.033980583,0.601941748,0,0.029324648
2317,53,20387,10,3,0,0,0,13,4,10,6,0,0,20,nowin,loss,beat,dlwin,0,10,13,250,0.372,0.064,0.564,0,0.013687345
2318,119,20387,3,10,0,0,0,13,4,10,6,0,0,20,nowin,loss,beat,dlwin,0,10,13,190,0.405263158,0.068421053,0.515789474,0,0.011837158
2319,142,20387,5,5,4,0,0,14,4,10,6,0,0,20,nowin,loss,beat,dlwin,0,10,10,211,0.417061611,0.047393365,0.526066351,1,0.271531309
2320,66,20387,10,11,0,0,0,21,4,10,6,0,0,20,win,win,plwin,beat,25,0,21,217,0.456221198,0.064516129,0.626728111,3,0.924304367
2321,38,20387,5,10,0,0,0,15,4,10,6,0,0,20,nowin,loss,beat,dlwin,0,10,15,202,0.361386139,0.03960396,0.564356436,0,0.010597953
2322,100,20388,10,7,0,0,0,17,2,7,6,10,0,25,nowin,win,dlbust,bust,20,0,17,190,0.452631579,0.036842105,0.594736842,3,0.888671154
2323,93,20388,8,5,0,0,0,13,2,7,6,10,0,25,nowin,win,dlbust,bust,20,0,13,175,0.485714286,0.051428571,0.548571429,1,0.323648091
2324,68,20388,3,1,10,0,0,14,2,7,6,10,0,25,nowin,win,dlbust,bust,20,0,4,205,0.434146341,0.029268293,0.6,2,0.59483189
2325,40,20388,10,10,0,0,0,20,2,7,6,10,0,25,nowin,win,dlbust,bust,20,0,20,196,0.367346939,0.030612245,0.617346939,0,0.025358183
2326,150,20388,6,3,3,9,0,21,2,7,6,10,0,25,nowin,win,dlbust,bust,20,0,9,192,0.401041667,0.036458333,0.567708333,0,0.023287458
2327,76,20388,8,3,10,0,0,21,2,7,6,10,0,25,nowin,win,dlbust,bust,20,0,11,189,0.534391534,0.079365079,0.608465608,3,1
2328,42,20389,3,5,6,2,9,25,8,8,10,0,0,26,nowin,loss,bust,plbust,0,10,8,212,0.443396226,0.051886792,0.570754717,1,0.309181312
2329,147,20389,4,5,5,9,0,23,8,8,10,0,0,26,nowin,loss,bust,plbust,0,10,9,205,0.380487805,0.014634146,0.536585366,0,0.00951447
2330,41,20389,2,10,0,5,0,17,8,8,10,0,0,26,nowin,win,dlbust,bust,20,0,12,192,0.364583333,0.036458333,0.520833333,0,0.00089702
2331,23,20389,4,7,8,0,0,19,8,8,10,0,0,26,nowin,win,dlbust,bust,20,0,11,208,0.427884615,0.0625,0.552884615,1,0.29114424
2332,99,20389,4,10,0,10,0,24,8,8,10,0,0,26,nowin,loss,bust,plbust,0,10,14,207,0.47826087,0.062801932,0.637681159,3,0.961418446
2333,130,20389,7,5,0,6,0,18,8,8,10,0,0,26,nowin,win,dlbust,bust,20,0,12,219,0.410958904,0.03652968,0.566210046,0,0.025888739
2334,55,20390,9,10,0,0,0,19,11,10,0,0,0,21,nowin,loss,beat,dlwin,0,10,19,191,0.371727749,0.057591623,0.54973822,0,0.01011347
2335,116,20390,10,4,0,10,0,24,11,10,0,0,0,21,nowin,loss,bust,plbust,0,10,14,195,0.425641026,0.056410256,0.538461538,1,0.28273747
2336,79,20390,10,9,0,0,0,19,11,10,0,0,0,21,nowin,loss,beat,dlwin,0,10,19,211,0.436018957,0.028436019,0.672985782,2,0.650131054
2337,3,20390,4,6,10,0,0,20,11,10,0,0,0,21,nowin,loss,beat,dlwin,0,10,10,190,0.431578947,0.026315789,0.542105263,1,0.288076384
2338,36,20390,10,8,0,0,0,18,11,10,0,0,0,21,nowin,loss,beat,dlwin,0,10,18,229,0.445414847,0.056768559,0.655021834,2,0.645370571
2339,38,20390,4,8,0,5,0,17,11,10,0,0,0,21,nowin,loss,beat,dlwin,0,10,12,202,0.361386139,0.03960396,0.564356436,0,0.010597953
2340,113,20391,8,6,0,9,0,23,10,10,0,0,0,20,nowin,loss,bust,plbust,0,10,14,199,0.407035176,0.055276382,0.668341709,2,0.620695264
2341,118,20391,10,6,0,5,0,21,10,10,0,0,0,20,nowin,win,plwin,beat,20,0,16,216,0.393518519,0.037037037,0.555555556,0,0.018059873
2342,98,20391,2,10,0,10,0,22,10,10,0,0,0,20,nowin,loss,bust,plbust,0,10,12,220,0.422727273,0.054545455,0.55,1,0.28664435
2343,124,20391,8,10,0,0,0,18,10,10,0,0,0,20,nowin,loss,beat,dlwin,0,10,18,202,0.47029703,0.064356436,0.584158416,3,0.899458193
2344,139,20391,10,7,0,0,0,17,10,10,0,0,0,20,nowin,loss,beat,dlwin,0,10,17,192,0.380208333,0.036458333,0.59375,0,0.023429169
2345,86,20391,3,3,4,10,0,20,10,10,0,0,0,20,nowin,push,push,push,10,0,6,196,0.454081633,0.040816327,0.591836735,3,0.887566443
2346,90,20392,3,7,6,0,0,16,3,4,10,0,0,17,nowin,loss,beat,dlwin,0,10,10,201,0.447761194,0.049751244,0.60199005,3,0.889945023
2347,59,20392,3,6,7,0,0,16,3,4,10,0,0,17,nowin,loss,beat,dlwin,0,10,9,228,0.429824561,0.048245614,0.543859649,1,0.287885446
2348,68,20392,3,10,0,0,0,13,3,4,10,0,0,17,nowin,loss,beat,dlwin,0,10,13,205,0.434146341,0.029268293,0.6,2,0.59483189
2349,37,20392,10,2,0,10,0,22,3,4,10,0,0,17,nowin,loss,bust,plbust,0,10,12,208,0.394230769,0.038461538,0.581730769,0,0.024682772
2350,143,20392,9,11,0,0,0,20,3,4,10,0,0,17,nowin,win,plwin,beat,20,0,20,203,0.463054187,0.044334975,0.57635468,3,0.883143365
2351,75,20392,1,1,10,10,0,22,3,4,10,0,0,17,nowin,loss,bust,plbust,0,10,2,191,0.418848168,0.052356021,0.570680628,0,0.029344702
2352,68,20393,2,6,8,10,0,26,10,10,0,0,0,20,nowin,loss,bust,plbust,0,10,8,205,0.434146341,0.029268293,0.6,2,0.59483189
2353,43,20393,10,5,0,10,0,25,10,10,0,0,0,20,nowin,loss,bust,plbust,0,10,15,192,0.40625,0.041666667,0.609375,2,0.576671372
2354,53,20393,10,4,0,3,0,17,10,10,0,0,0,20,nowin,loss,beat,dlwin,0,10,14,250,0.372,0.064,0.564,0,0.013687345
2355,71,20393,11,8,0,0,0,19,10,10,0,0,0,20,nowin,loss,beat,dlwin,0,10,19,193,0.352331606,0.046632124,0.585492228,0,0.013063661
2356,35,20393,1,5,9,10,0,25,10,10,0,0,0,20,nowin,loss,bust,plbust,0,10,6,202,0.410891089,0.044554455,0.633663366,2,0.598681573
2357,39,20393,10,9,0,0,0,19,10,10,0,0,0,20,nowin,loss,beat,dlwin,0,10,19,191,0.429319372,0.062827225,0.57591623,0,0.033760763
2358,29,20394,4,2,10,3,0,19,10,7,0,0,0,17,nowin,win,plwin,beat,20,0,6,189,0.44973545,0.058201058,0.544973545,1,0.300349439
2359,141,20394,10,10,0,0,0,20,10,7,0,0,0,17,nowin,win,plwin,beat,20,0,20,202,0.420792079,0.074257426,0.564356436,0,0.028377851
2360,113,20394,7,9,0,4,0,20,10,7,0,0,0,17,nowin,win,plwin,beat,20,0,16,199,0.407035176,0.055276382,0.668341709,2,0.620695264
2361,144,20394,10,8,0,0,0,18,10,7,0,0,0,17,nowin,win,plwin,beat,20,0,18,202,0.386138614,0.054455446,0.564356436,0,0.018006244
2362,68,20394,7,6,0,10,0,23,10,7,0,0,0,17,nowin,loss,bust,plbust,0,10,13,205,0.434146341,0.029268293,0.6,2,0.59483189
2363,42,20394,9,5,0,1,9,24,10,7,0,0,0,17,nowin,loss,bust,plbust,0,10,14,212,0.443396226,0.051886792,0.570754717,1,0.309181312
2364,109,20395,10,10,0,0,0,20,10,10,0,0,0,20,nowin,push,push,push,10,0,20,221,0.461538462,0.058823529,0.597285068,3,0.901830309
2365,74,20395,3,9,0,6,0,18,10,10,0,0,0,20,nowin,loss,beat,dlwin,0,10,12,209,0.411483254,0.04784689,0.531100478,0,0.017448125
2366,82,20395,4,7,9,0,0,20,10,10,0,0,0,20,nowin,push,push,push,10,0,11,225,0.408888889,0.075555556,0.577777778,0,0.028101874
2367,126,20395,2,5,10,0,0,17,10,10,0,0,0,20,nowin,loss,beat,dlwin,0,10,7,188,0.457446809,0.074468085,0.60106383,3,0.900633203
2368,127,20395,10,5,0,8,0,23,10,10,0,0,0,20,nowin,loss,bust,plbust,0,10,15,201,0.402985075,0.029850746,0.60199005,0,0.032263937
2369,48,20395,9,11,0,0,0,20,10,10,0,0,0,20,nowin,push,push,push,10,0,20,203,0.413793103,0.019704433,0.600985222,2,0.577280801
2370,71,20396,11,10,0,0,0,21,4,7,6,0,0,17,win,win,plwin,beat,25,0,21,193,0.352331606,0.046632124,0.585492228,0,0.013063661
2371,63,20396,10,7,0,0,0,17,4,7,6,0,0,17,nowin,push,push,push,10,0,17,216,0.467592593,0.037037037,0.62037037,3,0.931690496
2372,141,20396,1,4,8,0,0,13,4,7,6,0,0,17,nowin,loss,beat,dlwin,0,10,5,202,0.420792079,0.074257426,0.564356436,0,0.028377851
2373,111,20396,8,10,0,0,0,18,4,7,6,0,0,17,nowin,win,plwin,beat,20,0,18,180,0.433333333,0.055555556,0.611111111,2,0.602264492
2374,116,20396,8,8,0,0,0,16,4,7,6,0,0,17,nowin,loss,beat,dlwin,0,10,16,195,0.425641026,0.056410256,0.538461538,1,0.28273747
2375,138,20396,5,5,11,0,0,21,4,7,6,0,0,17,nowin,win,plwin,beat,20,0,10,190,0.442105263,0.047368421,0.610526316,2,0.609711065
2376,127,20397,3,10,0,10,0,23,11,10,0,0,0,21,nowin,loss,bust,plbust,0,10,13,201,0.402985075,0.029850746,0.60199005,0,0.032263937
2377,98,20397,5,3,4,6,0,18,11,10,0,0,0,21,nowin,loss,beat,dlwin,0,10,8,220,0.422727273,0.054545455,0.55,1,0.28664435
2378,84,20397,10,10,0,0,0,20,11,10,0,0,0,21,nowin,loss,beat,dlwin,0,10,20,195,0.379487179,0.056410256,0.569230769,0,0.017209119
2379,64,20397,10,10,0,0,0,20,11,10,0,0,0,21,nowin,loss,beat,dlwin,0,10,20,187,0.363636364,0.048128342,0.631016043,0,0.027594885
2380,27,20397,2,3,10,6,0,21,11,10,0,0,0,21,nowin,push,push,push,10,0,5,178,0.370786517,0.016853933,0.573033708,0,0.015536309
2381,9,20397,8,10,0,0,0,18,11,10,0,0,0,21,nowin,loss,beat,dlwin,0,10,18,194,0.37628866,0.015463918,0.541237113,0,0.009396796
2382,150,20398,7,2,10,0,0,19,10,10,0,0,0,20,nowin,loss,beat,dlwin,0,10,9,192,0.401041667,0.036458333,0.567708333,0,0.023287458
2383,102,20398,5,1,10,6,0,22,10,10,0,0,0,20,nowin,loss,bust,plbust,0,10,6,192,0.338541667,0.046875,0.5625,0,0.003306118
2384,65,20398,9,9,0,0,0,18,10,10,0,0,0,20,nowin,loss,beat,dlwin,0,10,18,203,0.492610837,0.054187192,0.571428571,3,0.913702814
2385,71,20398,9,10,0,0,0,19,10,10,0,0,0,20,nowin,loss,beat,dlwin,0,10,19,193,0.352331606,0.046632124,0.585492228,0,0.013063661
2386,107,20398,10,6,0,4,0,20,10,10,0,0,0,20,nowin,push,push,push,10,0,16,218,0.444954128,0.073394495,0.600917431,2,0.605210014
2387,69,20398,6,3,10,0,0,19,10,10,0,0,0,20,nowin,loss,beat,dlwin,0,10,9,194,0.365979381,0.030927835,0.515463918,0,0
2388,20,20399,7,10,0,0,0,17,10,2,2,7,0,21,nowin,loss,beat,dlwin,0,10,17,186,0.456989247,0.037634409,0.537634409,1,0.301097108
2389,23,20399,4,11,4,0,0,19,10,2,2,7,0,21,nowin,loss,beat,dlwin,0,10,15,208,0.427884615,0.0625,0.552884615,1,0.29114424
2390,84,20399,11,9,0,0,0,20,10,2,2,7,0,21,nowin,loss,beat,dlwin,0,10,20,195,0.379487179,0.056410256,0.569230769,0,0.017209119
2391,58,20399,10,6,0,10,0,26,10,2,2,7,0,21,nowin,loss,bust,plbust,0,10,16,195,0.430769231,0.041025641,0.584615385,2,0.580497586
2392,32,20399,9,5,0,10,0,24,10,2,2,7,0,21,nowin,loss,bust,plbust,0,10,14,189,0.391534392,0.037037037,0.53968254,0,0.013579086
2393,110,20399,6,2,4,5,0,17,10,2,2,7,0,21,nowin,loss,beat,dlwin,0,10,8,192,0.416666667,0.046875,0.557291667,0,0.025413132
2394,108,20400,10,4,0,0,0,14,4,4,10,0,0,18,nowin,loss,beat,dlwin,0,10,14,193,0.435233161,0.056994819,0.559585492,1,0.298824795
2395,74,20400,5,10,0,0,0,15,4,4,10,0,0,18,nowin,loss,beat,dlwin,0,10,15,209,0.411483254,0.04784689,0.531100478,0,0.017448125
2396,61,20400,11,8,0,0,0,19,4,4,10,0,0,18,nowin,win,plwin,beat,20,0,19,194,0.427835052,0.077319588,0.603092784,2,0.591437139
2397,87,20400,9,7,0,0,0,16,4,4,10,0,0,18,nowin,loss,beat,dlwin,0,10,16,202,0.405940594,0.054455446,0.628712871,2,0.590599801
2398,91,20400,1,6,6,0,0,13,4,4,10,0,0,18,nowin,loss,beat,dlwin,0,10,7,194,0.417525773,0.046391753,0.515463918,1,0.266616552
2399,78,20400,1,4,10,0,0,15,4,4,10,0,0,18,nowin,loss,beat,dlwin,0,10,5,201,0.517412935,0.034825871,0.587064677,3,0.95871112
2400,106,20401,6,9,0,8,0,23,11,6,0,0,0,17,nowin,loss,bust,plbust,0,10,15,192,0.411458333,0.026041667,0.557291667,0,0.023854304
2401,16,20401,5,1,10,8,0,24,11,6,0,0,0,17,nowin,loss,bust,plbust,0,10,6,220,0.427272727,0.081818182,0.6,2,0.588660176
2402,127,20401,10,5,0,9,0,24,11,6,0,0,0,17,nowin,loss,bust,plbust,0,10,15,201,0.402985075,0.029850746,0.60199005,0,0.032263937
2403,50,20401,9,10,0,0,0,19,11,6,0,0,0,17,nowin,win,plwin,beat,20,0,19,202,0.405940594,0.04950495,0.54950495,0,0.020296079
2404,32,20401,9,7,0,6,0,22,11,6,0,0,0,17,nowin,loss,bust,plbust,0,10,16,189,0.391534392,0.037037037,0.53968254,0,0.013579086
2405,12,20401,10,9,0,0,0,19,11,6,0,0,0,17,nowin,win,plwin,beat,20,0,19,189,0.470899471,0.015873016,0.613756614,3,0.929171178
2406,114,20402,10,7,0,0,0,17,6,8,3,0,0,17,nowin,push,push,push,10,0,17,198,0.47979798,0.025252525,0.611111111,3,0.937232995
2407,61,20402,11,7,0,0,0,18,6,8,3,0,0,17,nowin,win,plwin,beat,20,0,18,194,0.427835052,0.077319588,0.603092784,2,0.591437139
2408,117,20402,9,2,10,0,0,21,6,8,3,0,0,17,nowin,win,plwin,beat,20,0,11,173,0.410404624,0.069364162,0.606936416,2,0.578610282
2409,35,20402,8,10,0,0,0,18,6,8,3,0,0,17,nowin,win,plwin,beat,20,0,18,202,0.410891089,0.044554455,0.633663366,2,0.598681573
2410,40,20402,9,11,0,0,0,20,6,8,3,0,0,17,nowin,win,plwin,beat,20,0,20,196,0.367346939,0.030612245,0.617346939,0,0.025358183
2411,5,20402,7,11,0,0,0,18,6,8,3,0,0,17,nowin,win,plwin,beat,20,0,18,203,0.42364532,0.02955665,0.596059113,2,0.582508076
2412,86,20403,10,7,0,0,0,17,2,6,9,0,0,17,nowin,push,push,push,10,0,17,196,0.454081633,0.040816327,0.591836735,3,0.887566443
2413,53,20403,11,3,6,0,0,20,2,6,9,0,0,17,nowin,win,plwin,beat,20,0,14,250,0.372,0.064,0.564,0,0.013687345
2414,81,20403,1,4,10,0,0,15,2,6,9,0,0,17,nowin,loss,beat,dlwin,0,10,5,182,0.395604396,0.043956044,0.60989011,2,0.567491261
2415,78,20403,10,10,0,0,0,20,2,6,9,0,0,17,nowin,win,plwin,beat,20,0,20,201,0.517412935,0.034825871,0.587064677,3,0.95871112
2416,66,20403,8,3,10,0,0,21,2,6,9,0,0,17,nowin,win,plwin,beat,20,0,11,217,0.456221198,0.064516129,0.626728111,3,0.924304367
2417,126,20403,10,2,0,10,0,22,2,6,9,0,0,17,nowin,loss,bust,plbust,0,10,12,188,0.457446809,0.074468085,0.60106383,3,0.900633203
2418,81,20404,5,10,0,2,0,17,10,4,10,0,0,24,nowin,win,dlbust,bust,20,0,15,182,0.395604396,0.043956044,0.60989011,2,0.567491261
2419,128,20404,11,3,6,0,0,20,10,4,10,0,0,24,nowin,win,dlbust,bust,20,0,14,227,0.356828194,0.052863436,0.577092511,0,0.012352564
2420,139,20404,3,2,6,7,0,18,10,4,10,0,0,24,nowin,win,dlbust,bust,20,0,5,192,0.380208333,0.036458333,0.59375,0,0.023429169
2421,66,20404,10,8,0,0,0,18,10,4,10,0,0,24,nowin,win,dlbust,bust,20,0,18,217,0.456221198,0.064516129,0.626728111,3,0.924304367
2422,84,20404,3,7,2,5,0,17,10,4,10,0,0,24,nowin,win,dlbust,bust,20,0,10,195,0.379487179,0.056410256,0.569230769,0,0.017209119
2423,101,20404,5,4,5,2,1,17,10,4,10,0,0,24,nowin,win,dlbust,bust,20,0,9,205,0.424390244,0.068292683,0.63902439,2,0.614740646
2424,46,20405,2,9,10,0,0,21,2,11,5,0,0,18,nowin,win,plwin,beat,20,0,11,186,0.403225806,0.048387097,0.591397849,0,0.029742194
2425,38,20405,10,5,0,0,0,15,2,11,5,0,0,18,nowin,loss,beat,dlwin,0,10,15,202,0.361386139,0.03960396,0.564356436,0,0.010597953
2426,59,20405,10,10,0,0,0,20,2,11,5,0,0,18,nowin,win,plwin,beat,20,0,20,228,0.429824561,0.048245614,0.543859649,1,0.287885446
2427,5,20405,9,7,0,0,0,16,2,11,5,0,0,18,nowin,loss,beat,dlwin,0,10,16,203,0.42364532,0.02955665,0.596059113,2,0.582508076
2428,97,20405,3,11,4,0,0,18,2,11,5,0,0,18,nowin,push,push,push,10,0,14,182,0.450549451,0.06043956,0.692307692,2,0.677372279
2429,12,20405,6,4,8,0,0,18,2,11,5,0,0,18,nowin,push,push,push,10,0,10,189,0.470899471,0.015873016,0.613756614,3,0.929171178
2430,118,20406,6,7,0,10,0,23,10,9,0,0,0,19,nowin,loss,bust,plbust,0,10,13,216,0.393518519,0.037037037,0.555555556,0,0.018059873
2431,46,20406,4,11,6,0,0,21,10,9,0,0,0,19,nowin,win,plwin,beat,20,0,15,186,0.403225806,0.048387097,0.591397849,0,0.029742194
2432,48,20406,11,10,0,0,0,21,10,9,0,0,0,19,win,win,plwin,beat,25,0,21,203,0.413793103,0.019704433,0.600985222,2,0.577280801
2433,35,20406,2,10,0,10,0,22,10,9,0,0,0,19,nowin,loss,bust,plbust,0,10,12,202,0.410891089,0.044554455,0.633663366,2,0.598681573
2434,117,20406,4,9,0,10,0,23,10,9,0,0,0,19,nowin,loss,bust,plbust,0,10,13,173,0.410404624,0.069364162,0.606936416,2,0.578610282
2435,16,20406,11,10,0,0,0,21,10,9,0,0,0,19,win,win,plwin,beat,25,0,21,220,0.427272727,0.081818182,0.6,2,0.588660176
2436,14,20407,10,7,0,0,0,17,10,3,4,0,0,17,nowin,push,push,push,10,0,17,202,0.391089109,0.01980198,0.628712871,2,0.577264877
2437,105,20407,7,10,0,0,0,17,10,3,4,0,0,17,nowin,push,push,push,10,0,17,198,0.414141414,0.070707071,0.590909091,0,0.032889494
2438,123,20407,8,8,0,2,0,18,10,3,4,0,0,17,nowin,win,plwin,beat,20,0,16,205,0.43902439,0.034146341,0.614634146,2,0.609962544
2439,2,20407,11,1,7,0,0,19,10,3,4,0,0,17,nowin,win,plwin,beat,20,0,12,200,0.445,0.035,0.64,2,0.633962549
2440,125,20407,11,7,0,0,0,18,10,3,4,0,0,17,nowin,win,plwin,beat,20,0,18,219,0.438356164,0.050228311,0.575342466,1,0.308411257
2441,134,20407,8,10,0,0,0,18,10,3,4,0,0,17,nowin,win,plwin,beat,20,0,18,185,0.443243243,0.021621622,0.545945946,1,0.296939509
2442,27,20408,3,8,5,0,0,16,6,11,0,0,0,17,nowin,loss,beat,dlwin,0,10,11,178,0.370786517,0.016853933,0.573033708,0,0.015536309
2443,85,20408,5,1,10,0,0,16,6,11,0,0,0,17,nowin,loss,beat,dlwin,0,10,6,195,0.41025641,0.066666667,0.594871795,0,0.03269711
2444,145,20408,7,10,0,0,0,17,6,11,0,0,0,17,nowin,push,push,push,10,0,17,188,0.441489362,0.031914894,0.622340426,2,0.617837093
2445,75,20408,7,10,0,0,0,17,6,11,0,0,0,17,nowin,push,push,push,10,0,17,191,0.418848168,0.052356021,0.570680628,0,0.029344702
2446,64,20408,10,9,0,0,0,19,6,11,0,0,0,17,nowin,win,plwin,beat,20,0,19,187,0.363636364,0.048128342,0.631016043,0,0.027594885
2447,42,20408,5,10,0,0,0,15,6,11,0,0,0,17,nowin,loss,beat,dlwin,0,10,15,212,0.443396226,0.051886792,0.570754717,1,0.309181312
2448,31,20409,9,3,0,10,0,22,10,10,0,0,0,20,nowin,loss,bust,plbust,0,10,12,188,0.473404255,0.058510638,0.515957447,1,0.300306557
2449,80,20409,4,10,0,1,1,16,10,10,0,0,0,20,nowin,loss,beat,dlwin,0,10,14,186,0.419354839,0.059139785,0.623655914,2,0.59892924
2450,112,20409,4,8,0,10,0,22,10,10,0,0,0,20,nowin,loss,bust,plbust,0,10,12,203,0.448275862,0.054187192,0.600985222,3,0.889576933
2451,44,20409,8,3,10,0,0,21,10,10,0,0,0,20,nowin,win,plwin,beat,20,0,11,219,0.433789954,0.050228311,0.534246575,1,0.285551035
2452,107,20409,5,7,0,3,10,25,10,10,0,0,0,20,nowin,loss,bust,plbust,0,10,12,218,0.444954128,0.073394495,0.600917431,2,0.605210014
2453,14,20409,5,8,0,10,0,23,10,10,0,0,0,20,nowin,loss,bust,plbust,0,10,13,202,0.391089109,0.01980198,0.628712871,2,0.577264877
2454,53,20410,5,7,0,0,0,12,5,10,4,0,0,19,nowin,loss,beat,dlwin,0,10,12,250,0.372,0.064,0.564,0,0.013687345
2455,113,20410,1,6,10,0,0,17,5,10,4,0,0,19,nowin,loss,beat,dlwin,0,10,7,199,0.407035176,0.055276382,0.668341709,2,0.620695264
2456,58,20410,2,8,6,0,0,16,5,10,4,0,0,19,nowin,loss,beat,dlwin,0,10,10,195,0.430769231,0.041025641,0.584615385,2,0.580497586
2457,29,20410,9,5,0,0,0,14,5,10,4,0,0,19,nowin,loss,beat,dlwin,0,10,14,189,0.44973545,0.058201058,0.544973545,1,0.300349439
2458,70,20410,4,3,10,0,0,17,5,10,4,0,0,19,nowin,loss,beat,dlwin,0,10,7,228,0.385964912,0.039473684,0.557017544,0,0.016157125
2459,88,20410,4,10,0,0,0,14,5,10,4,0,0,19,nowin,loss,beat,dlwin,0,10,14,206,0.466019417,0.033980583,0.54368932,1,0.309467903
2460,133,20411,10,9,0,0,0,19,7,2,2,5,5,21,nowin,loss,beat,dlwin,0,10,19,201,0.47761194,0.064676617,0.611940299,3,0.935428111
2461,70,20411,10,10,0,0,0,20,7,2,2,5,5,21,nowin,loss,beat,dlwin,0,10,20,228,0.385964912,0.039473684,0.557017544,0,0.016157125
2462,80,20411,2,6,3,5,10,26,7,2,2,5,5,21,nowin,loss,bust,plbust,0,10,8,186,0.419354839,0.059139785,0.623655914,2,0.59892924
2463,32,20411,2,5,2,9,0,18,7,2,2,5,5,21,nowin,loss,beat,dlwin,0,10,7,189,0.391534392,0.037037037,0.53968254,0,0.013579086
2464,6,20411,11,5,4,0,0,20,7,2,2,5,5,21,nowin,loss,beat,dlwin,0,10,16,191,0.439790576,0.047120419,0.581151832,1,0.31211505
2465,49,20411,10,7,0,0,0,17,7,2,2,5,5,21,nowin,loss,beat,dlwin,0,10,17,207,0.396135266,0.053140097,0.594202899,0,0.028306925
2466,133,20412,9,5,0,6,0,20,8,8,1,0,0,17,nowin,win,plwin,beat,20,0,14,201,0.47761194,0.064676617,0.611940299,3,0.935428111
2467,58,20412,6,10,0,3,0,19,8,8,1,0,0,17,nowin,win,plwin,beat,20,0,16,195,0.430769231,0.041025641,0.584615385,2,0.580497586
2468,89,20412,11,10,0,0,0,21,8,8,1,0,0,17,win,win,plwin,beat,25,0,21,212,0.537735849,0.047169811,0.594339623,3,0.990167191
2469,110,20412,10,3,0,8,0,21,8,8,1,0,0,17,nowin,win,plwin,beat,20,0,13,192,0.416666667,0.046875,0.557291667,0,0.025413132
2470,119,20412,10,3,0,9,0,22,8,8,1,0,0,17,nowin,loss,bust,plbust,0,10,13,190,0.405263158,0.068421053,0.515789474,0,0.011837158
2471,21,20412,10,10,0,0,0,20,8,8,1,0,0,17,nowin,win,plwin,beat,20,0,20,214,0.359813084,0.042056075,0.626168224,0,0.025263474
2472,76,20413,6,10,0,5,0,21,10,7,0,0,0,17,nowin,win,plwin,beat,20,0,16,189,0.534391534,0.079365079,0.608465608,3,1
2473,24,20413,9,3,0,8,0,20,10,7,0,0,0,17,nowin,win,plwin,beat,20,0,12,207,0.458937198,0.048309179,0.570048309,1,0.318138014
2474,92,20413,5,11,5,0,0,21,10,7,0,0,0,17,nowin,win,plwin,beat,20,0,16,186,0.446236559,0.059139785,0.564516129,1,0.307826125
2475,119,20413,2,10,0,9,0,21,10,7,0,0,0,17,nowin,win,plwin,beat,20,0,12,190,0.405263158,0.068421053,0.515789474,0,0.011837158
2476,129,20413,4,4,10,0,0,18,10,7,0,0,0,17,nowin,win,plwin,beat,20,0,8,201,0.422885572,0.064676617,0.55721393,0,0.027255383
2477,17,20413,5,3,10,0,0,18,10,7,0,0,0,17,nowin,win,plwin,beat,20,0,8,171,0.444444444,0.070175439,0.555555556,1,0.302364894
2478,87,20414,10,8,0,0,0,18,6,11,0,0,0,17,nowin,win,plwin,beat,20,0,18,202,0.405940594,0.054455446,0.628712871,2,0.590599801
2479,142,20414,8,10,0,0,0,18,6,11,0,0,0,17,nowin,win,plwin,beat,20,0,18,211,0.417061611,0.047393365,0.526066351,1,0.271531309
2480,18,20414,10,11,0,0,0,21,6,11,0,0,0,17,win,win,plwin,beat,25,0,21,182,0.461538462,0.043956044,0.587912088,3,0.892649374
2481,123,20414,5,4,4,0,0,13,6,11,0,0,0,17,nowin,loss,beat,dlwin,0,10,9,205,0.43902439,0.034146341,0.614634146,2,0.609962544
2482,135,20414,4,2,10,0,0,16,6,11,0,0,0,17,nowin,loss,beat,dlwin,0,10,6,179,0.391061453,0.067039106,0.586592179,0,0.024924662
2483,37,20414,7,5,0,0,0,12,6,11,0,0,0,17,nowin,loss,beat,dlwin,0,10,12,208,0.394230769,0.038461538,0.581730769,0,0.024682772
2484,89,20415,6,9,0,0,0,15,3,10,8,0,0,21,nowin,loss,beat,dlwin,0,10,15,212,0.537735849,0.047169811,0.594339623,3,0.990167191
2485,71,20415,10,11,0,0,0,21,3,10,8,0,0,21,win,push,push,push,10,0,21,193,0.352331606,0.046632124,0.585492228,0,0.013063661
2486,146,20415,9,7,0,0,0,16,3,10,8,0,0,21,nowin,loss,beat,dlwin,0,10,16,221,0.43438914,0.040723982,0.542986425,1,0.290190091
2487,15,20415,4,10,0,0,0,14,3,10,8,0,0,21,nowin,loss,beat,dlwin,0,10,14,212,0.410377358,0.051886792,0.561320755,0,0.024517408
2488,107,20415,6,9,0,0,0,15,3,10,8,0,0,21,nowin,loss,beat,dlwin,0,10,15,218,0.444954128,0.073394495,0.600917431,2,0.605210014
2489,89,20415,10,10,0,0,0,20,3,10,8,0,0,21,nowin,loss,beat,dlwin,0,10,20,212,0.537735849,0.047169811,0.594339623,3,0.990167191
2490,95,20416,7,8,0,0,0,15,2,6,3,8,0,19,nowin,loss,beat,dlwin,0,10,15,218,0.412844037,0.04587156,0.559633028,0,0.024842385
2491,139,20416,10,2,0,4,0,16,2,6,3,8,0,19,nowin,loss,beat,dlwin,0,10,12,192,0.380208333,0.036458333,0.59375,0,0.023429169
2492,138,20416,10,9,0,0,0,19,2,6,3,8,0,19,nowin,push,push,push,10,0,19,190,0.442105263,0.047368421,0.610526316,2,0.609711065
2493,124,20416,5,7,0,10,0,22,2,6,3,8,0,19,nowin,loss,bust,plbust,0,10,12,202,0.47029703,0.064356436,0.584158416,3,0.899458193
2494,51,20416,10,6,0,0,0,16,2,6,3,8,0,19,nowin,loss,beat,dlwin,0,10,16,189,0.529100529,0.068783069,0.608465608,3,0.993665715
2495,145,20416,1,2,9,8,0,20,2,6,3,8,0,19,nowin,win,plwin,beat,20,0,3,188,0.441489362,0.031914894,0.622340426,2,0.617837093
2496,136,20417,9,10,0,0,0,19,10,10,0,0,0,20,nowin,loss,beat,dlwin,0,10,19,194,0.396907216,0.025773196,0.597938144,0,0.029452644
2497,56,20417,10,3,0,2,2,17,10,10,0,0,0,20,nowin,loss,beat,dlwin,0,10,13,175,0.4,0.057142857,0.582857143,0,0.026685297
2498,24,20417,10,7,0,0,0,17,10,10,0,0,0,20,nowin,loss,beat,dlwin,0,10,17,207,0.458937198,0.048309179,0.570048309,1,0.318138014
2499,67,20417,10,7,0,0,0,17,10,10,0,0,0,20,nowin,loss,beat,dlwin,0,10,17,195,0.369230769,0.041025641,0.569230769,0,0.014139427
2500,102,20417,3,10,0,1,6,20,10,10,0,0,0,20,nowin,push,push,push,10,0,13,192,0.338541667,0.046875,0.5625,0,0.003306118
2501,68,20417,10,8,0,0,0,18,10,10,0,0,0,20,nowin,loss,beat,dlwin,0,10,18,205,0.434146341,0.029268293,0.6,2,0.59483189
2502,14,20418,4,10,0,10,0,24,10,8,0,0,0,18,nowin,loss,bust,plbust,0,10,14,202,0.391089109,0.01980198,0.628712871,2,0.577264877
2503,61,20418,10,11,0,0,0,21,10,8,0,0,0,18,win,win,plwin,beat,25,0,21,194,0.427835052,0.077319588,0.603092784,2,0.591437139
2504,4,20418,9,4,0,2,10,25,10,8,0,0,0,18,nowin,loss,bust,plbust,0,10,13,217,0.460829493,0.036866359,0.562211982,1,0.315432839
2505,8,20418,8,6,0,10,0,24,10,8,0,0,0,18,nowin,loss,bust,plbust,0,10,14,181,0.44198895,0.071823204,0.596685083,2,0.599438402
2506,121,20418,7,7,0,3,0,17,10,8,0,0,0,18,nowin,loss,beat,dlwin,0,10,14,195,0.456410256,0.025641026,0.512820513,1,0.288597791
2507,100,20418,7,10,0,0,0,17,10,8,0,0,0,18,nowin,loss,beat,dlwin,0,10,17,190,0.452631579,0.036842105,0.594736842,3,0.888671154
2508,101,20419,5,10,0,9,0,24,8,9,0,0,0,17,nowin,loss,bust,plbust,0,10,15,205,0.424390244,0.068292683,0.63902439,2,0.614740646
2509,103,20419,2,5,2,1,10,20,8,9,0,0,0,17,nowin,win,plwin,beat,20,0,7,203,0.379310345,0.064039409,0.551724138,0,0.012869209
2510,73,20419,5,7,0,9,0,21,8,9,0,0,0,17,nowin,win,plwin,beat,20,0,12,181,0.375690608,0.011049724,0.596685083,0,0.022795773
2511,54,20419,10,10,0,0,0,20,8,9,0,0,0,17,nowin,win,plwin,beat,20,0,20,185,0.437837838,0.032432432,0.556756757,1,0.29899854
2512,12,20419,6,10,0,10,0,26,8,9,0,0,0,17,nowin,loss,bust,plbust,0,10,16,189,0.470899471,0.015873016,0.613756614,3,0.929171178
2513,24,20419,10,10,0,0,0,20,8,9,0,0,0,17,nowin,win,plwin,beat,20,0,20,207,0.458937198,0.048309179,0.570048309,1,0.318138014
2514,90,20420,10,8,0,0,0,18,11,10,0,0,0,21,nowin,loss,beat,dlwin,0,10,18,201,0.447761194,0.049751244,0.60199005,3,0.889945023
2515,37,20420,10,10,0,0,0,20,11,10,0,0,0,21,nowin,loss,beat,dlwin,0,10,20,208,0.394230769,0.038461538,0.581730769,0,0.024682772
2516,115,20420,8,2,4,10,0,24,11,10,0,0,0,21,nowin,loss,bust,plbust,0,10,10,194,0.427835052,0.041237113,0.592783505,2,0.583863602
2517,140,20420,1,5,10,5,0,21,11,10,0,0,0,21,nowin,push,push,push,10,0,6,210,0.466666667,0.023809524,0.604761905,3,0.915293335
2518,74,20420,5,6,7,0,0,18,11,10,0,0,0,21,nowin,loss,beat,dlwin,0,10,11,209,0.411483254,0.04784689,0.531100478,0,0.017448125
2519,92,20420,3,10,0,4,0,17,11,10,0,0,0,21,nowin,loss,beat,dlwin,0,10,13,186,0.446236559,0.059139785,0.564516129,1,0.307826125
2520,25,20421,9,7,0,2,0,18,7,9,10,0,0,26,nowin,win,dlbust,bust,20,0,16,190,0.463157895,0.063157895,0.536842105,1,0.304401563
2521,44,20421,5,9,0,2,5,21,7,9,10,0,0,26,nowin,win,dlbust,bust,20,0,14,219,0.433789954,0.050228311,0.534246575,1,0.285551035
2522,99,20421,10,5,0,1,10,26,7,9,10,0,0,26,nowin,loss,bust,plbust,0,10,15,207,0.47826087,0.062801932,0.637681159,3,0.961418446
2523,31,20421,10,11,0,0,0,21,7,9,10,0,0,26,win,win,dlbust,bust,25,0,21,188,0.473404255,0.058510638,0.515957447,1,0.300306557
2524,64,20421,10,2,0,10,0,22,7,9,10,0,0,26,nowin,loss,bust,plbust,0,10,12,187,0.363636364,0.048128342,0.631016043,0,0.027594885
2525,133,20421,5,5,2,5,0,17,7,9,10,0,0,26,nowin,win,dlbust,bust,20,0,10,201,0.47761194,0.064676617,0.611940299,3,0.935428111
2526,64,20422,4,4,10,0,0,18,10,7,0,0,0,17,nowin,win,plwin,beat,20,0,8,187,0.363636364,0.048128342,0.631016043,0,0.027594885
2527,97,20422,5,3,7,10,0,25,10,7,0,0,0,17,nowin,loss,bust,plbust,0,10,8,182,0.450549451,0.06043956,0.692307692,2,0.677372279
2528,113,20422,2,5,8,9,0,24,10,7,0,0,0,17,nowin,loss,bust,plbust,0,10,7,199,0.407035176,0.055276382,0.668341709,2,0.620695264
2529,84,20422,10,8,0,0,0,18,10,7,0,0,0,17,nowin,win,plwin,beat,20,0,18,195,0.379487179,0.056410256,0.569230769,0,0.017209119
2530,130,20422,5,3,10,0,0,18,10,7,0,0,0,17,nowin,win,plwin,beat,20,0,8,219,0.410958904,0.03652968,0.566210046,0,0.025888739
2531,112,20422,6,4,9,0,0,19,10,7,0,0,0,17,nowin,win,plwin,beat,20,0,10,203,0.448275862,0.054187192,0.600985222,3,0.889576933
2532,137,20423,5,3,11,0,0,19,4,4,6,6,0,20,nowin,loss,beat,dlwin,0,10,8,194,0.417525773,0.046391753,0.536082474,1,0.276714602
2533,62,20423,5,7,0,0,0,12,4,4,6,6,0,20,nowin,loss,beat,dlwin,0,10,12,178,0.370786517,0.028089888,0.54494382,0,0.008657722
2534,133,20423,8,2,7,0,0,17,4,4,6,6,0,20,nowin,loss,beat,dlwin,0,10,10,201,0.47761194,0.064676617,0.611940299,3,0.935428111
2535,6,20423,10,10,0,0,0,20,4,4,6,6,0,20,nowin,push,push,push,10,0,20,191,0.439790576,0.047120419,0.581151832,1,0.31211505
2536,68,20423,6,6,0,0,0,12,4,4,6,6,0,20,nowin,loss,beat,dlwin,0,10,12,205,0.434146341,0.029268293,0.6,2,0.59483189
2537,51,20423,10,11,0,0,0,21,4,4,6,6,0,20,win,win,plwin,beat,25,0,21,189,0.529100529,0.068783069,0.608465608,3,0.993665715
2538,63,20424,10,10,0,0,0,20,11,1,1,3,3,19,nowin,win,plwin,beat,20,0,20,216,0.467592593,0.037037037,0.62037037,3,0.931690496
2539,63,20424,4,3,7,4,0,18,11,1,1,3,3,19,nowin,loss,beat,dlwin,0,10,7,216,0.467592593,0.037037037,0.62037037,3,0.931690496
2540,93,20424,2,9,10,0,0,21,11,1,1,3,3,19,nowin,win,plwin,beat,20,0,11,175,0.485714286,0.051428571,0.548571429,1,0.323648091
2541,141,20424,2,8,9,0,0,19,11,1,1,3,3,19,nowin,push,push,push,10,0,10,202,0.420792079,0.074257426,0.564356436,0,0.028377851
2542,118,20424,10,10,0,0,0,20,11,1,1,3,3,19,nowin,win,plwin,beat,20,0,20,216,0.393518519,0.037037037,0.555555556,0,0.018059873
2543,142,20424,6,10,0,10,0,26,11,1,1,3,3,19,nowin,loss,bust,plbust,0,10,16,211,0.417061611,0.047393365,0.526066351,1,0.271531309
2544,128,20425,4,1,10,0,0,15,3,8,4,10,0,25,nowin,win,dlbust,bust,20,0,5,227,0.356828194,0.052863436,0.577092511,0,0.012352564
2545,9,20425,4,6,10,0,0,20,3,8,4,10,0,25,nowin,win,dlbust,bust,20,0,10,194,0.37628866,0.015463918,0.541237113,0,0.009396796
2546,60,20425,9,11,0,0,0,20,3,8,4,10,0,25,nowin,win,dlbust,bust,20,0,20,227,0.418502203,0.022026432,0.559471366,0,0.026496258
2547,19,20425,11,2,7,0,0,20,3,8,4,10,0,25,nowin,win,dlbust,bust,20,0,13,237,0.41350211,0.054852321,0.628691983,2,0.597373826
2548,87,20425,11,6,3,0,0,20,3,8,4,10,0,25,nowin,win,dlbust,bust,20,0,17,202,0.405940594,0.054455446,0.628712871,2,0.590599801
2549,125,20425,8,7,0,0,0,15,3,8,4,10,0,25,nowin,win,dlbust,bust,20,0,15,219,0.438356164,0.050228311,0.575342466,1,0.308411257
2550,47,20426,2,4,2,7,10,25,11,10,0,0,0,21,nowin,loss,bust,plbust,0,10,6,210,0.438095238,0.057142857,0.623809524,2,0.615868808
2551,43,20426,9,6,0,5,0,20,11,10,0,0,0,21,nowin,loss,beat,dlwin,0,10,15,192,0.40625,0.041666667,0.609375,2,0.576671372
2552,109,20426,8,2,10,0,0,20,11,10,0,0,0,21,nowin,loss,beat,dlwin,0,10,10,221,0.461538462,0.058823529,0.597285068,3,0.901830309
2553,107,20426,2,10,0,1,10,23,11,10,0,0,0,21,nowin,loss,bust,plbust,0,10,12,218,0.444954128,0.073394495,0.600917431,2,0.605210014
2554,125,20426,6,7,0,4,0,17,11,10,0,0,0,21,nowin,loss,beat,dlwin,0,10,13,219,0.438356164,0.050228311,0.575342466,1,0.308411257
2555,30,20426,10,9,0,0,0,19,11,10,0,0,0,21,nowin,loss,beat,dlwin,0,10,19,206,0.393203883,0.033980583,0.601941748,0,0.029324648
2556,73,20427,9,9,0,0,0,18,10,7,0,0,0,17,nowin,win,plwin,beat,20,0,18,181,0.375690608,0.011049724,0.596685083,0,0.022795773
2557,79,20427,7,10,0,0,0,17,10,7,0,0,0,17,nowin,push,push,push,10,0,17,211,0.436018957,0.028436019,0.672985782,2,0.650131054
2558,115,20427,5,10,0,6,0,21,10,7,0,0,0,17,nowin,win,plwin,beat,20,0,15,194,0.427835052,0.041237113,0.592783505,2,0.583863602
2559,89,20427,4,10,0,1,5,20,10,7,0,0,0,17,nowin,win,plwin,beat,20,0,14,212,0.537735849,0.047169811,0.594339623,3,0.990167191
2560,77,20427,4,3,2,10,0,19,10,7,0,0,0,17,nowin,win,plwin,beat,20,0,7,200,0.455,0.04,0.62,3,0.916252116
2561,84,20427,10,10,0,0,0,20,10,7,0,0,0,17,nowin,win,plwin,beat,20,0,20,195,0.379487179,0.056410256,0.569230769,0,0.017209119
2562,45,20428,5,2,5,10,0,22,10,11,0,0,0,21,nowin,loss,bust,plbust,0,10,7,196,0.428571429,0.051020408,0.612244898,2,0.598821767
2563,17,20428,10,4,0,10,0,24,10,11,0,0,0,21,nowin,loss,bust,plbust,0,10,14,171,0.444444444,0.070175439,0.555555556,1,0.302364894
2564,38,20428,6,8,0,10,0,24,10,11,0,0,0,21,nowin,loss,bust,plbust,0,10,14,202,0.361386139,0.03960396,0.564356436,0,0.010597953
2565,1,20428,5,9,0,6,0,20,10,11,0,0,0,21,nowin,loss,beat,dlwin,0,10,14,197,0.406091371,0.025380711,0.649746193,2,0.606186955
2566,5,20428,5,10,0,1,1,17,10,11,0,0,0,21,nowin,loss,beat,dlwin,0,10,15,203,0.42364532,0.02955665,0.596059113,2,0.582508076
2567,1,20428,10,7,0,0,0,17,10,11,0,0,0,21,nowin,loss,beat,dlwin,0,10,17,197,0.406091371,0.025380711,0.649746193,2,0.606186955
2568,143,20429,10,4,0,8,0,22,8,3,10,0,0,21,nowin,loss,bust,plbust,0,10,14,203,0.463054187,0.044334975,0.57635468,3,0.883143365
2569,33,20429,6,10,0,10,0,26,8,3,10,0,0,21,nowin,loss,bust,plbust,0,10,16,192,0.4375,0.057291667,0.625,2,0.616208916
2570,147,20429,10,10,0,0,0,20,8,3,10,0,0,21,nowin,loss,beat,dlwin,0,10,20,205,0.380487805,0.014634146,0.536585366,0,0.00951447
2571,56,20429,5,7,0,4,4,20,8,3,10,0,0,21,nowin,loss,beat,dlwin,0,10,12,175,0.4,0.057142857,0.582857143,0,0.026685297
2572,86,20429,8,7,0,1,10,26,8,3,10,0,0,21,nowin,loss,bust,plbust,0,10,15,196,0.454081633,0.040816327,0.591836735,3,0.887566443
2573,81,20429,11,3,6,0,0,20,8,3,10,0,0,21,nowin,loss,beat,dlwin,0,10,14,182,0.395604396,0.043956044,0.60989011,2,0.567491261
2574,21,20430,8,2,10,0,0,20,2,8,6,1,0,17,nowin,win,plwin,beat,20,0,10,214,0.359813084,0.042056075,0.626168224,0,0.025263474
2575,36,20430,4,10,0,0,0,14,2,8,6,1,0,17,nowin,loss,beat,dlwin,0,10,14,229,0.445414847,0.056768559,0.655021834,2,0.645370571
2576,41,20430,10,10,0,0,0,20,2,8,6,1,0,17,nowin,win,plwin,beat,20,0,20,192,0.364583333,0.036458333,0.520833333,0,0.00089702
2577,122,20430,7,10,0,0,0,17,2,8,6,1,0,17,nowin,push,push,push,10,0,17,210,0.347619048,0.052380952,0.59047619,0,0.012873677
2578,62,20430,2,2,9,0,0,13,2,8,6,1,0,17,nowin,loss,beat,dlwin,0,10,4,178,0.370786517,0.028089888,0.54494382,0,0.008657722
2579,75,20430,3,3,5,4,0,15,2,8,6,1,0,17,nowin,loss,beat,dlwin,0,10,6,191,0.418848168,0.052356021,0.570680628,0,0.029344702
2580,12,20431,11,9,0,0,0,20,10,5,4,0,0,19,nowin,win,plwin,beat,20,0,20,189,0.470899471,0.015873016,0.613756614,3,0.929171178
2581,39,20431,1,6,10,0,0,17,10,5,4,0,0,19,nowin,loss,beat,dlwin,0,10,7,191,0.429319372,0.062827225,0.57591623,0,0.033760763
2582,147,20431,10,10,0,0,0,20,10,5,4,0,0,19,nowin,win,plwin,beat,20,0,20,205,0.380487805,0.014634146,0.536585366,0,0.00951447
2583,119,20431,2,4,9,9,0,24,10,5,4,0,0,19,nowin,loss,bust,plbust,0,10,6,190,0.405263158,0.068421053,0.515789474,0,0.011837158
2584,17,20431,4,10,0,5,0,19,10,5,4,0,0,19,nowin,push,push,push,10,0,14,171,0.444444444,0.070175439,0.555555556,1,0.302364894
2585,134,20431,6,8,0,7,0,21,10,5,4,0,0,19,nowin,win,plwin,beat,20,0,14,185,0.443243243,0.021621622,0.545945946,1,0.296939509
2586,89,20432,5,10,0,8,0,23,10,2,9,0,0,21,nowin,loss,bust,plbust,0,10,15,212,0.537735849,0.047169811,0.594339623,3,0.990167191
2587,130,20432,10,10,0,0,0,20,10,2,9,0,0,21,nowin,loss,beat,dlwin,0,10,20,219,0.410958904,0.03652968,0.566210046,0,0.025888739
2588,81,20432,7,10,0,0,0,17,10,2,9,0,0,21,nowin,loss,beat,dlwin,0,10,17,182,0.395604396,0.043956044,0.60989011,2,0.567491261
2589,6,20432,10,8,0,0,0,18,10,2,9,0,0,21,nowin,loss,beat,dlwin,0,10,18,191,0.439790576,0.047120419,0.581151832,1,0.31211505
2590,122,20432,7,5,0,10,0,22,10,2,9,0,0,21,nowin,loss,bust,plbust,0,10,12,210,0.347619048,0.052380952,0.59047619,0,0.012873677
2591,42,20432,10,11,0,0,0,21,10,2,9,0,0,21,win,push,push,push,10,0,21,212,0.443396226,0.051886792,0.570754717,1,0.309181312
2592,103,20433,9,5,0,0,0,14,4,10,10,0,0,24,nowin,win,dlbust,bust,20,0,14,203,0.379310345,0.064039409,0.551724138,0,0.012869209
2593,117,20433,1,3,10,0,0,14,4,10,10,0,0,24,nowin,win,dlbust,bust,20,0,4,173,0.410404624,0.069364162,0.606936416,2,0.578610282
2594,12,20433,1,6,8,0,0,15,4,10,10,0,0,24,nowin,win,dlbust,bust,20,0,7,189,0.470899471,0.015873016,0.613756614,3,0.929171178
2595,11,20433,3,8,4,0,0,15,4,10,10,0,0,24,nowin,win,dlbust,bust,20,0,11,236,0.457627119,0.016949153,0.588983051,3,0.889015813
2596,65,20433,9,5,0,0,0,14,4,10,10,0,0,24,nowin,win,dlbust,bust,20,0,14,203,0.492610837,0.054187192,0.571428571,3,0.913702814
2597,90,20433,2,3,10,0,0,15,4,10,10,0,0,24,nowin,win,dlbust,bust,20,0,5,201,0.447761194,0.049751244,0.60199005,3,0.889945023
2598,114,20434,5,2,8,0,0,15,5,7,6,0,0,18,nowin,loss,beat,dlwin,0,10,7,198,0.47979798,0.025252525,0.611111111,3,0.937232995
2599,58,20434,9,4,0,0,0,13,5,7,6,0,0,18,nowin,loss,beat,dlwin,0,10,13,195,0.430769231,0.041025641,0.584615385,2,0.580497586
2600,111,20434,8,10,0,0,0,18,5,7,6,0,0,18,nowin,push,push,push,10,0,18,180,0.433333333,0.055555556,0.611111111,2,0.602264492
2601,140,20434,7,6,0,0,0,13,5,7,6,0,0,18,nowin,loss,beat,dlwin,0,10,13,210,0.466666667,0.023809524,0.604761905,3,0.915293335
2602,60,20434,2,8,8,0,0,18,5,7,6,0,0,18,nowin,push,push,push,10,0,10,227,0.418502203,0.022026432,0.559471366,0,0.026496258
2603,40,20434,10,9,0,0,0,19,5,7,6,0,0,18,nowin,win,plwin,beat,20,0,19,196,0.367346939,0.030612245,0.617346939,0,0.025358183
2604,81,20435,10,7,0,0,0,17,10,2,7,0,0,19,nowin,loss,beat,dlwin,0,10,17,182,0.395604396,0.043956044,0.60989011,2,0.567491261
2605,59,20435,10,6,0,7,0,23,10,2,7,0,0,19,nowin,loss,bust,plbust,0,10,16,228,0.429824561,0.048245614,0.543859649,1,0.287885446
2606,50,20435,3,6,6,5,0,20,10,2,7,0,0,19,nowin,win,plwin,beat,20,0,9,202,0.405940594,0.04950495,0.54950495,0,0.020296079
2607,77,20435,11,10,0,0,0,21,10,2,7,0,0,19,win,win,plwin,beat,25,0,21,200,0.455,0.04,0.62,3,0.916252116
2608,32,20435,11,10,0,0,0,21,10,2,7,0,0,19,win,win,plwin,beat,25,0,21,189,0.391534392,0.037037037,0.53968254,0,0.013579086
2609,99,20435,7,8,0,3,0,18,10,2,7,0,0,19,nowin,loss,beat,dlwin,0,10,15,207,0.47826087,0.062801932,0.637681159,3,0.961418446
2610,144,20436,6,7,0,0,0,13,4,9,10,0,0,23,nowin,win,dlbust,bust,20,0,13,202,0.386138614,0.054455446,0.564356436,0,0.018006244
2611,55,20436,9,9,0,0,0,18,4,9,10,0,0,23,nowin,win,dlbust,bust,20,0,18,191,0.371727749,0.057591623,0.54973822,0,0.01011347
2612,77,20436,2,9,10,0,0,21,4,9,10,0,0,23,nowin,win,dlbust,bust,20,0,11,200,0.455,0.04,0.62,3,0.916252116
2613,58,20436,4,10,0,0,0,14,4,9,10,0,0,23,nowin,win,dlbust,bust,20,0,14,195,0.430769231,0.041025641,0.584615385,2,0.580497586
2614,113,20436,10,10,0,0,0,20,4,9,10,0,0,23,nowin,win,dlbust,bust,20,0,20,199,0.407035176,0.055276382,0.668341709,2,0.620695264
2615,23,20436,3,10,0,0,0,13,4,9,10,0,0,23,nowin,win,dlbust,bust,20,0,13,208,0.427884615,0.0625,0.552884615,1,0.29114424
2616,124,20437,10,5,0,1,10,26,10,10,0,0,0,20,nowin,loss,bust,plbust,0,10,15,202,0.47029703,0.064356436,0.584158416,3,0.899458193
2617,21,20437,8,10,0,0,0,18,10,10,0,0,0,20,nowin,loss,beat,dlwin,0,10,18,214,0.359813084,0.042056075,0.626168224,0,0.025263474
2618,52,20437,10,4,0,3,0,17,10,10,0,0,0,20,nowin,loss,beat,dlwin,0,10,14,217,0.414746544,0.02764977,0.599078341,2,0.576736024
2619,120,20437,6,5,4,10,0,25,10,10,0,0,0,20,nowin,loss,bust,plbust,0,10,11,202,0.440594059,0.034653465,0.618811881,2,0.614441029
2620,115,20437,7,2,4,7,0,20,10,10,0,0,0,20,nowin,push,push,push,10,0,9,194,0.427835052,0.041237113,0.592783505,2,0.583863602
2621,98,20437,5,4,5,8,0,22,10,10,0,0,0,20,nowin,loss,bust,plbust,0,10,9,220,0.422727273,0.054545455,0.55,1,0.28664435
2622,14,20438,10,7,0,0,0,17,5,8,3,3,0,19,nowin,loss,beat,dlwin,0,10,17,202,0.391089109,0.01980198,0.628712871,2,0.577264877
2623,134,20438,3,7,8,0,0,18,5,8,3,3,0,19,nowin,loss,beat,dlwin,0,10,10,185,0.443243243,0.021621622,0.545945946,1,0.296939509
2624,79,20438,4,2,5,2,0,13,5,8,3,3,0,19,nowin,loss,beat,dlwin,0,10,6,211,0.436018957,0.028436019,0.672985782,2,0.650131054
2625,87,20438,9,10,0,0,0,19,5,8,3,3,0,19,nowin,push,push,push,10,0,19,202,0.405940594,0.054455446,0.628712871,2,0.590599801
2626,58,20438,3,10,0,0,0,13,5,8,3,3,0,19,nowin,loss,beat,dlwin,0,10,13,195,0.430769231,0.041025641,0.584615385,2,0.580497586
2627,103,20438,11,4,5,0,0,20,5,8,3,3,0,19,nowin,win,plwin,beat,20,0,15,203,0.379310345,0.064039409,0.551724138,0,0.012869209
2628,6,20439,10,10,0,0,0,20,8,10,0,0,0,18,nowin,win,plwin,beat,20,0,20,191,0.439790576,0.047120419,0.581151832,1,0.31211505
2629,89,20439,3,10,0,5,0,18,8,10,0,0,0,18,nowin,push,push,push,10,0,13,212,0.537735849,0.047169811,0.594339623,3,0.990167191
2630,102,20439,6,2,9,0,0,17,8,10,0,0,0,18,nowin,loss,beat,dlwin,0,10,8,192,0.338541667,0.046875,0.5625,0,0.003306118
2631,127,20439,7,8,0,3,0,18,8,10,0,0,0,18,nowin,push,push,push,10,0,15,201,0.402985075,0.029850746,0.60199005,0,0.032263937
2632,110,20439,2,10,0,10,0,22,8,10,0,0,0,18,nowin,loss,bust,plbust,0,10,12,192,0.416666667,0.046875,0.557291667,0,0.025413132
2633,57,20439,7,4,10,0,0,21,8,10,0,0,0,18,nowin,win,plwin,beat,20,0,11,192,0.46875,0.052083333,0.59375,3,0.907001181
2634,95,20440,10,2,0,0,0,12,5,10,10,0,0,25,nowin,win,dlbust,bust,20,0,12,218,0.412844037,0.04587156,0.559633028,0,0.024842385
2635,15,20440,8,8,0,0,0,16,5,10,10,0,0,25,nowin,win,dlbust,bust,20,0,16,212,0.410377358,0.051886792,0.561320755,0,0.024517408
2636,86,20440,10,10,0,0,0,20,5,10,10,0,0,25,nowin,win,dlbust,bust,20,0,20,196,0.454081633,0.040816327,0.591836735,3,0.887566443
2637,43,20440,6,10,0,0,0,16,5,10,10,0,0,25,nowin,win,dlbust,bust,20,0,16,192,0.40625,0.041666667,0.609375,2,0.576671372
2638,92,20440,8,3,10,0,0,21,5,10,10,0,0,25,nowin,win,dlbust,bust,20,0,11,186,0.446236559,0.059139785,0.564516129,1,0.307826125
2639,142,20440,11,10,0,0,0,21,5,10,10,0,0,25,win,win,dlbust,bust,25,0,21,211,0.417061611,0.047393365,0.526066351,1,0.271531309
2640,65,20441,2,9,9,0,0,20,4,10,10,0,0,24,nowin,win,dlbust,bust,20,0,11,203,0.492610837,0.054187192,0.571428571,3,0.913702814
2641,4,20441,9,6,0,0,0,15,4,10,10,0,0,24,nowin,win,dlbust,bust,20,0,15,217,0.460829493,0.036866359,0.562211982,1,0.315432839
2642,20,20441,2,2,3,5,0,12,4,10,10,0,0,24,nowin,win,dlbust,bust,20,0,4,186,0.456989247,0.037634409,0.537634409,1,0.301097108
2643,55,20441,10,8,0,0,0,18,4,10,10,0,0,24,nowin,win,dlbust,bust,20,0,18,191,0.371727749,0.057591623,0.54973822,0,0.01011347
2644,48,20441,2,2,6,10,0,20,4,10,10,0,0,24,nowin,win,dlbust,bust,20,0,4,203,0.413793103,0.019704433,0.600985222,2,0.577280801
2645,52,20441,6,4,6,0,0,16,4,10,10,0,0,24,nowin,win,dlbust,bust,20,0,10,217,0.414746544,0.02764977,0.599078341,2,0.576736024
2646,73,20442,10,8,0,0,0,18,4,1,9,10,0,24,nowin,win,dlbust,bust,20,0,18,181,0.375690608,0.011049724,0.596685083,0,0.022795773
2647,85,20442,10,11,0,0,0,21,4,1,9,10,0,24,win,win,dlbust,bust,25,0,21,195,0.41025641,0.066666667,0.594871795,0,0.03269711
2648,121,20442,10,3,0,0,0,13,4,1,9,10,0,24,nowin,win,dlbust,bust,20,0,13,195,0.456410256,0.025641026,0.512820513,1,0.288597791
2649,58,20442,5,10,0,0,0,15,4,1,9,10,0,24,nowin,win,dlbust,bust,20,0,15,195,0.430769231,0.041025641,0.584615385,2,0.580497586
2650,43,20442,5,2,10,0,0,17,4,1,9,10,0,24,nowin,win,dlbust,bust,20,0,7,192,0.40625,0.041666667,0.609375,2,0.576671372
2651,58,20442,10,3,0,0,0,13,4,1,9,10,0,24,nowin,win,dlbust,bust,20,0,13,195,0.430769231,0.041025641,0.584615385,2,0.580497586
2652,109,20443,2,10,0,5,0,17,7,11,0,0,0,18,nowin,loss,beat,dlwin,0,10,12,221,0.461538462,0.058823529,0.597285068,3,0.901830309
2653,64,20443,7,7,0,10,0,24,7,11,0,0,0,18,nowin,loss,bust,plbust,0,10,14,187,0.363636364,0.048128342,0.631016043,0,0.027594885
2654,110,20443,5,10,0,3,0,18,7,11,0,0,0,18,nowin,push,push,push,10,0,15,192,0.416666667,0.046875,0.557291667,0,0.025413132
2655,132,20443,5,2,10,0,0,17,7,11,0,0,0,18,nowin,loss,beat,dlwin,0,10,7,194,0.412371134,0.036082474,0.649484536,2,0.611633238
2656,28,20443,8,10,0,0,0,18,7,11,0,0,0,18,nowin,push,push,push,10,0,18,199,0.422110553,0.045226131,0.542713568,1,0.282706618
2657,95,20443,8,4,0,3,10,25,7,11,0,0,0,18,nowin,loss,bust,plbust,0,10,12,218,0.412844037,0.04587156,0.559633028,0,0.024842385
2658,71,20444,2,5,10,0,0,17,6,10,9,0,0,25,nowin,win,dlbust,bust,20,0,7,193,0.352331606,0.046632124,0.585492228,0,0.013063661
2659,111,20444,11,4,1,0,0,16,6,10,9,0,0,25,nowin,win,dlbust,bust,20,0,15,180,0.433333333,0.055555556,0.611111111,2,0.602264492
2660,52,20444,11,2,8,0,0,21,6,10,9,0,0,25,nowin,win,dlbust,bust,20,0,13,217,0.414746544,0.02764977,0.599078341,2,0.576736024
2661,139,20444,10,7,0,0,0,17,6,10,9,0,0,25,nowin,win,dlbust,bust,20,0,17,192,0.380208333,0.036458333,0.59375,0,0.023429169
2662,81,20444,6,7,0,0,0,13,6,10,9,0,0,25,nowin,win,dlbust,bust,20,0,13,182,0.395604396,0.043956044,0.60989011,2,0.567491261
2663,32,20444,5,10,0,0,0,15,6,10,9,0,0,25,nowin,win,dlbust,bust,20,0,15,189,0.391534392,0.037037037,0.53968254,0,0.013579086
2664,130,20445,10,5,0,10,0,25,11,8,0,0,0,19,nowin,loss,bust,plbust,0,10,15,219,0.410958904,0.03652968,0.566210046,0,0.025888739
2665,112,20445,4,5,8,0,0,17,11,8,0,0,0,19,nowin,loss,beat,dlwin,0,10,9,203,0.448275862,0.054187192,0.600985222,3,0.889576933
2666,66,20445,4,9,0,3,10,26,11,8,0,0,0,19,nowin,loss,bust,plbust,0,10,13,217,0.456221198,0.064516129,0.626728111,3,0.924304367
2667,101,20445,9,9,0,0,0,18,11,8,0,0,0,19,nowin,loss,beat,dlwin,0,10,18,205,0.424390244,0.068292683,0.63902439,2,0.614740646
2668,16,20445,10,2,0,6,0,18,11,8,0,0,0,19,nowin,loss,beat,dlwin,0,10,12,220,0.427272727,0.081818182,0.6,2,0.588660176
2669,31,20445,3,2,5,8,0,18,11,8,0,0,0,19,nowin,loss,beat,dlwin,0,10,5,188,0.473404255,0.058510638,0.515957447,1,0.300306557
2670,127,20446,10,7,0,0,0,17,5,8,10,0,0,23,nowin,win,dlbust,bust,20,0,17,201,0.402985075,0.029850746,0.60199005,0,0.032263937
2671,39,20446,2,7,10,0,0,19,5,8,10,0,0,23,nowin,win,dlbust,bust,20,0,9,191,0.429319372,0.062827225,0.57591623,0,0.033760763
2672,33,20446,11,7,0,0,0,18,5,8,10,0,0,23,nowin,win,dlbust,bust,20,0,18,192,0.4375,0.057291667,0.625,2,0.616208916
2673,131,20446,10,10,0,0,0,20,5,8,10,0,0,23,nowin,win,dlbust,bust,20,0,20,217,0.410138249,0.069124424,0.543778802,0,0.02015021
2674,112,20446,5,10,0,0,0,15,5,8,10,0,0,23,nowin,win,dlbust,bust,20,0,15,203,0.448275862,0.054187192,0.600985222,3,0.889576933
2675,109,20446,3,4,10,0,0,17,5,8,10,0,0,23,nowin,win,dlbust,bust,20,0,7,221,0.461538462,0.058823529,0.597285068,3,0.901830309
2676,38,20447,9,3,0,10,0,22,9,10,0,0,0,19,nowin,loss,bust,plbust,0,10,12,202,0.361386139,0.03960396,0.564356436,0,0.010597953
2677,107,20447,4,8,0,10,0,22,9,10,0,0,0,19,nowin,loss,bust,plbust,0,10,12,218,0.444954128,0.073394495,0.600917431,2,0.605210014
2678,143,20447,10,6,0,1,0,17,9,10,0,0,0,19,nowin,loss,beat,dlwin,0,10,16,203,0.463054187,0.044334975,0.57635468,3,0.883143365
2679,82,20447,10,10,0,0,0,20,9,10,0,0,0,19,nowin,win,plwin,beat,20,0,20,225,0.408888889,0.075555556,0.577777778,0,0.028101874
2680,94,20447,10,4,0,10,0,24,9,10,0,0,0,19,nowin,loss,bust,plbust,0,10,14,183,0.43715847,0.043715847,0.540983607,1,0.290866892
2681,126,20447,11,10,0,0,0,21,9,10,0,0,0,19,win,win,plwin,beat,25,0,21,188,0.457446809,0.074468085,0.60106383,3,0.900633203
2682,28,20448,1,2,10,0,0,13,6,3,10,0,0,19,nowin,loss,beat,dlwin,0,10,3,199,0.422110553,0.045226131,0.542713568,1,0.282706618
2683,149,20448,6,9,0,0,0,15,6,3,10,0,0,19,nowin,loss,beat,dlwin,0,10,15,225,0.457777778,0.057777778,0.648888889,2,0.651965595
2684,87,20448,9,10,0,0,0,19,6,3,10,0,0,19,nowin,push,push,push,10,0,19,202,0.405940594,0.054455446,0.628712871,2,0.590599801
2685,59,20448,7,5,0,0,0,12,6,3,10,0,0,19,nowin,loss,beat,dlwin,0,10,12,228,0.429824561,0.048245614,0.543859649,1,0.287885446
2686,105,20448,10,11,0,0,0,21,6,3,10,0,0,19,win,win,plwin,beat,25,0,21,198,0.414141414,0.070707071,0.590909091,0,0.032889494
2687,24,20448,10,4,0,0,0,14,6,3,10,0,0,19,nowin,loss,beat,dlwin,0,10,14,207,0.458937198,0.048309179,0.570048309,1,0.318138014
2688,69,20449,3,4,4,10,0,21,2,5,9,10,0,26,nowin,win,dlbust,bust,20,0,7,194,0.365979381,0.030927835,0.515463918,0,0
2689,17,20449,7,9,0,0,0,16,2,5,9,10,0,26,nowin,win,dlbust,bust,20,0,16,171,0.444444444,0.070175439,0.555555556,1,0.302364894
2690,44,20449,9,10,0,0,0,19,2,5,9,10,0,26,nowin,win,dlbust,bust,20,0,19,219,0.433789954,0.050228311,0.534246575,1,0.285551035
2691,131,20449,2,10,0,6,0,18,2,5,9,10,0,26,nowin,win,dlbust,bust,20,0,12,217,0.410138249,0.069124424,0.543778802,0,0.02015021
2692,21,20449,10,11,0,0,0,21,2,5,9,10,0,26,win,win,dlbust,bust,25,0,21,214,0.359813084,0.042056075,0.626168224,0,0.025263474
2693,59,20449,10,7,0,0,0,17,2,5,9,10,0,26,nowin,win,dlbust,bust,20,0,17,228,0.429824561,0.048245614,0.543859649,1,0.287885446
2694,42,20450,10,3,0,2,10,25,7,10,0,0,0,17,nowin,loss,bust,plbust,0,10,13,212,0.443396226,0.051886792,0.570754717,1,0.309181312
2695,143,20450,11,10,0,0,0,21,7,10,0,0,0,17,win,win,plwin,beat,25,0,21,203,0.463054187,0.044334975,0.57635468,3,0.883143365
2696,138,20450,8,10,0,0,0,18,7,10,0,0,0,17,nowin,win,plwin,beat,20,0,18,190,0.442105263,0.047368421,0.610526316,2,0.609711065
2697,122,20450,7,11,0,0,0,18,7,10,0,0,0,17,nowin,win,plwin,beat,20,0,18,210,0.347619048,0.052380952,0.59047619,0,0.012873677
2698,72,20450,10,5,0,10,0,25,7,10,0,0,0,17,nowin,loss,bust,plbust,0,10,15,185,0.394594595,0.032432432,0.508108108,0,0.006763115
2699,140,20450,9,10,0,0,0,19,7,10,0,0,0,17,nowin,win,plwin,beat,20,0,19,210,0.466666667,0.023809524,0.604761905,3,0.915293335
2700,149,20451,6,9,0,6,0,21,10,3,7,0,0,20,nowin,win,plwin,beat,20,0,15,225,0.457777778,0.057777778,0.648888889,2,0.651965595
2701,80,20451,5,2,7,8,0,22,10,3,7,0,0,20,nowin,loss,bust,plbust,0,10,7,186,0.419354839,0.059139785,0.623655914,2,0.59892924
2702,12,20451,11,2,6,0,0,19,10,3,7,0,0,20,nowin,loss,beat,dlwin,0,10,13,189,0.470899471,0.015873016,0.613756614,3,0.929171178
2703,130,20451,4,4,10,0,0,18,10,3,7,0,0,20,nowin,loss,beat,dlwin,0,10,8,219,0.410958904,0.03652968,0.566210046,0,0.025888739
2704,130,20451,3,10,0,10,0,23,10,3,7,0,0,20,nowin,loss,bust,plbust,0,10,13,219,0.410958904,0.03652968,0.566210046,0,0.025888739
2705,48,20451,5,9,0,5,0,19,10,3,7,0,0,20,nowin,loss,beat,dlwin,0,10,14,203,0.413793103,0.019704433,0.600985222,2,0.577280801
2706,66,20452,4,8,0,0,0,12,5,6,10,0,0,21,nowin,loss,beat,dlwin,0,10,12,217,0.456221198,0.064516129,0.626728111,3,0.924304367
2707,4,20452,11,3,5,0,0,19,5,6,10,0,0,21,nowin,loss,beat,dlwin,0,10,14,217,0.460829493,0.036866359,0.562211982,1,0.315432839
2708,71,20452,10,4,0,0,0,14,5,6,10,0,0,21,nowin,loss,beat,dlwin,0,10,14,193,0.352331606,0.046632124,0.585492228,0,0.013063661
2709,75,20452,10,4,0,0,0,14,5,6,10,0,0,21,nowin,loss,beat,dlwin,0,10,14,191,0.418848168,0.052356021,0.570680628,0,0.029344702
2710,11,20452,10,10,0,0,0,20,5,6,10,0,0,21,nowin,loss,beat,dlwin,0,10,20,236,0.457627119,0.016949153,0.588983051,3,0.889015813
2711,97,20452,8,10,0,0,0,18,5,6,10,0,0,21,nowin,loss,beat,dlwin,0,10,18,182,0.450549451,0.06043956,0.692307692,2,0.677372279
2712,133,20453,2,7,3,4,0,16,3,8,2,3,8,24,nowin,win,dlbust,bust,20,0,9,201,0.47761194,0.064676617,0.611940299,3,0.935428111
2713,29,20453,4,6,8,0,0,18,3,8,2,3,8,24,nowin,win,dlbust,bust,20,0,10,189,0.44973545,0.058201058,0.544973545,1,0.300349439
2714,100,20453,9,5,0,0,0,14,3,8,2,3,8,24,nowin,win,dlbust,bust,20,0,14,190,0.452631579,0.036842105,0.594736842,3,0.888671154
2715,88,20453,3,3,6,10,0,22,3,8,2,3,8,24,nowin,loss,bust,plbust,0,10,6,206,0.466019417,0.033980583,0.54368932,1,0.309467903
2716,58,20453,10,9,0,0,0,19,3,8,2,3,8,24,nowin,win,dlbust,bust,20,0,19,195,0.430769231,0.041025641,0.584615385,2,0.580497586
2717,18,20453,7,3,11,0,0,21,3,8,2,3,8,24,nowin,win,dlbust,bust,20,0,10,182,0.461538462,0.043956044,0.587912088,3,0.892649374
2718,95,20454,5,8,0,0,0,13,5,7,3,5,0,20,nowin,loss,beat,dlwin,0,10,13,218,0.412844037,0.04587156,0.559633028,0,0.024842385
2719,67,20454,11,8,0,0,0,19,5,7,3,5,0,20,nowin,loss,beat,dlwin,0,10,19,195,0.369230769,0.041025641,0.569230769,0,0.014139427
2720,42,20454,5,1,6,0,0,12,5,7,3,5,0,20,nowin,loss,beat,dlwin,0,10,6,212,0.443396226,0.051886792,0.570754717,1,0.309181312
2721,101,20454,7,3,10,0,0,20,5,7,3,5,0,20,nowin,push,push,push,10,0,10,205,0.424390244,0.068292683,0.63902439,2,0.614740646
2722,103,20454,6,10,0,0,0,16,5,7,3,5,0,20,nowin,loss,beat,dlwin,0,10,16,203,0.379310345,0.064039409,0.551724138,0,0.012869209
2723,31,20454,10,4,0,0,0,14,5,7,3,5,0,20,nowin,loss,beat,dlwin,0,10,14,188,0.473404255,0.058510638,0.515957447,1,0.300306557
2724,69,20455,10,10,0,0,0,20,11,10,0,0,0,21,nowin,loss,beat,dlwin,0,10,20,194,0.365979381,0.030927835,0.515463918,0,0
2725,17,20455,4,7,4,1,10,26,11,10,0,0,0,21,nowin,loss,bust,plbust,0,10,11,171,0.444444444,0.070175439,0.555555556,1,0.302364894
2726,49,20455,10,4,0,10,0,24,11,10,0,0,0,21,nowin,loss,bust,plbust,0,10,14,207,0.396135266,0.053140097,0.594202899,0,0.028306925
2727,94,20455,2,3,2,5,2,14,11,10,0,0,0,21,nowin,loss,beat,dlwin,0,10,5,183,0.43715847,0.043715847,0.540983607,1,0.290866892
2728,48,20455,10,9,0,0,0,19,11,10,0,0,0,21,nowin,loss,beat,dlwin,0,10,19,203,0.413793103,0.019704433,0.600985222,2,0.577280801
2729,122,20455,10,10,0,0,0,20,11,10,0,0,0,21,nowin,loss,beat,dlwin,0,10,20,210,0.347619048,0.052380952,0.59047619,0,0.012873677
2730,43,20456,10,10,0,0,0,20,9,10,0,0,0,19,nowin,win,plwin,beat,20,0,20,192,0.40625,0.041666667,0.609375,2,0.576671372
2731,145,20456,11,10,0,0,0,21,9,10,0,0,0,19,win,win,plwin,beat,25,0,21,188,0.441489362,0.031914894,0.622340426,2,0.617837093
2732,57,20456,3,8,10,0,0,21,9,10,0,0,0,19,nowin,win,plwin,beat,20,0,11,192,0.46875,0.052083333,0.59375,3,0.907001181
2733,35,20456,10,2,0,7,0,19,9,10,0,0,0,19,nowin,push,push,push,10,0,12,202,0.410891089,0.044554455,0.633663366,2,0.598681573
2734,43,20456,10,10,0,0,0,20,9,10,0,0,0,19,nowin,win,plwin,beat,20,0,20,192,0.40625,0.041666667,0.609375,2,0.576671372
2735,102,20456,2,4,8,1,10,25,9,10,0,0,0,19,nowin,loss,bust,plbust,0,10,6,192,0.338541667,0.046875,0.5625,0,0.003306118
2736,24,20457,1,3,8,1,10,23,10,6,10,0,0,26,nowin,loss,bust,plbust,0,10,4,207,0.458937198,0.048309179,0.570048309,1,0.318138014
2737,29,20457,5,6,2,3,8,24,10,6,10,0,0,26,nowin,loss,bust,plbust,0,10,11,189,0.44973545,0.058201058,0.544973545,1,0.300349439
2738,60,20457,8,10,0,0,0,18,10,6,10,0,0,26,nowin,win,dlbust,bust,20,0,18,227,0.418502203,0.022026432,0.559471366,0,0.026496258
2739,91,20457,10,7,0,0,0,17,10,6,10,0,0,26,nowin,win,dlbust,bust,20,0,17,194,0.417525773,0.046391753,0.515463918,1,0.266616552
2740,112,20457,4,11,2,0,0,17,10,6,10,0,0,26,nowin,win,dlbust,bust,20,0,15,203,0.448275862,0.054187192,0.600985222,3,0.889576933
2741,136,20457,4,10,0,1,3,18,10,6,10,0,0,26,nowin,win,dlbust,bust,20,0,14,194,0.396907216,0.025773196,0.597938144,0,0.029452644
2742,138,20458,7,10,0,0,0,17,2,8,10,0,0,20,nowin,loss,beat,dlwin,0,10,17,190,0.442105263,0.047368421,0.610526316,2,0.609711065
2743,85,20458,10,6,0,0,0,16,2,8,10,0,0,20,nowin,loss,beat,dlwin,0,10,16,195,0.41025641,0.066666667,0.594871795,0,0.03269711
2744,48,20458,4,4,9,0,0,17,2,8,10,0,0,20,nowin,loss,beat,dlwin,0,10,8,203,0.413793103,0.019704433,0.600985222,2,0.577280801
2745,43,20458,3,10,0,0,0,13,2,8,10,0,0,20,nowin,loss,beat,dlwin,0,10,13,192,0.40625,0.041666667,0.609375,2,0.576671372
2746,100,20458,2,10,0,10,0,22,2,8,10,0,0,20,nowin,loss,bust,plbust,0,10,12,190,0.452631579,0.036842105,0.594736842,3,0.888671154
2747,67,20458,10,2,0,1,0,13,2,8,10,0,0,20,nowin,loss,beat,dlwin,0,10,12,195,0.369230769,0.041025641,0.569230769,0,0.014139427
2748,69,20459,11,10,0,0,0,21,7,5,8,0,0,20,win,win,plwin,beat,25,0,21,194,0.365979381,0.030927835,0.515463918,0,0
2749,35,20459,10,11,0,0,0,21,7,5,8,0,0,20,win,win,plwin,beat,25,0,21,202,0.410891089,0.044554455,0.633663366,2,0.598681573
2750,128,20459,7,10,0,0,0,17,7,5,8,0,0,20,nowin,loss,beat,dlwin,0,10,17,227,0.356828194,0.052863436,0.577092511,0,0.012352564
2751,12,20459,2,10,0,4,7,23,7,5,8,0,0,20,nowin,loss,bust,plbust,0,10,12,189,0.470899471,0.015873016,0.613756614,3,0.929171178
2752,32,20459,10,4,0,4,0,18,7,5,8,0,0,20,nowin,loss,beat,dlwin,0,10,14,189,0.391534392,0.037037037,0.53968254,0,0.013579086
2753,122,20459,10,10,0,0,0,20,7,5,8,0,0,20,nowin,push,push,push,10,0,20,210,0.347619048,0.052380952,0.59047619,0,0.012873677
2754,88,20460,9,10,0,0,0,19,5,10,1,10,0,26,nowin,win,dlbust,bust,20,0,19,206,0.466019417,0.033980583,0.54368932,1,0.309467903
2755,43,20460,2,5,9,0,0,16,5,10,1,10,0,26,nowin,win,dlbust,bust,20,0,7,192,0.40625,0.041666667,0.609375,2,0.576671372
2756,95,20460,11,1,2,0,0,14,5,10,1,10,0,26,nowin,win,dlbust,bust,20,0,12,218,0.412844037,0.04587156,0.559633028,0,0.024842385
2757,126,20460,3,6,8,0,0,17,5,10,1,10,0,26,nowin,win,dlbust,bust,20,0,9,188,0.457446809,0.074468085,0.60106383,3,0.900633203
2758,70,20460,3,10,0,0,0,13,5,10,1,10,0,26,nowin,win,dlbust,bust,20,0,13,228,0.385964912,0.039473684,0.557017544,0,0.016157125
2759,131,20460,4,10,0,0,0,14,5,10,1,10,0,26,nowin,win,dlbust,bust,20,0,14,217,0.410138249,0.069124424,0.543778802,0,0.02015021
2760,69,20461,10,10,0,0,0,20,6,2,2,5,5,20,nowin,push,push,push,10,0,20,194,0.365979381,0.030927835,0.515463918,0,0
2761,54,20461,2,9,4,0,0,15,6,2,2,5,5,20,nowin,loss,beat,dlwin,0,10,11,185,0.437837838,0.032432432,0.556756757,1,0.29899854
2762,45,20461,10,9,0,0,0,19,6,2,2,5,5,20,nowin,loss,beat,dlwin,0,10,19,196,0.428571429,0.051020408,0.612244898,2,0.598821767
2763,136,20461,3,10,0,0,0,13,6,2,2,5,5,20,nowin,loss,beat,dlwin,0,10,13,194,0.396907216,0.025773196,0.597938144,0,0.029452644
2764,37,20461,5,7,0,0,0,12,6,2,2,5,5,20,nowin,loss,beat,dlwin,0,10,12,208,0.394230769,0.038461538,0.581730769,0,0.024682772
2765,120,20461,4,10,0,0,0,14,6,2,2,5,5,20,nowin,loss,beat,dlwin,0,10,14,202,0.440594059,0.034653465,0.618811881,2,0.614441029
2766,129,20462,9,10,0,0,0,19,2,10,7,0,0,19,nowin,push,push,push,10,0,19,201,0.422885572,0.064676617,0.55721393,0,0.027255383
2767,64,20462,8,10,0,0,0,18,2,10,7,0,0,19,nowin,loss,beat,dlwin,0,10,18,187,0.363636364,0.048128342,0.631016043,0,0.027594885
2768,145,20462,10,4,0,0,0,14,2,10,7,0,0,19,nowin,loss,beat,dlwin,0,10,14,188,0.441489362,0.031914894,0.622340426,2,0.617837093
2769,69,20462,10,3,0,0,0,13,2,10,7,0,0,19,nowin,loss,beat,dlwin,0,10,13,194,0.365979381,0.030927835,0.515463918,0,0
2770,80,20462,11,6,3,0,0,20,2,10,7,0,0,19,nowin,win,plwin,beat,20,0,17,186,0.419354839,0.059139785,0.623655914,2,0.59892924
2771,42,20462,4,2,10,0,0,16,2,10,7,0,0,19,nowin,loss,beat,dlwin,0,10,6,212,0.443396226,0.051886792,0.570754717,1,0.309181312
2772,135,20463,10,10,0,0,0,20,3,10,8,0,0,21,nowin,loss,beat,dlwin,0,10,20,179,0.391061453,0.067039106,0.586592179,0,0.024924662
2773,7,20463,7,7,0,0,0,14,3,10,8,0,0,21,nowin,loss,beat,dlwin,0,10,14,183,0.442622951,0.06010929,0.62295082,2,0.619303341
2774,133,20463,9,7,0,0,0,16,3,10,8,0,0,21,nowin,loss,beat,dlwin,0,10,16,201,0.47761194,0.064676617,0.611940299,3,0.935428111
2775,36,20463,10,10,0,0,0,20,3,10,8,0,0,21,nowin,loss,beat,dlwin,0,10,20,229,0.445414847,0.056768559,0.655021834,2,0.645370571
2776,9,20463,8,6,0,0,0,14,3,10,8,0,0,21,nowin,loss,beat,dlwin,0,10,14,194,0.37628866,0.015463918,0.541237113,0,0.009396796
2777,20,20463,8,8,0,0,0,16,3,10,8,0,0,21,nowin,loss,beat,dlwin,0,10,16,186,0.456989247,0.037634409,0.537634409,1,0.301097108
2778,26,20464,11,10,0,0,0,21,11,7,0,0,0,18,win,win,plwin,beat,25,0,21,203,0.463054187,0.0591133,0.541871921,1,0.306802864
2779,31,20464,7,10,0,0,0,17,11,7,0,0,0,18,nowin,loss,beat,dlwin,0,10,17,188,0.473404255,0.058510638,0.515957447,1,0.300306557
2780,8,20464,11,1,3,8,0,23,11,7,0,0,0,18,nowin,loss,bust,plbust,0,10,12,181,0.44198895,0.071823204,0.596685083,2,0.599438402
2781,55,20464,3,10,0,1,1,15,11,7,0,0,0,18,nowin,loss,beat,dlwin,0,10,13,191,0.371727749,0.057591623,0.54973822,0,0.01011347
2782,142,20464,3,9,0,2,9,23,11,7,0,0,0,18,nowin,loss,bust,plbust,0,10,12,211,0.417061611,0.047393365,0.526066351,1,0.271531309
2783,63,20464,5,2,3,8,0,18,11,7,0,0,0,18,nowin,push,push,push,10,0,7,216,0.467592593,0.037037037,0.62037037,3,0.931690496
2784,23,20465,2,10,0,0,0,12,4,10,3,0,0,17,nowin,loss,beat,dlwin,0,10,12,208,0.427884615,0.0625,0.552884615,1,0.29114424
2785,105,20465,9,2,10,0,0,21,4,10,3,0,0,17,nowin,win,plwin,beat,20,0,11,198,0.414141414,0.070707071,0.590909091,0,0.032889494
2786,144,20465,10,7,0,0,0,17,4,10,3,0,0,17,nowin,push,push,push,10,0,17,202,0.386138614,0.054455446,0.564356436,0,0.018006244
2787,69,20465,9,8,0,0,0,17,4,10,3,0,0,17,nowin,push,push,push,10,0,17,194,0.365979381,0.030927835,0.515463918,0,0
2788,87,20465,4,8,0,0,0,12,4,10,3,0,0,17,nowin,loss,beat,dlwin,0,10,12,202,0.405940594,0.054455446,0.628712871,2,0.590599801
2789,7,20465,10,5,0,0,0,15,4,10,3,0,0,17,nowin,loss,beat,dlwin,0,10,15,183,0.442622951,0.06010929,0.62295082,2,0.619303341
2790,82,20466,3,10,0,8,0,21,9,10,0,0,0,19,nowin,win,plwin,beat,20,0,13,225,0.408888889,0.075555556,0.577777778,0,0.028101874
2791,99,20466,10,9,0,0,0,19,9,10,0,0,0,19,nowin,push,push,push,10,0,19,207,0.47826087,0.062801932,0.637681159,3,0.961418446
2792,1,20466,5,2,7,10,0,24,9,10,0,0,0,19,nowin,loss,bust,plbust,0,10,7,197,0.406091371,0.025380711,0.649746193,2,0.606186955
2793,7,20466,4,10,0,5,0,19,9,10,0,0,0,19,nowin,push,push,push,10,0,14,183,0.442622951,0.06010929,0.62295082,2,0.619303341
2794,118,20466,4,9,0,6,0,19,9,10,0,0,0,19,nowin,push,push,push,10,0,13,216,0.393518519,0.037037037,0.555555556,0,0.018059873
2795,147,20466,10,5,0,9,0,24,9,10,0,0,0,19,nowin,loss,bust,plbust,0,10,15,205,0.380487805,0.014634146,0.536585366,0,0.00951447
2796,12,20467,3,7,10,0,0,20,2,1,9,5,0,17,nowin,win,plwin,beat,20,0,10,189,0.470899471,0.015873016,0.613756614,3,0.929171178
2797,70,20467,5,6,6,0,0,17,2,1,9,5,0,17,nowin,push,push,push,10,0,11,228,0.385964912,0.039473684,0.557017544,0,0.016157125
2798,131,20467,10,5,0,0,0,15,2,1,9,5,0,17,nowin,loss,beat,dlwin,0,10,15,217,0.410138249,0.069124424,0.543778802,0,0.02015021
2799,58,20467,9,10,0,0,0,19,2,1,9,5,0,17,nowin,win,plwin,beat,20,0,19,195,0.430769231,0.041025641,0.584615385,2,0.580497586
2800,63,20467,5,6,3,0,0,14,2,1,9,5,0,17,nowin,loss,beat,dlwin,0,10,11,216,0.467592593,0.037037037,0.62037037,3,0.931690496
2801,144,20467,10,6,0,0,0,16,2,1,9,5,0,17,nowin,loss,beat,dlwin,0,10,16,202,0.386138614,0.054455446,0.564356436,0,0.018006244
2802,86,20468,1,6,9,0,0,16,3,8,10,0,0,21,nowin,loss,beat,dlwin,0,10,7,196,0.454081633,0.040816327,0.591836735,3,0.887566443
2803,95,20468,4,5,8,0,0,17,3,8,10,0,0,21,nowin,loss,beat,dlwin,0,10,9,218,0.412844037,0.04587156,0.559633028,0,0.024842385
2804,65,20468,10,10,0,0,0,20,3,8,10,0,0,21,nowin,loss,beat,dlwin,0,10,20,203,0.492610837,0.054187192,0.571428571,3,0.913702814
2805,56,20468,6,3,9,0,0,18,3,8,10,0,0,21,nowin,loss,beat,dlwin,0,10,9,175,0.4,0.057142857,0.582857143,0,0.026685297
2806,88,20468,9,11,0,0,0,20,3,8,10,0,0,21,nowin,loss,beat,dlwin,0,10,20,206,0.466019417,0.033980583,0.54368932,1,0.309467903
2807,50,20468,11,2,5,0,0,18,3,8,10,0,0,21,nowin,loss,beat,dlwin,0,10,13,202,0.405940594,0.04950495,0.54950495,0,0.020296079
2808,143,20469,9,3,0,9,0,21,10,5,7,0,0,22,nowin,win,dlbust,bust,20,0,12,203,0.463054187,0.044334975,0.57635468,3,0.883143365
2809,118,20469,10,10,0,0,0,20,10,5,7,0,0,22,nowin,win,dlbust,bust,20,0,20,216,0.393518519,0.037037037,0.555555556,0,0.018059873
2810,34,20469,7,10,0,0,0,17,10,5,7,0,0,22,nowin,win,dlbust,bust,20,0,17,202,0.5,0.079207921,0.618811881,3,0.968961434
2811,52,20469,11,2,1,2,10,26,10,5,7,0,0,22,nowin,loss,bust,plbust,0,10,13,217,0.414746544,0.02764977,0.599078341,2,0.576736024
2812,77,20469,11,8,0,0,0,19,10,5,7,0,0,22,nowin,win,dlbust,bust,20,0,19,200,0.455,0.04,0.62,3,0.916252116
2813,18,20469,8,11,0,0,0,19,10,5,7,0,0,22,nowin,win,dlbust,bust,20,0,19,182,0.461538462,0.043956044,0.587912088,3,0.892649374
2814,73,20470,11,5,4,0,0,20,4,10,10,0,0,24,nowin,win,dlbust,bust,20,0,16,181,0.375690608,0.011049724,0.596685083,0,0.022795773
2815,146,20470,4,10,0,0,0,14,4,10,10,0,0,24,nowin,win,dlbust,bust,20,0,14,221,0.43438914,0.040723982,0.542986425,1,0.290190091
2816,33,20470,5,10,0,0,0,15,4,10,10,0,0,24,nowin,win,dlbust,bust,20,0,15,192,0.4375,0.057291667,0.625,2,0.616208916
2817,133,20470,6,9,0,0,0,15,4,10,10,0,0,24,nowin,win,dlbust,bust,20,0,15,201,0.47761194,0.064676617,0.611940299,3,0.935428111
2818,3,20470,2,4,9,0,0,15,4,10,10,0,0,24,nowin,win,dlbust,bust,20,0,6,190,0.431578947,0.026315789,0.542105263,1,0.288076384
2819,2,20470,7,10,0,0,0,17,4,10,10,0,0,24,nowin,win,dlbust,bust,20,0,17,200,0.445,0.035,0.64,2,0.633962549
2820,101,20471,7,11,0,0,0,18,5,5,4,6,0,20,nowin,loss,beat,dlwin,0,10,18,205,0.424390244,0.068292683,0.63902439,2,0.614740646
2821,56,20471,3,10,0,0,0,13,5,5,4,6,0,20,nowin,loss,beat,dlwin,0,10,13,175,0.4,0.057142857,0.582857143,0,0.026685297
2822,115,20471,4,2,5,1,0,12,5,5,4,6,0,20,nowin,loss,beat,dlwin,0,10,6,194,0.427835052,0.041237113,0.592783505,2,0.583863602
2823,44,20471,7,10,0,0,0,17,5,5,4,6,0,20,nowin,loss,beat,dlwin,0,10,17,219,0.433789954,0.050228311,0.534246575,1,0.285551035
2824,127,20471,5,10,0,0,0,15,5,5,4,6,0,20,nowin,loss,beat,dlwin,0,10,15,201,0.402985075,0.029850746,0.60199005,0,0.032263937
2825,17,20471,7,7,0,0,0,14,5,5,4,6,0,20,nowin,loss,beat,dlwin,0,10,14,171,0.444444444,0.070175439,0.555555556,1,0.302364894
2826,77,20472,4,3,3,3,0,13,3,10,10,0,0,23,nowin,win,dlbust,bust,20,0,7,200,0.455,0.04,0.62,3,0.916252116
2827,47,20472,9,11,0,0,0,20,3,10,10,0,0,23,nowin,win,dlbust,bust,20,0,20,210,0.438095238,0.057142857,0.623809524,2,0.615868808
2828,112,20472,8,10,0,0,0,18,3,10,10,0,0,23,nowin,win,dlbust,bust,20,0,18,203,0.448275862,0.054187192,0.600985222,3,0.889576933
2829,91,20472,4,9,0,0,0,13,3,10,10,0,0,23,nowin,win,dlbust,bust,20,0,13,194,0.417525773,0.046391753,0.515463918,1,0.266616552
2830,93,20472,10,4,0,0,0,14,3,10,10,0,0,23,nowin,win,dlbust,bust,20,0,14,175,0.485714286,0.051428571,0.548571429,1,0.323648091
2831,117,20472,8,8,0,0,0,16,3,10,10,0,0,23,nowin,win,dlbust,bust,20,0,16,173,0.410404624,0.069364162,0.606936416,2,0.578610282
2832,63,20473,10,10,0,0,0,20,10,7,0,0,0,17,nowin,win,plwin,beat,20,0,20,216,0.467592593,0.037037037,0.62037037,3,0.931690496
2833,71,20473,4,7,10,0,0,21,10,7,0,0,0,17,nowin,win,plwin,beat,20,0,11,193,0.352331606,0.046632124,0.585492228,0,0.013063661
2834,139,20473,10,8,0,0,0,18,10,7,0,0,0,17,nowin,win,plwin,beat,20,0,18,192,0.380208333,0.036458333,0.59375,0,0.023429169
2835,31,20473,8,2,8,0,0,18,10,7,0,0,0,17,nowin,win,plwin,beat,20,0,10,188,0.473404255,0.058510638,0.515957447,1,0.300306557
2836,31,20473,9,10,0,0,0,19,10,7,0,0,0,17,nowin,win,plwin,beat,20,0,19,188,0.473404255,0.058510638,0.515957447,1,0.300306557
2837,100,20473,7,8,0,10,0,25,10,7,0,0,0,17,nowin,loss,bust,plbust,0,10,15,190,0.452631579,0.036842105,0.594736842,3,0.888671154
2838,15,20474,9,10,0,0,0,19,7,6,8,0,0,21,nowin,loss,beat,dlwin,0,10,19,212,0.410377358,0.051886792,0.561320755,0,0.024517408
2839,90,20474,10,10,0,0,0,20,7,6,8,0,0,21,nowin,loss,beat,dlwin,0,10,20,201,0.447761194,0.049751244,0.60199005,3,0.889945023
2840,60,20474,4,3,9,3,0,19,7,6,8,0,0,21,nowin,loss,beat,dlwin,0,10,7,227,0.418502203,0.022026432,0.559471366,0,0.026496258
2841,90,20474,9,11,0,0,0,20,7,6,8,0,0,21,nowin,loss,beat,dlwin,0,10,20,201,0.447761194,0.049751244,0.60199005,3,0.889945023
2842,116,20474,10,8,0,0,0,18,7,6,8,0,0,21,nowin,loss,beat,dlwin,0,10,18,195,0.425641026,0.056410256,0.538461538,1,0.28273747
2843,131,20474,10,10,0,0,0,20,7,6,8,0,0,21,nowin,loss,beat,dlwin,0,10,20,217,0.410138249,0.069124424,0.543778802,0,0.02015021
2844,145,20475,10,2,0,0,0,12,5,8,10,0,0,23,nowin,win,dlbust,bust,20,0,12,188,0.441489362,0.031914894,0.622340426,2,0.617837093
2845,5,20475,10,4,0,0,0,14,5,8,10,0,0,23,nowin,win,dlbust,bust,20,0,14,203,0.42364532,0.02955665,0.596059113,2,0.582508076
2846,105,20475,10,11,0,0,0,21,5,8,10,0,0,23,win,win,dlbust,bust,25,0,21,198,0.414141414,0.070707071,0.590909091,0,0.032889494
2847,48,20475,4,10,0,0,0,14,5,8,10,0,0,23,nowin,win,dlbust,bust,20,0,14,203,0.413793103,0.019704433,0.600985222,2,0.577280801
2848,53,20475,8,10,0,0,0,18,5,8,10,0,0,23,nowin,win,dlbust,bust,20,0,18,250,0.372,0.064,0.564,0,0.013687345
2849,4,20475,10,10,0,0,0,20,5,8,10,0,0,23,nowin,win,dlbust,bust,20,0,20,217,0.460829493,0.036866359,0.562211982,1,0.315432839
2850,12,20476,10,6,0,3,0,19,8,8,10,0,0,26,nowin,win,dlbust,bust,20,0,16,189,0.470899471,0.015873016,0.613756614,3,0.929171178
2851,84,20476,10,2,0,2,7,21,8,8,10,0,0,26,nowin,win,dlbust,bust,20,0,12,195,0.379487179,0.056410256,0.569230769,0,0.017209119
2852,125,20476,9,10,0,0,0,19,8,8,10,0,0,26,nowin,win,dlbust,bust,20,0,19,219,0.438356164,0.050228311,0.575342466,1,0.308411257
2853,78,20476,1,4,10,7,0,22,8,8,10,0,0,26,nowin,loss,bust,plbust,0,10,5,201,0.517412935,0.034825871,0.587064677,3,0.95871112
2854,9,20476,10,4,0,8,0,22,8,8,10,0,0,26,nowin,loss,bust,plbust,0,10,14,194,0.37628866,0.015463918,0.541237113,0,0.009396796
2855,25,20476,10,11,0,0,0,21,8,8,10,0,0,26,win,win,dlbust,bust,25,0,21,190,0.463157895,0.063157895,0.536842105,1,0.304401563
2856,101,20477,7,6,0,0,0,13,6,4,10,0,0,20,nowin,loss,beat,dlwin,0,10,13,205,0.424390244,0.068292683,0.63902439,2,0.614740646
2857,65,20477,10,9,0,0,0,19,6,4,10,0,0,20,nowin,loss,beat,dlwin,0,10,19,203,0.492610837,0.054187192,0.571428571,3,0.913702814
2858,120,20477,8,10,0,0,0,18,6,4,10,0,0,20,nowin,loss,beat,dlwin,0,10,18,202,0.440594059,0.034653465,0.618811881,2,0.614441029
2859,10,20477,10,2,0,0,0,12,6,4,10,0,0,20,nowin,loss,beat,dlwin,0,10,12,191,0.413612565,0.057591623,0.596858639,2,0.574087175
2860,15,20477,9,10,0,0,0,19,6,4,10,0,0,20,nowin,loss,beat,dlwin,0,10,19,212,0.410377358,0.051886792,0.561320755,0,0.024517408
2861,27,20477,10,10,0,0,0,20,6,4,10,0,0,20,nowin,push,push,push,10,0,20,178,0.370786517,0.016853933,0.573033708,0,0.015536309
2862,46,20478,10,3,0,0,0,13,4,1,9,2,2,18,nowin,loss,beat,dlwin,0,10,13,186,0.403225806,0.048387097,0.591397849,0,0.029742194
2863,131,20478,7,6,0,0,0,13,4,1,9,2,2,18,nowin,loss,beat,dlwin,0,10,13,217,0.410138249,0.069124424,0.543778802,0,0.02015021
2864,48,20478,1,4,10,0,0,15,4,1,9,2,2,18,nowin,loss,beat,dlwin,0,10,5,203,0.413793103,0.019704433,0.600985222,2,0.577280801
2865,103,20478,7,10,0,0,0,17,4,1,9,2,2,18,nowin,loss,beat,dlwin,0,10,17,203,0.379310345,0.064039409,0.551724138,0,0.012869209
2866,135,20478,10,10,0,0,0,20,4,1,9,2,2,18,nowin,win,plwin,beat,20,0,20,179,0.391061453,0.067039106,0.586592179,0,0.024924662
2867,41,20478,11,10,0,0,0,21,4,1,9,2,2,18,win,win,plwin,beat,25,0,21,192,0.364583333,0.036458333,0.520833333,0,0.00089702
2868,147,20479,5,3,11,0,0,19,10,8,0,0,0,18,nowin,win,plwin,beat,20,0,8,205,0.380487805,0.014634146,0.536585366,0,0.00951447
2869,119,20479,2,2,8,2,10,24,10,8,0,0,0,18,nowin,loss,bust,plbust,0,10,4,190,0.405263158,0.068421053,0.515789474,0,0.011837158
2870,122,20479,10,10,0,0,0,20,10,8,0,0,0,18,nowin,win,plwin,beat,20,0,20,210,0.347619048,0.052380952,0.59047619,0,0.012873677
2871,74,20479,3,2,10,10,0,25,10,8,0,0,0,18,nowin,loss,bust,plbust,0,10,5,209,0.411483254,0.04784689,0.531100478,0,0.017448125
2872,119,20479,10,11,0,0,0,21,10,8,0,0,0,18,win,win,plwin,beat,25,0,21,190,0.405263158,0.068421053,0.515789474,0,0.011837158
2873,103,20479,10,3,0,6,0,19,10,8,0,0,0,18,nowin,win,plwin,beat,20,0,13,203,0.379310345,0.064039409,0.551724138,0,0.012869209
2874,105,20480,10,8,0,0,0,18,5,4,3,7,0,19,nowin,loss,beat,dlwin,0,10,18,198,0.414141414,0.070707071,0.590909091,0,0.032889494
2875,126,20480,10,10,0,0,0,20,5,4,3,7,0,19,nowin,win,plwin,beat,20,0,20,188,0.457446809,0.074468085,0.60106383,3,0.900633203
2876,69,20480,7,10,0,0,0,17,5,4,3,7,0,19,nowin,loss,beat,dlwin,0,10,17,194,0.365979381,0.030927835,0.515463918,0,0
2877,40,20480,7,4,8,0,0,19,5,4,3,7,0,19,nowin,push,push,push,10,0,11,196,0.367346939,0.030612245,0.617346939,0,0.025358183
2878,119,20480,4,2,3,10,0,19,5,4,3,7,0,19,nowin,push,push,push,10,0,6,190,0.405263158,0.068421053,0.515789474,0,0.011837158
2879,70,20480,2,4,7,0,0,13,5,4,3,7,0,19,nowin,loss,beat,dlwin,0,10,6,228,0.385964912,0.039473684,0.557017544,0,0.016157125
2880,141,20481,3,3,7,10,0,23,11,6,0,0,0,17,nowin,loss,bust,plbust,0,10,6,202,0.420792079,0.074257426,0.564356436,0,0.028377851
2881,66,20481,8,8,0,6,0,22,11,6,0,0,0,17,nowin,loss,bust,plbust,0,10,16,217,0.456221198,0.064516129,0.626728111,3,0.924304367
2882,75,20481,10,2,0,9,0,21,11,6,0,0,0,17,nowin,win,plwin,beat,20,0,12,191,0.418848168,0.052356021,0.570680628,0,0.029344702
2883,53,20481,9,8,0,0,0,17,11,6,0,0,0,17,nowin,push,push,push,10,0,17,250,0.372,0.064,0.564,0,0.013687345
2884,119,20481,6,10,0,7,0,23,11,6,0,0,0,17,nowin,loss,bust,plbust,0,10,16,190,0.405263158,0.068421053,0.515789474,0,0.011837158
2885,141,20481,10,10,0,0,0,20,11,6,0,0,0,17,nowin,win,plwin,beat,20,0,20,202,0.420792079,0.074257426,0.564356436,0,0.028377851
2886,146,20482,9,4,0,2,6,21,9,11,0,0,0,20,nowin,win,plwin,beat,20,0,13,221,0.43438914,0.040723982,0.542986425,1,0.290190091
2887,112,20482,4,1,10,4,0,19,9,11,0,0,0,20,nowin,loss,beat,dlwin,0,10,5,203,0.448275862,0.054187192,0.600985222,3,0.889576933
2888,106,20482,5,10,0,10,0,25,9,11,0,0,0,20,nowin,loss,bust,plbust,0,10,15,192,0.411458333,0.026041667,0.557291667,0,0.023854304
2889,29,20482,10,5,0,2,0,17,9,11,0,0,0,20,nowin,loss,beat,dlwin,0,10,15,189,0.44973545,0.058201058,0.544973545,1,0.300349439
2890,130,20482,7,5,0,4,10,26,9,11,0,0,0,20,nowin,loss,bust,plbust,0,10,12,219,0.410958904,0.03652968,0.566210046,0,0.025888739
2891,143,20482,4,11,3,0,0,18,9,11,0,0,0,20,nowin,loss,beat,dlwin,0,10,15,203,0.463054187,0.044334975,0.57635468,3,0.883143365
2892,145,20483,8,4,0,10,0,22,11,6,0,0,0,17,nowin,loss,bust,plbust,0,10,12,188,0.441489362,0.031914894,0.622340426,2,0.617837093
2893,111,20483,11,10,0,0,0,21,11,6,0,0,0,17,win,win,plwin,beat,25,0,21,180,0.433333333,0.055555556,0.611111111,2,0.602264492
2894,59,20483,2,10,0,6,0,18,11,6,0,0,0,17,nowin,win,plwin,beat,20,0,12,228,0.429824561,0.048245614,0.543859649,1,0.287885446
2895,78,20483,6,7,0,10,0,23,11,6,0,0,0,17,nowin,loss,bust,plbust,0,10,13,201,0.517412935,0.034825871,0.587064677,3,0.95871112
2896,59,20483,7,6,0,10,0,23,11,6,0,0,0,17,nowin,loss,bust,plbust,0,10,13,228,0.429824561,0.048245614,0.543859649,1,0.287885446
2897,49,20483,10,3,0,2,8,23,11,6,0,0,0,17,nowin,loss,bust,plbust,0,10,13,207,0.396135266,0.053140097,0.594202899,0,0.028306925
2898,3,20484,9,9,0,0,0,18,4,2,7,1,8,22,nowin,win,dlbust,bust,20,0,18,190,0.431578947,0.026315789,0.542105263,1,0.288076384
2899,137,20484,2,4,8,0,0,14,4,2,7,1,8,22,nowin,win,dlbust,bust,20,0,6,194,0.417525773,0.046391753,0.536082474,1,0.276714602
2900,59,20484,9,11,0,0,0,20,4,2,7,1,8,22,nowin,win,dlbust,bust,20,0,20,228,0.429824561,0.048245614,0.543859649,1,0.287885446
2901,11,20484,11,6,1,0,0,18,4,2,7,1,8,22,nowin,win,dlbust,bust,20,0,17,236,0.457627119,0.016949153,0.588983051,3,0.889015813
2902,50,20484,4,8,0,0,0,12,4,2,7,1,8,22,nowin,win,dlbust,bust,20,0,12,202,0.405940594,0.04950495,0.54950495,0,0.020296079
2903,89,20484,10,8,0,0,0,18,4,2,7,1,8,22,nowin,win,dlbust,bust,20,0,18,212,0.537735849,0.047169811,0.594339623,3,0.990167191
2904,24,20485,5,10,0,5,0,20,8,10,0,0,0,18,nowin,win,plwin,beat,20,0,15,207,0.458937198,0.048309179,0.570048309,1,0.318138014
2905,143,20485,9,8,0,0,0,17,8,10,0,0,0,18,nowin,loss,beat,dlwin,0,10,17,203,0.463054187,0.044334975,0.57635468,3,0.883143365
2906,42,20485,7,5,0,4,10,26,8,10,0,0,0,18,nowin,loss,bust,plbust,0,10,12,212,0.443396226,0.051886792,0.570754717,1,0.309181312
2907,117,20485,5,2,11,0,0,18,8,10,0,0,0,18,nowin,push,push,push,10,0,7,173,0.410404624,0.069364162,0.606936416,2,0.578610282
2908,63,20485,10,10,0,0,0,20,8,10,0,0,0,18,nowin,win,plwin,beat,20,0,20,216,0.467592593,0.037037037,0.62037037,3,0.931690496
2909,130,20485,10,6,0,8,0,24,8,10,0,0,0,18,nowin,loss,bust,plbust,0,10,16,219,0.410958904,0.03652968,0.566210046,0,0.025888739
2910,97,20486,10,6,0,0,0,16,5,10,2,0,0,17,nowin,loss,beat,dlwin,0,10,16,182,0.450549451,0.06043956,0.692307692,2,0.677372279
2911,94,20486,7,6,0,0,0,13,5,10,2,0,0,17,nowin,loss,beat,dlwin,0,10,13,183,0.43715847,0.043715847,0.540983607,1,0.290866892
2912,78,20486,10,5,0,0,0,15,5,10,2,0,0,17,nowin,loss,beat,dlwin,0,10,15,201,0.517412935,0.034825871,0.587064677,3,0.95871112
2913,7,20486,3,7,10,0,0,20,5,10,2,0,0,17,nowin,win,plwin,beat,20,0,10,183,0.442622951,0.06010929,0.62295082,2,0.619303341
2914,111,20486,7,10,0,0,0,17,5,10,2,0,0,17,nowin,push,push,push,10,0,17,180,0.433333333,0.055555556,0.611111111,2,0.602264492
2915,34,20486,10,8,0,0,0,18,5,10,2,0,0,17,nowin,win,plwin,beat,20,0,18,202,0.5,0.079207921,0.618811881,3,0.968961434
2916,20,20487,2,10,0,3,10,25,11,9,0,0,0,20,nowin,loss,bust,plbust,0,10,12,186,0.456989247,0.037634409,0.537634409,1,0.301097108
2917,98,20487,8,8,0,5,0,21,11,9,0,0,0,20,nowin,win,plwin,beat,20,0,16,220,0.422727273,0.054545455,0.55,1,0.28664435
2918,60,20487,10,10,0,0,0,20,11,9,0,0,0,20,nowin,push,push,push,10,0,20,227,0.418502203,0.022026432,0.559471366,0,0.026496258
2919,143,20487,7,9,0,10,0,26,11,9,0,0,0,20,nowin,loss,bust,plbust,0,10,16,203,0.463054187,0.044334975,0.57635468,3,0.883143365
2920,108,20487,9,2,9,0,0,20,11,9,0,0,0,20,nowin,push,push,push,10,0,11,193,0.435233161,0.056994819,0.559585492,1,0.298824795
2921,115,20487,10,10,0,0,0,20,11,9,0,0,0,20,nowin,push,push,push,10,0,20,194,0.427835052,0.041237113,0.592783505,2,0.583863602
2922,129,20488,7,10,0,0,0,17,11,10,0,0,0,21,nowin,loss,beat,dlwin,0,10,17,201,0.422885572,0.064676617,0.55721393,0,0.027255383
2923,36,20488,10,9,0,0,0,19,11,10,0,0,0,21,nowin,loss,beat,dlwin,0,10,19,229,0.445414847,0.056768559,0.655021834,2,0.645370571
2924,74,20488,3,11,3,0,0,17,11,10,0,0,0,21,nowin,loss,beat,dlwin,0,10,14,209,0.411483254,0.04784689,0.531100478,0,0.017448125
2925,21,20488,8,9,0,0,0,17,11,10,0,0,0,21,nowin,loss,beat,dlwin,0,10,17,214,0.359813084,0.042056075,0.626168224,0,0.025263474
2926,59,20488,10,10,0,0,0,20,11,10,0,0,0,21,nowin,loss,beat,dlwin,0,10,20,228,0.429824561,0.048245614,0.543859649,1,0.287885446
2927,145,20488,2,11,4,0,0,17,11,10,0,0,0,21,nowin,loss,beat,dlwin,0,10,13,188,0.441489362,0.031914894,0.622340426,2,0.617837093
2928,17,20489,10,6,0,6,0,22,7,9,2,0,0,18,nowin,loss,bust,plbust,0,10,16,171,0.444444444,0.070175439,0.555555556,1,0.302364894
2929,1,20489,10,10,0,0,0,20,7,9,2,0,0,18,nowin,win,plwin,beat,20,0,20,197,0.406091371,0.025380711,0.649746193,2,0.606186955
2930,128,20489,10,7,0,0,0,17,7,9,2,0,0,18,nowin,loss,beat,dlwin,0,10,17,227,0.356828194,0.052863436,0.577092511,0,0.012352564
2931,78,20489,7,4,4,10,0,25,7,9,2,0,0,18,nowin,loss,bust,plbust,0,10,11,201,0.517412935,0.034825871,0.587064677,3,0.95871112
2932,9,20489,11,7,0,0,0,18,7,9,2,0,0,18,nowin,push,push,push,10,0,18,194,0.37628866,0.015463918,0.541237113,0,0.009396796
2933,88,20489,2,8,11,0,0,21,7,9,2,0,0,18,nowin,win,plwin,beat,20,0,10,206,0.466019417,0.033980583,0.54368932,1,0.309467903
2934,55,20490,7,7,0,10,0,24,9,10,0,0,0,19,nowin,loss,bust,plbust,0,10,14,191,0.371727749,0.057591623,0.54973822,0,0.01011347
2935,60,20490,3,3,4,8,0,18,9,10,0,0,0,19,nowin,loss,beat,dlwin,0,10,6,227,0.418502203,0.022026432,0.559471366,0,0.026496258
2936,139,20490,10,5,0,8,0,23,9,10,0,0,0,19,nowin,loss,bust,plbust,0,10,15,192,0.380208333,0.036458333,0.59375,0,0.023429169
2937,123,20490,1,1,10,2,5,19,9,10,0,0,0,19,nowin,push,push,push,10,0,2,205,0.43902439,0.034146341,0.614634146,2,0.609962544
2938,95,20490,11,6,1,0,0,18,9,10,0,0,0,19,nowin,loss,beat,dlwin,0,10,17,218,0.412844037,0.04587156,0.559633028,0,0.024842385
2939,136,20490,10,10,0,0,0,20,9,10,0,0,0,19,nowin,win,plwin,beat,20,0,20,194,0.396907216,0.025773196,0.597938144,0,0.029452644
2940,145,20491,2,9,10,0,0,21,6,3,4,1,4,18,nowin,win,plwin,beat,20,0,11,188,0.441489362,0.031914894,0.622340426,2,0.617837093
2941,24,20491,10,5,0,0,0,15,6,3,4,1,4,18,nowin,loss,beat,dlwin,0,10,15,207,0.458937198,0.048309179,0.570048309,1,0.318138014
2942,101,20491,3,1,10,0,0,14,6,3,4,1,4,18,nowin,loss,beat,dlwin,0,10,4,205,0.424390244,0.068292683,0.63902439,2,0.614740646
2943,129,20491,9,10,0,0,0,19,6,3,4,1,4,18,nowin,win,plwin,beat,20,0,19,201,0.422885572,0.064676617,0.55721393,0,0.027255383
2944,3,20491,2,10,0,0,0,12,6,3,4,1,4,18,nowin,loss,beat,dlwin,0,10,12,190,0.431578947,0.026315789,0.542105263,1,0.288076384
2945,110,20491,10,10,0,0,0,20,6,3,4,1,4,18,nowin,win,plwin,beat,20,0,20,192,0.416666667,0.046875,0.557291667,0,0.025413132
2946,148,20492,8,10,0,0,0,18,5,10,10,0,0,25,nowin,win,dlbust,bust,20,0,18,204,0.401960784,0.078431373,0.593137255,0,0.029789521
2947,86,20492,4,4,8,0,0,16,5,10,10,0,0,25,nowin,win,dlbust,bust,20,0,8,196,0.454081633,0.040816327,0.591836735,3,0.887566443
2948,20,20492,1,2,10,0,0,13,5,10,10,0,0,25,nowin,win,dlbust,bust,20,0,3,186,0.456989247,0.037634409,0.537634409,1,0.301097108
2949,143,20492,7,6,0,0,0,13,5,10,10,0,0,25,nowin,win,dlbust,bust,20,0,13,203,0.463054187,0.044334975,0.57635468,3,0.883143365
2950,64,20492,6,3,8,0,0,17,5,10,10,0,0,25,nowin,win,dlbust,bust,20,0,9,187,0.363636364,0.048128342,0.631016043,0,0.027594885
2951,120,20492,2,10,0,0,0,12,5,10,10,0,0,25,nowin,win,dlbust,bust,20,0,12,202,0.440594059,0.034653465,0.618811881,2,0.614441029
2952,53,20493,8,5,0,0,0,13,2,3,6,10,0,21,nowin,loss,beat,dlwin,0,10,13,250,0.372,0.064,0.564,0,0.013687345
2953,101,20493,10,9,0,0,0,19,2,3,6,10,0,21,nowin,loss,beat,dlwin,0,10,19,205,0.424390244,0.068292683,0.63902439,2,0.614740646
2954,48,20493,8,5,0,0,0,13,2,3,6,10,0,21,nowin,loss,beat,dlwin,0,10,13,203,0.413793103,0.019704433,0.600985222,2,0.577280801
2955,110,20493,7,5,0,10,0,22,2,3,6,10,0,21,nowin,loss,bust,plbust,0,10,12,192,0.416666667,0.046875,0.557291667,0,0.025413132
2956,54,20493,4,10,0,0,0,14,2,3,6,10,0,21,nowin,loss,beat,dlwin,0,10,14,185,0.437837838,0.032432432,0.556756757,1,0.29899854
2957,89,20493,3,7,6,0,0,16,2,3,6,10,0,21,nowin,loss,beat,dlwin,0,10,10,212,0.537735849,0.047169811,0.594339623,3,0.990167191
2958,147,20494,2,10,0,10,0,22,8,7,5,0,0,20,nowin,loss,bust,plbust,0,10,12,205,0.380487805,0.014634146,0.536585366,0,0.00951447
2959,128,20494,11,5,1,0,0,17,8,7,5,0,0,20,nowin,loss,beat,dlwin,0,10,16,227,0.356828194,0.052863436,0.577092511,0,0.012352564
2960,3,20494,1,6,10,0,0,17,8,7,5,0,0,20,nowin,loss,beat,dlwin,0,10,7,190,0.431578947,0.026315789,0.542105263,1,0.288076384
2961,76,20494,10,10,0,0,0,20,8,7,5,0,0,20,nowin,push,push,push,10,0,20,189,0.534391534,0.079365079,0.608465608,3,1
2962,133,20494,5,5,10,0,0,20,8,7,5,0,0,20,nowin,push,push,push,10,0,10,201,0.47761194,0.064676617,0.611940299,3,0.935428111
2963,145,20494,7,10,0,0,0,17,8,7,5,0,0,20,nowin,loss,beat,dlwin,0,10,17,188,0.441489362,0.031914894,0.622340426,2,0.617837093
2964,40,20495,10,5,0,4,0,19,8,11,0,0,0,19,nowin,push,push,push,10,0,15,196,0.367346939,0.030612245,0.617346939,0,0.025358183
2965,105,20495,5,10,0,5,0,20,8,11,0,0,0,19,nowin,win,plwin,beat,20,0,15,198,0.414141414,0.070707071,0.590909091,0,0.032889494
2966,134,20495,10,9,0,0,0,19,8,11,0,0,0,19,nowin,push,push,push,10,0,19,185,0.443243243,0.021621622,0.545945946,1,0.296939509
2967,36,20495,6,10,0,1,0,17,8,11,0,0,0,19,nowin,loss,beat,dlwin,0,10,16,229,0.445414847,0.056768559,0.655021834,2,0.645370571
2968,125,20495,5,6,7,0,0,18,8,11,0,0,0,19,nowin,loss,beat,dlwin,0,10,11,219,0.438356164,0.050228311,0.575342466,1,0.308411257
2969,150,20495,4,11,1,2,0,18,8,11,0,0,0,19,nowin,loss,beat,dlwin,0,10,15,192,0.401041667,0.036458333,0.567708333,0,0.023287458
2970,48,20496,5,8,0,10,0,23,10,10,0,0,0,20,nowin,loss,bust,plbust,0,10,13,203,0.413793103,0.019704433,0.600985222,2,0.577280801
2971,77,20496,5,7,0,5,0,17,10,10,0,0,0,20,nowin,loss,beat,dlwin,0,10,12,200,0.455,0.04,0.62,3,0.916252116
2972,134,20496,10,9,0,0,0,19,10,10,0,0,0,20,nowin,loss,beat,dlwin,0,10,19,185,0.443243243,0.021621622,0.545945946,1,0.296939509
2973,48,20496,3,4,10,0,0,17,10,10,0,0,0,20,nowin,loss,beat,dlwin,0,10,7,203,0.413793103,0.019704433,0.600985222,2,0.577280801
2974,42,20496,4,7,5,10,0,26,10,10,0,0,0,20,nowin,loss,bust,plbust,0,10,11,212,0.443396226,0.051886792,0.570754717,1,0.309181312
2975,78,20496,2,7,2,10,0,21,10,10,0,0,0,20,nowin,win,plwin,beat,20,0,9,201,0.517412935,0.034825871,0.587064677,3,0.95871112
2976,128,20497,3,6,8,0,0,17,10,3,9,0,0,22,nowin,win,dlbust,bust,20,0,9,227,0.356828194,0.052863436,0.577092511,0,0.012352564
2977,122,20497,3,10,0,1,10,24,10,3,9,0,0,22,nowin,loss,bust,plbust,0,10,13,210,0.347619048,0.052380952,0.59047619,0,0.012873677
2978,44,20497,10,11,0,0,0,21,10,3,9,0,0,22,win,win,dlbust,bust,25,0,21,219,0.433789954,0.050228311,0.534246575,1,0.285551035
2979,93,20497,2,4,4,10,0,20,10,3,9,0,0,22,nowin,win,dlbust,bust,20,0,6,175,0.485714286,0.051428571,0.548571429,1,0.323648091
2980,16,20497,11,8,0,0,0,19,10,3,9,0,0,22,nowin,win,dlbust,bust,20,0,19,220,0.427272727,0.081818182,0.6,2,0.588660176
2981,143,20497,6,9,0,6,0,21,10,3,9,0,0,22,nowin,win,dlbust,bust,20,0,15,203,0.463054187,0.044334975,0.57635468,3,0.883143365
2982,95,20498,8,4,0,8,0,20,8,2,5,10,0,25,nowin,win,dlbust,bust,20,0,12,218,0.412844037,0.04587156,0.559633028,0,0.024842385
2983,77,20498,1,6,5,6,0,18,8,2,5,10,0,25,nowin,win,dlbust,bust,20,0,7,200,0.455,0.04,0.62,3,0.916252116
2984,101,20498,10,6,0,2,0,18,8,2,5,10,0,25,nowin,win,dlbust,bust,20,0,16,205,0.424390244,0.068292683,0.63902439,2,0.614740646
2985,10,20498,8,2,10,0,0,20,8,2,5,10,0,25,nowin,win,dlbust,bust,20,0,10,191,0.413612565,0.057591623,0.596858639,2,0.574087175
2986,123,20498,7,9,0,9,0,25,8,2,5,10,0,25,nowin,loss,bust,plbust,0,10,16,205,0.43902439,0.034146341,0.614634146,2,0.609962544
2987,141,20498,4,8,0,10,0,22,8,2,5,10,0,25,nowin,loss,bust,plbust,0,10,12,202,0.420792079,0.074257426,0.564356436,0,0.028377851
2988,22,20499,9,2,10,0,0,21,9,7,1,0,0,17,nowin,win,plwin,beat,20,0,11,187,0.481283422,0.042780749,0.577540107,3,0.906128176
2989,115,20499,10,10,0,0,0,20,9,7,1,0,0,17,nowin,win,plwin,beat,20,0,20,194,0.427835052,0.041237113,0.592783505,2,0.583863602
2990,142,20499,10,5,0,2,0,17,9,7,1,0,0,17,nowin,push,push,push,10,0,15,211,0.417061611,0.047393365,0.526066351,1,0.271531309
2991,80,20499,10,4,0,4,0,18,9,7,1,0,0,17,nowin,win,plwin,beat,20,0,14,186,0.419354839,0.059139785,0.623655914,2,0.59892924
2992,7,20499,9,10,0,0,0,19,9,7,1,0,0,17,nowin,win,plwin,beat,20,0,19,183,0.442622951,0.06010929,0.62295082,2,0.619303341
2993,10,20499,4,1,8,10,0,23,9,7,1,0,0,17,nowin,loss,bust,plbust,0,10,5,191,0.413612565,0.057591623,0.596858639,2,0.574087175
2994,15,20500,10,10,0,0,0,20,10,10,0,0,0,20,nowin,push,push,push,10,0,20,212,0.410377358,0.051886792,0.561320755,0,0.024517408
2995,13,20500,7,8,0,10,0,25,10,10,0,0,0,20,nowin,loss,bust,plbust,0,10,15,206,0.417475728,0.063106796,0.621359223,2,0.59555479
2996,95,20500,9,10,0,0,0,19,10,10,0,0,0,20,nowin,loss,beat,dlwin,0,10,19,218,0.412844037,0.04587156,0.559633028,0,0.024842385
2997,51,20500,10,10,0,0,0,20,10,10,0,0,0,20,nowin,push,push,push,10,0,20,189,0.529100529,0.068783069,0.608465608,3,0.993665715
2998,49,20500,10,10,0,0,0,20,10,10,0,0,0,20,nowin,push,push,push,10,0,20,207,0.396135266,0.053140097,0.594202899,0,0.028306925
2999,121,20500,3,7,11,0,0,21,10,10,0,0,0,20,nowin,win,plwin,beat,20,0,10,195,0.456410256,0.025641026,0.512820513,1,0.288597791
3000,29,20501,10,8,0,0,0,18,10,2,7,0,0,19,nowin,loss,beat,dlwin,0,10,18,189,0.44973545,0.058201058,0.544973545,1,0.300349439
3001,22,20501,10,10,0,0,0,20,10,2,7,0,0,19,nowin,win,plwin,beat,20,0,20,187,0.481283422,0.042780749,0.577540107,3,0.906128176
3002,9,20501,9,6,0,10,0,25,10,2,7,0,0,19,nowin,loss,bust,plbust,0,10,15,194,0.37628866,0.015463918,0.541237113,0,0.009396796
3003,35,20501,10,9,0,0,0,19,10,2,7,0,0,19,nowin,push,push,push,10,0,19,202,0.410891089,0.044554455,0.633663366,2,0.598681573
3004,64,20501,3,10,0,1,7,21,10,2,7,0,0,19,nowin,win,plwin,beat,20,0,13,187,0.363636364,0.048128342,0.631016043,0,0.027594885
3005,94,20501,10,4,0,2,5,21,10,2,7,0,0,19,nowin,win,plwin,beat,20,0,14,183,0.43715847,0.043715847,0.540983607,1,0.290866892
3006,123,20502,2,10,0,5,0,17,10,8,0,0,0,18,nowin,loss,beat,dlwin,0,10,12,205,0.43902439,0.034146341,0.614634146,2,0.609962544
3007,3,20502,4,10,0,2,7,23,10,8,0,0,0,18,nowin,loss,bust,plbust,0,10,14,190,0.431578947,0.026315789,0.542105263,1,0.288076384
3008,70,20502,11,10,0,0,0,21,10,8,0,0,0,18,win,win,plwin,beat,25,0,21,228,0.385964912,0.039473684,0.557017544,0,0.016157125
3009,145,20502,10,4,0,6,0,20,10,8,0,0,0,18,nowin,win,plwin,beat,20,0,14,188,0.441489362,0.031914894,0.622340426,2,0.617837093
3010,90,20502,3,6,9,0,0,18,10,8,0,0,0,18,nowin,push,push,push,10,0,9,201,0.447761194,0.049751244,0.60199005,3,0.889945023
3011,39,20502,6,10,0,9,0,25,10,8,0,0,0,18,nowin,loss,bust,plbust,0,10,16,191,0.429319372,0.062827225,0.57591623,0,0.033760763
3012,96,20503,3,4,10,0,0,17,6,7,10,0,0,23,nowin,win,dlbust,bust,20,0,7,190,0.468421053,0.057894737,0.584210526,3,0.897263354
3013,16,20503,3,7,10,0,0,20,6,7,10,0,0,23,nowin,win,dlbust,bust,20,0,10,220,0.427272727,0.081818182,0.6,2,0.588660176
3014,113,20503,2,10,0,0,0,12,6,7,10,0,0,23,nowin,win,dlbust,bust,20,0,12,199,0.407035176,0.055276382,0.668341709,2,0.620695264
3015,38,20503,10,4,0,0,0,14,6,7,10,0,0,23,nowin,win,dlbust,bust,20,0,14,202,0.361386139,0.03960396,0.564356436,0,0.010597953
3016,113,20503,2,5,6,0,0,13,6,7,10,0,0,23,nowin,win,dlbust,bust,20,0,7,199,0.407035176,0.055276382,0.668341709,2,0.620695264
3017,72,20503,5,10,0,0,0,15,6,7,10,0,0,23,nowin,win,dlbust,bust,20,0,15,185,0.394594595,0.032432432,0.508108108,0,0.006763115
3018,90,20504,2,6,10,0,0,18,2,10,5,0,0,17,nowin,win,plwin,beat,20,0,8,201,0.447761194,0.049751244,0.60199005,3,0.889945023
3019,3,20504,8,10,0,0,0,18,2,10,5,0,0,17,nowin,win,plwin,beat,20,0,18,190,0.431578947,0.026315789,0.542105263,1,0.288076384
3020,126,20504,7,3,9,0,0,19,2,10,5,0,0,17,nowin,win,plwin,beat,20,0,10,188,0.457446809,0.074468085,0.60106383,3,0.900633203
3021,108,20504,10,5,0,0,0,15,2,10,5,0,0,17,nowin,loss,beat,dlwin,0,10,15,193,0.435233161,0.056994819,0.559585492,1,0.298824795
3022,82,20504,10,11,0,0,0,21,2,10,5,0,0,17,win,win,plwin,beat,25,0,21,225,0.408888889,0.075555556,0.577777778,0,0.028101874
3023,117,20504,8,8,0,0,0,16,2,10,5,0,0,17,nowin,loss,beat,dlwin,0,10,16,173,0.410404624,0.069364162,0.606936416,2,0.578610282
3024,2,20505,2,7,7,10,0,26,8,9,0,0,0,17,nowin,loss,bust,plbust,0,10,9,200,0.445,0.035,0.64,2,0.633962549
3025,36,20505,9,3,0,5,0,17,8,9,0,0,0,17,nowin,push,push,push,10,0,12,229,0.445414847,0.056768559,0.655021834,2,0.645370571
3026,145,20505,10,10,0,0,0,20,8,9,0,0,0,17,nowin,win,plwin,beat,20,0,20,188,0.441489362,0.031914894,0.622340426,2,0.617837093
3027,81,20505,5,7,0,7,0,19,8,9,0,0,0,17,nowin,win,plwin,beat,20,0,12,182,0.395604396,0.043956044,0.60989011,2,0.567491261
3028,11,20505,8,6,0,6,0,20,8,9,0,0,0,17,nowin,win,plwin,beat,20,0,14,236,0.457627119,0.016949153,0.588983051,3,0.889015813
3029,139,20505,9,9,0,0,0,18,8,9,0,0,0,17,nowin,win,plwin,beat,20,0,18,192,0.380208333,0.036458333,0.59375,0,0.023429169
3030,12,20506,4,10,0,0,0,14,2,11,2,10,0,25,nowin,win,dlbust,bust,20,0,14,189,0.470899471,0.015873016,0.613756614,3,0.929171178
3031,16,20506,7,7,0,0,0,14,2,11,2,10,0,25,nowin,win,dlbust,bust,20,0,14,220,0.427272727,0.081818182,0.6,2,0.588660176
3032,60,20506,7,7,0,0,0,14,2,11,2,10,0,25,nowin,win,dlbust,bust,20,0,14,227,0.418502203,0.022026432,0.559471366,0,0.026496258
3033,75,20506,3,3,6,9,0,21,2,11,2,10,0,25,nowin,win,dlbust,bust,20,0,6,191,0.418848168,0.052356021,0.570680628,0,0.029344702
3034,138,20506,7,10,0,0,0,17,2,11,2,10,0,25,nowin,win,dlbust,bust,20,0,17,190,0.442105263,0.047368421,0.610526316,2,0.609711065
3035,74,20506,8,3,2,0,0,13,2,11,2,10,0,25,nowin,win,dlbust,bust,20,0,11,209,0.411483254,0.04784689,0.531100478,0,0.017448125
3036,141,20507,9,6,0,3,0,18,10,8,0,0,0,18,nowin,push,push,push,10,0,15,202,0.420792079,0.074257426,0.564356436,0,0.028377851
3037,25,20507,9,8,0,0,0,17,10,8,0,0,0,18,nowin,loss,beat,dlwin,0,10,17,190,0.463157895,0.063157895,0.536842105,1,0.304401563
3038,16,20507,8,7,0,2,0,17,10,8,0,0,0,18,nowin,loss,beat,dlwin,0,10,15,220,0.427272727,0.081818182,0.6,2,0.588660176
3039,53,20507,4,10,0,6,0,20,10,8,0,0,0,18,nowin,win,plwin,beat,20,0,14,250,0.372,0.064,0.564,0,0.013687345
3040,109,20507,10,10,0,0,0,20,10,8,0,0,0,18,nowin,win,plwin,beat,20,0,20,221,0.461538462,0.058823529,0.597285068,3,0.901830309
3041,54,20507,8,11,0,0,0,19,10,8,0,0,0,18,nowin,win,plwin,beat,20,0,19,185,0.437837838,0.032432432,0.556756757,1,0.29899854
3042,60,20508,10,6,0,0,0,16,4,8,3,10,0,25,nowin,win,dlbust,bust,20,0,16,227,0.418502203,0.022026432,0.559471366,0,0.026496258
3043,50,20508,4,10,0,0,0,14,4,8,3,10,0,25,nowin,win,dlbust,bust,20,0,14,202,0.405940594,0.04950495,0.54950495,0,0.020296079
3044,30,20508,8,3,1,0,0,12,4,8,3,10,0,25,nowin,win,dlbust,bust,20,0,11,206,0.393203883,0.033980583,0.601941748,0,0.029324648
3045,2,20508,9,2,7,0,0,18,4,8,3,10,0,25,nowin,win,dlbust,bust,20,0,11,200,0.445,0.035,0.64,2,0.633962549
3046,79,20508,10,5,0,0,0,15,4,8,3,10,0,25,nowin,win,dlbust,bust,20,0,15,211,0.436018957,0.028436019,0.672985782,2,0.650131054
3047,93,20508,6,9,0,0,0,15,4,8,3,10,0,25,nowin,win,dlbust,bust,20,0,15,175,0.485714286,0.051428571,0.548571429,1,0.323648091
3048,63,20509,5,4,10,0,0,19,10,8,0,0,0,18,nowin,win,plwin,beat,20,0,9,216,0.467592593,0.037037037,0.62037037,3,0.931690496
3049,59,20509,7,7,0,10,0,24,10,8,0,0,0,18,nowin,loss,bust,plbust,0,10,14,228,0.429824561,0.048245614,0.543859649,1,0.287885446
3050,144,20509,8,10,0,0,0,18,10,8,0,0,0,18,nowin,push,push,push,10,0,18,202,0.386138614,0.054455446,0.564356436,0,0.018006244
3051,119,20509,9,7,0,8,0,24,10,8,0,0,0,18,nowin,loss,bust,plbust,0,10,16,190,0.405263158,0.068421053,0.515789474,0,0.011837158
3052,142,20509,2,10,0,10,0,22,10,8,0,0,0,18,nowin,loss,bust,plbust,0,10,12,211,0.417061611,0.047393365,0.526066351,1,0.271531309
3053,75,20509,10,6,0,1,0,17,10,8,0,0,0,18,nowin,loss,beat,dlwin,0,10,16,191,0.418848168,0.052356021,0.570680628,0,0.029344702
3054,145,20510,9,6,0,0,0,15,4,2,8,5,0,19,nowin,loss,beat,dlwin,0,10,15,188,0.441489362,0.031914894,0.622340426,2,0.617837093
3055,142,20510,10,9,0,0,0,19,4,2,8,5,0,19,nowin,push,push,push,10,0,19,211,0.417061611,0.047393365,0.526066351,1,0.271531309
3056,38,20510,7,11,0,0,0,18,4,2,8,5,0,19,nowin,loss,beat,dlwin,0,10,18,202,0.361386139,0.03960396,0.564356436,0,0.010597953
3057,83,20510,2,7,5,0,0,14,4,2,8,5,0,19,nowin,loss,beat,dlwin,0,10,9,193,0.424870466,0.051813472,0.678756477,2,0.644360335
3058,150,20510,10,2,0,0,0,12,4,2,8,5,0,19,nowin,loss,beat,dlwin,0,10,12,192,0.401041667,0.036458333,0.567708333,0,0.023287458
3059,113,20510,10,7,0,0,0,17,4,2,8,5,0,19,nowin,loss,beat,dlwin,0,10,17,199,0.407035176,0.055276382,0.668341709,2,0.620695264
3060,59,20511,9,10,0,0,0,19,10,10,0,0,0,20,nowin,loss,beat,dlwin,0,10,19,228,0.429824561,0.048245614,0.543859649,1,0.287885446
3061,66,20511,8,10,0,0,0,18,10,10,0,0,0,20,nowin,loss,beat,dlwin,0,10,18,217,0.456221198,0.064516129,0.626728111,3,0.924304367
3062,92,20511,10,10,0,0,0,20,10,10,0,0,0,20,nowin,push,push,push,10,0,20,186,0.446236559,0.059139785,0.564516129,1,0.307826125
3063,14,20511,5,8,0,9,0,22,10,10,0,0,0,20,nowin,loss,bust,plbust,0,10,13,202,0.391089109,0.01980198,0.628712871,2,0.577264877
3064,99,20511,10,10,0,0,0,20,10,10,0,0,0,20,nowin,push,push,push,10,0,20,207,0.47826087,0.062801932,0.637681159,3,0.961418446
3065,28,20511,10,10,0,0,0,20,10,10,0,0,0,20,nowin,push,push,push,10,0,20,199,0.422110553,0.045226131,0.542713568,1,0.282706618
3066,99,20512,2,10,0,1,10,23,10,10,0,0,0,20,nowin,loss,bust,plbust,0,10,12,207,0.47826087,0.062801932,0.637681159,3,0.961418446
3067,103,20512,11,10,0,0,0,21,10,10,0,0,0,20,win,win,plwin,beat,25,0,21,203,0.379310345,0.064039409,0.551724138,0,0.012869209
3068,54,20512,8,10,0,0,0,18,10,10,0,0,0,20,nowin,loss,beat,dlwin,0,10,18,185,0.437837838,0.032432432,0.556756757,1,0.29899854
3069,19,20512,8,7,0,4,0,19,10,10,0,0,0,20,nowin,loss,beat,dlwin,0,10,15,237,0.41350211,0.054852321,0.628691983,2,0.597373826
3070,142,20512,3,9,0,4,10,26,10,10,0,0,0,20,nowin,loss,bust,plbust,0,10,12,211,0.417061611,0.047393365,0.526066351,1,0.271531309
3071,102,20512,10,8,0,0,0,18,10,10,0,0,0,20,nowin,loss,beat,dlwin,0,10,18,192,0.338541667,0.046875,0.5625,0,0.003306118
3072,38,20513,10,5,0,0,0,15,2,10,10,0,0,22,nowin,win,dlbust,bust,20,0,15,202,0.361386139,0.03960396,0.564356436,0,0.010597953
3073,24,20513,4,10,0,0,0,14,2,10,10,0,0,22,nowin,win,dlbust,bust,20,0,14,207,0.458937198,0.048309179,0.570048309,1,0.318138014
3074,138,20513,5,6,10,0,0,21,2,10,10,0,0,22,nowin,win,dlbust,bust,20,0,11,190,0.442105263,0.047368421,0.610526316,2,0.609711065
3075,16,20513,10,7,0,0,0,17,2,10,10,0,0,22,nowin,win,dlbust,bust,20,0,17,220,0.427272727,0.081818182,0.6,2,0.588660176
3076,114,20513,10,10,0,0,0,20,2,10,10,0,0,22,nowin,win,dlbust,bust,20,0,20,198,0.47979798,0.025252525,0.611111111,3,0.937232995
3077,115,20513,7,3,5,0,0,15,2,10,10,0,0,22,nowin,win,dlbust,bust,20,0,10,194,0.427835052,0.041237113,0.592783505,2,0.583863602
3078,65,20514,10,3,0,0,0,13,2,9,8,0,0,19,nowin,loss,beat,dlwin,0,10,13,203,0.492610837,0.054187192,0.571428571,3,0.913702814
3079,125,20514,5,10,0,0,0,15,2,9,8,0,0,19,nowin,loss,beat,dlwin,0,10,15,219,0.438356164,0.050228311,0.575342466,1,0.308411257
3080,98,20514,4,10,0,0,0,14,2,9,8,0,0,19,nowin,loss,beat,dlwin,0,10,14,220,0.422727273,0.054545455,0.55,1,0.28664435
3081,24,20514,4,10,0,0,0,14,2,9,8,0,0,19,nowin,loss,beat,dlwin,0,10,14,207,0.458937198,0.048309179,0.570048309,1,0.318138014
3082,50,20514,10,4,0,0,0,14,2,9,8,0,0,19,nowin,loss,beat,dlwin,0,10,14,202,0.405940594,0.04950495,0.54950495,0,0.020296079
3083,148,20514,2,10,0,7,0,19,2,9,8,0,0,19,nowin,push,push,push,10,0,12,204,0.401960784,0.078431373,0.593137255,0,0.029789521
3084,20,20515,10,10,0,0,0,20,3,3,8,2,10,26,nowin,win,dlbust,bust,20,0,20,186,0.456989247,0.037634409,0.537634409,1,0.301097108
3085,93,20515,10,4,0,0,0,14,3,3,8,2,10,26,nowin,win,dlbust,bust,20,0,14,175,0.485714286,0.051428571,0.548571429,1,0.323648091
3086,141,20515,4,10,0,0,0,14,3,3,8,2,10,26,nowin,win,dlbust,bust,20,0,14,202,0.420792079,0.074257426,0.564356436,0,0.028377851
3087,15,20515,7,10,0,0,0,17,3,3,8,2,10,26,nowin,win,dlbust,bust,20,0,17,212,0.410377358,0.051886792,0.561320755,0,0.024517408
3088,10,20515,8,6,0,0,0,14,3,3,8,2,10,26,nowin,win,dlbust,bust,20,0,14,191,0.413612565,0.057591623,0.596858639,2,0.574087175
3089,77,20515,6,8,0,0,0,14,3,3,8,2,10,26,nowin,win,dlbust,bust,20,0,14,200,0.455,0.04,0.62,3,0.916252116
3090,14,20516,7,3,10,0,0,20,4,5,8,0,0,17,nowin,win,plwin,beat,20,0,10,202,0.391089109,0.01980198,0.628712871,2,0.577264877
3091,52,20516,10,4,0,0,0,14,4,5,8,0,0,17,nowin,loss,beat,dlwin,0,10,14,217,0.414746544,0.02764977,0.599078341,2,0.576736024
3092,5,20516,5,2,6,0,0,13,4,5,8,0,0,17,nowin,loss,beat,dlwin,0,10,7,203,0.42364532,0.02955665,0.596059113,2,0.582508076
3093,88,20516,3,9,0,0,0,12,4,5,8,0,0,17,nowin,loss,beat,dlwin,0,10,12,206,0.466019417,0.033980583,0.54368932,1,0.309467903
3094,75,20516,5,1,10,0,0,16,4,5,8,0,0,17,nowin,loss,beat,dlwin,0,10,6,191,0.418848168,0.052356021,0.570680628,0,0.029344702
3095,105,20516,10,8,0,0,0,18,4,5,8,0,0,17,nowin,win,plwin,beat,20,0,18,198,0.414141414,0.070707071,0.590909091,0,0.032889494
3096,98,20517,10,10,0,0,0,20,3,10,7,0,0,20,nowin,push,push,push,10,0,20,220,0.422727273,0.054545455,0.55,1,0.28664435
3097,123,20517,10,8,0,0,0,18,3,10,7,0,0,20,nowin,loss,beat,dlwin,0,10,18,205,0.43902439,0.034146341,0.614634146,2,0.609962544
3098,113,20517,9,3,0,2,0,14,3,10,7,0,0,20,nowin,loss,beat,dlwin,0,10,12,199,0.407035176,0.055276382,0.668341709,2,0.620695264
3099,40,20517,5,6,5,0,0,16,3,10,7,0,0,20,nowin,loss,beat,dlwin,0,10,11,196,0.367346939,0.030612245,0.617346939,0,0.025358183
3100,11,20517,4,10,0,0,0,14,3,10,7,0,0,20,nowin,loss,beat,dlwin,0,10,14,236,0.457627119,0.016949153,0.588983051,3,0.889015813
3101,21,20517,4,9,0,0,0,13,3,10,7,0,0,20,nowin,loss,beat,dlwin,0,10,13,214,0.359813084,0.042056075,0.626168224,0,0.025263474
3102,72,20518,10,10,0,0,0,20,10,10,0,0,0,20,nowin,push,push,push,10,0,20,185,0.394594595,0.032432432,0.508108108,0,0.006763115
3103,99,20518,7,9,0,8,0,24,10,10,0,0,0,20,nowin,loss,bust,plbust,0,10,16,207,0.47826087,0.062801932,0.637681159,3,0.961418446
3104,123,20518,11,10,0,0,0,21,10,10,0,0,0,20,win,win,plwin,beat,25,0,21,205,0.43902439,0.034146341,0.614634146,2,0.609962544
3105,77,20518,4,9,0,4,0,17,10,10,0,0,0,20,nowin,loss,beat,dlwin,0,10,13,200,0.455,0.04,0.62,3,0.916252116
3106,116,20518,5,6,6,0,0,17,10,10,0,0,0,20,nowin,loss,beat,dlwin,0,10,11,195,0.425641026,0.056410256,0.538461538,1,0.28273747
3107,73,20518,6,10,0,10,0,26,10,10,0,0,0,20,nowin,loss,bust,plbust,0,10,16,181,0.375690608,0.011049724,0.596685083,0,0.022795773
3108,91,20519,1,3,10,0,0,14,3,10,2,1,2,18,nowin,loss,beat,dlwin,0,10,4,194,0.417525773,0.046391753,0.515463918,1,0.266616552
3109,136,20519,8,5,0,0,0,13,3,10,2,1,2,18,nowin,loss,beat,dlwin,0,10,13,194,0.396907216,0.025773196,0.597938144,0,0.029452644
3110,29,20519,9,10,0,0,0,19,3,10,2,1,2,18,nowin,win,plwin,beat,20,0,19,189,0.44973545,0.058201058,0.544973545,1,0.300349439
3111,5,20519,10,7,0,0,0,17,3,10,2,1,2,18,nowin,loss,beat,dlwin,0,10,17,203,0.42364532,0.02955665,0.596059113,2,0.582508076
3112,117,20519,5,8,0,0,0,13,3,10,2,1,2,18,nowin,loss,beat,dlwin,0,10,13,173,0.410404624,0.069364162,0.606936416,2,0.578610282
3113,18,20519,6,10,0,0,0,16,3,10,2,1,2,18,nowin,loss,beat,dlwin,0,10,16,182,0.461538462,0.043956044,0.587912088,3,0.892649374
3114,92,20520,3,10,0,0,0,13,4,10,9,0,0,23,nowin,win,dlbust,bust,20,0,13,186,0.446236559,0.059139785,0.564516129,1,0.307826125
3115,113,20520,10,10,0,0,0,20,4,10,9,0,0,23,nowin,win,dlbust,bust,20,0,20,199,0.407035176,0.055276382,0.668341709,2,0.620695264
3116,50,20520,4,9,0,0,0,13,4,10,9,0,0,23,nowin,win,dlbust,bust,20,0,13,202,0.405940594,0.04950495,0.54950495,0,0.020296079
3117,134,20520,9,3,0,0,0,12,4,10,9,0,0,23,nowin,win,dlbust,bust,20,0,12,185,0.443243243,0.021621622,0.545945946,1,0.296939509
3118,86,20520,10,3,0,0,0,13,4,10,9,0,0,23,nowin,win,dlbust,bust,20,0,13,196,0.454081633,0.040816327,0.591836735,3,0.887566443
3119,37,20520,11,10,0,0,0,21,4,10,9,0,0,23,win,win,dlbust,bust,25,0,21,208,0.394230769,0.038461538,0.581730769,0,0.024682772
3120,79,20521,6,10,0,0,0,16,6,6,1,5,0,18,nowin,loss,beat,dlwin,0,10,16,211,0.436018957,0.028436019,0.672985782,2,0.650131054
3121,52,20521,10,4,0,0,0,14,6,6,1,5,0,18,nowin,loss,beat,dlwin,0,10,14,217,0.414746544,0.02764977,0.599078341,2,0.576736024
3122,14,20521,10,3,0,0,0,13,6,6,1,5,0,18,nowin,loss,beat,dlwin,0,10,13,202,0.391089109,0.01980198,0.628712871,2,0.577264877
3123,49,20521,10,10,0,0,0,20,6,6,1,5,0,18,nowin,win,plwin,beat,20,0,20,207,0.396135266,0.053140097,0.594202899,0,0.028306925
3124,11,20521,6,10,0,0,0,16,6,6,1,5,0,18,nowin,loss,beat,dlwin,0,10,16,236,0.457627119,0.016949153,0.588983051,3,0.889015813
3125,36,20521,5,4,3,0,0,12,6,6,1,5,0,18,nowin,loss,beat,dlwin,0,10,9,229,0.445414847,0.056768559,0.655021834,2,0.645370571
3126,117,20522,1,6,10,0,0,17,10,10,0,0,0,20,nowin,loss,beat,dlwin,0,10,7,173,0.410404624,0.069364162,0.606936416,2,0.578610282
3127,112,20522,2,11,3,4,0,20,10,10,0,0,0,20,nowin,push,push,push,10,0,13,203,0.448275862,0.054187192,0.600985222,3,0.889576933
3128,17,20522,8,9,0,0,0,17,10,10,0,0,0,20,nowin,loss,beat,dlwin,0,10,17,171,0.444444444,0.070175439,0.555555556,1,0.302364894
3129,102,20522,4,7,7,0,0,18,10,10,0,0,0,20,nowin,loss,beat,dlwin,0,10,11,192,0.338541667,0.046875,0.5625,0,0.003306118
3130,95,20522,11,7,0,0,0,18,10,10,0,0,0,20,nowin,loss,beat,dlwin,0,10,18,218,0.412844037,0.04587156,0.559633028,0,0.024842385
3131,80,20522,10,7,0,0,0,17,10,10,0,0,0,20,nowin,loss,beat,dlwin,0,10,17,186,0.419354839,0.059139785,0.623655914,2,0.59892924
3132,109,20523,5,2,2,10,0,19,9,9,0,0,0,18,nowin,win,plwin,beat,20,0,7,221,0.461538462,0.058823529,0.597285068,3,0.901830309
3133,12,20523,5,6,10,0,0,21,9,9,0,0,0,18,nowin,win,plwin,beat,20,0,11,189,0.470899471,0.015873016,0.613756614,3,0.929171178
3134,12,20523,9,11,0,0,0,20,9,9,0,0,0,18,nowin,win,plwin,beat,20,0,20,189,0.470899471,0.015873016,0.613756614,3,0.929171178
3135,66,20523,10,2,0,9,0,21,9,9,0,0,0,18,nowin,win,plwin,beat,20,0,12,217,0.456221198,0.064516129,0.626728111,3,0.924304367
3136,83,20523,3,1,8,10,0,22,9,9,0,0,0,18,nowin,loss,bust,plbust,0,10,4,193,0.424870466,0.051813472,0.678756477,2,0.644360335
3137,10,20523,8,6,0,6,0,20,9,9,0,0,0,18,nowin,win,plwin,beat,20,0,14,191,0.413612565,0.057591623,0.596858639,2,0.574087175
3138,61,20524,8,10,0,0,0,18,3,10,2,5,0,20,nowin,loss,beat,dlwin,0,10,18,194,0.427835052,0.077319588,0.603092784,2,0.591437139
3139,99,20524,10,10,0,0,0,20,3,10,2,5,0,20,nowin,push,push,push,10,0,20,207,0.47826087,0.062801932,0.637681159,3,0.961418446
3140,76,20524,10,10,0,0,0,20,3,10,2,5,0,20,nowin,push,push,push,10,0,20,189,0.534391534,0.079365079,0.608465608,3,1
3141,82,20524,2,10,0,1,0,13,3,10,2,5,0,20,nowin,loss,beat,dlwin,0,10,12,225,0.408888889,0.075555556,0.577777778,0,0.028101874
3142,60,20524,10,10,0,0,0,20,3,10,2,5,0,20,nowin,push,push,push,10,0,20,227,0.418502203,0.022026432,0.559471366,0,0.026496258
3143,14,20524,8,3,1,10,0,22,3,10,2,5,0,20,nowin,loss,bust,plbust,0,10,11,202,0.391089109,0.01980198,0.628712871,2,0.577264877
3144,42,20525,4,6,4,9,0,23,10,10,0,0,0,20,nowin,loss,bust,plbust,0,10,10,212,0.443396226,0.051886792,0.570754717,1,0.309181312
3145,103,20525,3,10,0,10,0,23,10,10,0,0,0,20,nowin,loss,bust,plbust,0,10,13,203,0.379310345,0.064039409,0.551724138,0,0.012869209
3146,17,20525,10,7,0,0,0,17,10,10,0,0,0,20,nowin,loss,beat,dlwin,0,10,17,171,0.444444444,0.070175439,0.555555556,1,0.302364894
3147,111,20525,1,4,10,10,0,25,10,10,0,0,0,20,nowin,loss,bust,plbust,0,10,5,180,0.433333333,0.055555556,0.611111111,2,0.602264492
3148,148,20525,5,10,0,5,0,20,10,10,0,0,0,20,nowin,push,push,push,10,0,15,204,0.401960784,0.078431373,0.593137255,0,0.029789521
3149,72,20525,4,10,0,9,0,23,10,10,0,0,0,20,nowin,loss,bust,plbust,0,10,14,185,0.394594595,0.032432432,0.508108108,0,0.006763115
3150,129,20526,10,11,0,0,0,21,3,1,10,4,0,18,win,win,plwin,beat,25,0,21,201,0.422885572,0.064676617,0.55721393,0,0.027255383
3151,51,20526,10,10,0,0,0,20,3,1,10,4,0,18,nowin,win,plwin,beat,20,0,20,189,0.529100529,0.068783069,0.608465608,3,0.993665715
3152,67,20526,10,3,0,0,0,13,3,1,10,4,0,18,nowin,loss,beat,dlwin,0,10,13,195,0.369230769,0.041025641,0.569230769,0,0.014139427
3153,35,20526,2,5,10,0,0,17,3,1,10,4,0,18,nowin,loss,beat,dlwin,0,10,7,202,0.410891089,0.044554455,0.633663366,2,0.598681573
3154,31,20526,6,7,0,0,0,13,3,1,10,4,0,18,nowin,loss,beat,dlwin,0,10,13,188,0.473404255,0.058510638,0.515957447,1,0.300306557
3155,5,20526,10,10,0,0,0,20,3,1,10,4,0,18,nowin,win,plwin,beat,20,0,20,203,0.42364532,0.02955665,0.596059113,2,0.582508076
3156,141,20527,5,10,0,0,0,15,6,10,1,0,0,17,nowin,loss,beat,dlwin,0,10,15,202,0.420792079,0.074257426,0.564356436,0,0.028377851
3157,111,20527,3,2,10,0,0,15,6,10,1,0,0,17,nowin,loss,beat,dlwin,0,10,5,180,0.433333333,0.055555556,0.611111111,2,0.602264492
3158,19,20527,10,10,0,0,0,20,6,10,1,0,0,17,nowin,win,plwin,beat,20,0,20,237,0.41350211,0.054852321,0.628691983,2,0.597373826
3159,34,20527,10,4,0,0,0,14,6,10,1,0,0,17,nowin,loss,beat,dlwin,0,10,14,202,0.5,0.079207921,0.618811881,3,0.968961434
3160,116,20527,10,10,0,0,0,20,6,10,1,0,0,17,nowin,win,plwin,beat,20,0,20,195,0.425641026,0.056410256,0.538461538,1,0.28273747
3161,120,20527,4,8,0,0,0,12,6,10,1,0,0,17,nowin,loss,beat,dlwin,0,10,12,202,0.440594059,0.034653465,0.618811881,2,0.614441029
3162,38,20528,8,10,0,0,0,18,11,10,0,0,0,21,nowin,loss,beat,dlwin,0,10,18,202,0.361386139,0.03960396,0.564356436,0,0.010597953
3163,2,20528,6,1,8,6,0,21,11,10,0,0,0,21,nowin,push,push,push,10,0,7,200,0.445,0.035,0.64,2,0.633962549
3164,143,20528,10,10,0,0,0,20,11,10,0,0,0,21,nowin,loss,beat,dlwin,0,10,20,203,0.463054187,0.044334975,0.57635468,3,0.883143365
3165,105,20528,8,10,0,0,0,18,11,10,0,0,0,21,nowin,loss,beat,dlwin,0,10,18,198,0.414141414,0.070707071,0.590909091,0,0.032889494
3166,147,20528,10,2,0,6,0,18,11,10,0,0,0,21,nowin,loss,beat,dlwin,0,10,12,205,0.380487805,0.014634146,0.536585366,0,0.00951447
3167,143,20528,10,2,0,5,0,17,11,10,0,0,0,21,nowin,loss,beat,dlwin,0,10,12,203,0.463054187,0.044334975,0.57635468,3,0.883143365
3168,5,20529,6,9,0,8,0,23,11,10,0,0,0,21,nowin,loss,bust,plbust,0,10,15,203,0.42364532,0.02955665,0.596059113,2,0.582508076
3169,29,20529,5,3,10,0,0,18,11,10,0,0,0,21,nowin,loss,beat,dlwin,0,10,8,189,0.44973545,0.058201058,0.544973545,1,0.300349439
3170,36,20529,11,10,0,0,0,21,11,10,0,0,0,21,win,push,push,push,10,0,21,229,0.445414847,0.056768559,0.655021834,2,0.645370571
3171,60,20529,10,11,0,0,0,21,11,10,0,0,0,21,win,push,push,push,10,0,21,227,0.418502203,0.022026432,0.559471366,0,0.026496258
3172,80,20529,10,7,0,0,0,17,11,10,0,0,0,21,nowin,loss,beat,dlwin,0,10,17,186,0.419354839,0.059139785,0.623655914,2,0.59892924
3173,64,20529,4,10,0,9,0,23,11,10,0,0,0,21,nowin,loss,bust,plbust,0,10,14,187,0.363636364,0.048128342,0.631016043,0,0.027594885
3174,129,20530,3,11,2,5,0,21,11,10,0,0,0,21,nowin,push,push,push,10,0,14,201,0.422885572,0.064676617,0.55721393,0,0.027255383
3175,55,20530,10,4,0,10,0,24,11,10,0,0,0,21,nowin,loss,bust,plbust,0,10,14,191,0.371727749,0.057591623,0.54973822,0,0.01011347
3176,98,20530,8,10,0,0,0,18,11,10,0,0,0,21,nowin,loss,beat,dlwin,0,10,18,220,0.422727273,0.054545455,0.55,1,0.28664435
3177,74,20530,5,10,0,8,0,23,11,10,0,0,0,21,nowin,loss,bust,plbust,0,10,15,209,0.411483254,0.04784689,0.531100478,0,0.017448125
3178,72,20530,6,4,10,0,0,20,11,10,0,0,0,21,nowin,loss,beat,dlwin,0,10,10,185,0.394594595,0.032432432,0.508108108,0,0.006763115
3179,139,20530,10,10,0,0,0,20,11,10,0,0,0,21,nowin,loss,beat,dlwin,0,10,20,192,0.380208333,0.036458333,0.59375,0,0.023429169
3180,56,20531,2,7,6,10,0,25,8,3,10,0,0,21,nowin,loss,bust,plbust,0,10,9,175,0.4,0.057142857,0.582857143,0,0.026685297
3181,82,20531,7,2,6,10,0,25,8,3,10,0,0,21,nowin,loss,bust,plbust,0,10,9,225,0.408888889,0.075555556,0.577777778,0,0.028101874
3182,7,20531,10,4,0,1,10,25,8,3,10,0,0,21,nowin,loss,bust,plbust,0,10,14,183,0.442622951,0.06010929,0.62295082,2,0.619303341
3183,3,20531,3,4,3,5,10,25,8,3,10,0,0,21,nowin,loss,bust,plbust,0,10,7,190,0.431578947,0.026315789,0.542105263,1,0.288076384
3184,85,20531,6,1,10,0,0,17,8,3,10,0,0,21,nowin,loss,beat,dlwin,0,10,7,195,0.41025641,0.066666667,0.594871795,0,0.03269711
3185,79,20531,10,3,0,2,10,25,8,3,10,0,0,21,nowin,loss,bust,plbust,0,10,13,211,0.436018957,0.028436019,0.672985782,2,0.650131054
3186,105,20532,7,6,0,1,7,21,8,10,0,0,0,18,nowin,win,plwin,beat,20,0,13,198,0.414141414,0.070707071,0.590909091,0,0.032889494
3187,84,20532,10,8,0,0,0,18,8,10,0,0,0,18,nowin,push,push,push,10,0,18,195,0.379487179,0.056410256,0.569230769,0,0.017209119
3188,30,20532,3,10,0,8,0,21,8,10,0,0,0,18,nowin,win,plwin,beat,20,0,13,206,0.393203883,0.033980583,0.601941748,0,0.029324648
3189,107,20532,5,3,7,5,0,20,8,10,0,0,0,18,nowin,win,plwin,beat,20,0,8,218,0.444954128,0.073394495,0.600917431,2,0.605210014
3190,95,20532,4,10,0,3,0,17,8,10,0,0,0,18,nowin,loss,beat,dlwin,0,10,14,218,0.412844037,0.04587156,0.559633028,0,0.024842385
3191,133,20532,10,4,0,1,10,25,8,10,0,0,0,18,nowin,loss,bust,plbust,0,10,14,201,0.47761194,0.064676617,0.611940299,3,0.935428111
3192,95,20533,10,8,0,0,0,18,3,6,4,9,0,22,nowin,win,dlbust,bust,20,0,18,218,0.412844037,0.04587156,0.559633028,0,0.024842385
3193,132,20533,5,10,0,0,0,15,3,6,4,9,0,22,nowin,win,dlbust,bust,20,0,15,194,0.412371134,0.036082474,0.649484536,2,0.611633238
3194,126,20533,8,10,0,0,0,18,3,6,4,9,0,22,nowin,win,dlbust,bust,20,0,18,188,0.457446809,0.074468085,0.60106383,3,0.900633203
3195,113,20533,10,10,0,0,0,20,3,6,4,9,0,22,nowin,win,dlbust,bust,20,0,20,199,0.407035176,0.055276382,0.668341709,2,0.620695264
3196,79,20533,9,10,0,0,0,19,3,6,4,9,0,22,nowin,win,dlbust,bust,20,0,19,211,0.436018957,0.028436019,0.672985782,2,0.650131054
3197,118,20533,5,10,0,0,0,15,3,6,4,9,0,22,nowin,win,dlbust,bust,20,0,15,216,0.393518519,0.037037037,0.555555556,0,0.018059873
3198,99,20534,2,11,3,0,0,16,4,8,9,0,0,21,nowin,loss,beat,dlwin,0,10,13,207,0.47826087,0.062801932,0.637681159,3,0.961418446
3199,123,20534,8,8,0,0,0,16,4,8,9,0,0,21,nowin,loss,beat,dlwin,0,10,16,205,0.43902439,0.034146341,0.614634146,2,0.609962544
3200,146,20534,6,10,0,0,0,16,4,8,9,0,0,21,nowin,loss,beat,dlwin,0,10,16,221,0.43438914,0.040723982,0.542986425,1,0.290190091
3201,56,20534,10,11,0,0,0,21,4,8,9,0,0,21,win,push,push,push,10,0,21,175,0.4,0.057142857,0.582857143,0,0.026685297
3202,42,20534,10,11,0,0,0,21,4,8,9,0,0,21,win,push,push,push,10,0,21,212,0.443396226,0.051886792,0.570754717,1,0.309181312
3203,94,20534,3,10,0,0,0,13,4,8,9,0,0,21,nowin,loss,beat,dlwin,0,10,13,183,0.43715847,0.043715847,0.540983607,1,0.290866892
3204,129,20535,10,2,0,7,0,19,2,2,10,9,0,23,nowin,win,dlbust,bust,20,0,12,201,0.422885572,0.064676617,0.55721393,0,0.027255383
3205,137,20535,9,10,0,0,0,19,2,2,10,9,0,23,nowin,win,dlbust,bust,20,0,19,194,0.417525773,0.046391753,0.536082474,1,0.276714602
3206,107,20535,8,9,0,0,0,17,2,2,10,9,0,23,nowin,win,dlbust,bust,20,0,17,218,0.444954128,0.073394495,0.600917431,2,0.605210014
3207,98,20535,4,9,0,0,0,13,2,2,10,9,0,23,nowin,win,dlbust,bust,20,0,13,220,0.422727273,0.054545455,0.55,1,0.28664435
3208,9,20535,10,9,0,0,0,19,2,2,10,9,0,23,nowin,win,dlbust,bust,20,0,19,194,0.37628866,0.015463918,0.541237113,0,0.009396796
3209,114,20535,11,10,0,0,0,21,2,2,10,9,0,23,win,win,dlbust,bust,25,0,21,198,0.47979798,0.025252525,0.611111111,3,0.937232995
3210,123,20536,10,3,0,6,0,19,10,3,10,0,0,23,nowin,win,dlbust,bust,20,0,13,205,0.43902439,0.034146341,0.614634146,2,0.609962544
3211,128,20536,5,8,0,10,0,23,10,3,10,0,0,23,nowin,loss,bust,plbust,0,10,13,227,0.356828194,0.052863436,0.577092511,0,0.012352564
3212,27,20536,4,10,0,6,0,20,10,3,10,0,0,23,nowin,win,dlbust,bust,20,0,14,178,0.370786517,0.016853933,0.573033708,0,0.015536309
3213,103,20536,3,7,10,0,0,20,10,3,10,0,0,23,nowin,win,dlbust,bust,20,0,10,203,0.379310345,0.064039409,0.551724138,0,0.012869209
3214,22,20536,10,8,0,0,0,18,10,3,10,0,0,23,nowin,win,dlbust,bust,20,0,18,187,0.481283422,0.042780749,0.577540107,3,0.906128176
3215,12,20536,10,2,0,4,8,24,10,3,10,0,0,23,nowin,loss,bust,plbust,0,10,12,189,0.470899471,0.015873016,0.613756614,3,0.929171178
3216,95,20537,9,5,0,10,0,24,8,11,0,0,0,19,nowin,loss,bust,plbust,0,10,14,218,0.412844037,0.04587156,0.559633028,0,0.024842385
3217,96,20537,4,5,10,0,0,19,8,11,0,0,0,19,nowin,push,push,push,10,0,9,190,0.468421053,0.057894737,0.584210526,3,0.897263354
3218,6,20537,8,4,0,1,10,23,8,11,0,0,0,19,nowin,loss,bust,plbust,0,10,12,191,0.439790576,0.047120419,0.581151832,1,0.31211505
3219,94,20537,5,6,10,0,0,21,8,11,0,0,0,19,nowin,win,plwin,beat,20,0,11,183,0.43715847,0.043715847,0.540983607,1,0.290866892
3220,13,20537,11,10,0,0,0,21,8,11,0,0,0,19,win,win,plwin,beat,25,0,21,206,0.417475728,0.063106796,0.621359223,2,0.59555479
3221,25,20537,4,4,11,0,0,19,8,11,0,0,0,19,nowin,push,push,push,10,0,8,190,0.463157895,0.063157895,0.536842105,1,0.304401563
3222,43,20538,10,10,0,0,0,20,11,7,0,0,0,18,nowin,win,plwin,beat,20,0,20,192,0.40625,0.041666667,0.609375,2,0.576671372
3223,32,20538,7,9,0,6,0,22,11,7,0,0,0,18,nowin,loss,bust,plbust,0,10,16,189,0.391534392,0.037037037,0.53968254,0,0.013579086
3224,54,20538,10,10,0,0,0,20,11,7,0,0,0,18,nowin,win,plwin,beat,20,0,20,185,0.437837838,0.032432432,0.556756757,1,0.29899854
3225,22,20538,11,7,0,0,0,18,11,7,0,0,0,18,nowin,push,push,push,10,0,18,187,0.481283422,0.042780749,0.577540107,3,0.906128176
3226,70,20538,5,7,0,10,0,22,11,7,0,0,0,18,nowin,loss,bust,plbust,0,10,12,228,0.385964912,0.039473684,0.557017544,0,0.016157125
3227,45,20538,8,6,0,10,0,24,11,7,0,0,0,18,nowin,loss,bust,plbust,0,10,14,196,0.428571429,0.051020408,0.612244898,2,0.598821767
3228,1,20539,10,9,0,0,0,19,6,3,2,5,6,22,nowin,win,dlbust,bust,20,0,19,197,0.406091371,0.025380711,0.649746193,2,0.606186955
3229,137,20539,6,3,3,0,0,12,6,3,2,5,6,22,nowin,win,dlbust,bust,20,0,9,194,0.417525773,0.046391753,0.536082474,1,0.276714602
3230,149,20539,10,8,0,0,0,18,6,3,2,5,6,22,nowin,win,dlbust,bust,20,0,18,225,0.457777778,0.057777778,0.648888889,2,0.651965595
3231,49,20539,10,10,0,0,0,20,6,3,2,5,6,22,nowin,win,dlbust,bust,20,0,20,207,0.396135266,0.053140097,0.594202899,0,0.028306925
3232,40,20539,5,10,0,0,0,15,6,3,2,5,6,22,nowin,win,dlbust,bust,20,0,15,196,0.367346939,0.030612245,0.617346939,0,0.025358183
3233,16,20539,3,9,0,0,0,12,6,3,2,5,6,22,nowin,win,dlbust,bust,20,0,12,220,0.427272727,0.081818182,0.6,2,0.588660176
3234,9,20540,9,6,0,0,0,15,3,6,10,0,0,19,nowin,loss,beat,dlwin,0,10,15,194,0.37628866,0.015463918,0.541237113,0,0.009396796
3235,35,20540,10,2,0,7,0,19,3,6,10,0,0,19,nowin,push,push,push,10,0,12,202,0.410891089,0.044554455,0.633663366,2,0.598681573
3236,26,20540,10,7,0,0,0,17,3,6,10,0,0,19,nowin,loss,beat,dlwin,0,10,17,203,0.463054187,0.0591133,0.541871921,1,0.306802864
3237,123,20540,10,10,0,0,0,20,3,6,10,0,0,19,nowin,win,plwin,beat,20,0,20,205,0.43902439,0.034146341,0.614634146,2,0.609962544
3238,96,20540,8,5,0,0,0,13,3,6,10,0,0,19,nowin,loss,beat,dlwin,0,10,13,190,0.468421053,0.057894737,0.584210526,3,0.897263354
3239,80,20540,11,10,0,0,0,21,3,6,10,0,0,19,win,win,plwin,beat,25,0,21,186,0.419354839,0.059139785,0.623655914,2,0.59892924
3240,65,20541,7,5,0,7,0,19,10,2,5,0,0,17,nowin,win,plwin,beat,20,0,12,203,0.492610837,0.054187192,0.571428571,3,0.913702814
3241,122,20541,10,11,0,0,0,21,10,2,5,0,0,17,win,win,plwin,beat,25,0,21,210,0.347619048,0.052380952,0.59047619,0,0.012873677
3242,46,20541,7,8,0,6,0,21,10,2,5,0,0,17,nowin,win,plwin,beat,20,0,15,186,0.403225806,0.048387097,0.591397849,0,0.029742194
3243,82,20541,1,5,6,10,0,22,10,2,5,0,0,17,nowin,loss,bust,plbust,0,10,6,225,0.408888889,0.075555556,0.577777778,0,0.028101874
3244,40,20541,3,3,2,8,5,21,10,2,5,0,0,17,nowin,win,plwin,beat,20,0,6,196,0.367346939,0.030612245,0.617346939,0,0.025358183
3245,17,20541,11,10,0,0,0,21,10,2,5,0,0,17,win,win,plwin,beat,25,0,21,171,0.444444444,0.070175439,0.555555556,1,0.302364894
3246,51,20542,3,4,5,3,10,25,11,10,0,0,0,21,nowin,loss,bust,plbust,0,10,7,189,0.529100529,0.068783069,0.608465608,3,0.993665715
3247,109,20542,10,11,0,0,0,21,11,10,0,0,0,21,win,push,push,push,10,0,21,221,0.461538462,0.058823529,0.597285068,3,0.901830309
3248,132,20542,2,5,3,5,10,25,11,10,0,0,0,21,nowin,loss,bust,plbust,0,10,7,194,0.412371134,0.036082474,0.649484536,2,0.611633238
3249,125,20542,7,11,0,0,0,18,11,10,0,0,0,21,nowin,loss,beat,dlwin,0,10,18,219,0.438356164,0.050228311,0.575342466,1,0.308411257
3250,58,20542,7,6,0,2,1,16,11,10,0,0,0,21,nowin,loss,beat,dlwin,0,10,13,195,0.430769231,0.041025641,0.584615385,2,0.580497586
3251,144,20542,10,4,0,8,0,22,11,10,0,0,0,21,nowin,loss,bust,plbust,0,10,14,202,0.386138614,0.054455446,0.564356436,0,0.018006244
3252,8,20543,10,3,0,4,0,17,10,8,0,0,0,18,nowin,loss,beat,dlwin,0,10,13,181,0.44198895,0.071823204,0.596685083,2,0.599438402
3253,105,20543,2,6,8,5,0,21,10,8,0,0,0,18,nowin,win,plwin,beat,20,0,8,198,0.414141414,0.070707071,0.590909091,0,0.032889494
3254,43,20543,1,2,10,3,2,18,10,8,0,0,0,18,nowin,push,push,push,10,0,3,192,0.40625,0.041666667,0.609375,2,0.576671372
3255,99,20543,4,10,0,2,6,22,10,8,0,0,0,18,nowin,loss,bust,plbust,0,10,14,207,0.47826087,0.062801932,0.637681159,3,0.961418446
3256,30,20543,6,3,3,3,5,20,10,8,0,0,0,18,nowin,win,plwin,beat,20,0,9,206,0.393203883,0.033980583,0.601941748,0,0.029324648
3257,91,20543,2,10,0,9,0,21,10,8,0,0,0,18,nowin,win,plwin,beat,20,0,12,194,0.417525773,0.046391753,0.515463918,1,0.266616552
3258,140,20544,11,10,0,0,0,21,10,3,7,0,0,20,win,win,plwin,beat,25,0,21,210,0.466666667,0.023809524,0.604761905,3,0.915293335
3259,28,20544,9,6,0,10,0,25,10,3,7,0,0,20,nowin,loss,bust,plbust,0,10,15,199,0.422110553,0.045226131,0.542713568,1,0.282706618
3260,137,20544,5,9,0,7,0,21,10,3,7,0,0,20,nowin,win,plwin,beat,20,0,14,194,0.417525773,0.046391753,0.536082474,1,0.276714602
3261,53,20544,10,11,0,0,0,21,10,3,7,0,0,20,win,win,plwin,beat,25,0,21,250,0.372,0.064,0.564,0,0.013687345
3262,61,20544,2,3,11,5,0,21,10,3,7,0,0,20,nowin,win,plwin,beat,20,0,5,194,0.427835052,0.077319588,0.603092784,2,0.591437139
3263,61,20544,10,8,0,0,0,18,10,3,7,0,0,20,nowin,loss,beat,dlwin,0,10,18,194,0.427835052,0.077319588,0.603092784,2,0.591437139
3264,66,20545,4,10,0,1,10,25,11,9,0,0,0,20,nowin,loss,bust,plbust,0,10,14,217,0.456221198,0.064516129,0.626728111,3,0.924304367
3265,104,20545,10,10,0,0,0,20,11,9,0,0,0,20,nowin,push,push,push,10,0,20,209,0.363636364,0.052631579,0.593301435,0,0.018359419
3266,117,20545,10,11,0,0,0,21,11,9,0,0,0,20,win,win,plwin,beat,25,0,21,173,0.410404624,0.069364162,0.606936416,2,0.578610282
3267,129,20545,10,10,0,0,0,20,11,9,0,0,0,20,nowin,push,push,push,10,0,20,201,0.422885572,0.064676617,0.55721393,0,0.027255383
3268,104,20545,1,5,10,10,0,26,11,9,0,0,0,20,nowin,loss,bust,plbust,0,10,6,209,0.363636364,0.052631579,0.593301435,0,0.018359419
3269,27,20545,8,8,0,3,0,19,11,9,0,0,0,20,nowin,loss,beat,dlwin,0,10,16,178,0.370786517,0.016853933,0.573033708,0,0.015536309
3270,115,20546,10,4,0,0,0,14,2,2,8,3,4,19,nowin,loss,beat,dlwin,0,10,14,194,0.427835052,0.041237113,0.592783505,2,0.583863602
3271,76,20546,4,10,0,0,0,14,2,2,8,3,4,19,nowin,loss,beat,dlwin,0,10,14,189,0.534391534,0.079365079,0.608465608,3,1
3272,110,20546,11,10,0,0,0,21,2,2,8,3,4,19,win,win,plwin,beat,25,0,21,192,0.416666667,0.046875,0.557291667,0,0.025413132
3273,11,20546,5,4,7,0,0,16,2,2,8,3,4,19,nowin,loss,beat,dlwin,0,10,9,236,0.457627119,0.016949153,0.588983051,3,0.889015813
3274,50,20546,10,10,0,0,0,20,2,2,8,3,4,19,nowin,win,plwin,beat,20,0,20,202,0.405940594,0.04950495,0.54950495,0,0.020296079
3275,9,20546,5,10,0,0,0,15,2,2,8,3,4,19,nowin,loss,beat,dlwin,0,10,15,194,0.37628866,0.015463918,0.541237113,0,0.009396796
3276,40,20547,7,3,4,0,0,14,4,3,10,0,0,17,nowin,loss,beat,dlwin,0,10,10,196,0.367346939,0.030612245,0.617346939,0,0.025358183
3277,139,20547,9,3,0,0,0,12,4,3,10,0,0,17,nowin,loss,beat,dlwin,0,10,12,192,0.380208333,0.036458333,0.59375,0,0.023429169
3278,97,20547,10,10,0,0,0,20,4,3,10,0,0,17,nowin,win,plwin,beat,20,0,20,182,0.450549451,0.06043956,0.692307692,2,0.677372279
3279,125,20547,10,10,0,0,0,20,4,3,10,0,0,17,nowin,win,plwin,beat,20,0,20,219,0.438356164,0.050228311,0.575342466,1,0.308411257
3280,34,20547,10,4,0,0,0,14,4,3,10,0,0,17,nowin,loss,beat,dlwin,0,10,14,202,0.5,0.079207921,0.618811881,3,0.968961434
3281,137,20547,10,10,0,0,0,20,4,3,10,0,0,17,nowin,win,plwin,beat,20,0,20,194,0.417525773,0.046391753,0.536082474,1,0.276714602
3282,109,20548,9,11,0,0,0,20,3,3,8,10,0,24,nowin,win,dlbust,bust,20,0,20,221,0.461538462,0.058823529,0.597285068,3,0.901830309
3283,69,20548,10,5,0,0,0,15,3,3,8,10,0,24,nowin,win,dlbust,bust,20,0,15,194,0.365979381,0.030927835,0.515463918,0,0
3284,62,20548,6,10,0,0,0,16,3,3,8,10,0,24,nowin,win,dlbust,bust,20,0,16,178,0.370786517,0.028089888,0.54494382,0,0.008657722
3285,85,20548,2,9,5,0,0,16,3,3,8,10,0,24,nowin,win,dlbust,bust,20,0,11,195,0.41025641,0.066666667,0.594871795,0,0.03269711
3286,127,20548,10,5,0,0,0,15,3,3,8,10,0,24,nowin,win,dlbust,bust,20,0,15,201,0.402985075,0.029850746,0.60199005,0,0.032263937
3287,100,20548,6,10,0,0,0,16,3,3,8,10,0,24,nowin,win,dlbust,bust,20,0,16,190,0.452631579,0.036842105,0.594736842,3,0.888671154
3288,70,20549,6,4,6,10,0,26,8,3,2,4,0,17,nowin,loss,bust,plbust,0,10,10,228,0.385964912,0.039473684,0.557017544,0,0.016157125
3289,84,20549,10,7,0,0,0,17,8,3,2,4,0,17,nowin,push,push,push,10,0,17,195,0.379487179,0.056410256,0.569230769,0,0.017209119
3290,43,20549,11,10,0,0,0,21,8,3,2,4,0,17,win,win,plwin,beat,25,0,21,192,0.40625,0.041666667,0.609375,2,0.576671372
3291,131,20549,8,6,0,2,2,18,8,3,2,4,0,17,nowin,win,plwin,beat,20,0,14,217,0.410138249,0.069124424,0.543778802,0,0.02015021
3292,109,20549,10,2,0,7,0,19,8,3,2,4,0,17,nowin,win,plwin,beat,20,0,12,221,0.461538462,0.058823529,0.597285068,3,0.901830309
3293,60,20549,2,10,0,1,7,20,8,3,2,4,0,17,nowin,win,plwin,beat,20,0,12,227,0.418502203,0.022026432,0.559471366,0,0.026496258
3294,7,20550,10,6,0,0,0,16,3,7,11,0,0,21,nowin,loss,beat,dlwin,0,10,16,183,0.442622951,0.06010929,0.62295082,2,0.619303341
3295,83,20550,9,8,0,0,0,17,3,7,11,0,0,21,nowin,loss,beat,dlwin,0,10,17,193,0.424870466,0.051813472,0.678756477,2,0.644360335
3296,97,20550,10,10,0,0,0,20,3,7,11,0,0,21,nowin,loss,beat,dlwin,0,10,20,182,0.450549451,0.06043956,0.692307692,2,0.677372279
3297,142,20550,4,1,10,0,0,15,3,7,11,0,0,21,nowin,loss,beat,dlwin,0,10,5,211,0.417061611,0.047393365,0.526066351,1,0.271531309
3298,115,20550,2,10,0,3,0,15,3,7,11,0,0,21,nowin,loss,beat,dlwin,0,10,12,194,0.427835052,0.041237113,0.592783505,2,0.583863602
3299,65,20550,10,6,0,0,0,16,3,7,11,0,0,21,nowin,loss,beat,dlwin,0,10,16,203,0.492610837,0.054187192,0.571428571,3,0.913702814
3300,39,20551,10,7,0,0,0,17,10,3,7,0,0,20,nowin,loss,beat,dlwin,0,10,17,191,0.429319372,0.062827225,0.57591623,0,0.033760763
3301,76,20551,10,11,0,0,0,21,10,3,7,0,0,20,win,win,plwin,beat,25,0,21,189,0.534391534,0.079365079,0.608465608,3,1
3302,143,20551,10,6,0,10,0,26,10,3,7,0,0,20,nowin,loss,bust,plbust,0,10,16,203,0.463054187,0.044334975,0.57635468,3,0.883143365
3303,32,20551,2,3,10,10,0,25,10,3,7,0,0,20,nowin,loss,bust,plbust,0,10,5,189,0.391534392,0.037037037,0.53968254,0,0.013579086
3304,147,20551,4,7,1,10,0,22,10,3,7,0,0,20,nowin,loss,bust,plbust,0,10,11,205,0.380487805,0.014634146,0.536585366,0,0.00951447
3305,9,20551,8,4,0,10,0,22,10,3,7,0,0,20,nowin,loss,bust,plbust,0,10,12,194,0.37628866,0.015463918,0.541237113,0,0.009396796
3306,52,20552,5,2,8,0,0,15,3,9,10,0,0,22,nowin,win,dlbust,bust,20,0,7,217,0.414746544,0.02764977,0.599078341,2,0.576736024
3307,66,20552,9,7,0,0,0,16,3,9,10,0,0,22,nowin,win,dlbust,bust,20,0,16,217,0.456221198,0.064516129,0.626728111,3,0.924304367
3308,82,20552,5,2,4,8,0,19,3,9,10,0,0,22,nowin,win,dlbust,bust,20,0,7,225,0.408888889,0.075555556,0.577777778,0,0.028101874
3309,41,20552,8,3,10,0,0,21,3,9,10,0,0,22,nowin,win,dlbust,bust,20,0,11,192,0.364583333,0.036458333,0.520833333,0,0.00089702
3310,122,20552,2,3,9,0,0,14,3,9,10,0,0,22,nowin,win,dlbust,bust,20,0,5,210,0.347619048,0.052380952,0.59047619,0,0.012873677
3311,38,20552,5,2,4,1,10,22,3,9,10,0,0,22,nowin,loss,bust,plbust,0,10,7,202,0.361386139,0.03960396,0.564356436,0,0.010597953
3312,62,20553,10,9,0,0,0,19,10,9,0,0,0,19,nowin,push,push,push,10,0,19,178,0.370786517,0.028089888,0.54494382,0,0.008657722
3313,3,20553,10,6,0,5,0,21,10,9,0,0,0,19,nowin,win,plwin,beat,20,0,16,190,0.431578947,0.026315789,0.542105263,1,0.288076384
3314,41,20553,8,7,0,6,0,21,10,9,0,0,0,19,nowin,win,plwin,beat,20,0,15,192,0.364583333,0.036458333,0.520833333,0,0.00089702
3315,85,20553,5,8,0,10,0,23,10,9,0,0,0,19,nowin,loss,bust,plbust,0,10,13,195,0.41025641,0.066666667,0.594871795,0,0.03269711
3316,74,20553,4,10,0,4,0,18,10,9,0,0,0,19,nowin,loss,beat,dlwin,0,10,14,209,0.411483254,0.04784689,0.531100478,0,0.017448125
3317,150,20553,10,5,0,10,0,25,10,9,0,0,0,19,nowin,loss,bust,plbust,0,10,15,192,0.401041667,0.036458333,0.567708333,0,0.023287458
3318,123,20554,3,6,7,10,0,26,11,4,2,0,0,17,nowin,loss,bust,plbust,0,10,9,205,0.43902439,0.034146341,0.614634146,2,0.609962544
3319,75,20554,6,9,0,10,0,25,11,4,2,0,0,17,nowin,loss,bust,plbust,0,10,15,191,0.418848168,0.052356021,0.570680628,0,0.029344702
3320,91,20554,7,7,0,3,0,17,11,4,2,0,0,17,nowin,push,push,push,10,0,14,194,0.417525773,0.046391753,0.515463918,1,0.266616552
3321,86,20554,6,1,10,0,0,17,11,4,2,0,0,17,nowin,push,push,push,10,0,7,196,0.454081633,0.040816327,0.591836735,3,0.887566443
3322,66,20554,9,11,0,0,0,20,11,4,2,0,0,17,nowin,win,plwin,beat,20,0,20,217,0.456221198,0.064516129,0.626728111,3,0.924304367
3323,70,20554,3,9,0,8,0,20,11,4,2,0,0,17,nowin,win,plwin,beat,20,0,12,228,0.385964912,0.039473684,0.557017544,0,0.016157125
3324,67,20555,6,6,0,3,0,15,3,10,7,0,0,20,nowin,loss,beat,dlwin,0,10,12,195,0.369230769,0.041025641,0.569230769,0,0.014139427
3325,36,20555,2,7,9,0,0,18,3,10,7,0,0,20,nowin,loss,beat,dlwin,0,10,9,229,0.445414847,0.056768559,0.655021834,2,0.645370571
3326,148,20555,10,6,0,0,0,16,3,10,7,0,0,20,nowin,loss,beat,dlwin,0,10,16,204,0.401960784,0.078431373,0.593137255,0,0.029789521
3327,37,20555,4,2,4,10,0,20,3,10,7,0,0,20,nowin,push,push,push,10,0,6,208,0.394230769,0.038461538,0.581730769,0,0.024682772
3328,82,20555,11,10,0,0,0,21,3,10,7,0,0,20,win,win,plwin,beat,25,0,21,225,0.408888889,0.075555556,0.577777778,0,0.028101874
3329,147,20555,8,9,0,0,0,17,3,10,7,0,0,20,nowin,loss,beat,dlwin,0,10,17,205,0.380487805,0.014634146,0.536585366,0,0.00951447
3330,149,20556,9,10,0,0,0,19,11,10,0,0,0,21,nowin,loss,beat,dlwin,0,10,19,225,0.457777778,0.057777778,0.648888889,2,0.651965595
3331,115,20556,8,9,0,0,0,17,11,10,0,0,0,21,nowin,loss,beat,dlwin,0,10,17,194,0.427835052,0.041237113,0.592783505,2,0.583863602
3332,118,20556,2,5,2,10,0,19,11,10,0,0,0,21,nowin,loss,beat,dlwin,0,10,7,216,0.393518519,0.037037037,0.555555556,0,0.018059873
3333,98,20556,3,10,0,3,3,19,11,10,0,0,0,21,nowin,loss,beat,dlwin,0,10,13,220,0.422727273,0.054545455,0.55,1,0.28664435
3334,57,20556,10,10,0,0,0,20,11,10,0,0,0,21,nowin,loss,beat,dlwin,0,10,20,192,0.46875,0.052083333,0.59375,3,0.907001181
3335,62,20556,7,8,0,10,0,25,11,10,0,0,0,21,nowin,loss,bust,plbust,0,10,15,178,0.370786517,0.028089888,0.54494382,0,0.008657722
3336,42,20557,5,4,2,10,0,21,11,7,0,0,0,18,nowin,win,plwin,beat,20,0,9,212,0.443396226,0.051886792,0.570754717,1,0.309181312
3337,107,20557,5,1,7,10,0,23,11,7,0,0,0,18,nowin,loss,bust,plbust,0,10,6,218,0.444954128,0.073394495,0.600917431,2,0.605210014
3338,144,20557,10,5,0,6,0,21,11,7,0,0,0,18,nowin,win,plwin,beat,20,0,15,202,0.386138614,0.054455446,0.564356436,0,0.018006244
3339,48,20557,9,3,0,3,10,25,11,7,0,0,0,18,nowin,loss,bust,plbust,0,10,12,203,0.413793103,0.019704433,0.600985222,2,0.577280801
3340,119,20557,10,11,0,0,0,21,11,7,0,0,0,18,win,win,plwin,beat,25,0,21,190,0.405263158,0.068421053,0.515789474,0,0.011837158
3341,23,20557,9,5,0,4,0,18,11,7,0,0,0,18,nowin,push,push,push,10,0,14,208,0.427884615,0.0625,0.552884615,1,0.29114424
3342,36,20558,4,10,0,10,0,24,11,3,6,0,0,20,nowin,loss,bust,plbust,0,10,14,229,0.445414847,0.056768559,0.655021834,2,0.645370571
3343,53,20558,3,6,10,0,0,19,11,3,6,0,0,20,nowin,loss,beat,dlwin,0,10,9,250,0.372,0.064,0.564,0,0.013687345
3344,43,20558,11,8,0,0,0,19,11,3,6,0,0,20,nowin,loss,beat,dlwin,0,10,19,192,0.40625,0.041666667,0.609375,2,0.576671372
3345,21,20558,10,10,0,0,0,20,11,3,6,0,0,20,nowin,push,push,push,10,0,20,214,0.359813084,0.042056075,0.626168224,0,0.025263474
3346,148,20558,6,7,0,10,0,23,11,3,6,0,0,20,nowin,loss,bust,plbust,0,10,13,204,0.401960784,0.078431373,0.593137255,0,0.029789521
3347,13,20558,10,10,0,0,0,20,11,3,6,0,0,20,nowin,push,push,push,10,0,20,206,0.417475728,0.063106796,0.621359223,2,0.59555479
3348,112,20559,3,9,0,9,0,21,2,5,10,0,0,17,nowin,win,plwin,beat,20,0,12,203,0.448275862,0.054187192,0.600985222,3,0.889576933
3349,108,20559,10,10,0,0,0,20,2,5,10,0,0,17,nowin,win,plwin,beat,20,0,20,193,0.435233161,0.056994819,0.559585492,1,0.298824795
3350,24,20559,8,10,0,0,0,18,2,5,10,0,0,17,nowin,win,plwin,beat,20,0,18,207,0.458937198,0.048309179,0.570048309,1,0.318138014
3351,55,20559,7,10,0,0,0,17,2,5,10,0,0,17,nowin,push,push,push,10,0,17,191,0.371727749,0.057591623,0.54973822,0,0.01011347
3352,23,20559,5,5,2,10,0,22,2,5,10,0,0,17,nowin,loss,bust,plbust,0,10,10,208,0.427884615,0.0625,0.552884615,1,0.29114424
3353,63,20559,8,2,10,0,0,20,2,5,10,0,0,17,nowin,win,plwin,beat,20,0,10,216,0.467592593,0.037037037,0.62037037,3,0.931690496
3354,22,20560,7,10,0,0,0,17,2,2,11,9,0,24,nowin,win,dlbust,bust,20,0,17,187,0.481283422,0.042780749,0.577540107,3,0.906128176
3355,51,20560,8,3,6,0,0,17,2,2,11,9,0,24,nowin,win,dlbust,bust,20,0,11,189,0.529100529,0.068783069,0.608465608,3,0.993665715
3356,80,20560,8,10,0,0,0,18,2,2,11,9,0,24,nowin,win,dlbust,bust,20,0,18,186,0.419354839,0.059139785,0.623655914,2,0.59892924
3357,25,20560,10,6,0,0,0,16,2,2,11,9,0,24,nowin,win,dlbust,bust,20,0,16,190,0.463157895,0.063157895,0.536842105,1,0.304401563
3358,132,20560,4,10,0,0,0,14,2,2,11,9,0,24,nowin,win,dlbust,bust,20,0,14,194,0.412371134,0.036082474,0.649484536,2,0.611633238
3359,89,20560,10,3,0,0,0,13,2,2,11,9,0,24,nowin,win,dlbust,bust,20,0,13,212,0.537735849,0.047169811,0.594339623,3,0.990167191
3360,115,20561,11,1,8,0,0,20,6,10,5,0,0,21,nowin,loss,beat,dlwin,0,10,12,194,0.427835052,0.041237113,0.592783505,2,0.583863602
3361,25,20561,10,5,0,0,0,15,6,10,5,0,0,21,nowin,loss,beat,dlwin,0,10,15,190,0.463157895,0.063157895,0.536842105,1,0.304401563
3362,133,20561,10,8,0,0,0,18,6,10,5,0,0,21,nowin,loss,beat,dlwin,0,10,18,201,0.47761194,0.064676617,0.611940299,3,0.935428111
3363,22,20561,3,2,11,0,0,16,6,10,5,0,0,21,nowin,loss,beat,dlwin,0,10,5,187,0.481283422,0.042780749,0.577540107,3,0.906128176
3364,39,20561,8,8,0,0,0,16,6,10,5,0,0,21,nowin,loss,beat,dlwin,0,10,16,191,0.429319372,0.062827225,0.57591623,0,0.033760763
3365,36,20561,10,10,0,0,0,20,6,10,5,0,0,21,nowin,loss,beat,dlwin,0,10,20,229,0.445414847,0.056768559,0.655021834,2,0.645370571
3366,26,20562,8,10,0,0,0,18,5,3,3,3,1,15,nowin,win,plwin,beat,20,0,18,203,0.463054187,0.0591133,0.541871921,1,0.306802864
3367,105,20562,4,10,0,0,0,14,5,3,3,3,1,15,nowin,loss,beat,dlwin,0,10,14,198,0.414141414,0.070707071,0.590909091,0,0.032889494
3368,22,20562,4,5,7,0,0,16,5,3,3,3,1,15,nowin,win,plwin,beat,20,0,9,187,0.481283422,0.042780749,0.577540107,3,0.906128176
3369,114,20562,6,10,0,0,0,16,5,3,3,3,1,15,nowin,win,plwin,beat,20,0,16,198,0.47979798,0.025252525,0.611111111,3,0.937232995
3370,148,20562,1,3,10,0,0,14,5,3,3,3,1,15,nowin,loss,beat,dlwin,0,10,4,204,0.401960784,0.078431373,0.593137255,0,0.029789521
3371,129,20562,4,6,8,0,0,18,5,3,3,3,1,15,nowin,win,plwin,beat,20,0,10,201,0.422885572,0.064676617,0.55721393,0,0.027255383
3372,73,20563,5,5,2,4,4,20,10,11,0,0,0,21,nowin,loss,beat,dlwin,0,10,10,181,0.375690608,0.011049724,0.596685083,0,0.022795773
3373,107,20563,10,2,0,10,0,22,10,11,0,0,0,21,nowin,loss,bust,plbust,0,10,12,218,0.444954128,0.073394495,0.600917431,2,0.605210014
3374,13,20563,5,7,0,5,0,17,10,11,0,0,0,21,nowin,loss,beat,dlwin,0,10,12,206,0.417475728,0.063106796,0.621359223,2,0.59555479
3375,42,20563,10,11,0,0,0,21,10,11,0,0,0,21,win,push,push,push,10,0,21,212,0.443396226,0.051886792,0.570754717,1,0.309181312
3376,54,20563,10,10,0,0,0,20,10,11,0,0,0,21,nowin,loss,beat,dlwin,0,10,20,185,0.437837838,0.032432432,0.556756757,1,0.29899854
3377,137,20563,8,3,8,0,0,19,10,11,0,0,0,21,nowin,loss,beat,dlwin,0,10,11,194,0.417525773,0.046391753,0.536082474,1,0.276714602
3378,64,20564,6,11,3,0,0,20,7,8,1,5,0,21,nowin,loss,beat,dlwin,0,10,17,187,0.363636364,0.048128342,0.631016043,0,0.027594885
3379,71,20564,10,10,0,0,0,20,7,8,1,5,0,21,nowin,loss,beat,dlwin,0,10,20,193,0.352331606,0.046632124,0.585492228,0,0.013063661
3380,146,20564,10,10,0,0,0,20,7,8,1,5,0,21,nowin,loss,beat,dlwin,0,10,20,221,0.43438914,0.040723982,0.542986425,1,0.290190091
3381,79,20564,10,5,0,5,0,20,7,8,1,5,0,21,nowin,loss,beat,dlwin,0,10,15,211,0.436018957,0.028436019,0.672985782,2,0.650131054
3382,23,20564,11,3,6,0,0,20,7,8,1,5,0,21,nowin,loss,beat,dlwin,0,10,14,208,0.427884615,0.0625,0.552884615,1,0.29114424
3383,60,20564,10,7,0,0,0,17,7,8,1,5,0,21,nowin,loss,beat,dlwin,0,10,17,227,0.418502203,0.022026432,0.559471366,0,0.026496258
3384,93,20565,5,8,0,7,0,20,10,10,0,0,0,20,nowin,push,push,push,10,0,13,175,0.485714286,0.051428571,0.548571429,1,0.323648091
3385,68,20565,6,9,0,2,0,17,10,10,0,0,0,20,nowin,loss,beat,dlwin,0,10,15,205,0.434146341,0.029268293,0.6,2,0.59483189
3386,138,20565,10,11,0,0,0,21,10,10,0,0,0,20,win,win,plwin,beat,25,0,21,190,0.442105263,0.047368421,0.610526316,2,0.609711065
3387,120,20565,10,5,0,6,0,21,10,10,0,0,0,20,nowin,win,plwin,beat,20,0,15,202,0.440594059,0.034653465,0.618811881,2,0.614441029
3388,92,20565,7,3,3,5,0,18,10,10,0,0,0,20,nowin,loss,beat,dlwin,0,10,10,186,0.446236559,0.059139785,0.564516129,1,0.307826125
3389,140,20565,10,10,0,0,0,20,10,10,0,0,0,20,nowin,push,push,push,10,0,20,210,0.466666667,0.023809524,0.604761905,3,0.915293335
3390,69,20566,10,7,0,0,0,17,4,4,7,6,0,21,nowin,loss,beat,dlwin,0,10,17,194,0.365979381,0.030927835,0.515463918,0,0
3391,17,20566,6,1,10,0,0,17,4,4,7,6,0,21,nowin,loss,beat,dlwin,0,10,7,171,0.444444444,0.070175439,0.555555556,1,0.302364894
3392,97,20566,4,9,0,0,0,13,4,4,7,6,0,21,nowin,loss,beat,dlwin,0,10,13,182,0.450549451,0.06043956,0.692307692,2,0.677372279
3393,75,20566,9,10,0,0,0,19,4,4,7,6,0,21,nowin,loss,beat,dlwin,0,10,19,191,0.418848168,0.052356021,0.570680628,0,0.029344702
3394,22,20566,10,10,0,0,0,20,4,4,7,6,0,21,nowin,loss,beat,dlwin,0,10,20,187,0.481283422,0.042780749,0.577540107,3,0.906128176
3395,38,20566,3,3,7,0,0,13,4,4,7,6,0,21,nowin,loss,beat,dlwin,0,10,6,202,0.361386139,0.03960396,0.564356436,0,0.010597953
3396,138,20567,8,10,0,0,0,18,6,10,10,0,0,26,nowin,win,dlbust,bust,20,0,18,190,0.442105263,0.047368421,0.610526316,2,0.609711065
3397,9,20567,3,7,10,0,0,20,6,10,10,0,0,26,nowin,win,dlbust,bust,20,0,10,194,0.37628866,0.015463918,0.541237113,0,0.009396796
3398,141,20567,5,10,0,0,0,15,6,10,10,0,0,26,nowin,win,dlbust,bust,20,0,15,202,0.420792079,0.074257426,0.564356436,0,0.028377851
3399,92,20567,10,9,0,0,0,19,6,10,10,0,0,26,nowin,win,dlbust,bust,20,0,19,186,0.446236559,0.059139785,0.564516129,1,0.307826125
3400,71,20567,10,5,0,0,0,15,6,10,10,0,0,26,nowin,win,dlbust,bust,20,0,15,193,0.352331606,0.046632124,0.585492228,0,0.013063661
3401,54,20567,7,10,0,0,0,17,6,10,10,0,0,26,nowin,win,dlbust,bust,20,0,17,185,0.437837838,0.032432432,0.556756757,1,0.29899854
3402,47,20568,5,9,0,10,0,24,9,5,9,0,0,23,nowin,loss,bust,plbust,0,10,14,210,0.438095238,0.057142857,0.623809524,2,0.615868808
3403,114,20568,7,10,0,0,0,17,9,5,9,0,0,23,nowin,win,dlbust,bust,20,0,17,198,0.47979798,0.025252525,0.611111111,3,0.937232995
3404,114,20568,2,3,10,1,10,26,9,5,9,0,0,23,nowin,loss,bust,plbust,0,10,5,198,0.47979798,0.025252525,0.611111111,3,0.937232995
3405,20,20568,10,10,0,0,0,20,9,5,9,0,0,23,nowin,win,dlbust,bust,20,0,20,186,0.456989247,0.037634409,0.537634409,1,0.301097108
3406,90,20568,10,5,0,10,0,25,9,5,9,0,0,23,nowin,loss,bust,plbust,0,10,15,201,0.447761194,0.049751244,0.60199005,3,0.889945023
3407,118,20568,10,11,0,0,0,21,9,5,9,0,0,23,win,win,dlbust,bust,25,0,21,216,0.393518519,0.037037037,0.555555556,0,0.018059873
3408,90,20569,3,1,10,0,0,14,5,10,9,0,0,24,nowin,win,dlbust,bust,20,0,4,201,0.447761194,0.049751244,0.60199005,3,0.889945023
3409,3,20569,2,6,10,0,0,18,5,10,9,0,0,24,nowin,win,dlbust,bust,20,0,8,190,0.431578947,0.026315789,0.542105263,1,0.288076384
3410,53,20569,10,10,0,0,0,20,5,10,9,0,0,24,nowin,win,dlbust,bust,20,0,20,250,0.372,0.064,0.564,0,0.013687345
3411,52,20569,3,2,10,0,0,15,5,10,9,0,0,24,nowin,win,dlbust,bust,20,0,5,217,0.414746544,0.02764977,0.599078341,2,0.576736024
3412,59,20569,1,1,10,0,0,12,5,10,9,0,0,24,nowin,win,dlbust,bust,20,0,2,228,0.429824561,0.048245614,0.543859649,1,0.287885446
3413,83,20569,11,9,0,0,0,20,5,10,9,0,0,24,nowin,win,dlbust,bust,20,0,20,193,0.424870466,0.051813472,0.678756477,2,0.644360335
3414,1,20570,6,5,6,0,0,17,2,10,8,0,0,20,nowin,loss,beat,dlwin,0,10,11,197,0.406091371,0.025380711,0.649746193,2,0.606186955
3415,137,20570,5,10,0,0,0,15,2,10,8,0,0,20,nowin,loss,beat,dlwin,0,10,15,194,0.417525773,0.046391753,0.536082474,1,0.276714602
3416,90,20570,5,2,2,9,0,18,2,10,8,0,0,20,nowin,loss,beat,dlwin,0,10,7,201,0.447761194,0.049751244,0.60199005,3,0.889945023
3417,86,20570,8,3,9,0,0,20,2,10,8,0,0,20,nowin,push,push,push,10,0,11,196,0.454081633,0.040816327,0.591836735,3,0.887566443
3418,25,20570,3,10,0,0,0,13,2,10,8,0,0,20,nowin,loss,beat,dlwin,0,10,13,190,0.463157895,0.063157895,0.536842105,1,0.304401563
3419,139,20570,4,5,10,0,0,19,2,10,8,0,0,20,nowin,loss,beat,dlwin,0,10,9,192,0.380208333,0.036458333,0.59375,0,0.023429169
3420,72,20571,10,3,0,4,0,17,7,4,10,0,0,21,nowin,loss,beat,dlwin,0,10,13,185,0.394594595,0.032432432,0.508108108,0,0.006763115
3421,59,20571,10,4,0,5,0,19,7,4,10,0,0,21,nowin,loss,beat,dlwin,0,10,14,228,0.429824561,0.048245614,0.543859649,1,0.287885446
3422,111,20571,10,8,0,0,0,18,7,4,10,0,0,21,nowin,loss,beat,dlwin,0,10,18,180,0.433333333,0.055555556,0.611111111,2,0.602264492
3423,63,20571,8,7,0,10,0,25,7,4,10,0,0,21,nowin,loss,bust,plbust,0,10,15,216,0.467592593,0.037037037,0.62037037,3,0.931690496
3424,135,20571,10,7,0,0,0,17,7,4,10,0,0,21,nowin,loss,beat,dlwin,0,10,17,179,0.391061453,0.067039106,0.586592179,0,0.024924662
3425,140,20571,11,1,1,3,10,26,7,4,10,0,0,21,nowin,loss,bust,plbust,0,10,12,210,0.466666667,0.023809524,0.604761905,3,0.915293335
3426,4,20572,2,4,3,4,0,13,2,10,9,0,0,21,nowin,loss,beat,dlwin,0,10,6,217,0.460829493,0.036866359,0.562211982,1,0.315432839
3427,44,20572,7,10,0,0,0,17,2,10,9,0,0,21,nowin,loss,beat,dlwin,0,10,17,219,0.433789954,0.050228311,0.534246575,1,0.285551035
3428,127,20572,10,6,0,0,0,16,2,10,9,0,0,21,nowin,loss,beat,dlwin,0,10,16,201,0.402985075,0.029850746,0.60199005,0,0.032263937
3429,8,20572,10,6,0,0,0,16,2,10,9,0,0,21,nowin,loss,beat,dlwin,0,10,16,181,0.44198895,0.071823204,0.596685083,2,0.599438402
3430,34,20572,4,7,5,0,0,16,2,10,9,0,0,21,nowin,loss,beat,dlwin,0,10,11,202,0.5,0.079207921,0.618811881,3,0.968961434
3431,116,20572,3,4,9,0,0,16,2,10,9,0,0,21,nowin,loss,beat,dlwin,0,10,7,195,0.425641026,0.056410256,0.538461538,1,0.28273747
3432,72,20573,3,9,0,9,0,21,10,9,0,0,0,19,nowin,win,plwin,beat,20,0,12,185,0.394594595,0.032432432,0.508108108,0,0.006763115
3433,140,20573,10,6,0,1,0,17,10,9,0,0,0,19,nowin,loss,beat,dlwin,0,10,16,210,0.466666667,0.023809524,0.604761905,3,0.915293335
3434,90,20573,6,8,0,1,3,18,10,9,0,0,0,19,nowin,loss,beat,dlwin,0,10,14,201,0.447761194,0.049751244,0.60199005,3,0.889945023
3435,144,20573,7,8,0,9,0,24,10,9,0,0,0,19,nowin,loss,bust,plbust,0,10,15,202,0.386138614,0.054455446,0.564356436,0,0.018006244
3436,78,20573,11,9,0,0,0,20,10,9,0,0,0,19,nowin,win,plwin,beat,20,0,20,201,0.517412935,0.034825871,0.587064677,3,0.95871112
3437,96,20573,10,10,0,0,0,20,10,9,0,0,0,19,nowin,win,plwin,beat,20,0,20,190,0.468421053,0.057894737,0.584210526,3,0.897263354
3438,132,20574,9,8,0,0,0,17,10,10,0,0,0,20,nowin,loss,beat,dlwin,0,10,17,194,0.412371134,0.036082474,0.649484536,2,0.611633238
3439,140,20574,3,10,0,2,1,16,10,10,0,0,0,20,nowin,loss,beat,dlwin,0,10,13,210,0.466666667,0.023809524,0.604761905,3,0.915293335
3440,111,20574,10,3,0,10,0,23,10,10,0,0,0,20,nowin,loss,bust,plbust,0,10,13,180,0.433333333,0.055555556,0.611111111,2,0.602264492
3441,11,20574,10,10,0,0,0,20,10,10,0,0,0,20,nowin,push,push,push,10,0,20,236,0.457627119,0.016949153,0.588983051,3,0.889015813
3442,79,20574,10,2,0,10,0,22,10,10,0,0,0,20,nowin,loss,bust,plbust,0,10,12,211,0.436018957,0.028436019,0.672985782,2,0.650131054
3443,1,20574,10,3,0,6,0,19,10,10,0,0,0,20,nowin,loss,beat,dlwin,0,10,13,197,0.406091371,0.025380711,0.649746193,2,0.606186955
3444,36,20575,9,3,0,0,0,12,4,6,10,0,0,20,nowin,loss,beat,dlwin,0,10,12,229,0.445414847,0.056768559,0.655021834,2,0.645370571
3445,19,20575,10,8,0,0,0,18,4,6,10,0,0,20,nowin,loss,beat,dlwin,0,10,18,237,0.41350211,0.054852321,0.628691983,2,0.597373826
3446,75,20575,11,6,2,0,0,19,4,6,10,0,0,20,nowin,loss,beat,dlwin,0,10,17,191,0.418848168,0.052356021,0.570680628,0,0.029344702
3447,88,20575,10,10,0,0,0,20,4,6,10,0,0,20,nowin,push,push,push,10,0,20,206,0.466019417,0.033980583,0.54368932,1,0.309467903
3448,89,20575,2,9,10,0,0,21,4,6,10,0,0,20,nowin,win,plwin,beat,20,0,11,212,0.537735849,0.047169811,0.594339623,3,0.990167191
3449,77,20575,9,9,0,0,0,18,4,6,10,0,0,20,nowin,loss,beat,dlwin,0,10,18,200,0.455,0.04,0.62,3,0.916252116
3450,10,20576,5,6,3,4,0,18,10,6,3,0,0,19,nowin,loss,beat,dlwin,0,10,11,191,0.413612565,0.057591623,0.596858639,2,0.574087175
3451,8,20576,10,10,0,0,0,20,10,6,3,0,0,19,nowin,win,plwin,beat,20,0,20,181,0.44198895,0.071823204,0.596685083,2,0.599438402
3452,62,20576,6,2,10,0,0,18,10,6,3,0,0,19,nowin,loss,beat,dlwin,0,10,8,178,0.370786517,0.028089888,0.54494382,0,0.008657722
3453,86,20576,10,9,0,0,0,19,10,6,3,0,0,19,nowin,push,push,push,10,0,19,196,0.454081633,0.040816327,0.591836735,3,0.887566443
3454,8,20576,10,10,0,0,0,20,10,6,3,0,0,19,nowin,win,plwin,beat,20,0,20,181,0.44198895,0.071823204,0.596685083,2,0.599438402
3455,94,20576,11,5,3,0,0,19,10,6,3,0,0,19,nowin,push,push,push,10,0,16,183,0.43715847,0.043715847,0.540983607,1,0.290866892
3456,118,20577,6,8,0,0,0,14,2,10,10,0,0,22,nowin,win,dlbust,bust,20,0,14,216,0.393518519,0.037037037,0.555555556,0,0.018059873
3457,40,20577,4,5,3,3,0,15,2,10,10,0,0,22,nowin,win,dlbust,bust,20,0,9,196,0.367346939,0.030612245,0.617346939,0,0.025358183
3458,18,20577,5,10,0,0,0,15,2,10,10,0,0,22,nowin,win,dlbust,bust,20,0,15,182,0.461538462,0.043956044,0.587912088,3,0.892649374
3459,116,20577,1,1,10,4,0,16,2,10,10,0,0,22,nowin,win,dlbust,bust,20,0,2,195,0.425641026,0.056410256,0.538461538,1,0.28273747
3460,46,20577,6,3,10,0,0,19,2,10,10,0,0,22,nowin,win,dlbust,bust,20,0,9,186,0.403225806,0.048387097,0.591397849,0,0.029742194
3461,143,20577,6,10,0,0,0,16,2,10,10,0,0,22,nowin,win,dlbust,bust,20,0,16,203,0.463054187,0.044334975,0.57635468,3,0.883143365
3462,64,20578,8,9,0,0,0,17,7,6,6,0,0,19,nowin,loss,beat,dlwin,0,10,17,187,0.363636364,0.048128342,0.631016043,0,0.027594885
3463,70,20578,10,2,0,10,0,22,7,6,6,0,0,19,nowin,loss,bust,plbust,0,10,12,228,0.385964912,0.039473684,0.557017544,0,0.016157125
3464,66,20578,8,7,0,1,10,26,7,6,6,0,0,19,nowin,loss,bust,plbust,0,10,15,217,0.456221198,0.064516129,0.626728111,3,0.924304367
3465,137,20578,10,10,0,0,0,20,7,6,6,0,0,19,nowin,win,plwin,beat,20,0,20,194,0.417525773,0.046391753,0.536082474,1,0.276714602
3466,144,20578,2,9,10,0,0,21,7,6,6,0,0,19,nowin,win,plwin,beat,20,0,11,202,0.386138614,0.054455446,0.564356436,0,0.018006244
3467,9,20578,6,10,0,2,0,18,7,6,6,0,0,19,nowin,loss,beat,dlwin,0,10,16,194,0.37628866,0.015463918,0.541237113,0,0.009396796
3468,37,20579,3,6,2,4,3,18,8,7,1,10,0,26,nowin,win,dlbust,bust,20,0,9,208,0.394230769,0.038461538,0.581730769,0,0.024682772
3469,96,20579,10,9,0,0,0,19,8,7,1,10,0,26,nowin,win,dlbust,bust,20,0,19,190,0.468421053,0.057894737,0.584210526,3,0.897263354
3470,9,20579,9,3,0,5,0,17,8,7,1,10,0,26,nowin,win,dlbust,bust,20,0,12,194,0.37628866,0.015463918,0.541237113,0,0.009396796
3471,49,20579,5,10,0,6,0,21,8,7,1,10,0,26,nowin,win,dlbust,bust,20,0,15,207,0.396135266,0.053140097,0.594202899,0,0.028306925
3472,96,20579,10,10,0,0,0,20,8,7,1,10,0,26,nowin,win,dlbust,bust,20,0,20,190,0.468421053,0.057894737,0.584210526,3,0.897263354
3473,137,20579,5,4,9,0,0,18,8,7,1,10,0,26,nowin,win,dlbust,bust,20,0,9,194,0.417525773,0.046391753,0.536082474,1,0.276714602
3474,48,20580,10,9,0,0,0,19,4,8,2,10,0,24,nowin,win,dlbust,bust,20,0,19,203,0.413793103,0.019704433,0.600985222,2,0.577280801
3475,52,20580,1,6,8,0,0,15,4,8,2,10,0,24,nowin,win,dlbust,bust,20,0,7,217,0.414746544,0.02764977,0.599078341,2,0.576736024
3476,116,20580,4,11,2,0,0,17,4,8,2,10,0,24,nowin,win,dlbust,bust,20,0,15,195,0.425641026,0.056410256,0.538461538,1,0.28273747
3477,28,20580,4,2,6,0,0,12,4,8,2,10,0,24,nowin,win,dlbust,bust,20,0,6,199,0.422110553,0.045226131,0.542713568,1,0.282706618
3478,62,20580,3,4,11,0,0,18,4,8,2,10,0,24,nowin,win,dlbust,bust,20,0,7,178,0.370786517,0.028089888,0.54494382,0,0.008657722
3479,4,20580,3,9,0,0,0,12,4,8,2,10,0,24,nowin,win,dlbust,bust,20,0,12,217,0.460829493,0.036866359,0.562211982,1,0.315432839
3480,108,20581,6,1,10,0,0,17,8,11,0,0,0,19,nowin,loss,beat,dlwin,0,10,7,193,0.435233161,0.056994819,0.559585492,1,0.298824795
3481,51,20581,10,7,0,0,0,17,8,11,0,0,0,19,nowin,loss,beat,dlwin,0,10,17,189,0.529100529,0.068783069,0.608465608,3,0.993665715
3482,9,20581,10,10,0,0,0,20,8,11,0,0,0,19,nowin,win,plwin,beat,20,0,20,194,0.37628866,0.015463918,0.541237113,0,0.009396796
3483,79,20581,5,7,0,4,10,26,8,11,0,0,0,19,nowin,loss,bust,plbust,0,10,12,211,0.436018957,0.028436019,0.672985782,2,0.650131054
3484,77,20581,10,10,0,0,0,20,8,11,0,0,0,19,nowin,win,plwin,beat,20,0,20,200,0.455,0.04,0.62,3,0.916252116
3485,5,20581,8,10,0,0,0,18,8,11,0,0,0,19,nowin,loss,beat,dlwin,0,10,18,203,0.42364532,0.02955665,0.596059113,2,0.582508076
3486,98,20582,10,6,0,6,0,22,9,10,0,0,0,19,nowin,loss,bust,plbust,0,10,16,220,0.422727273,0.054545455,0.55,1,0.28664435
3487,108,20582,3,10,0,3,10,26,9,10,0,0,0,19,nowin,loss,bust,plbust,0,10,13,193,0.435233161,0.056994819,0.559585492,1,0.298824795
3488,123,20582,7,10,0,0,0,17,9,10,0,0,0,19,nowin,loss,beat,dlwin,0,10,17,205,0.43902439,0.034146341,0.614634146,2,0.609962544
3489,7,20582,10,8,0,0,0,18,9,10,0,0,0,19,nowin,loss,beat,dlwin,0,10,18,183,0.442622951,0.06010929,0.62295082,2,0.619303341
3490,9,20582,3,1,9,3,5,21,9,10,0,0,0,19,nowin,win,plwin,beat,20,0,4,194,0.37628866,0.015463918,0.541237113,0,0.009396796
3491,123,20582,4,8,0,4,6,22,9,10,0,0,0,19,nowin,loss,bust,plbust,0,10,12,205,0.43902439,0.034146341,0.614634146,2,0.609962544
3492,44,20583,5,10,0,10,0,25,9,10,0,0,0,19,nowin,loss,bust,plbust,0,10,15,219,0.433789954,0.050228311,0.534246575,1,0.285551035
3493,64,20583,10,10,0,0,0,20,9,10,0,0,0,19,nowin,win,plwin,beat,20,0,20,187,0.363636364,0.048128342,0.631016043,0,0.027594885
3494,19,20583,8,2,3,5,0,18,9,10,0,0,0,19,nowin,loss,beat,dlwin,0,10,10,237,0.41350211,0.054852321,0.628691983,2,0.597373826
3495,131,20583,3,7,4,7,0,21,9,10,0,0,0,19,nowin,win,plwin,beat,20,0,10,217,0.410138249,0.069124424,0.543778802,0,0.02015021
3496,11,20583,4,10,0,4,0,18,9,10,0,0,0,19,nowin,loss,beat,dlwin,0,10,14,236,0.457627119,0.016949153,0.588983051,3,0.889015813
3497,120,20583,2,9,6,0,0,17,9,10,0,0,0,19,nowin,loss,beat,dlwin,0,10,11,202,0.440594059,0.034653465,0.618811881,2,0.614441029
3498,93,20584,7,10,0,0,0,17,4,4,10,0,0,18,nowin,loss,beat,dlwin,0,10,17,175,0.485714286,0.051428571,0.548571429,1,0.323648091
3499,25,20584,9,11,0,0,0,20,4,4,10,0,0,18,nowin,win,plwin,beat,20,0,20,190,0.463157895,0.063157895,0.536842105,1,0.304401563
3500,91,20584,5,1,6,0,0,12,4,4,10,0,0,18,nowin,loss,beat,dlwin,0,10,6,194,0.417525773,0.046391753,0.515463918,1,0.266616552
3501,37,20584,3,7,10,0,0,20,4,4,10,0,0,18,nowin,win,plwin,beat,20,0,10,208,0.394230769,0.038461538,0.581730769,0,0.024682772
3502,96,20584,6,3,10,0,0,19,4,4,10,0,0,18,nowin,win,plwin,beat,20,0,9,190,0.468421053,0.057894737,0.584210526,3,0.897263354
3503,61,20584,9,7,0,0,0,16,4,4,10,0,0,18,nowin,loss,beat,dlwin,0,10,16,194,0.427835052,0.077319588,0.603092784,2,0.591437139
3504,45,20585,10,10,0,0,0,20,9,10,0,0,0,19,nowin,win,plwin,beat,20,0,20,196,0.428571429,0.051020408,0.612244898,2,0.598821767
3505,92,20585,8,2,10,0,0,20,9,10,0,0,0,19,nowin,win,plwin,beat,20,0,10,186,0.446236559,0.059139785,0.564516129,1,0.307826125
3506,147,20585,10,3,0,1,3,17,9,10,0,0,0,19,nowin,loss,beat,dlwin,0,10,13,205,0.380487805,0.014634146,0.536585366,0,0.00951447
3507,131,20585,10,11,0,0,0,21,9,10,0,0,0,19,win,win,plwin,beat,25,0,21,217,0.410138249,0.069124424,0.543778802,0,0.02015021
3508,104,20585,10,10,0,0,0,20,9,10,0,0,0,19,nowin,win,plwin,beat,20,0,20,209,0.363636364,0.052631579,0.593301435,0,0.018359419
3509,109,20585,2,3,11,1,0,17,9,10,0,0,0,19,nowin,loss,beat,dlwin,0,10,5,221,0.461538462,0.058823529,0.597285068,3,0.901830309
3510,116,20586,3,7,5,3,0,18,11,9,0,0,0,20,nowin,loss,beat,dlwin,0,10,10,195,0.425641026,0.056410256,0.538461538,1,0.28273747
3511,110,20586,4,6,11,0,0,21,11,9,0,0,0,20,nowin,win,plwin,beat,20,0,10,192,0.416666667,0.046875,0.557291667,0,0.025413132
3512,79,20586,8,6,0,10,0,24,11,9,0,0,0,20,nowin,loss,bust,plbust,0,10,14,211,0.436018957,0.028436019,0.672985782,2,0.650131054
3513,30,20586,7,11,0,0,0,18,11,9,0,0,0,20,nowin,loss,beat,dlwin,0,10,18,206,0.393203883,0.033980583,0.601941748,0,0.029324648
3514,114,20586,4,2,2,10,0,18,11,9,0,0,0,20,nowin,loss,beat,dlwin,0,10,6,198,0.47979798,0.025252525,0.611111111,3,0.937232995
3515,61,20586,7,3,5,10,0,25,11,9,0,0,0,20,nowin,loss,bust,plbust,0,10,10,194,0.427835052,0.077319588,0.603092784,2,0.591437139
3516,117,20587,10,2,0,7,0,19,10,10,0,0,0,20,nowin,loss,beat,dlwin,0,10,12,173,0.410404624,0.069364162,0.606936416,2,0.578610282
3517,119,20587,10,10,0,0,0,20,10,10,0,0,0,20,nowin,push,push,push,10,0,20,190,0.405263158,0.068421053,0.515789474,0,0.011837158
3518,59,20587,8,10,0,0,0,18,10,10,0,0,0,20,nowin,loss,beat,dlwin,0,10,18,228,0.429824561,0.048245614,0.543859649,1,0.287885446
3519,35,20587,5,4,10,0,0,19,10,10,0,0,0,20,nowin,loss,beat,dlwin,0,10,9,202,0.410891089,0.044554455,0.633663366,2,0.598681573
3520,16,20587,6,5,4,10,0,25,10,10,0,0,0,20,nowin,loss,bust,plbust,0,10,11,220,0.427272727,0.081818182,0.6,2,0.588660176
3521,74,20587,6,10,0,7,0,23,10,10,0,0,0,20,nowin,loss,bust,plbust,0,10,16,209,0.411483254,0.04784689,0.531100478,0,0.017448125
3522,145,20588,1,4,10,10,0,25,8,4,9,0,0,21,nowin,loss,bust,plbust,0,10,5,188,0.441489362,0.031914894,0.622340426,2,0.617837093
3523,85,20588,10,10,0,0,0,20,8,4,9,0,0,21,nowin,loss,beat,dlwin,0,10,20,195,0.41025641,0.066666667,0.594871795,0,0.03269711
3524,130,20588,2,10,0,9,0,21,8,4,9,0,0,21,nowin,push,push,push,10,0,12,219,0.410958904,0.03652968,0.566210046,0,0.025888739
3525,130,20588,10,11,0,0,0,21,8,4,9,0,0,21,win,push,push,push,10,0,21,219,0.410958904,0.03652968,0.566210046,0,0.025888739
3526,126,20588,8,4,0,5,0,17,8,4,9,0,0,21,nowin,loss,beat,dlwin,0,10,12,188,0.457446809,0.074468085,0.60106383,3,0.900633203
3527,118,20588,7,10,0,0,0,17,8,4,9,0,0,21,nowin,loss,beat,dlwin,0,10,17,216,0.393518519,0.037037037,0.555555556,0,0.018059873
3528,9,20589,10,2,0,10,0,22,9,3,8,0,0,20,nowin,loss,bust,plbust,0,10,12,194,0.37628866,0.015463918,0.541237113,0,0.009396796
3529,77,20589,4,3,2,7,8,24,9,3,8,0,0,20,nowin,loss,bust,plbust,0,10,7,200,0.455,0.04,0.62,3,0.916252116
3530,116,20589,3,6,10,0,0,19,9,3,8,0,0,20,nowin,loss,beat,dlwin,0,10,9,195,0.425641026,0.056410256,0.538461538,1,0.28273747
3531,127,20589,10,9,0,0,0,19,9,3,8,0,0,20,nowin,loss,beat,dlwin,0,10,19,201,0.402985075,0.029850746,0.60199005,0,0.032263937
3532,75,20589,7,10,0,0,0,17,9,3,8,0,0,20,nowin,loss,beat,dlwin,0,10,17,191,0.418848168,0.052356021,0.570680628,0,0.029344702
3533,150,20589,9,2,10,0,0,21,9,3,8,0,0,20,nowin,win,plwin,beat,20,0,11,192,0.401041667,0.036458333,0.567708333,0,0.023287458
3534,118,20590,2,10,0,3,10,25,7,2,4,5,0,18,nowin,loss,bust,plbust,0,10,12,216,0.393518519,0.037037037,0.555555556,0,0.018059873
3535,90,20590,4,2,2,2,10,20,7,2,4,5,0,18,nowin,win,plwin,beat,20,0,6,201,0.447761194,0.049751244,0.60199005,3,0.889945023
3536,113,20590,10,8,0,0,0,18,7,2,4,5,0,18,nowin,push,push,push,10,0,18,199,0.407035176,0.055276382,0.668341709,2,0.620695264
3537,20,20590,10,4,0,3,0,17,7,2,4,5,0,18,nowin,loss,beat,dlwin,0,10,14,186,0.456989247,0.037634409,0.537634409,1,0.301097108
3538,6,20590,10,11,0,0,0,21,7,2,4,5,0,18,win,win,plwin,beat,25,0,21,191,0.439790576,0.047120419,0.581151832,1,0.31211505
3539,85,20590,5,10,0,6,0,21,7,2,4,5,0,18,nowin,win,plwin,beat,20,0,15,195,0.41025641,0.066666667,0.594871795,0,0.03269711
3540,142,20591,11,7,0,0,0,18,10,8,0,0,0,18,nowin,push,push,push,10,0,18,211,0.417061611,0.047393365,0.526066351,1,0.271531309
3541,120,20591,6,4,10,0,0,20,10,8,0,0,0,18,nowin,win,plwin,beat,20,0,10,202,0.440594059,0.034653465,0.618811881,2,0.614441029
3542,113,20591,10,9,0,0,0,19,10,8,0,0,0,18,nowin,win,plwin,beat,20,0,19,199,0.407035176,0.055276382,0.668341709,2,0.620695264
3543,130,20591,5,5,8,0,0,18,10,8,0,0,0,18,nowin,push,push,push,10,0,10,219,0.410958904,0.03652968,0.566210046,0,0.025888739
3544,56,20591,4,10,0,3,0,17,10,8,0,0,0,18,nowin,loss,beat,dlwin,0,10,14,175,0.4,0.057142857,0.582857143,0,0.026685297
3545,106,20591,2,6,8,7,0,23,10,8,0,0,0,18,nowin,loss,bust,plbust,0,10,8,192,0.411458333,0.026041667,0.557291667,0,0.023854304
3546,40,20592,7,11,0,0,0,18,9,5,8,0,0,22,nowin,win,dlbust,bust,20,0,18,196,0.367346939,0.030612245,0.617346939,0,0.025358183
3547,34,20592,4,8,0,10,0,22,9,5,8,0,0,22,nowin,loss,bust,plbust,0,10,12,202,0.5,0.079207921,0.618811881,3,0.968961434
3548,42,20592,7,10,0,0,0,17,9,5,8,0,0,22,nowin,win,dlbust,bust,20,0,17,212,0.443396226,0.051886792,0.570754717,1,0.309181312
3549,57,20592,2,11,7,0,0,20,9,5,8,0,0,22,nowin,win,dlbust,bust,20,0,13,192,0.46875,0.052083333,0.59375,3,0.907001181
3550,142,20592,1,4,10,10,0,25,9,5,8,0,0,22,nowin,loss,bust,plbust,0,10,5,211,0.417061611,0.047393365,0.526066351,1,0.271531309
3551,85,20592,6,10,0,10,0,26,9,5,8,0,0,22,nowin,loss,bust,plbust,0,10,16,195,0.41025641,0.066666667,0.594871795,0,0.03269711
3552,146,20593,1,5,10,0,0,16,6,10,4,0,0,20,nowin,loss,beat,dlwin,0,10,6,221,0.43438914,0.040723982,0.542986425,1,0.290190091
3553,104,20593,10,6,0,0,0,16,6,10,4,0,0,20,nowin,loss,beat,dlwin,0,10,16,209,0.363636364,0.052631579,0.593301435,0,0.018359419
3554,58,20593,8,10,0,0,0,18,6,10,4,0,0,20,nowin,loss,beat,dlwin,0,10,18,195,0.430769231,0.041025641,0.584615385,2,0.580497586
3555,148,20593,10,11,0,0,0,21,6,10,4,0,0,20,win,win,plwin,beat,25,0,21,204,0.401960784,0.078431373,0.593137255,0,0.029789521
3556,114,20593,10,7,0,0,0,17,6,10,4,0,0,20,nowin,loss,beat,dlwin,0,10,17,198,0.47979798,0.025252525,0.611111111,3,0.937232995
3557,37,20593,1,4,10,0,0,15,6,10,4,0,0,20,nowin,loss,beat,dlwin,0,10,5,208,0.394230769,0.038461538,0.581730769,0,0.024682772
3558,92,20594,6,4,6,10,0,26,9,2,10,0,0,21,nowin,loss,bust,plbust,0,10,10,186,0.446236559,0.059139785,0.564516129,1,0.307826125
3559,94,20594,3,5,10,0,0,18,9,2,10,0,0,21,nowin,loss,beat,dlwin,0,10,8,183,0.43715847,0.043715847,0.540983607,1,0.290866892
3560,125,20594,2,3,9,6,0,20,9,2,10,0,0,21,nowin,loss,beat,dlwin,0,10,5,219,0.438356164,0.050228311,0.575342466,1,0.308411257
3561,59,20594,4,5,9,0,0,18,9,2,10,0,0,21,nowin,loss,beat,dlwin,0,10,9,228,0.429824561,0.048245614,0.543859649,1,0.287885446
3562,99,20594,10,10,0,0,0,20,9,2,10,0,0,21,nowin,loss,beat,dlwin,0,10,20,207,0.47826087,0.062801932,0.637681159,3,0.961418446
3563,66,20594,10,8,0,0,0,18,9,2,10,0,0,21,nowin,loss,beat,dlwin,0,10,18,217,0.456221198,0.064516129,0.626728111,3,0.924304367
3564,107,20595,5,10,0,2,0,17,7,10,0,0,0,17,nowin,push,push,push,10,0,15,218,0.444954128,0.073394495,0.600917431,2,0.605210014
3565,10,20595,8,7,0,10,0,25,7,10,0,0,0,17,nowin,loss,bust,plbust,0,10,15,191,0.413612565,0.057591623,0.596858639,2,0.574087175
3566,35,20595,8,10,0,0,0,18,7,10,0,0,0,17,nowin,win,plwin,beat,20,0,18,202,0.410891089,0.044554455,0.633663366,2,0.598681573
3567,143,20595,10,7,0,0,0,17,7,10,0,0,0,17,nowin,push,push,push,10,0,17,203,0.463054187,0.044334975,0.57635468,3,0.883143365
3568,118,20595,3,10,0,4,0,17,7,10,0,0,0,17,nowin,push,push,push,10,0,13,216,0.393518519,0.037037037,0.555555556,0,0.018059873
3569,89,20595,10,9,0,0,0,19,7,10,0,0,0,17,nowin,win,plwin,beat,20,0,19,212,0.537735849,0.047169811,0.594339623,3,0.990167191
3570,19,20596,4,10,0,7,0,21,10,2,8,0,0,20,nowin,win,plwin,beat,20,0,14,237,0.41350211,0.054852321,0.628691983,2,0.597373826
3571,124,20596,11,10,0,0,0,21,10,2,8,0,0,20,win,win,plwin,beat,25,0,21,202,0.47029703,0.064356436,0.584158416,3,0.899458193
3572,56,20596,1,2,10,10,0,23,10,2,8,0,0,20,nowin,loss,bust,plbust,0,10,3,175,0.4,0.057142857,0.582857143,0,0.026685297
3573,105,20596,10,7,0,0,0,17,10,2,8,0,0,20,nowin,loss,beat,dlwin,0,10,17,198,0.414141414,0.070707071,0.590909091,0,0.032889494
3574,67,20596,7,3,10,0,0,20,10,2,8,0,0,20,nowin,push,push,push,10,0,10,195,0.369230769,0.041025641,0.569230769,0,0.014139427
3575,78,20596,4,10,0,9,0,23,10,2,8,0,0,20,nowin,loss,bust,plbust,0,10,14,201,0.517412935,0.034825871,0.587064677,3,0.95871112
3576,113,20597,1,4,10,7,0,22,10,2,8,0,0,20,nowin,loss,bust,plbust,0,10,5,199,0.407035176,0.055276382,0.668341709,2,0.620695264
3577,124,20597,8,3,10,0,0,21,10,2,8,0,0,20,nowin,win,plwin,beat,20,0,11,202,0.47029703,0.064356436,0.584158416,3,0.899458193
3578,137,20597,2,6,10,0,0,18,10,2,8,0,0,20,nowin,loss,beat,dlwin,0,10,8,194,0.417525773,0.046391753,0.536082474,1,0.276714602
3579,55,20597,7,10,0,0,0,17,10,2,8,0,0,20,nowin,loss,beat,dlwin,0,10,17,191,0.371727749,0.057591623,0.54973822,0,0.01011347
3580,33,20597,10,9,0,0,0,19,10,2,8,0,0,20,nowin,loss,beat,dlwin,0,10,19,192,0.4375,0.057291667,0.625,2,0.616208916
3581,119,20597,7,2,2,10,0,21,10,2,8,0,0,20,nowin,win,plwin,beat,20,0,9,190,0.405263158,0.068421053,0.515789474,0,0.011837158
3582,14,20598,4,10,0,6,0,20,8,7,7,0,0,22,nowin,win,dlbust,bust,20,0,14,202,0.391089109,0.01980198,0.628712871,2,0.577264877
3583,31,20598,10,3,0,9,0,22,8,7,7,0,0,22,nowin,loss,bust,plbust,0,10,13,188,0.473404255,0.058510638,0.515957447,1,0.300306557
3584,142,20598,4,10,0,3,0,17,8,7,7,0,0,22,nowin,win,dlbust,bust,20,0,14,211,0.417061611,0.047393365,0.526066351,1,0.271531309
3585,112,20598,10,11,0,0,0,21,8,7,7,0,0,22,win,win,dlbust,bust,25,0,21,203,0.448275862,0.054187192,0.600985222,3,0.889576933
3586,108,20598,3,2,10,10,0,25,8,7,7,0,0,22,nowin,loss,bust,plbust,0,10,5,193,0.435233161,0.056994819,0.559585492,1,0.298824795
3587,24,20598,2,11,7,0,0,20,8,7,7,0,0,22,nowin,win,dlbust,bust,20,0,13,207,0.458937198,0.048309179,0.570048309,1,0.318138014
3588,136,20599,9,4,0,7,0,20,10,4,3,0,0,17,nowin,win,plwin,beat,20,0,13,194,0.396907216,0.025773196,0.597938144,0,0.029452644
3589,65,20599,7,3,10,0,0,20,10,4,3,0,0,17,nowin,win,plwin,beat,20,0,10,203,0.492610837,0.054187192,0.571428571,3,0.913702814
3590,89,20599,10,9,0,0,0,19,10,4,3,0,0,17,nowin,win,plwin,beat,20,0,19,212,0.537735849,0.047169811,0.594339623,3,0.990167191
3591,104,20599,3,8,10,0,0,21,10,4,3,0,0,17,nowin,win,plwin,beat,20,0,11,209,0.363636364,0.052631579,0.593301435,0,0.018359419
3592,48,20599,8,2,7,0,0,17,10,4,3,0,0,17,nowin,push,push,push,10,0,10,203,0.413793103,0.019704433,0.600985222,2,0.577280801
3593,118,20599,10,8,0,0,0,18,10,4,3,0,0,17,nowin,win,plwin,beat,20,0,18,216,0.393518519,0.037037037,0.555555556,0,0.018059873
3594,77,20600,2,10,0,10,0,22,1,3,9,2,10,25,nowin,loss,bust,plbust,0,10,12,200,0.455,0.04,0.62,3,0.916252116
3595,11,20600,9,8,0,0,0,17,1,3,9,2,10,25,nowin,win,dlbust,bust,20,0,17,236,0.457627119,0.016949153,0.588983051,3,0.889015813
3596,33,20600,8,10,0,0,0,18,1,3,9,2,10,25,nowin,win,dlbust,bust,20,0,18,192,0.4375,0.057291667,0.625,2,0.616208916
3597,42,20600,10,4,0,10,0,24,1,3,9,2,10,25,nowin,loss,bust,plbust,0,10,14,212,0.443396226,0.051886792,0.570754717,1,0.309181312
3598,39,20600,8,10,0,0,0,18,1,3,9,2,10,25,nowin,win,dlbust,bust,20,0,18,191,0.429319372,0.062827225,0.57591623,0,0.033760763
3599,62,20600,4,5,7,4,0,20,1,3,9,2,10,25,nowin,win,dlbust,bust,20,0,9,178,0.370786517,0.028089888,0.54494382,0,0.008657722
3600,70,20601,10,2,0,10,0,22,3,10,3,1,0,17,nowin,loss,bust,plbust,0,10,12,228,0.385964912,0.039473684,0.557017544,0,0.016157125
3601,62,20601,8,10,0,0,0,18,3,10,3,1,0,17,nowin,win,plwin,beat,20,0,18,178,0.370786517,0.028089888,0.54494382,0,0.008657722
3602,43,20601,10,10,0,0,0,20,3,10,3,1,0,17,nowin,win,plwin,beat,20,0,20,192,0.40625,0.041666667,0.609375,2,0.576671372
3603,15,20601,10,10,0,0,0,20,3,10,3,1,0,17,nowin,win,plwin,beat,20,0,20,212,0.410377358,0.051886792,0.561320755,0,0.024517408
3604,136,20601,10,6,0,0,0,16,3,10,3,1,0,17,nowin,loss,beat,dlwin,0,10,16,194,0.396907216,0.025773196,0.597938144,0,0.029452644
3605,3,20601,10,7,0,0,0,17,3,10,3,1,0,17,nowin,push,push,push,10,0,17,190,0.431578947,0.026315789,0.542105263,1,0.288076384
3606,39,20602,10,10,0,0,0,20,6,11,0,0,0,17,nowin,win,plwin,beat,20,0,20,191,0.429319372,0.062827225,0.57591623,0,0.033760763
3607,34,20602,4,5,10,0,0,19,6,11,0,0,0,17,nowin,win,plwin,beat,20,0,9,202,0.5,0.079207921,0.618811881,3,0.968961434
3608,144,20602,4,3,3,6,0,16,6,11,0,0,0,17,nowin,loss,beat,dlwin,0,10,7,202,0.386138614,0.054455446,0.564356436,0,0.018006244
3609,16,20602,10,5,0,0,0,15,6,11,0,0,0,17,nowin,loss,beat,dlwin,0,10,15,220,0.427272727,0.081818182,0.6,2,0.588660176
3610,121,20602,10,10,0,0,0,20,6,11,0,0,0,17,nowin,win,plwin,beat,20,0,20,195,0.456410256,0.025641026,0.512820513,1,0.288597791
3611,27,20602,10,10,0,0,0,20,6,11,0,0,0,17,nowin,win,plwin,beat,20,0,20,178,0.370786517,0.016853933,0.573033708,0,0.015536309
3612,75,20603,7,6,0,5,0,18,10,10,0,0,0,20,nowin,loss,beat,dlwin,0,10,13,191,0.418848168,0.052356021,0.570680628,0,0.029344702
3613,17,20603,11,10,0,0,0,21,10,10,0,0,0,20,win,win,plwin,beat,25,0,21,171,0.444444444,0.070175439,0.555555556,1,0.302364894
3614,59,20603,3,8,1,8,0,20,10,10,0,0,0,20,nowin,push,push,push,10,0,11,228,0.429824561,0.048245614,0.543859649,1,0.287885446
3615,102,20603,4,10,0,10,0,24,10,10,0,0,0,20,nowin,loss,bust,plbust,0,10,14,192,0.338541667,0.046875,0.5625,0,0.003306118
3616,12,20603,4,3,10,0,0,17,10,10,0,0,0,20,nowin,loss,beat,dlwin,0,10,7,189,0.470899471,0.015873016,0.613756614,3,0.929171178
3617,30,20603,3,2,9,7,0,21,10,10,0,0,0,20,nowin,win,plwin,beat,20,0,5,206,0.393203883,0.033980583,0.601941748,0,0.029324648
3618,23,20604,10,9,0,0,0,19,6,7,10,0,0,23,nowin,win,dlbust,bust,20,0,19,208,0.427884615,0.0625,0.552884615,1,0.29114424
3619,87,20604,10,10,0,0,0,20,6,7,10,0,0,23,nowin,win,dlbust,bust,20,0,20,202,0.405940594,0.054455446,0.628712871,2,0.590599801
3620,22,20604,2,3,10,0,0,15,6,7,10,0,0,23,nowin,win,dlbust,bust,20,0,5,187,0.481283422,0.042780749,0.577540107,3,0.906128176
3621,82,20604,6,10,0,0,0,16,6,7,10,0,0,23,nowin,win,dlbust,bust,20,0,16,225,0.408888889,0.075555556,0.577777778,0,0.028101874
3622,28,20604,4,9,0,0,0,13,6,7,10,0,0,23,nowin,win,dlbust,bust,20,0,13,199,0.422110553,0.045226131,0.542713568,1,0.282706618
3623,24,20604,2,7,10,0,0,19,6,7,10,0,0,23,nowin,win,dlbust,bust,20,0,9,207,0.458937198,0.048309179,0.570048309,1,0.318138014
3624,106,20605,7,4,7,0,0,18,11,10,0,0,0,21,nowin,loss,beat,dlwin,0,10,11,192,0.411458333,0.026041667,0.557291667,0,0.023854304
3625,139,20605,7,7,0,10,0,24,11,10,0,0,0,21,nowin,loss,bust,plbust,0,10,14,192,0.380208333,0.036458333,0.59375,0,0.023429169
3626,31,20605,11,8,0,0,0,19,11,10,0,0,0,21,nowin,loss,beat,dlwin,0,10,19,188,0.473404255,0.058510638,0.515957447,1,0.300306557
3627,76,20605,6,1,6,2,4,19,11,10,0,0,0,21,nowin,loss,beat,dlwin,0,10,7,189,0.534391534,0.079365079,0.608465608,3,1
3628,82,20605,8,11,0,0,0,19,11,10,0,0,0,21,nowin,loss,beat,dlwin,0,10,19,225,0.408888889,0.075555556,0.577777778,0,0.028101874
3629,115,20605,10,6,0,7,0,23,11,10,0,0,0,21,nowin,loss,bust,plbust,0,10,16,194,0.427835052,0.041237113,0.592783505,2,0.583863602
3630,120,20606,10,6,0,3,0,19,10,6,1,0,0,17,nowin,win,plwin,beat,20,0,16,202,0.440594059,0.034653465,0.618811881,2,0.614441029
3631,140,20606,8,7,0,8,0,23,10,6,1,0,0,17,nowin,loss,bust,plbust,0,10,15,210,0.466666667,0.023809524,0.604761905,3,0.915293335
3632,130,20606,5,3,3,7,0,18,10,6,1,0,0,17,nowin,win,plwin,beat,20,0,8,219,0.410958904,0.03652968,0.566210046,0,0.025888739
3633,38,20606,3,7,6,4,0,20,10,6,1,0,0,17,nowin,win,plwin,beat,20,0,10,202,0.361386139,0.03960396,0.564356436,0,0.010597953
3634,31,20606,2,5,6,10,0,23,10,6,1,0,0,17,nowin,loss,bust,plbust,0,10,7,188,0.473404255,0.058510638,0.515957447,1,0.300306557
3635,130,20606,6,10,0,10,0,26,10,6,1,0,0,17,nowin,loss,bust,plbust,0,10,16,219,0.410958904,0.03652968,0.566210046,0,0.025888739
3636,64,20607,10,7,0,0,0,17,4,10,10,0,0,24,nowin,win,dlbust,bust,20,0,17,187,0.363636364,0.048128342,0.631016043,0,0.027594885
3637,109,20607,4,2,10,0,0,16,4,10,10,0,0,24,nowin,win,dlbust,bust,20,0,6,221,0.461538462,0.058823529,0.597285068,3,0.901830309
3638,145,20607,10,8,0,0,0,18,4,10,10,0,0,24,nowin,win,dlbust,bust,20,0,18,188,0.441489362,0.031914894,0.622340426,2,0.617837093
3639,18,20607,8,11,0,0,0,19,4,10,10,0,0,24,nowin,win,dlbust,bust,20,0,19,182,0.461538462,0.043956044,0.587912088,3,0.892649374
3640,33,20607,6,5,10,0,0,21,4,10,10,0,0,24,nowin,win,dlbust,bust,20,0,11,192,0.4375,0.057291667,0.625,2,0.616208916
3641,91,20607,8,10,0,0,0,18,4,10,10,0,0,24,nowin,win,dlbust,bust,20,0,18,194,0.417525773,0.046391753,0.515463918,1,0.266616552
3642,54,20608,10,10,0,0,0,20,11,10,0,0,0,21,nowin,loss,beat,dlwin,0,10,20,185,0.437837838,0.032432432,0.556756757,1,0.29899854
3643,90,20608,3,10,0,5,0,18,11,10,0,0,0,21,nowin,loss,beat,dlwin,0,10,13,201,0.447761194,0.049751244,0.60199005,3,0.889945023
3644,120,20608,10,10,0,0,0,20,11,10,0,0,0,21,nowin,loss,beat,dlwin,0,10,20,202,0.440594059,0.034653465,0.618811881,2,0.614441029
3645,76,20608,10,10,0,0,0,20,11,10,0,0,0,21,nowin,loss,beat,dlwin,0,10,20,189,0.534391534,0.079365079,0.608465608,3,1
3646,102,20608,1,5,8,7,0,21,11,10,0,0,0,21,nowin,push,push,push,10,0,6,192,0.338541667,0.046875,0.5625,0,0.003306118
3647,64,20608,6,2,2,4,6,20,11,10,0,0,0,21,nowin,loss,beat,dlwin,0,10,8,187,0.363636364,0.048128342,0.631016043,0,0.027594885
3648,136,20609,5,5,5,0,0,15,2,10,6,0,0,18,nowin,loss,beat,dlwin,0,10,10,194,0.396907216,0.025773196,0.597938144,0,0.029452644
3649,129,20609,3,2,5,2,5,17,2,10,6,0,0,18,nowin,loss,beat,dlwin,0,10,5,201,0.422885572,0.064676617,0.55721393,0,0.027255383
3650,145,20609,10,10,0,0,0,20,2,10,6,0,0,18,nowin,win,plwin,beat,20,0,20,188,0.441489362,0.031914894,0.622340426,2,0.617837093
3651,142,20609,4,8,0,10,0,22,2,10,6,0,0,18,nowin,loss,bust,plbust,0,10,12,211,0.417061611,0.047393365,0.526066351,1,0.271531309
3652,81,20609,10,4,0,0,0,14,2,10,6,0,0,18,nowin,loss,beat,dlwin,0,10,14,182,0.395604396,0.043956044,0.60989011,2,0.567491261
3653,128,20609,2,1,9,10,0,22,2,10,6,0,0,18,nowin,loss,bust,plbust,0,10,3,227,0.356828194,0.052863436,0.577092511,0,0.012352564
3654,98,20610,10,10,0,0,0,20,8,10,0,0,0,18,nowin,win,plwin,beat,20,0,20,220,0.422727273,0.054545455,0.55,1,0.28664435
3655,39,20610,6,10,0,10,0,26,8,10,0,0,0,18,nowin,loss,bust,plbust,0,10,16,191,0.429319372,0.062827225,0.57591623,0,0.033760763
3656,144,20610,9,5,0,10,0,24,8,10,0,0,0,18,nowin,loss,bust,plbust,0,10,14,202,0.386138614,0.054455446,0.564356436,0,0.018006244
3657,62,20610,2,8,2,10,0,22,8,10,0,0,0,18,nowin,loss,bust,plbust,0,10,10,178,0.370786517,0.028089888,0.54494382,0,0.008657722
3658,145,20610,11,1,2,4,0,18,8,10,0,0,0,18,nowin,push,push,push,10,0,12,188,0.441489362,0.031914894,0.622340426,2,0.617837093
3659,3,20610,10,3,0,4,0,17,8,10,0,0,0,18,nowin,loss,beat,dlwin,0,10,13,190,0.431578947,0.026315789,0.542105263,1,0.288076384
3660,30,20611,10,3,0,7,0,20,9,3,8,0,0,20,nowin,push,push,push,10,0,13,206,0.393203883,0.033980583,0.601941748,0,0.029324648
3661,30,20611,5,10,0,3,0,18,9,3,8,0,0,20,nowin,loss,beat,dlwin,0,10,15,206,0.393203883,0.033980583,0.601941748,0,0.029324648
3662,118,20611,3,1,10,10,0,24,9,3,8,0,0,20,nowin,loss,bust,plbust,0,10,4,216,0.393518519,0.037037037,0.555555556,0,0.018059873
3663,7,20611,11,10,0,0,0,21,9,3,8,0,0,20,win,win,plwin,beat,25,0,21,183,0.442622951,0.06010929,0.62295082,2,0.619303341
3664,93,20611,10,4,0,10,0,24,9,3,8,0,0,20,nowin,loss,bust,plbust,0,10,14,175,0.485714286,0.051428571,0.548571429,1,0.323648091
3665,122,20611,10,11,0,0,0,21,9,3,8,0,0,20,win,win,plwin,beat,25,0,21,210,0.347619048,0.052380952,0.59047619,0,0.012873677
3666,131,20612,9,2,10,0,0,21,1,5,7,10,0,23,nowin,win,dlbust,bust,20,0,11,217,0.410138249,0.069124424,0.543778802,0,0.02015021
3667,21,20612,4,3,9,8,0,24,1,5,7,10,0,23,nowin,loss,bust,plbust,0,10,7,214,0.359813084,0.042056075,0.626168224,0,0.025263474
3668,130,20612,10,10,0,0,0,20,1,5,7,10,0,23,nowin,win,dlbust,bust,20,0,20,219,0.410958904,0.03652968,0.566210046,0,0.025888739
3669,113,20612,7,10,0,0,0,17,1,5,7,10,0,23,nowin,win,dlbust,bust,20,0,17,199,0.407035176,0.055276382,0.668341709,2,0.620695264
3670,63,20612,1,6,7,10,0,24,1,5,7,10,0,23,nowin,loss,bust,plbust,0,10,7,216,0.467592593,0.037037037,0.62037037,3,0.931690496
3671,89,20612,5,10,0,10,0,25,1,5,7,10,0,23,nowin,loss,bust,plbust,0,10,15,212,0.537735849,0.047169811,0.594339623,3,0.990167191
3672,10,20613,9,7,0,8,0,24,10,10,0,0,0,20,nowin,loss,bust,plbust,0,10,16,191,0.413612565,0.057591623,0.596858639,2,0.574087175
3673,77,20613,10,8,0,0,0,18,10,10,0,0,0,20,nowin,loss,beat,dlwin,0,10,18,200,0.455,0.04,0.62,3,0.916252116
3674,96,20613,2,4,5,8,0,19,10,10,0,0,0,20,nowin,loss,beat,dlwin,0,10,6,190,0.468421053,0.057894737,0.584210526,3,0.897263354
3675,95,20613,7,10,0,0,0,17,10,10,0,0,0,20,nowin,loss,beat,dlwin,0,10,17,218,0.412844037,0.04587156,0.559633028,0,0.024842385
3676,75,20613,8,8,0,6,0,22,10,10,0,0,0,20,nowin,loss,bust,plbust,0,10,16,191,0.418848168,0.052356021,0.570680628,0,0.029344702
3677,150,20613,9,10,0,0,0,19,10,10,0,0,0,20,nowin,loss,beat,dlwin,0,10,19,192,0.401041667,0.036458333,0.567708333,0,0.023287458
3678,47,20614,10,6,0,5,0,21,10,6,10,0,0,26,nowin,win,dlbust,bust,20,0,16,210,0.438095238,0.057142857,0.623809524,2,0.615868808
3679,46,20614,6,8,0,10,0,24,10,6,10,0,0,26,nowin,loss,bust,plbust,0,10,14,186,0.403225806,0.048387097,0.591397849,0,0.029742194
3680,71,20614,7,9,0,10,0,26,10,6,10,0,0,26,nowin,loss,bust,plbust,0,10,16,193,0.352331606,0.046632124,0.585492228,0,0.013063661
3681,109,20614,9,2,2,5,0,18,10,6,10,0,0,26,nowin,win,dlbust,bust,20,0,11,221,0.461538462,0.058823529,0.597285068,3,0.901830309
3682,68,20614,7,7,0,7,0,21,10,6,10,0,0,26,nowin,win,dlbust,bust,20,0,14,205,0.434146341,0.029268293,0.6,2,0.59483189
3683,119,20614,2,8,3,2,8,23,10,6,10,0,0,26,nowin,loss,bust,plbust,0,10,10,190,0.405263158,0.068421053,0.515789474,0,0.011837158
3684,130,20615,11,8,0,0,0,19,4,8,10,0,0,22,nowin,win,dlbust,bust,20,0,19,219,0.410958904,0.03652968,0.566210046,0,0.025888739
3685,45,20615,4,4,10,0,0,18,4,8,10,0,0,22,nowin,win,dlbust,bust,20,0,8,196,0.428571429,0.051020408,0.612244898,2,0.598821767
3686,142,20615,7,10,0,0,0,17,4,8,10,0,0,22,nowin,win,dlbust,bust,20,0,17,211,0.417061611,0.047393365,0.526066351,1,0.271531309
3687,89,20615,10,6,0,0,0,16,4,8,10,0,0,22,nowin,win,dlbust,bust,20,0,16,212,0.537735849,0.047169811,0.594339623,3,0.990167191
3688,100,20615,8,9,0,0,0,17,4,8,10,0,0,22,nowin,win,dlbust,bust,20,0,17,190,0.452631579,0.036842105,0.594736842,3,0.888671154
3689,48,20615,4,11,3,0,0,18,4,8,10,0,0,22,nowin,win,dlbust,bust,20,0,15,203,0.413793103,0.019704433,0.600985222,2,0.577280801
3690,51,20616,8,11,0,0,0,19,3,4,10,0,0,17,nowin,win,plwin,beat,20,0,19,189,0.529100529,0.068783069,0.608465608,3,0.993665715
3691,116,20616,5,4,6,0,0,15,3,4,10,0,0,17,nowin,loss,beat,dlwin,0,10,9,195,0.425641026,0.056410256,0.538461538,1,0.28273747
3692,28,20616,10,4,0,0,0,14,3,4,10,0,0,17,nowin,loss,beat,dlwin,0,10,14,199,0.422110553,0.045226131,0.542713568,1,0.282706618
3693,122,20616,7,7,0,0,0,14,3,4,10,0,0,17,nowin,loss,beat,dlwin,0,10,14,210,0.347619048,0.052380952,0.59047619,0,0.012873677
3694,92,20616,2,10,0,8,0,20,3,4,10,0,0,17,nowin,win,plwin,beat,20,0,12,186,0.446236559,0.059139785,0.564516129,1,0.307826125
3695,30,20616,9,9,0,0,0,18,3,4,10,0,0,17,nowin,win,plwin,beat,20,0,18,206,0.393203883,0.033980583,0.601941748,0,0.029324648
3696,143,20617,3,6,10,0,0,19,10,11,0,0,0,21,nowin,loss,beat,dlwin,0,10,9,203,0.463054187,0.044334975,0.57635468,3,0.883143365
3697,142,20617,7,10,0,0,0,17,10,11,0,0,0,21,nowin,loss,beat,dlwin,0,10,17,211,0.417061611,0.047393365,0.526066351,1,0.271531309
3698,65,20617,11,10,0,0,0,21,10,11,0,0,0,21,win,push,push,push,10,0,21,203,0.492610837,0.054187192,0.571428571,3,0.913702814
3699,64,20617,1,6,5,8,0,20,10,11,0,0,0,21,nowin,loss,beat,dlwin,0,10,7,187,0.363636364,0.048128342,0.631016043,0,0.027594885
3700,53,20617,9,10,0,0,0,19,10,11,0,0,0,21,nowin,loss,beat,dlwin,0,10,19,250,0.372,0.064,0.564,0,0.013687345
3701,61,20617,11,10,0,0,0,21,10,11,0,0,0,21,win,push,push,push,10,0,21,194,0.427835052,0.077319588,0.603092784,2,0.591437139
3702,106,20618,5,8,0,10,0,23,10,8,0,0,0,18,nowin,loss,bust,plbust,0,10,13,192,0.411458333,0.026041667,0.557291667,0,0.023854304
3703,145,20618,10,9,0,0,0,19,10,8,0,0,0,18,nowin,win,plwin,beat,20,0,19,188,0.441489362,0.031914894,0.622340426,2,0.617837093
3704,46,20618,2,1,10,4,0,17,10,8,0,0,0,18,nowin,loss,beat,dlwin,0,10,3,186,0.403225806,0.048387097,0.591397849,0,0.029742194
3705,90,20618,10,2,0,10,0,22,10,8,0,0,0,18,nowin,loss,bust,plbust,0,10,12,201,0.447761194,0.049751244,0.60199005,3,0.889945023
3706,41,20618,10,9,0,0,0,19,10,8,0,0,0,18,nowin,win,plwin,beat,20,0,19,192,0.364583333,0.036458333,0.520833333,0,0.00089702
3707,32,20618,3,2,10,7,0,22,10,8,0,0,0,18,nowin,loss,bust,plbust,0,10,5,189,0.391534392,0.037037037,0.53968254,0,0.013579086
3708,140,20619,8,10,0,0,0,18,11,8,0,0,0,19,nowin,loss,beat,dlwin,0,10,18,210,0.466666667,0.023809524,0.604761905,3,0.915293335
3709,70,20619,10,6,0,6,0,22,11,8,0,0,0,19,nowin,loss,bust,plbust,0,10,16,228,0.385964912,0.039473684,0.557017544,0,0.016157125
3710,49,20619,5,3,6,7,0,21,11,8,0,0,0,19,nowin,win,plwin,beat,20,0,8,207,0.396135266,0.053140097,0.594202899,0,0.028306925
3711,37,20619,5,8,0,3,10,26,11,8,0,0,0,19,nowin,loss,bust,plbust,0,10,13,208,0.394230769,0.038461538,0.581730769,0,0.024682772
3712,27,20619,7,7,0,10,0,24,11,8,0,0,0,19,nowin,loss,bust,plbust,0,10,14,178,0.370786517,0.016853933,0.573033708,0,0.015536309
3713,13,20619,10,3,0,4,0,17,11,8,0,0,0,19,nowin,loss,beat,dlwin,0,10,13,206,0.417475728,0.063106796,0.621359223,2,0.59555479
3714,70,20620,10,8,0,0,0,18,7,10,0,0,0,17,nowin,win,plwin,beat,20,0,18,228,0.385964912,0.039473684,0.557017544,0,0.016157125
3715,55,20620,4,10,0,10,0,24,7,10,0,0,0,17,nowin,loss,bust,plbust,0,10,14,191,0.371727749,0.057591623,0.54973822,0,0.01011347
3716,43,20620,10,10,0,0,0,20,7,10,0,0,0,17,nowin,win,plwin,beat,20,0,20,192,0.40625,0.041666667,0.609375,2,0.576671372
3717,137,20620,7,10,0,0,0,17,7,10,0,0,0,17,nowin,push,push,push,10,0,17,194,0.417525773,0.046391753,0.536082474,1,0.276714602
3718,124,20620,3,4,9,8,0,24,7,10,0,0,0,17,nowin,loss,bust,plbust,0,10,7,202,0.47029703,0.064356436,0.584158416,3,0.899458193
3719,147,20620,5,10,0,10,0,25,7,10,0,0,0,17,nowin,loss,bust,plbust,0,10,15,205,0.380487805,0.014634146,0.536585366,0,0.00951447
3720,60,20621,2,8,2,10,0,22,10,8,0,0,0,18,nowin,loss,bust,plbust,0,10,10,227,0.418502203,0.022026432,0.559471366,0,0.026496258
3721,126,20621,9,8,0,0,0,17,10,8,0,0,0,18,nowin,loss,beat,dlwin,0,10,17,188,0.457446809,0.074468085,0.60106383,3,0.900633203
3722,26,20621,4,10,0,10,0,24,10,8,0,0,0,18,nowin,loss,bust,plbust,0,10,14,203,0.463054187,0.0591133,0.541871921,1,0.306802864
3723,81,20621,10,2,0,10,0,22,10,8,0,0,0,18,nowin,loss,bust,plbust,0,10,12,182,0.395604396,0.043956044,0.60989011,2,0.567491261
3724,3,20621,10,4,0,10,0,24,10,8,0,0,0,18,nowin,loss,bust,plbust,0,10,14,190,0.431578947,0.026315789,0.542105263,1,0.288076384
3725,108,20621,8,7,0,10,0,25,10,8,0,0,0,18,nowin,loss,bust,plbust,0,10,15,193,0.435233161,0.056994819,0.559585492,1,0.298824795
3726,43,20622,4,10,0,0,0,14,4,10,6,0,0,20,nowin,loss,beat,dlwin,0,10,14,192,0.40625,0.041666667,0.609375,2,0.576671372
3727,131,20622,9,10,0,0,0,19,4,10,6,0,0,20,nowin,loss,beat,dlwin,0,10,19,217,0.410138249,0.069124424,0.543778802,0,0.02015021
3728,102,20622,10,8,0,0,0,18,4,10,6,0,0,20,nowin,loss,beat,dlwin,0,10,18,192,0.338541667,0.046875,0.5625,0,0.003306118
3729,48,20622,7,7,0,0,0,14,4,10,6,0,0,20,nowin,loss,beat,dlwin,0,10,14,203,0.413793103,0.019704433,0.600985222,2,0.577280801
3730,71,20622,5,10,0,0,0,15,4,10,6,0,0,20,nowin,loss,beat,dlwin,0,10,15,193,0.352331606,0.046632124,0.585492228,0,0.013063661
3731,137,20622,9,3,0,0,0,12,4,10,6,0,0,20,nowin,loss,beat,dlwin,0,10,12,194,0.417525773,0.046391753,0.536082474,1,0.276714602
3732,73,20623,2,4,5,2,7,20,8,10,0,0,0,18,nowin,win,plwin,beat,20,0,6,181,0.375690608,0.011049724,0.596685083,0,0.022795773
3733,3,20623,10,2,0,10,0,22,8,10,0,0,0,18,nowin,loss,bust,plbust,0,10,12,190,0.431578947,0.026315789,0.542105263,1,0.288076384
3734,16,20623,11,10,0,0,0,21,8,10,0,0,0,18,win,win,plwin,beat,25,0,21,220,0.427272727,0.081818182,0.6,2,0.588660176
3735,109,20623,10,6,0,9,0,25,8,10,0,0,0,18,nowin,loss,bust,plbust,0,10,16,221,0.461538462,0.058823529,0.597285068,3,0.901830309
3736,118,20623,8,6,0,3,0,17,8,10,0,0,0,18,nowin,loss,beat,dlwin,0,10,14,216,0.393518519,0.037037037,0.555555556,0,0.018059873
3737,40,20623,10,9,0,0,0,19,8,10,0,0,0,18,nowin,win,plwin,beat,20,0,19,196,0.367346939,0.030612245,0.617346939,0,0.025358183
3738,128,20624,2,2,11,0,0,15,6,7,4,0,0,17,nowin,loss,beat,dlwin,0,10,4,227,0.356828194,0.052863436,0.577092511,0,0.012352564
3739,100,20624,2,7,10,0,0,19,6,7,4,0,0,17,nowin,win,plwin,beat,20,0,9,190,0.452631579,0.036842105,0.594736842,3,0.888671154
3740,112,20624,5,4,5,0,0,14,6,7,4,0,0,17,nowin,loss,beat,dlwin,0,10,9,203,0.448275862,0.054187192,0.600985222,3,0.889576933
3741,105,20624,10,3,0,0,0,13,6,7,4,0,0,17,nowin,loss,beat,dlwin,0,10,13,198,0.414141414,0.070707071,0.590909091,0,0.032889494
3742,100,20624,10,7,0,0,0,17,6,7,4,0,0,17,nowin,push,push,push,10,0,17,190,0.452631579,0.036842105,0.594736842,3,0.888671154
3743,129,20624,3,10,0,0,0,13,6,7,4,0,0,17,nowin,loss,beat,dlwin,0,10,13,201,0.422885572,0.064676617,0.55721393,0,0.027255383
3744,98,20625,5,7,0,5,0,17,3,10,9,0,0,22,nowin,win,dlbust,bust,20,0,12,220,0.422727273,0.054545455,0.55,1,0.28664435
3745,41,20625,2,11,8,0,0,21,3,10,9,0,0,22,nowin,win,dlbust,bust,20,0,13,192,0.364583333,0.036458333,0.520833333,0,0.00089702
3746,29,20625,10,4,0,0,0,14,3,10,9,0,0,22,nowin,win,dlbust,bust,20,0,14,189,0.44973545,0.058201058,0.544973545,1,0.300349439
3747,58,20625,6,10,0,0,0,16,3,10,9,0,0,22,nowin,win,dlbust,bust,20,0,16,195,0.430769231,0.041025641,0.584615385,2,0.580497586
3748,47,20625,8,10,0,0,0,18,3,10,9,0,0,22,nowin,win,dlbust,bust,20,0,18,210,0.438095238,0.057142857,0.623809524,2,0.615868808
3749,100,20625,5,2,9,0,0,16,3,10,9,0,0,22,nowin,win,dlbust,bust,20,0,7,190,0.452631579,0.036842105,0.594736842,3,0.888671154
3750,122,20626,8,10,0,0,0,18,10,9,0,0,0,19,nowin,loss,beat,dlwin,0,10,18,210,0.347619048,0.052380952,0.59047619,0,0.012873677
3751,6,20626,8,10,0,0,0,18,10,9,0,0,0,19,nowin,loss,beat,dlwin,0,10,18,191,0.439790576,0.047120419,0.581151832,1,0.31211505
3752,42,20626,9,3,0,10,0,22,10,9,0,0,0,19,nowin,loss,bust,plbust,0,10,12,212,0.443396226,0.051886792,0.570754717,1,0.309181312
3753,37,20626,2,7,10,0,0,19,10,9,0,0,0,19,nowin,push,push,push,10,0,9,208,0.394230769,0.038461538,0.581730769,0,0.024682772
3754,6,20626,7,8,0,10,0,25,10,9,0,0,0,19,nowin,loss,bust,plbust,0,10,15,191,0.439790576,0.047120419,0.581151832,1,0.31211505
3755,18,20626,4,4,11,0,0,19,10,9,0,0,0,19,nowin,push,push,push,10,0,8,182,0.461538462,0.043956044,0.587912088,3,0.892649374
3756,30,20627,11,2,2,3,0,18,11,10,0,0,0,21,nowin,loss,beat,dlwin,0,10,13,206,0.393203883,0.033980583,0.601941748,0,0.029324648
3757,106,20627,10,10,0,0,0,20,11,10,0,0,0,21,nowin,loss,beat,dlwin,0,10,20,192,0.411458333,0.026041667,0.557291667,0,0.023854304
3758,16,20627,10,7,0,0,0,17,11,10,0,0,0,21,nowin,loss,beat,dlwin,0,10,17,220,0.427272727,0.081818182,0.6,2,0.588660176
3759,87,20627,10,2,0,3,10,25,11,10,0,0,0,21,nowin,loss,bust,plbust,0,10,12,202,0.405940594,0.054455446,0.628712871,2,0.590599801
3760,102,20627,9,5,0,10,0,24,11,10,0,0,0,21,nowin,loss,bust,plbust,0,10,14,192,0.338541667,0.046875,0.5625,0,0.003306118
3761,36,20627,10,6,0,2,0,18,11,10,0,0,0,21,nowin,loss,beat,dlwin,0,10,16,229,0.445414847,0.056768559,0.655021834,2,0.645370571
3762,147,20628,7,10,0,0,0,17,5,10,6,0,0,21,nowin,loss,beat,dlwin,0,10,17,205,0.380487805,0.014634146,0.536585366,0,0.00951447
3763,124,20628,9,9,0,0,0,18,5,10,6,0,0,21,nowin,loss,beat,dlwin,0,10,18,202,0.47029703,0.064356436,0.584158416,3,0.899458193
3764,22,20628,3,4,10,0,0,17,5,10,6,0,0,21,nowin,loss,beat,dlwin,0,10,7,187,0.481283422,0.042780749,0.577540107,3,0.906128176
3765,12,20628,8,8,0,0,0,16,5,10,6,0,0,21,nowin,loss,beat,dlwin,0,10,16,189,0.470899471,0.015873016,0.613756614,3,0.929171178
3766,100,20628,10,10,0,0,0,20,5,10,6,0,0,21,nowin,loss,beat,dlwin,0,10,20,190,0.452631579,0.036842105,0.594736842,3,0.888671154
3767,12,20628,8,2,5,0,0,15,5,10,6,0,0,21,nowin,loss,beat,dlwin,0,10,10,189,0.470899471,0.015873016,0.613756614,3,0.929171178
3768,57,20629,9,10,0,0,0,19,10,10,0,0,0,20,nowin,loss,beat,dlwin,0,10,19,192,0.46875,0.052083333,0.59375,3,0.907001181
3769,100,20629,7,10,0,0,0,17,10,10,0,0,0,20,nowin,loss,beat,dlwin,0,10,17,190,0.452631579,0.036842105,0.594736842,3,0.888671154
3770,34,20629,6,10,0,10,0,26,10,10,0,0,0,20,nowin,loss,bust,plbust,0,10,16,202,0.5,0.079207921,0.618811881,3,0.968961434
3771,148,20629,2,10,0,6,0,18,10,10,0,0,0,20,nowin,loss,beat,dlwin,0,10,12,204,0.401960784,0.078431373,0.593137255,0,0.029789521
3772,83,20629,4,9,0,10,0,23,10,10,0,0,0,20,nowin,loss,bust,plbust,0,10,13,193,0.424870466,0.051813472,0.678756477,2,0.644360335
3773,107,20629,7,2,4,10,0,23,10,10,0,0,0,20,nowin,loss,bust,plbust,0,10,9,218,0.444954128,0.073394495,0.600917431,2,0.605210014
3774,83,20630,4,4,5,0,0,13,3,5,5,3,2,18,nowin,loss,beat,dlwin,0,10,8,193,0.424870466,0.051813472,0.678756477,2,0.644360335
3775,12,20630,2,7,10,0,0,19,3,5,5,3,2,18,nowin,win,plwin,beat,20,0,9,189,0.470899471,0.015873016,0.613756614,3,0.929171178
3776,65,20630,10,9,0,0,0,19,3,5,5,3,2,18,nowin,win,plwin,beat,20,0,19,203,0.492610837,0.054187192,0.571428571,3,0.913702814
3777,36,20630,6,10,0,0,0,16,3,5,5,3,2,18,nowin,loss,beat,dlwin,0,10,16,229,0.445414847,0.056768559,0.655021834,2,0.645370571
3778,85,20630,7,7,0,0,0,14,3,5,5,3,2,18,nowin,loss,beat,dlwin,0,10,14,195,0.41025641,0.066666667,0.594871795,0,0.03269711
3779,24,20630,11,10,0,0,0,21,3,5,5,3,2,18,win,win,plwin,beat,25,0,21,207,0.458937198,0.048309179,0.570048309,1,0.318138014
3780,110,20631,9,10,0,0,0,19,10,11,0,0,0,21,nowin,loss,beat,dlwin,0,10,19,192,0.416666667,0.046875,0.557291667,0,0.025413132
3781,101,20631,7,11,0,0,0,18,10,11,0,0,0,21,nowin,loss,beat,dlwin,0,10,18,205,0.424390244,0.068292683,0.63902439,2,0.614740646
3782,35,20631,2,4,8,10,0,24,10,11,0,0,0,21,nowin,loss,bust,plbust,0,10,6,202,0.410891089,0.044554455,0.633663366,2,0.598681573
3783,63,20631,9,10,0,0,0,19,10,11,0,0,0,21,nowin,loss,beat,dlwin,0,10,19,216,0.467592593,0.037037037,0.62037037,3,0.931690496
3784,131,20631,5,11,3,0,0,19,10,11,0,0,0,21,nowin,loss,beat,dlwin,0,10,16,217,0.410138249,0.069124424,0.543778802,0,0.02015021
3785,71,20631,10,5,0,4,0,19,10,11,0,0,0,21,nowin,loss,beat,dlwin,0,10,15,193,0.352331606,0.046632124,0.585492228,0,0.013063661
3786,129,20632,9,4,0,0,0,13,3,10,3,10,0,26,nowin,win,dlbust,bust,20,0,13,201,0.422885572,0.064676617,0.55721393,0,0.027255383
3787,1,20632,3,11,5,0,0,19,3,10,3,10,0,26,nowin,win,dlbust,bust,20,0,14,197,0.406091371,0.025380711,0.649746193,2,0.606186955
3788,124,20632,4,10,0,0,0,14,3,10,3,10,0,26,nowin,win,dlbust,bust,20,0,14,202,0.47029703,0.064356436,0.584158416,3,0.899458193
3789,46,20632,10,8,0,0,0,18,3,10,3,10,0,26,nowin,win,dlbust,bust,20,0,18,186,0.403225806,0.048387097,0.591397849,0,0.029742194
3790,141,20632,10,10,0,0,0,20,3,10,3,10,0,26,nowin,win,dlbust,bust,20,0,20,202,0.420792079,0.074257426,0.564356436,0,0.028377851
3791,124,20632,7,9,0,0,0,16,3,10,3,10,0,26,nowin,win,dlbust,bust,20,0,16,202,0.47029703,0.064356436,0.584158416,3,0.899458193
3792,13,20633,5,10,0,10,0,25,10,7,0,0,0,17,nowin,loss,bust,plbust,0,10,15,206,0.417475728,0.063106796,0.621359223,2,0.59555479
3793,10,20633,5,3,5,8,0,21,10,7,0,0,0,17,nowin,win,plwin,beat,20,0,8,191,0.413612565,0.057591623,0.596858639,2,0.574087175
3794,149,20633,4,2,10,4,0,20,10,7,0,0,0,17,nowin,win,plwin,beat,20,0,6,225,0.457777778,0.057777778,0.648888889,2,0.651965595
3795,8,20633,10,6,0,10,0,26,10,7,0,0,0,17,nowin,loss,bust,plbust,0,10,16,181,0.44198895,0.071823204,0.596685083,2,0.599438402
3796,118,20633,10,4,0,5,0,19,10,7,0,0,0,17,nowin,win,plwin,beat,20,0,14,216,0.393518519,0.037037037,0.555555556,0,0.018059873
3797,104,20633,1,3,10,10,0,24,10,7,0,0,0,17,nowin,loss,bust,plbust,0,10,4,209,0.363636364,0.052631579,0.593301435,0,0.018359419
3798,115,20634,7,9,0,9,0,25,10,10,0,0,0,20,nowin,loss,bust,plbust,0,10,16,194,0.427835052,0.041237113,0.592783505,2,0.583863602
3799,51,20634,2,7,11,0,0,20,10,10,0,0,0,20,nowin,push,push,push,10,0,9,189,0.529100529,0.068783069,0.608465608,3,0.993665715
3800,116,20634,7,9,0,5,0,21,10,10,0,0,0,20,nowin,win,plwin,beat,20,0,16,195,0.425641026,0.056410256,0.538461538,1,0.28273747
3801,8,20634,2,7,7,10,0,26,10,10,0,0,0,20,nowin,loss,bust,plbust,0,10,9,181,0.44198895,0.071823204,0.596685083,2,0.599438402
3802,19,20634,10,11,0,0,0,21,10,10,0,0,0,20,win,win,plwin,beat,25,0,21,237,0.41350211,0.054852321,0.628691983,2,0.597373826
3803,45,20634,10,4,0,7,0,21,10,10,0,0,0,20,nowin,win,plwin,beat,20,0,14,196,0.428571429,0.051020408,0.612244898,2,0.598821767
3804,35,20635,8,10,0,0,0,18,10,10,0,0,0,20,nowin,loss,beat,dlwin,0,10,18,202,0.410891089,0.044554455,0.633663366,2,0.598681573
3805,113,20635,8,10,0,0,0,18,10,10,0,0,0,20,nowin,loss,beat,dlwin,0,10,18,199,0.407035176,0.055276382,0.668341709,2,0.620695264
3806,87,20635,10,4,0,9,0,23,10,10,0,0,0,20,nowin,loss,bust,plbust,0,10,14,202,0.405940594,0.054455446,0.628712871,2,0.590599801
3807,7,20635,10,10,0,0,0,20,10,10,0,0,0,20,nowin,push,push,push,10,0,20,183,0.442622951,0.06010929,0.62295082,2,0.619303341
3808,143,20635,10,5,0,7,0,22,10,10,0,0,0,20,nowin,loss,bust,plbust,0,10,15,203,0.463054187,0.044334975,0.57635468,3,0.883143365
3809,127,20635,5,10,0,1,10,26,10,10,0,0,0,20,nowin,loss,bust,plbust,0,10,15,201,0.402985075,0.029850746,0.60199005,0,0.032263937
3810,90,20636,7,6,0,5,0,18,11,7,0,0,0,18,nowin,push,push,push,10,0,13,201,0.447761194,0.049751244,0.60199005,3,0.889945023
3811,138,20636,10,9,0,0,0,19,11,7,0,0,0,18,nowin,win,plwin,beat,20,0,19,190,0.442105263,0.047368421,0.610526316,2,0.609711065
3812,103,20636,5,10,0,3,0,18,11,7,0,0,0,18,nowin,push,push,push,10,0,15,203,0.379310345,0.064039409,0.551724138,0,0.012869209
3813,55,20636,11,2,2,6,0,21,11,7,0,0,0,18,nowin,win,plwin,beat,20,0,13,191,0.371727749,0.057591623,0.54973822,0,0.01011347
3814,11,20636,6,9,0,6,0,21,11,7,0,0,0,18,nowin,win,plwin,beat,20,0,15,236,0.457627119,0.016949153,0.588983051,3,0.889015813
3815,113,20636,5,2,4,10,0,21,11,7,0,0,0,18,nowin,win,plwin,beat,20,0,7,199,0.407035176,0.055276382,0.668341709,2,0.620695264
3816,31,20637,11,1,9,0,0,21,9,10,0,0,0,19,nowin,win,plwin,beat,20,0,12,188,0.473404255,0.058510638,0.515957447,1,0.300306557
3817,57,20637,10,2,0,10,0,22,9,10,0,0,0,19,nowin,loss,bust,plbust,0,10,12,192,0.46875,0.052083333,0.59375,3,0.907001181
3818,133,20637,4,8,0,8,0,20,9,10,0,0,0,19,nowin,win,plwin,beat,20,0,12,201,0.47761194,0.064676617,0.611940299,3,0.935428111
3819,97,20637,11,1,7,0,0,19,9,10,0,0,0,19,nowin,push,push,push,10,0,12,182,0.450549451,0.06043956,0.692307692,2,0.677372279
3820,36,20637,2,10,0,9,0,21,9,10,0,0,0,19,nowin,win,plwin,beat,20,0,12,229,0.445414847,0.056768559,0.655021834,2,0.645370571
3821,105,20637,9,10,0,0,0,19,9,10,0,0,0,19,nowin,push,push,push,10,0,19,198,0.414141414,0.070707071,0.590909091,0,0.032889494
3822,116,20638,10,7,0,0,0,17,8,5,10,0,0,23,nowin,win,dlbust,bust,20,0,17,195,0.425641026,0.056410256,0.538461538,1,0.28273747
3823,109,20638,10,9,0,0,0,19,8,5,10,0,0,23,nowin,win,dlbust,bust,20,0,19,221,0.461538462,0.058823529,0.597285068,3,0.901830309
3824,18,20638,3,7,8,0,0,18,8,5,10,0,0,23,nowin,win,dlbust,bust,20,0,10,182,0.461538462,0.043956044,0.587912088,3,0.892649374
3825,11,20638,9,3,0,6,0,18,8,5,10,0,0,23,nowin,win,dlbust,bust,20,0,12,236,0.457627119,0.016949153,0.588983051,3,0.889015813
3826,128,20638,6,10,0,2,0,18,8,5,10,0,0,23,nowin,win,dlbust,bust,20,0,16,227,0.356828194,0.052863436,0.577092511,0,0.012352564
3827,51,20638,3,11,2,10,0,26,8,5,10,0,0,23,nowin,loss,bust,plbust,0,10,14,189,0.529100529,0.068783069,0.608465608,3,0.993665715
3828,63,20639,8,4,0,10,0,22,7,7,5,0,0,19,nowin,loss,bust,plbust,0,10,12,216,0.467592593,0.037037037,0.62037037,3,0.931690496
3829,89,20639,11,1,6,0,0,18,7,7,5,0,0,19,nowin,loss,beat,dlwin,0,10,12,212,0.537735849,0.047169811,0.594339623,3,0.990167191
3830,101,20639,10,10,0,0,0,20,7,7,5,0,0,19,nowin,win,plwin,beat,20,0,20,205,0.424390244,0.068292683,0.63902439,2,0.614740646
3831,54,20639,2,6,2,4,9,23,7,7,5,0,0,19,nowin,loss,bust,plbust,0,10,8,185,0.437837838,0.032432432,0.556756757,1,0.29899854
3832,142,20639,2,11,3,8,0,24,7,7,5,0,0,19,nowin,loss,bust,plbust,0,10,13,211,0.417061611,0.047393365,0.526066351,1,0.271531309
3833,14,20639,9,7,0,9,0,25,7,7,5,0,0,19,nowin,loss,bust,plbust,0,10,16,202,0.391089109,0.01980198,0.628712871,2,0.577264877
3834,79,20640,8,8,0,0,0,16,4,11,6,0,0,21,nowin,loss,beat,dlwin,0,10,16,211,0.436018957,0.028436019,0.672985782,2,0.650131054
3835,114,20640,1,2,10,0,0,13,4,11,6,0,0,21,nowin,loss,beat,dlwin,0,10,3,198,0.47979798,0.025252525,0.611111111,3,0.937232995
3836,11,20640,8,10,0,0,0,18,4,11,6,0,0,21,nowin,loss,beat,dlwin,0,10,18,236,0.457627119,0.016949153,0.588983051,3,0.889015813
3837,125,20640,10,7,0,0,0,17,4,11,6,0,0,21,nowin,loss,beat,dlwin,0,10,17,219,0.438356164,0.050228311,0.575342466,1,0.308411257
3838,2,20640,11,10,0,0,0,21,4,11,6,0,0,21,win,push,push,push,10,0,21,200,0.445,0.035,0.64,2,0.633962549
3839,79,20640,8,10,0,0,0,18,4,11,6,0,0,21,nowin,loss,beat,dlwin,0,10,18,211,0.436018957,0.028436019,0.672985782,2,0.650131054
3840,94,20641,10,11,0,0,0,21,5,4,10,0,0,19,win,win,plwin,beat,25,0,21,183,0.43715847,0.043715847,0.540983607,1,0.290866892
3841,95,20641,11,7,0,0,0,18,5,4,10,0,0,19,nowin,loss,beat,dlwin,0,10,18,218,0.412844037,0.04587156,0.559633028,0,0.024842385
3842,29,20641,10,8,0,0,0,18,5,4,10,0,0,19,nowin,loss,beat,dlwin,0,10,18,189,0.44973545,0.058201058,0.544973545,1,0.300349439
3843,38,20641,10,5,0,0,0,15,5,4,10,0,0,19,nowin,loss,beat,dlwin,0,10,15,202,0.361386139,0.03960396,0.564356436,0,0.010597953
3844,137,20641,11,10,0,0,0,21,5,4,10,0,0,19,win,win,plwin,beat,25,0,21,194,0.417525773,0.046391753,0.536082474,1,0.276714602
3845,19,20641,11,7,0,0,0,18,5,4,10,0,0,19,nowin,loss,beat,dlwin,0,10,18,237,0.41350211,0.054852321,0.628691983,2,0.597373826
3846,127,20642,2,10,0,9,0,21,10,11,0,0,0,21,nowin,push,push,push,10,0,12,201,0.402985075,0.029850746,0.60199005,0,0.032263937
3847,150,20642,8,11,0,0,0,19,10,11,0,0,0,21,nowin,loss,beat,dlwin,0,10,19,192,0.401041667,0.036458333,0.567708333,0,0.023287458
3848,71,20642,9,10,0,0,0,19,10,11,0,0,0,21,nowin,loss,beat,dlwin,0,10,19,193,0.352331606,0.046632124,0.585492228,0,0.013063661
3849,29,20642,10,5,0,2,0,17,10,11,0,0,0,21,nowin,loss,beat,dlwin,0,10,15,189,0.44973545,0.058201058,0.544973545,1,0.300349439
3850,133,20642,2,10,0,4,6,22,10,11,0,0,0,21,nowin,loss,bust,plbust,0,10,12,201,0.47761194,0.064676617,0.611940299,3,0.935428111
3851,65,20642,9,10,0,0,0,19,10,11,0,0,0,21,nowin,loss,beat,dlwin,0,10,19,203,0.492610837,0.054187192,0.571428571,3,0.913702814
3852,60,20643,5,8,0,6,0,19,10,2,10,0,0,22,nowin,win,dlbust,bust,20,0,13,227,0.418502203,0.022026432,0.559471366,0,0.026496258
3853,79,20643,4,8,0,9,0,21,10,2,10,0,0,22,nowin,win,dlbust,bust,20,0,12,211,0.436018957,0.028436019,0.672985782,2,0.650131054
3854,80,20643,8,5,0,9,0,22,10,2,10,0,0,22,nowin,loss,bust,plbust,0,10,13,186,0.419354839,0.059139785,0.623655914,2,0.59892924
3855,42,20643,10,10,0,0,0,20,10,2,10,0,0,22,nowin,win,dlbust,bust,20,0,20,212,0.443396226,0.051886792,0.570754717,1,0.309181312
3856,149,20643,11,10,0,0,0,21,10,2,10,0,0,22,win,win,dlbust,bust,25,0,21,225,0.457777778,0.057777778,0.648888889,2,0.651965595
3857,33,20643,10,10,0,0,0,20,10,2,10,0,0,22,nowin,win,dlbust,bust,20,0,20,192,0.4375,0.057291667,0.625,2,0.616208916
3858,28,20644,9,3,0,2,0,14,2,9,7,0,0,18,nowin,loss,beat,dlwin,0,10,12,199,0.422110553,0.045226131,0.542713568,1,0.282706618
3859,54,20644,5,9,0,0,0,14,2,9,7,0,0,18,nowin,loss,beat,dlwin,0,10,14,185,0.437837838,0.032432432,0.556756757,1,0.29899854
3860,4,20644,10,7,0,0,0,17,2,9,7,0,0,18,nowin,loss,beat,dlwin,0,10,17,217,0.460829493,0.036866359,0.562211982,1,0.315432839
3861,7,20644,6,3,10,0,0,19,2,9,7,0,0,18,nowin,win,plwin,beat,20,0,9,183,0.442622951,0.06010929,0.62295082,2,0.619303341
3862,30,20644,6,6,0,7,0,19,2,9,7,0,0,18,nowin,win,plwin,beat,20,0,12,206,0.393203883,0.033980583,0.601941748,0,0.029324648
3863,91,20644,2,10,0,10,0,22,2,9,7,0,0,18,nowin,loss,bust,plbust,0,10,12,194,0.417525773,0.046391753,0.515463918,1,0.266616552
3864,49,20645,7,3,4,1,7,22,7,2,11,0,0,20,nowin,loss,bust,plbust,0,10,10,207,0.396135266,0.053140097,0.594202899,0,0.028306925
3865,43,20645,7,10,0,0,0,17,7,2,11,0,0,20,nowin,loss,beat,dlwin,0,10,17,192,0.40625,0.041666667,0.609375,2,0.576671372
3866,49,20645,9,10,0,0,0,19,7,2,11,0,0,20,nowin,loss,beat,dlwin,0,10,19,207,0.396135266,0.053140097,0.594202899,0,0.028306925
3867,150,20645,8,5,0,7,0,20,7,2,11,0,0,20,nowin,push,push,push,10,0,13,192,0.401041667,0.036458333,0.567708333,0,0.023287458
3868,19,20645,6,6,0,2,3,17,7,2,11,0,0,20,nowin,loss,beat,dlwin,0,10,12,237,0.41350211,0.054852321,0.628691983,2,0.597373826
3869,58,20645,10,10,0,0,0,20,7,2,11,0,0,20,nowin,push,push,push,10,0,20,195,0.430769231,0.041025641,0.584615385,2,0.580497586
3870,143,20646,9,10,0,0,0,19,5,10,8,0,0,23,nowin,win,dlbust,bust,20,0,19,203,0.463054187,0.044334975,0.57635468,3,0.883143365
3871,135,20646,10,2,0,0,0,12,5,10,8,0,0,23,nowin,win,dlbust,bust,20,0,12,179,0.391061453,0.067039106,0.586592179,0,0.024924662
3872,65,20646,8,9,0,0,0,17,5,10,8,0,0,23,nowin,win,dlbust,bust,20,0,17,203,0.492610837,0.054187192,0.571428571,3,0.913702814
3873,19,20646,10,8,0,0,0,18,5,10,8,0,0,23,nowin,win,dlbust,bust,20,0,18,237,0.41350211,0.054852321,0.628691983,2,0.597373826
3874,76,20646,7,8,0,0,0,15,5,10,8,0,0,23,nowin,win,dlbust,bust,20,0,15,189,0.534391534,0.079365079,0.608465608,3,1
3875,47,20646,10,8,0,0,0,18,5,10,8,0,0,23,nowin,win,dlbust,bust,20,0,18,210,0.438095238,0.057142857,0.623809524,2,0.615868808
3876,91,20647,10,11,0,0,0,21,7,2,3,10,0,22,win,win,dlbust,bust,25,0,21,194,0.417525773,0.046391753,0.515463918,1,0.266616552
3877,57,20647,7,7,0,4,0,18,7,2,3,10,0,22,nowin,win,dlbust,bust,20,0,14,192,0.46875,0.052083333,0.59375,3,0.907001181
3878,27,20647,3,5,11,0,0,19,7,2,3,10,0,22,nowin,win,dlbust,bust,20,0,8,178,0.370786517,0.016853933,0.573033708,0,0.015536309
3879,90,20647,8,10,0,0,0,18,7,2,3,10,0,22,nowin,win,dlbust,bust,20,0,18,201,0.447761194,0.049751244,0.60199005,3,0.889945023
3880,84,20647,8,5,0,3,2,18,7,2,3,10,0,22,nowin,win,dlbust,bust,20,0,13,195,0.379487179,0.056410256,0.569230769,0,0.017209119
3881,150,20647,7,5,0,10,0,22,7,2,3,10,0,22,nowin,loss,bust,plbust,0,10,12,192,0.401041667,0.036458333,0.567708333,0,0.023287458
3882,50,20648,10,8,0,0,0,18,11,8,0,0,0,19,nowin,loss,beat,dlwin,0,10,18,202,0.405940594,0.04950495,0.54950495,0,0.020296079
3883,55,20648,10,8,0,0,0,18,11,8,0,0,0,19,nowin,loss,beat,dlwin,0,10,18,191,0.371727749,0.057591623,0.54973822,0,0.01011347
3884,41,20648,9,10,0,0,0,19,11,8,0,0,0,19,nowin,push,push,push,10,0,19,192,0.364583333,0.036458333,0.520833333,0,0.00089702
3885,73,20648,11,3,1,4,0,19,11,8,0,0,0,19,nowin,push,push,push,10,0,14,181,0.375690608,0.011049724,0.596685083,0,0.022795773
3886,76,20648,5,10,0,4,0,19,11,8,0,0,0,19,nowin,push,push,push,10,0,15,189,0.534391534,0.079365079,0.608465608,3,1
3887,31,20648,5,7,0,10,0,22,11,8,0,0,0,19,nowin,loss,bust,plbust,0,10,12,188,0.473404255,0.058510638,0.515957447,1,0.300306557
3888,14,20649,4,10,0,6,0,20,10,10,0,0,0,20,nowin,push,push,push,10,0,14,202,0.391089109,0.01980198,0.628712871,2,0.577264877
3889,109,20649,5,9,0,6,0,20,10,10,0,0,0,20,nowin,push,push,push,10,0,14,221,0.461538462,0.058823529,0.597285068,3,0.901830309
3890,89,20649,3,8,7,0,0,18,10,10,0,0,0,20,nowin,loss,beat,dlwin,0,10,11,212,0.537735849,0.047169811,0.594339623,3,0.990167191
3891,20,20649,10,9,0,0,0,19,10,10,0,0,0,20,nowin,loss,beat,dlwin,0,10,19,186,0.456989247,0.037634409,0.537634409,1,0.301097108
3892,133,20649,10,7,0,0,0,17,10,10,0,0,0,20,nowin,loss,beat,dlwin,0,10,17,201,0.47761194,0.064676617,0.611940299,3,0.935428111
3893,72,20649,8,10,0,0,0,18,10,10,0,0,0,20,nowin,loss,beat,dlwin,0,10,18,185,0.394594595,0.032432432,0.508108108,0,0.006763115
3894,25,20650,10,8,0,0,0,18,3,2,9,2,7,23,nowin,win,dlbust,bust,20,0,18,190,0.463157895,0.063157895,0.536842105,1,0.304401563
3895,112,20650,9,10,0,0,0,19,3,2,9,2,7,23,nowin,win,dlbust,bust,20,0,19,203,0.448275862,0.054187192,0.600985222,3,0.889576933
3896,18,20650,4,10,0,0,0,14,3,2,9,2,7,23,nowin,win,dlbust,bust,20,0,14,182,0.461538462,0.043956044,0.587912088,3,0.892649374
3897,56,20650,2,6,10,0,0,18,3,2,9,2,7,23,nowin,win,dlbust,bust,20,0,8,175,0.4,0.057142857,0.582857143,0,0.026685297
3898,130,20650,3,6,3,6,0,18,3,2,9,2,7,23,nowin,win,dlbust,bust,20,0,9,219,0.410958904,0.03652968,0.566210046,0,0.025888739
3899,28,20650,6,5,10,0,0,21,3,2,9,2,7,23,nowin,win,dlbust,bust,20,0,11,199,0.422110553,0.045226131,0.542713568,1,0.282706618
3900,87,20651,9,6,0,10,0,25,10,6,2,0,0,18,nowin,loss,bust,plbust,0,10,15,202,0.405940594,0.054455446,0.628712871,2,0.590599801
3901,25,20651,7,4,4,6,0,21,10,6,2,0,0,18,nowin,win,plwin,beat,20,0,11,190,0.463157895,0.063157895,0.536842105,1,0.304401563
3902,51,20651,2,4,4,7,0,17,10,6,2,0,0,18,nowin,loss,beat,dlwin,0,10,6,189,0.529100529,0.068783069,0.608465608,3,0.993665715
3903,66,20651,2,3,5,8,0,18,10,6,2,0,0,18,nowin,push,push,push,10,0,5,217,0.456221198,0.064516129,0.626728111,3,0.924304367
3904,32,20651,2,10,0,2,4,18,10,6,2,0,0,18,nowin,push,push,push,10,0,12,189,0.391534392,0.037037037,0.53968254,0,0.013579086
3905,79,20651,1,1,10,2,9,23,10,6,2,0,0,18,nowin,loss,bust,plbust,0,10,2,211,0.436018957,0.028436019,0.672985782,2,0.650131054
3906,105,20652,10,6,0,10,0,26,10,4,7,0,0,21,nowin,loss,bust,plbust,0,10,16,198,0.414141414,0.070707071,0.590909091,0,0.032889494
3907,44,20652,11,10,0,0,0,21,10,4,7,0,0,21,win,push,push,push,10,0,21,219,0.433789954,0.050228311,0.534246575,1,0.285551035
3908,33,20652,5,10,0,10,0,25,10,4,7,0,0,21,nowin,loss,bust,plbust,0,10,15,192,0.4375,0.057291667,0.625,2,0.616208916
3909,145,20652,6,4,3,10,0,23,10,4,7,0,0,21,nowin,loss,bust,plbust,0,10,10,188,0.441489362,0.031914894,0.622340426,2,0.617837093
3910,93,20652,2,11,2,4,0,19,10,4,7,0,0,21,nowin,loss,beat,dlwin,0,10,13,175,0.485714286,0.051428571,0.548571429,1,0.323648091
3911,3,20652,5,7,0,5,0,17,10,4,7,0,0,21,nowin,loss,beat,dlwin,0,10,12,190,0.431578947,0.026315789,0.542105263,1,0.288076384
3912,122,20653,2,10,0,6,0,18,10,9,0,0,0,19,nowin,loss,beat,dlwin,0,10,12,210,0.347619048,0.052380952,0.59047619,0,0.012873677
3913,95,20653,5,2,8,10,0,25,10,9,0,0,0,19,nowin,loss,bust,plbust,0,10,7,218,0.412844037,0.04587156,0.559633028,0,0.024842385
3914,10,20653,5,10,0,9,0,24,10,9,0,0,0,19,nowin,loss,bust,plbust,0,10,15,191,0.413612565,0.057591623,0.596858639,2,0.574087175
3915,86,20653,7,5,0,8,0,20,10,9,0,0,0,19,nowin,win,plwin,beat,20,0,12,196,0.454081633,0.040816327,0.591836735,3,0.887566443
3916,33,20653,7,10,0,0,0,17,10,9,0,0,0,19,nowin,loss,beat,dlwin,0,10,17,192,0.4375,0.057291667,0.625,2,0.616208916
3917,115,20653,4,7,10,0,0,21,10,9,0,0,0,19,nowin,win,plwin,beat,20,0,11,194,0.427835052,0.041237113,0.592783505,2,0.583863602
3918,95,20654,6,1,10,0,0,17,10,10,0,0,0,20,nowin,loss,beat,dlwin,0,10,7,218,0.412844037,0.04587156,0.559633028,0,0.024842385
3919,135,20654,4,5,8,0,0,17,10,10,0,0,0,20,nowin,loss,beat,dlwin,0,10,9,179,0.391061453,0.067039106,0.586592179,0,0.024924662
3920,14,20654,11,7,0,0,0,18,10,10,0,0,0,20,nowin,loss,beat,dlwin,0,10,18,202,0.391089109,0.01980198,0.628712871,2,0.577264877
3921,53,20654,9,10,0,0,0,19,10,10,0,0,0,20,nowin,loss,beat,dlwin,0,10,19,250,0.372,0.064,0.564,0,0.013687345
3922,48,20654,6,2,10,0,0,18,10,10,0,0,0,20,nowin,loss,beat,dlwin,0,10,8,203,0.413793103,0.019704433,0.600985222,2,0.577280801
3923,79,20654,10,5,0,1,10,26,10,10,0,0,0,20,nowin,loss,bust,plbust,0,10,15,211,0.436018957,0.028436019,0.672985782,2,0.650131054
3924,19,20655,10,9,0,0,0,19,2,10,3,3,0,18,nowin,win,plwin,beat,20,0,19,237,0.41350211,0.054852321,0.628691983,2,0.597373826
3925,66,20655,10,9,0,0,0,19,2,10,3,3,0,18,nowin,win,plwin,beat,20,0,19,217,0.456221198,0.064516129,0.626728111,3,0.924304367
3926,28,20655,10,8,0,0,0,18,2,10,3,3,0,18,nowin,push,push,push,10,0,18,199,0.422110553,0.045226131,0.542713568,1,0.282706618
3927,144,20655,10,6,0,0,0,16,2,10,3,3,0,18,nowin,loss,beat,dlwin,0,10,16,202,0.386138614,0.054455446,0.564356436,0,0.018006244
3928,88,20655,11,10,0,0,0,21,2,10,3,3,0,18,win,win,plwin,beat,25,0,21,206,0.466019417,0.033980583,0.54368932,1,0.309467903
3929,24,20655,7,10,0,0,0,17,2,10,3,3,0,18,nowin,loss,beat,dlwin,0,10,17,207,0.458937198,0.048309179,0.570048309,1,0.318138014
3930,138,20656,10,10,0,0,0,20,9,3,10,0,0,22,nowin,win,dlbust,bust,20,0,20,190,0.442105263,0.047368421,0.610526316,2,0.609711065
3931,34,20656,10,5,0,1,5,21,9,3,10,0,0,22,nowin,win,dlbust,bust,20,0,15,202,0.5,0.079207921,0.618811881,3,0.968961434
3932,114,20656,10,5,0,2,0,17,9,3,10,0,0,22,nowin,win,dlbust,bust,20,0,15,198,0.47979798,0.025252525,0.611111111,3,0.937232995
3933,117,20656,6,9,0,10,0,25,9,3,10,0,0,22,nowin,loss,bust,plbust,0,10,15,173,0.410404624,0.069364162,0.606936416,2,0.578610282
3934,76,20656,8,11,0,0,0,19,9,3,10,0,0,22,nowin,win,dlbust,bust,20,0,19,189,0.534391534,0.079365079,0.608465608,3,1
3935,28,20656,10,11,0,0,0,21,9,3,10,0,0,22,win,win,dlbust,bust,25,0,21,199,0.422110553,0.045226131,0.542713568,1,0.282706618
3936,118,20657,5,2,10,0,0,17,3,5,11,0,0,19,nowin,loss,beat,dlwin,0,10,7,216,0.393518519,0.037037037,0.555555556,0,0.018059873
3937,95,20657,8,9,0,0,0,17,3,5,11,0,0,19,nowin,loss,beat,dlwin,0,10,17,218,0.412844037,0.04587156,0.559633028,0,0.024842385
3938,63,20657,8,8,0,0,0,16,3,5,11,0,0,19,nowin,loss,beat,dlwin,0,10,16,216,0.467592593,0.037037037,0.62037037,3,0.931690496
3939,123,20657,7,10,0,0,0,17,3,5,11,0,0,19,nowin,loss,beat,dlwin,0,10,17,205,0.43902439,0.034146341,0.614634146,2,0.609962544
3940,99,20657,9,10,0,0,0,19,3,5,11,0,0,19,nowin,push,push,push,10,0,19,207,0.47826087,0.062801932,0.637681159,3,0.961418446
3941,7,20657,1,6,10,0,0,17,3,5,11,0,0,19,nowin,loss,beat,dlwin,0,10,7,183,0.442622951,0.06010929,0.62295082,2,0.619303341
3942,104,20658,10,3,0,0,0,13,3,9,10,0,0,22,nowin,win,dlbust,bust,20,0,13,209,0.363636364,0.052631579,0.593301435,0,0.018359419
3943,88,20658,10,6,0,0,0,16,3,9,10,0,0,22,nowin,win,dlbust,bust,20,0,16,206,0.466019417,0.033980583,0.54368932,1,0.309467903
3944,20,20658,2,10,0,8,0,20,3,9,10,0,0,22,nowin,win,dlbust,bust,20,0,12,186,0.456989247,0.037634409,0.537634409,1,0.301097108
3945,39,20658,10,3,0,0,0,13,3,9,10,0,0,22,nowin,win,dlbust,bust,20,0,13,191,0.429319372,0.062827225,0.57591623,0,0.033760763
3946,77,20658,6,4,9,0,0,19,3,9,10,0,0,22,nowin,win,dlbust,bust,20,0,10,200,0.455,0.04,0.62,3,0.916252116
3947,49,20658,2,7,9,0,0,18,3,9,10,0,0,22,nowin,win,dlbust,bust,20,0,9,207,0.396135266,0.053140097,0.594202899,0,0.028306925
3948,71,20659,10,10,0,0,0,20,3,8,10,0,0,21,nowin,loss,beat,dlwin,0,10,20,193,0.352331606,0.046632124,0.585492228,0,0.013063661
3949,54,20659,3,10,0,0,0,13,3,8,10,0,0,21,nowin,loss,beat,dlwin,0,10,13,185,0.437837838,0.032432432,0.556756757,1,0.29899854
3950,16,20659,8,8,0,0,0,16,3,8,10,0,0,21,nowin,loss,beat,dlwin,0,10,16,220,0.427272727,0.081818182,0.6,2,0.588660176
3951,10,20659,10,8,0,0,0,18,3,8,10,0,0,21,nowin,loss,beat,dlwin,0,10,18,191,0.413612565,0.057591623,0.596858639,2,0.574087175
3952,82,20659,5,7,0,5,0,17,3,8,10,0,0,21,nowin,loss,beat,dlwin,0,10,12,225,0.408888889,0.075555556,0.577777778,0,0.028101874
3953,113,20659,10,10,0,0,0,20,3,8,10,0,0,21,nowin,loss,beat,dlwin,0,10,20,199,0.407035176,0.055276382,0.668341709,2,0.620695264
3954,39,20660,10,11,0,0,0,21,11,9,0,0,0,20,win,win,plwin,beat,25,0,21,191,0.429319372,0.062827225,0.57591623,0,0.033760763
3955,84,20660,1,3,9,1,10,24,11,9,0,0,0,20,nowin,loss,bust,plbust,0,10,4,195,0.379487179,0.056410256,0.569230769,0,0.017209119
3956,96,20660,10,10,0,0,0,20,11,9,0,0,0,20,nowin,push,push,push,10,0,20,190,0.468421053,0.057894737,0.584210526,3,0.897263354
3957,55,20660,9,10,0,0,0,19,11,9,0,0,0,20,nowin,loss,beat,dlwin,0,10,19,191,0.371727749,0.057591623,0.54973822,0,0.01011347
3958,135,20660,7,6,0,6,0,19,11,9,0,0,0,20,nowin,loss,beat,dlwin,0,10,13,179,0.391061453,0.067039106,0.586592179,0,0.024924662
3959,33,20660,2,8,10,0,0,20,11,9,0,0,0,20,nowin,push,push,push,10,0,10,192,0.4375,0.057291667,0.625,2,0.616208916
3960,147,20661,2,5,10,0,0,17,4,10,1,5,0,20,nowin,loss,beat,dlwin,0,10,7,205,0.380487805,0.014634146,0.536585366,0,0.00951447
3961,18,20661,7,8,0,0,0,15,4,10,1,5,0,20,nowin,loss,beat,dlwin,0,10,15,182,0.461538462,0.043956044,0.587912088,3,0.892649374
3962,113,20661,6,4,10,0,0,20,4,10,1,5,0,20,nowin,push,push,push,10,0,10,199,0.407035176,0.055276382,0.668341709,2,0.620695264
3963,80,20661,1,6,8,0,0,15,4,10,1,5,0,20,nowin,loss,beat,dlwin,0,10,7,186,0.419354839,0.059139785,0.623655914,2,0.59892924
3964,127,20661,5,10,0,0,0,15,4,10,1,5,0,20,nowin,loss,beat,dlwin,0,10,15,201,0.402985075,0.029850746,0.60199005,0,0.032263937
3965,98,20661,10,6,0,0,0,16,4,10,1,5,0,20,nowin,loss,beat,dlwin,0,10,16,220,0.422727273,0.054545455,0.55,1,0.28664435
3966,102,20662,10,9,0,0,0,19,8,10,0,0,0,18,nowin,win,plwin,beat,20,0,19,192,0.338541667,0.046875,0.5625,0,0.003306118
3967,150,20662,8,10,0,0,0,18,8,10,0,0,0,18,nowin,push,push,push,10,0,18,192,0.401041667,0.036458333,0.567708333,0,0.023287458
3968,6,20662,9,10,0,0,0,19,8,10,0,0,0,18,nowin,win,plwin,beat,20,0,19,191,0.439790576,0.047120419,0.581151832,1,0.31211505
3969,39,20662,3,8,2,10,0,23,8,10,0,0,0,18,nowin,loss,bust,plbust,0,10,11,191,0.429319372,0.062827225,0.57591623,0,0.033760763
3970,100,20662,2,7,11,0,0,20,8,10,0,0,0,18,nowin,win,plwin,beat,20,0,9,190,0.452631579,0.036842105,0.594736842,3,0.888671154
3971,96,20662,10,10,0,0,0,20,8,10,0,0,0,18,nowin,win,plwin,beat,20,0,20,190,0.468421053,0.057894737,0.584210526,3,0.897263354
3972,130,20663,6,9,0,0,0,15,6,10,3,0,0,19,nowin,loss,beat,dlwin,0,10,15,219,0.410958904,0.03652968,0.566210046,0,0.025888739
3973,67,20663,11,10,0,0,0,21,6,10,3,0,0,19,win,win,plwin,beat,25,0,21,195,0.369230769,0.041025641,0.569230769,0,0.014139427
3974,99,20663,2,9,6,0,0,17,6,10,3,0,0,19,nowin,loss,beat,dlwin,0,10,11,207,0.47826087,0.062801932,0.637681159,3,0.961418446
3975,90,20663,1,6,10,0,0,17,6,10,3,0,0,19,nowin,loss,beat,dlwin,0,10,7,201,0.447761194,0.049751244,0.60199005,3,0.889945023
3976,117,20663,2,2,8,0,0,12,6,10,3,0,0,19,nowin,loss,beat,dlwin,0,10,4,173,0.410404624,0.069364162,0.606936416,2,0.578610282
3977,104,20663,4,3,9,0,0,16,6,10,3,0,0,19,nowin,loss,beat,dlwin,0,10,7,209,0.363636364,0.052631579,0.593301435,0,0.018359419
3978,112,20664,10,2,0,2,4,18,10,5,8,0,0,23,nowin,win,dlbust,bust,20,0,12,203,0.448275862,0.054187192,0.600985222,3,0.889576933
3979,45,20664,9,9,0,0,0,18,10,5,8,0,0,23,nowin,win,dlbust,bust,20,0,18,196,0.428571429,0.051020408,0.612244898,2,0.598821767
3980,55,20664,10,2,0,6,0,18,10,5,8,0,0,23,nowin,win,dlbust,bust,20,0,12,191,0.371727749,0.057591623,0.54973822,0,0.01011347
3981,15,20664,10,10,0,0,0,20,10,5,8,0,0,23,nowin,win,dlbust,bust,20,0,20,212,0.410377358,0.051886792,0.561320755,0,0.024517408
3982,113,20664,4,10,0,10,0,24,10,5,8,0,0,23,nowin,loss,bust,plbust,0,10,14,199,0.407035176,0.055276382,0.668341709,2,0.620695264
3983,80,20664,10,9,0,0,0,19,10,5,8,0,0,23,nowin,win,dlbust,bust,20,0,19,186,0.419354839,0.059139785,0.623655914,2,0.59892924
3984,58,20665,7,2,4,0,0,13,4,10,10,0,0,24,nowin,win,dlbust,bust,20,0,9,195,0.430769231,0.041025641,0.584615385,2,0.580497586
3985,62,20665,4,1,7,0,0,12,4,10,10,0,0,24,nowin,win,dlbust,bust,20,0,5,178,0.370786517,0.028089888,0.54494382,0,0.008657722
3986,94,20665,10,5,0,0,0,15,4,10,10,0,0,24,nowin,win,dlbust,bust,20,0,15,183,0.43715847,0.043715847,0.540983607,1,0.290866892
3987,5,20665,8,11,0,0,0,19,4,10,10,0,0,24,nowin,win,dlbust,bust,20,0,19,203,0.42364532,0.02955665,0.596059113,2,0.582508076
3988,36,20665,10,10,0,0,0,20,4,10,10,0,0,24,nowin,win,dlbust,bust,20,0,20,229,0.445414847,0.056768559,0.655021834,2,0.645370571
3989,119,20665,8,7,0,0,0,15,4,10,10,0,0,24,nowin,win,dlbust,bust,20,0,15,190,0.405263158,0.068421053,0.515789474,0,0.011837158
3990,74,20666,4,4,3,3,4,18,10,10,0,0,0,20,nowin,loss,beat,dlwin,0,10,8,209,0.411483254,0.04784689,0.531100478,0,0.017448125
3991,1,20666,6,9,0,2,0,17,10,10,0,0,0,20,nowin,loss,beat,dlwin,0,10,15,197,0.406091371,0.025380711,0.649746193,2,0.606186955
3992,19,20666,10,10,0,0,0,20,10,10,0,0,0,20,nowin,push,push,push,10,0,20,237,0.41350211,0.054852321,0.628691983,2,0.597373826
3993,22,20666,4,6,11,0,0,21,10,10,0,0,0,20,nowin,win,plwin,beat,20,0,10,187,0.481283422,0.042780749,0.577540107,3,0.906128176
3994,78,20666,10,6,0,10,0,26,10,10,0,0,0,20,nowin,loss,bust,plbust,0,10,16,201,0.517412935,0.034825871,0.587064677,3,0.95871112
3995,130,20666,7,10,0,0,0,17,10,10,0,0,0,20,nowin,loss,beat,dlwin,0,10,17,219,0.410958904,0.03652968,0.566210046,0,0.025888739
3996,110,20667,7,4,2,0,0,13,4,10,9,0,0,23,nowin,win,dlbust,bust,20,0,11,192,0.416666667,0.046875,0.557291667,0,0.025413132
3997,71,20667,4,10,0,0,0,14,4,10,9,0,0,23,nowin,win,dlbust,bust,20,0,14,193,0.352331606,0.046632124,0.585492228,0,0.013063661
3998,1,20667,10,2,0,0,0,12,4,10,9,0,0,23,nowin,win,dlbust,bust,20,0,12,197,0.406091371,0.025380711,0.649746193,2,0.606186955
3999,122,20667,2,10,0,0,0,12,4,10,9,0,0,23,nowin,win,dlbust,bust,20,0,12,210,0.347619048,0.052380952,0.59047619,0,0.012873677
4000,85,20667,2,6,5,0,0,13,4,10,9,0,0,23,nowin,win,dlbust,bust,20,0,8,195,0.41025641,0.066666667,0.594871795,0,0.03269711
4001,11,20667,10,8,0,0,0,18,4,10,9,0,0,23,nowin,win,dlbust,bust,20,0,18,236,0.457627119,0.016949153,0.588983051,3,0.889015813
4002,84,20668,5,10,0,7,0,22,8,10,0,0,0,18,nowin,loss,bust,plbust,0,10,15,195,0.379487179,0.056410256,0.569230769,0,0.017209119
4003,71,20668,10,3,0,8,0,21,8,10,0,0,0,18,nowin,win,plwin,beat,20,0,13,193,0.352331606,0.046632124,0.585492228,0,0.013063661
4004,139,20668,10,9,0,0,0,19,8,10,0,0,0,18,nowin,win,plwin,beat,20,0,19,192,0.380208333,0.036458333,0.59375,0,0.023429169
4005,90,20668,4,7,8,0,0,19,8,10,0,0,0,18,nowin,win,plwin,beat,20,0,11,201,0.447761194,0.049751244,0.60199005,3,0.889945023
4006,99,20668,10,9,0,0,0,19,8,10,0,0,0,18,nowin,win,plwin,beat,20,0,19,207,0.47826087,0.062801932,0.637681159,3,0.961418446
4007,20,20668,4,4,10,0,0,18,8,10,0,0,0,18,nowin,push,push,push,10,0,8,186,0.456989247,0.037634409,0.537634409,1,0.301097108
4008,136,20669,8,7,0,0,0,15,2,3,9,10,0,24,nowin,win,dlbust,bust,20,0,15,194,0.396907216,0.025773196,0.597938144,0,0.029452644
4009,12,20669,10,10,0,0,0,20,2,3,9,10,0,24,nowin,win,dlbust,bust,20,0,20,189,0.470899471,0.015873016,0.613756614,3,0.929171178
4010,61,20669,2,6,6,0,0,14,2,3,9,10,0,24,nowin,win,dlbust,bust,20,0,8,194,0.427835052,0.077319588,0.603092784,2,0.591437139
4011,25,20669,4,9,0,0,0,13,2,3,9,10,0,24,nowin,win,dlbust,bust,20,0,13,190,0.463157895,0.063157895,0.536842105,1,0.304401563
4012,67,20669,10,10,0,0,0,20,2,3,9,10,0,24,nowin,win,dlbust,bust,20,0,20,195,0.369230769,0.041025641,0.569230769,0,0.014139427
4013,16,20669,9,2,6,0,0,17,2,3,9,10,0,24,nowin,win,dlbust,bust,20,0,11,220,0.427272727,0.081818182,0.6,2,0.588660176
4014,91,20670,10,2,0,0,0,12,6,10,10,0,0,26,nowin,win,dlbust,bust,20,0,12,194,0.417525773,0.046391753,0.515463918,1,0.266616552
4015,3,20670,6,7,0,0,0,13,6,10,10,0,0,26,nowin,win,dlbust,bust,20,0,13,190,0.431578947,0.026315789,0.542105263,1,0.288076384
4016,2,20670,3,10,0,0,0,13,6,10,10,0,0,26,nowin,win,dlbust,bust,20,0,13,200,0.445,0.035,0.64,2,0.633962549
4017,94,20670,5,10,0,0,0,15,6,10,10,0,0,26,nowin,win,dlbust,bust,20,0,15,183,0.43715847,0.043715847,0.540983607,1,0.290866892
4018,83,20670,6,10,0,0,0,16,6,10,10,0,0,26,nowin,win,dlbust,bust,20,0,16,193,0.424870466,0.051813472,0.678756477,2,0.644360335
4019,124,20670,4,8,0,0,0,12,6,10,10,0,0,26,nowin,win,dlbust,bust,20,0,12,202,0.47029703,0.064356436,0.584158416,3,0.899458193
4020,95,20671,10,10,0,0,0,20,10,11,0,0,0,21,nowin,loss,beat,dlwin,0,10,20,218,0.412844037,0.04587156,0.559633028,0,0.024842385
4021,104,20671,10,10,0,0,0,20,10,11,0,0,0,21,nowin,loss,beat,dlwin,0,10,20,209,0.363636364,0.052631579,0.593301435,0,0.018359419
4022,1,20671,6,10,0,2,0,18,10,11,0,0,0,21,nowin,loss,beat,dlwin,0,10,16,197,0.406091371,0.025380711,0.649746193,2,0.606186955
4023,11,20671,10,9,0,0,0,19,10,11,0,0,0,21,nowin,loss,beat,dlwin,0,10,19,236,0.457627119,0.016949153,0.588983051,3,0.889015813
4024,30,20671,7,5,0,6,0,18,10,11,0,0,0,21,nowin,loss,beat,dlwin,0,10,12,206,0.393203883,0.033980583,0.601941748,0,0.029324648
4025,99,20671,10,10,0,0,0,20,10,11,0,0,0,21,nowin,loss,beat,dlwin,0,10,20,207,0.47826087,0.062801932,0.637681159,3,0.961418446
4026,32,20672,2,10,0,1,0,13,2,10,10,0,0,22,nowin,win,dlbust,bust,20,0,12,189,0.391534392,0.037037037,0.53968254,0,0.013579086
4027,59,20672,7,4,9,0,0,20,2,10,10,0,0,22,nowin,win,dlbust,bust,20,0,11,228,0.429824561,0.048245614,0.543859649,1,0.287885446
4028,43,20672,8,7,0,0,0,15,2,10,10,0,0,22,nowin,win,dlbust,bust,20,0,15,192,0.40625,0.041666667,0.609375,2,0.576671372
4029,71,20672,5,10,0,0,0,15,2,10,10,0,0,22,nowin,win,dlbust,bust,20,0,15,193,0.352331606,0.046632124,0.585492228,0,0.013063661
4030,98,20672,2,2,10,0,0,14,2,10,10,0,0,22,nowin,win,dlbust,bust,20,0,4,220,0.422727273,0.054545455,0.55,1,0.28664435
4031,62,20672,7,9,0,0,0,16,2,10,10,0,0,22,nowin,win,dlbust,bust,20,0,16,178,0.370786517,0.028089888,0.54494382,0,0.008657722
4032,33,20673,10,2,0,10,0,22,3,10,3,5,0,21,nowin,loss,bust,plbust,0,10,12,192,0.4375,0.057291667,0.625,2,0.616208916
4033,40,20673,10,11,0,0,0,21,3,10,3,5,0,21,win,push,push,push,10,0,21,196,0.367346939,0.030612245,0.617346939,0,0.025358183
4034,11,20673,9,6,0,0,0,15,3,10,3,5,0,21,nowin,loss,beat,dlwin,0,10,15,236,0.457627119,0.016949153,0.588983051,3,0.889015813
4035,68,20673,2,5,7,0,0,14,3,10,3,5,0,21,nowin,loss,beat,dlwin,0,10,7,205,0.434146341,0.029268293,0.6,2,0.59483189
4036,97,20673,10,7,0,0,0,17,3,10,3,5,0,21,nowin,loss,beat,dlwin,0,10,17,182,0.450549451,0.06043956,0.692307692,2,0.677372279
4037,66,20673,10,2,0,10,0,22,3,10,3,5,0,21,nowin,loss,bust,plbust,0,10,12,217,0.456221198,0.064516129,0.626728111,3,0.924304367
4038,23,20674,3,10,0,0,0,13,6,10,6,0,0,22,nowin,win,dlbust,bust,20,0,13,208,0.427884615,0.0625,0.552884615,1,0.29114424
4039,87,20674,3,5,10,0,0,18,6,10,6,0,0,22,nowin,win,dlbust,bust,20,0,8,202,0.405940594,0.054455446,0.628712871,2,0.590599801
4040,4,20674,6,7,0,0,0,13,6,10,6,0,0,22,nowin,win,dlbust,bust,20,0,13,217,0.460829493,0.036866359,0.562211982,1,0.315432839
4041,37,20674,6,10,0,0,0,16,6,10,6,0,0,22,nowin,win,dlbust,bust,20,0,16,208,0.394230769,0.038461538,0.581730769,0,0.024682772
4042,124,20674,8,3,7,0,0,18,6,10,6,0,0,22,nowin,win,dlbust,bust,20,0,11,202,0.47029703,0.064356436,0.584158416,3,0.899458193
4043,138,20674,4,8,0,0,0,12,6,10,6,0,0,22,nowin,win,dlbust,bust,20,0,12,190,0.442105263,0.047368421,0.610526316,2,0.609711065
4044,82,20675,10,11,0,0,0,21,6,7,10,0,0,23,win,win,dlbust,bust,25,0,21,225,0.408888889,0.075555556,0.577777778,0,0.028101874
4045,9,20675,4,10,0,0,0,14,6,7,10,0,0,23,nowin,win,dlbust,bust,20,0,14,194,0.37628866,0.015463918,0.541237113,0,0.009396796
4046,101,20675,10,11,0,0,0,21,6,7,10,0,0,23,win,win,dlbust,bust,25,0,21,205,0.424390244,0.068292683,0.63902439,2,0.614740646
4047,103,20675,4,6,4,0,0,14,6,7,10,0,0,23,nowin,win,dlbust,bust,20,0,10,203,0.379310345,0.064039409,0.551724138,0,0.012869209
4048,57,20675,3,10,0,0,0,13,6,7,10,0,0,23,nowin,win,dlbust,bust,20,0,13,192,0.46875,0.052083333,0.59375,3,0.907001181
4049,111,20675,7,2,11,0,0,20,6,7,10,0,0,23,nowin,win,dlbust,bust,20,0,9,180,0.433333333,0.055555556,0.611111111,2,0.602264492
4050,110,20676,11,4,2,0,0,17,7,2,8,0,0,17,nowin,push,push,push,10,0,15,192,0.416666667,0.046875,0.557291667,0,0.025413132
4051,49,20676,10,4,0,10,0,24,7,2,8,0,0,17,nowin,loss,bust,plbust,0,10,14,207,0.396135266,0.053140097,0.594202899,0,0.028306925
4052,74,20676,4,2,2,10,0,18,7,2,8,0,0,17,nowin,win,plwin,beat,20,0,6,209,0.411483254,0.04784689,0.531100478,0,0.017448125
4053,27,20676,3,10,0,10,0,23,7,2,8,0,0,17,nowin,loss,bust,plbust,0,10,13,178,0.370786517,0.016853933,0.573033708,0,0.015536309
4054,113,20676,6,3,11,0,0,20,7,2,8,0,0,17,nowin,win,plwin,beat,20,0,9,199,0.407035176,0.055276382,0.668341709,2,0.620695264
4055,41,20676,6,8,0,10,0,24,7,2,8,0,0,17,nowin,loss,bust,plbust,0,10,14,192,0.364583333,0.036458333,0.520833333,0,0.00089702
4056,4,20677,2,10,0,1,2,15,10,11,0,0,0,21,nowin,loss,beat,dlwin,0,10,12,217,0.460829493,0.036866359,0.562211982,1,0.315432839
4057,84,20677,10,10,0,0,0,20,10,11,0,0,0,21,nowin,loss,beat,dlwin,0,10,20,195,0.379487179,0.056410256,0.569230769,0,0.017209119
4058,27,20677,6,10,0,7,0,23,10,11,0,0,0,21,nowin,loss,bust,plbust,0,10,16,178,0.370786517,0.016853933,0.573033708,0,0.015536309
4059,107,20677,10,2,0,10,0,22,10,11,0,0,0,21,nowin,loss,bust,plbust,0,10,12,218,0.444954128,0.073394495,0.600917431,2,0.605210014
4060,57,20677,10,5,0,9,0,24,10,11,0,0,0,21,nowin,loss,bust,plbust,0,10,15,192,0.46875,0.052083333,0.59375,3,0.907001181
4061,139,20677,10,7,0,0,0,17,10,11,0,0,0,21,nowin,loss,beat,dlwin,0,10,17,192,0.380208333,0.036458333,0.59375,0,0.023429169
4062,98,20678,10,8,0,0,0,18,10,10,0,0,0,20,nowin,loss,beat,dlwin,0,10,18,220,0.422727273,0.054545455,0.55,1,0.28664435
4063,53,20678,7,10,0,0,0,17,10,10,0,0,0,20,nowin,loss,beat,dlwin,0,10,17,250,0.372,0.064,0.564,0,0.013687345
4064,37,20678,2,9,10,0,0,21,10,10,0,0,0,20,nowin,win,plwin,beat,20,0,11,208,0.394230769,0.038461538,0.581730769,0,0.024682772
4065,120,20678,7,3,10,0,0,20,10,10,0,0,0,20,nowin,push,push,push,10,0,10,202,0.440594059,0.034653465,0.618811881,2,0.614441029
4066,116,20678,10,10,0,0,0,20,10,10,0,0,0,20,nowin,push,push,push,10,0,20,195,0.425641026,0.056410256,0.538461538,1,0.28273747
4067,80,20678,8,10,0,0,0,18,10,10,0,0,0,20,nowin,loss,beat,dlwin,0,10,18,186,0.419354839,0.059139785,0.623655914,2,0.59892924
4068,129,20679,6,2,3,7,0,18,10,7,0,0,0,17,nowin,win,plwin,beat,20,0,8,201,0.422885572,0.064676617,0.55721393,0,0.027255383
4069,48,20679,6,10,0,7,0,23,10,7,0,0,0,17,nowin,loss,bust,plbust,0,10,16,203,0.413793103,0.019704433,0.600985222,2,0.577280801
4070,114,20679,8,10,0,0,0,18,10,7,0,0,0,17,nowin,win,plwin,beat,20,0,18,198,0.47979798,0.025252525,0.611111111,3,0.937232995
4071,121,20679,8,10,0,0,0,18,10,7,0,0,0,17,nowin,win,plwin,beat,20,0,18,195,0.456410256,0.025641026,0.512820513,1,0.288597791
4072,140,20679,10,8,0,0,0,18,10,7,0,0,0,17,nowin,win,plwin,beat,20,0,18,210,0.466666667,0.023809524,0.604761905,3,0.915293335
4073,110,20679,2,10,0,9,0,21,10,7,0,0,0,17,nowin,win,plwin,beat,20,0,12,192,0.416666667,0.046875,0.557291667,0,0.025413132
4074,132,20680,8,5,0,3,6,22,10,7,0,0,0,17,nowin,loss,bust,plbust,0,10,13,194,0.412371134,0.036082474,0.649484536,2,0.611633238
4075,82,20680,4,9,0,10,0,23,10,7,0,0,0,17,nowin,loss,bust,plbust,0,10,13,225,0.408888889,0.075555556,0.577777778,0,0.028101874
4076,119,20680,7,11,0,0,0,18,10,7,0,0,0,17,nowin,win,plwin,beat,20,0,18,190,0.405263158,0.068421053,0.515789474,0,0.011837158
4077,35,20680,7,2,5,8,0,22,10,7,0,0,0,17,nowin,loss,bust,plbust,0,10,9,202,0.410891089,0.044554455,0.633663366,2,0.598681573
4078,105,20680,11,10,0,0,0,21,10,7,0,0,0,17,win,win,plwin,beat,25,0,21,198,0.414141414,0.070707071,0.590909091,0,0.032889494
4079,77,20680,11,3,1,4,0,19,10,7,0,0,0,17,nowin,win,plwin,beat,20,0,14,200,0.455,0.04,0.62,3,0.916252116
4080,122,20681,4,2,10,7,0,23,10,5,4,0,0,19,nowin,loss,bust,plbust,0,10,6,210,0.347619048,0.052380952,0.59047619,0,0.012873677
4081,72,20681,2,6,10,0,0,18,10,5,4,0,0,19,nowin,loss,beat,dlwin,0,10,8,185,0.394594595,0.032432432,0.508108108,0,0.006763115
4082,77,20681,10,3,0,2,3,18,10,5,4,0,0,19,nowin,loss,beat,dlwin,0,10,13,200,0.455,0.04,0.62,3,0.916252116
4083,26,20681,10,10,0,0,0,20,10,5,4,0,0,19,nowin,win,plwin,beat,20,0,20,203,0.463054187,0.0591133,0.541871921,1,0.306802864
4084,104,20681,8,7,0,10,0,25,10,5,4,0,0,19,nowin,loss,bust,plbust,0,10,15,209,0.363636364,0.052631579,0.593301435,0,0.018359419
4085,89,20681,10,4,0,9,0,23,10,5,4,0,0,19,nowin,loss,bust,plbust,0,10,14,212,0.537735849,0.047169811,0.594339623,3,0.990167191
4086,112,20682,10,10,0,0,0,20,9,10,0,0,0,19,nowin,win,plwin,beat,20,0,20,203,0.448275862,0.054187192,0.600985222,3,0.889576933
4087,77,20682,3,8,10,0,0,21,9,10,0,0,0,19,nowin,win,plwin,beat,20,0,11,200,0.455,0.04,0.62,3,0.916252116
4088,85,20682,6,10,0,7,0,23,9,10,0,0,0,19,nowin,loss,bust,plbust,0,10,16,195,0.41025641,0.066666667,0.594871795,0,0.03269711
4089,106,20682,2,10,0,8,0,20,9,10,0,0,0,19,nowin,win,plwin,beat,20,0,12,192,0.411458333,0.026041667,0.557291667,0,0.023854304
4090,94,20682,10,5,0,2,0,17,9,10,0,0,0,19,nowin,loss,beat,dlwin,0,10,15,183,0.43715847,0.043715847,0.540983607,1,0.290866892
4091,18,20682,9,8,0,0,0,17,9,10,0,0,0,19,nowin,loss,beat,dlwin,0,10,17,182,0.461538462,0.043956044,0.587912088,3,0.892649374
4092,105,20683,9,10,0,0,0,19,9,9,0,0,0,18,nowin,win,plwin,beat,20,0,19,198,0.414141414,0.070707071,0.590909091,0,0.032889494
4093,130,20683,3,5,7,5,0,20,9,9,0,0,0,18,nowin,win,plwin,beat,20,0,8,219,0.410958904,0.03652968,0.566210046,0,0.025888739
4094,44,20683,10,8,0,0,0,18,9,9,0,0,0,18,nowin,push,push,push,10,0,18,219,0.433789954,0.050228311,0.534246575,1,0.285551035
4095,22,20683,2,2,11,2,0,17,9,9,0,0,0,18,nowin,loss,beat,dlwin,0,10,4,187,0.481283422,0.042780749,0.577540107,3,0.906128176
4096,104,20683,10,6,0,10,0,26,9,9,0,0,0,18,nowin,loss,bust,plbust,0,10,16,209,0.363636364,0.052631579,0.593301435,0,0.018359419
4097,100,20683,9,2,5,3,0,19,9,9,0,0,0,18,nowin,win,plwin,beat,20,0,11,190,0.452631579,0.036842105,0.594736842,3,0.888671154
4098,47,20684,10,8,0,0,0,18,8,10,0,0,0,18,nowin,push,push,push,10,0,18,210,0.438095238,0.057142857,0.623809524,2,0.615868808
4099,52,20684,4,6,10,0,0,20,8,10,0,0,0,18,nowin,win,plwin,beat,20,0,10,217,0.414746544,0.02764977,0.599078341,2,0.576736024
4100,75,20684,9,6,0,9,0,24,8,10,0,0,0,18,nowin,loss,bust,plbust,0,10,15,191,0.418848168,0.052356021,0.570680628,0,0.029344702
4101,88,20684,4,8,0,1,10,23,8,10,0,0,0,18,nowin,loss,bust,plbust,0,10,12,206,0.466019417,0.033980583,0.54368932,1,0.309467903
4102,131,20684,10,10,0,0,0,20,8,10,0,0,0,18,nowin,win,plwin,beat,20,0,20,217,0.410138249,0.069124424,0.543778802,0,0.02015021
4103,18,20684,8,10,0,0,0,18,8,10,0,0,0,18,nowin,push,push,push,10,0,18,182,0.461538462,0.043956044,0.587912088,3,0.892649374
4104,106,20685,2,7,10,0,0,19,11,1,1,10,0,23,nowin,win,dlbust,bust,20,0,9,192,0.411458333,0.026041667,0.557291667,0,0.023854304
4105,57,20685,9,10,0,0,0,19,11,1,1,10,0,23,nowin,win,dlbust,bust,20,0,19,192,0.46875,0.052083333,0.59375,3,0.907001181
4106,58,20685,10,2,0,10,0,22,11,1,1,10,0,23,nowin,loss,bust,plbust,0,10,12,195,0.430769231,0.041025641,0.584615385,2,0.580497586
4107,67,20685,2,6,10,0,0,18,11,1,1,10,0,23,nowin,win,dlbust,bust,20,0,8,195,0.369230769,0.041025641,0.569230769,0,0.014139427
4108,77,20685,10,10,0,0,0,20,11,1,1,10,0,23,nowin,win,dlbust,bust,20,0,20,200,0.455,0.04,0.62,3,0.916252116
4109,31,20685,10,10,0,0,0,20,11,1,1,10,0,23,nowin,win,dlbust,bust,20,0,20,188,0.473404255,0.058510638,0.515957447,1,0.300306557
4110,99,20686,11,10,0,0,0,21,11,2,8,0,0,21,win,push,push,push,10,0,21,207,0.47826087,0.062801932,0.637681159,3,0.961418446
4111,38,20686,10,10,0,0,0,20,11,2,8,0,0,21,nowin,loss,beat,dlwin,0,10,20,202,0.361386139,0.03960396,0.564356436,0,0.010597953
4112,98,20686,7,9,0,2,0,18,11,2,8,0,0,21,nowin,loss,beat,dlwin,0,10,16,220,0.422727273,0.054545455,0.55,1,0.28664435
4113,56,20686,6,4,11,0,0,21,11,2,8,0,0,21,nowin,push,push,push,10,0,10,175,0.4,0.057142857,0.582857143,0,0.026685297
4114,44,20686,6,3,10,0,0,19,11,2,8,0,0,21,nowin,loss,beat,dlwin,0,10,9,219,0.433789954,0.050228311,0.534246575,1,0.285551035
4115,34,20686,9,5,0,8,0,22,11,2,8,0,0,21,nowin,loss,bust,plbust,0,10,14,202,0.5,0.079207921,0.618811881,3,0.968961434
4116,26,20687,10,10,0,0,0,20,2,10,10,0,0,22,nowin,win,dlbust,bust,20,0,20,203,0.463054187,0.0591133,0.541871921,1,0.306802864
4117,122,20687,10,10,0,0,0,20,2,10,10,0,0,22,nowin,win,dlbust,bust,20,0,20,210,0.347619048,0.052380952,0.59047619,0,0.012873677
4118,61,20687,11,10,0,0,0,21,2,10,10,0,0,22,win,win,dlbust,bust,25,0,21,194,0.427835052,0.077319588,0.603092784,2,0.591437139
4119,131,20687,4,10,0,0,0,14,2,10,10,0,0,22,nowin,win,dlbust,bust,20,0,14,217,0.410138249,0.069124424,0.543778802,0,0.02015021
4120,90,20687,10,11,0,0,0,21,2,10,10,0,0,22,win,win,dlbust,bust,25,0,21,201,0.447761194,0.049751244,0.60199005,3,0.889945023
4121,31,20687,5,8,0,0,0,13,2,10,10,0,0,22,nowin,win,dlbust,bust,20,0,13,188,0.473404255,0.058510638,0.515957447,1,0.300306557
4122,79,20688,3,3,9,0,0,15,2,5,7,6,0,20,nowin,loss,beat,dlwin,0,10,6,211,0.436018957,0.028436019,0.672985782,2,0.650131054
4123,86,20688,4,10,0,0,0,14,2,5,7,6,0,20,nowin,loss,beat,dlwin,0,10,14,196,0.454081633,0.040816327,0.591836735,3,0.887566443
4124,33,20688,7,10,0,0,0,17,2,5,7,6,0,20,nowin,loss,beat,dlwin,0,10,17,192,0.4375,0.057291667,0.625,2,0.616208916
4125,139,20688,6,5,10,0,0,21,2,5,7,6,0,20,nowin,win,plwin,beat,20,0,11,192,0.380208333,0.036458333,0.59375,0,0.023429169
4126,58,20688,4,4,5,0,0,13,2,5,7,6,0,20,nowin,loss,beat,dlwin,0,10,8,195,0.430769231,0.041025641,0.584615385,2,0.580497586
4127,24,20688,2,1,10,0,0,13,2,5,7,6,0,20,nowin,loss,beat,dlwin,0,10,3,207,0.458937198,0.048309179,0.570048309,1,0.318138014
4128,52,20689,3,4,10,0,0,17,7,11,0,0,0,18,nowin,loss,beat,dlwin,0,10,7,217,0.414746544,0.02764977,0.599078341,2,0.576736024
4129,33,20689,8,7,0,8,0,23,7,11,0,0,0,18,nowin,loss,bust,plbust,0,10,15,192,0.4375,0.057291667,0.625,2,0.616208916
4130,75,20689,10,3,0,9,0,22,7,11,0,0,0,18,nowin,loss,bust,plbust,0,10,13,191,0.418848168,0.052356021,0.570680628,0,0.029344702
4131,148,20689,5,10,0,10,0,25,7,11,0,0,0,18,nowin,loss,bust,plbust,0,10,15,204,0.401960784,0.078431373,0.593137255,0,0.029789521
4132,36,20689,8,11,0,0,0,19,7,11,0,0,0,18,nowin,win,plwin,beat,20,0,19,229,0.445414847,0.056768559,0.655021834,2,0.645370571
4133,72,20689,10,5,0,2,0,17,7,11,0,0,0,18,nowin,loss,beat,dlwin,0,10,15,185,0.394594595,0.032432432,0.508108108,0,0.006763115
4134,127,20690,9,10,0,0,0,19,3,6,2,1,8,20,nowin,loss,beat,dlwin,0,10,19,201,0.402985075,0.029850746,0.60199005,0,0.032263937
4135,116,20690,11,8,0,0,0,19,3,6,2,1,8,20,nowin,loss,beat,dlwin,0,10,19,195,0.425641026,0.056410256,0.538461538,1,0.28273747
4136,111,20690,3,10,0,0,0,13,3,6,2,1,8,20,nowin,loss,beat,dlwin,0,10,13,180,0.433333333,0.055555556,0.611111111,2,0.602264492
4137,50,20690,6,9,0,0,0,15,3,6,2,1,8,20,nowin,loss,beat,dlwin,0,10,15,202,0.405940594,0.04950495,0.54950495,0,0.020296079
4138,25,20690,4,5,11,0,0,20,3,6,2,1,8,20,nowin,push,push,push,10,0,9,190,0.463157895,0.063157895,0.536842105,1,0.304401563
4139,113,20690,11,10,0,0,0,21,3,6,2,1,8,20,win,win,plwin,beat,25,0,21,199,0.407035176,0.055276382,0.668341709,2,0.620695264
4140,124,20691,6,5,7,0,0,18,10,4,3,0,0,17,nowin,win,plwin,beat,20,0,11,202,0.47029703,0.064356436,0.584158416,3,0.899458193
4141,117,20691,10,8,0,0,0,18,10,4,3,0,0,17,nowin,win,plwin,beat,20,0,18,173,0.410404624,0.069364162,0.606936416,2,0.578610282
4142,125,20691,9,10,0,0,0,19,10,4,3,0,0,17,nowin,win,plwin,beat,20,0,19,219,0.438356164,0.050228311,0.575342466,1,0.308411257
4143,3,20691,5,2,3,4,10,24,10,4,3,0,0,17,nowin,loss,bust,plbust,0,10,7,190,0.431578947,0.026315789,0.542105263,1,0.288076384
4144,62,20691,10,2,0,10,0,22,10,4,3,0,0,17,nowin,loss,bust,plbust,0,10,12,178,0.370786517,0.028089888,0.54494382,0,0.008657722
4145,118,20691,11,1,2,10,0,24,10,4,3,0,0,17,nowin,loss,bust,plbust,0,10,12,216,0.393518519,0.037037037,0.555555556,0,0.018059873
4146,143,20692,7,5,0,6,0,18,8,10,0,0,0,18,nowin,push,push,push,10,0,12,203,0.463054187,0.044334975,0.57635468,3,0.883143365
4147,37,20692,9,5,0,10,0,24,8,10,0,0,0,18,nowin,loss,bust,plbust,0,10,14,208,0.394230769,0.038461538,0.581730769,0,0.024682772
4148,82,20692,3,3,6,10,0,22,8,10,0,0,0,18,nowin,loss,bust,plbust,0,10,6,225,0.408888889,0.075555556,0.577777778,0,0.028101874
4149,18,20692,7,9,0,5,0,21,8,10,0,0,0,18,nowin,win,plwin,beat,20,0,16,182,0.461538462,0.043956044,0.587912088,3,0.892649374
4150,26,20692,10,5,0,10,0,25,8,10,0,0,0,18,nowin,loss,bust,plbust,0,10,15,203,0.463054187,0.0591133,0.541871921,1,0.306802864
4151,12,20692,7,10,0,0,0,17,8,10,0,0,0,18,nowin,loss,beat,dlwin,0,10,17,189,0.470899471,0.015873016,0.613756614,3,0.929171178
4152,19,20693,10,10,0,0,0,20,10,3,4,0,0,17,nowin,win,plwin,beat,20,0,20,237,0.41350211,0.054852321,0.628691983,2,0.597373826
4153,65,20693,10,10,0,0,0,20,10,3,4,0,0,17,nowin,win,plwin,beat,20,0,20,203,0.492610837,0.054187192,0.571428571,3,0.913702814
4154,146,20693,11,5,5,0,0,21,10,3,4,0,0,17,nowin,win,plwin,beat,20,0,16,221,0.43438914,0.040723982,0.542986425,1,0.290190091
4155,17,20693,5,2,4,10,0,21,10,3,4,0,0,17,nowin,win,plwin,beat,20,0,7,171,0.444444444,0.070175439,0.555555556,1,0.302364894
4156,134,20693,6,10,0,8,0,24,10,3,4,0,0,17,nowin,loss,bust,plbust,0,10,16,185,0.443243243,0.021621622,0.545945946,1,0.296939509
4157,79,20693,2,11,6,0,0,19,10,3,4,0,0,17,nowin,win,plwin,beat,20,0,13,211,0.436018957,0.028436019,0.672985782,2,0.650131054
4158,47,20694,10,6,0,3,0,19,11,10,0,0,0,21,nowin,loss,beat,dlwin,0,10,16,210,0.438095238,0.057142857,0.623809524,2,0.615868808
4159,85,20694,10,10,0,0,0,20,11,10,0,0,0,21,nowin,loss,beat,dlwin,0,10,20,195,0.41025641,0.066666667,0.594871795,0,0.03269711
4160,111,20694,5,3,10,0,0,18,11,10,0,0,0,21,nowin,loss,beat,dlwin,0,10,8,180,0.433333333,0.055555556,0.611111111,2,0.602264492
4161,150,20694,10,10,0,0,0,20,11,10,0,0,0,21,nowin,loss,beat,dlwin,0,10,20,192,0.401041667,0.036458333,0.567708333,0,0.023287458
4162,96,20694,4,10,0,1,2,17,11,10,0,0,0,21,nowin,loss,beat,dlwin,0,10,14,190,0.468421053,0.057894737,0.584210526,3,0.897263354
4163,45,20694,5,3,2,10,0,20,11,10,0,0,0,21,nowin,loss,beat,dlwin,0,10,8,196,0.428571429,0.051020408,0.612244898,2,0.598821767
4164,147,20695,10,2,0,10,0,22,9,2,10,0,0,21,nowin,loss,bust,plbust,0,10,12,205,0.380487805,0.014634146,0.536585366,0,0.00951447
4165,10,20695,5,10,0,10,0,25,9,2,10,0,0,21,nowin,loss,bust,plbust,0,10,15,191,0.413612565,0.057591623,0.596858639,2,0.574087175
4166,52,20695,7,10,0,0,0,17,9,2,10,0,0,21,nowin,loss,beat,dlwin,0,10,17,217,0.414746544,0.02764977,0.599078341,2,0.576736024
4167,91,20695,9,7,0,9,0,25,9,2,10,0,0,21,nowin,loss,bust,plbust,0,10,16,194,0.417525773,0.046391753,0.515463918,1,0.266616552
4168,35,20695,8,7,0,10,0,25,9,2,10,0,0,21,nowin,loss,bust,plbust,0,10,15,202,0.410891089,0.044554455,0.633663366,2,0.598681573
4169,84,20695,8,3,7,0,0,18,9,2,10,0,0,21,nowin,loss,beat,dlwin,0,10,11,195,0.379487179,0.056410256,0.569230769,0,0.017209119
4170,92,20696,3,9,0,0,0,12,5,6,1,10,0,22,nowin,win,dlbust,bust,20,0,12,186,0.446236559,0.059139785,0.564516129,1,0.307826125
4171,41,20696,3,9,0,0,0,12,5,6,1,10,0,22,nowin,win,dlbust,bust,20,0,12,192,0.364583333,0.036458333,0.520833333,0,0.00089702
4172,14,20696,10,9,0,0,0,19,5,6,1,10,0,22,nowin,win,dlbust,bust,20,0,19,202,0.391089109,0.01980198,0.628712871,2,0.577264877
4173,84,20696,4,10,0,0,0,14,5,6,1,10,0,22,nowin,win,dlbust,bust,20,0,14,195,0.379487179,0.056410256,0.569230769,0,0.017209119
4174,73,20696,5,6,8,0,0,19,5,6,1,10,0,22,nowin,win,dlbust,bust,20,0,11,181,0.375690608,0.011049724,0.596685083,0,0.022795773
4175,127,20696,7,10,0,0,0,17,5,6,1,10,0,22,nowin,win,dlbust,bust,20,0,17,201,0.402985075,0.029850746,0.60199005,0,0.032263937
4176,81,20697,11,7,0,0,0,18,4,10,10,0,0,24,nowin,win,dlbust,bust,20,0,18,182,0.395604396,0.043956044,0.60989011,2,0.567491261
4177,52,20697,8,11,0,0,0,19,4,10,10,0,0,24,nowin,win,dlbust,bust,20,0,19,217,0.414746544,0.02764977,0.599078341,2,0.576736024
4178,12,20697,8,4,0,0,0,12,4,10,10,0,0,24,nowin,win,dlbust,bust,20,0,12,189,0.470899471,0.015873016,0.613756614,3,0.929171178
4179,1,20697,5,10,0,0,0,15,4,10,10,0,0,24,nowin,win,dlbust,bust,20,0,15,197,0.406091371,0.025380711,0.649746193,2,0.606186955
4180,98,20697,9,7,0,0,0,16,4,10,10,0,0,24,nowin,win,dlbust,bust,20,0,16,220,0.422727273,0.054545455,0.55,1,0.28664435
4181,59,20697,10,2,0,0,0,12,4,10,10,0,0,24,nowin,win,dlbust,bust,20,0,12,228,0.429824561,0.048245614,0.543859649,1,0.287885446
4182,70,20698,2,10,0,6,0,18,2,10,10,0,0,22,nowin,win,dlbust,bust,20,0,12,228,0.385964912,0.039473684,0.557017544,0,0.016157125
4183,51,20698,7,3,8,0,0,18,2,10,10,0,0,22,nowin,win,dlbust,bust,20,0,10,189,0.529100529,0.068783069,0.608465608,3,0.993665715
4184,122,20698,8,2,9,0,0,19,2,10,10,0,0,22,nowin,win,dlbust,bust,20,0,10,210,0.347619048,0.052380952,0.59047619,0,0.012873677
4185,51,20698,11,8,0,0,0,19,2,10,10,0,0,22,nowin,win,dlbust,bust,20,0,19,189,0.529100529,0.068783069,0.608465608,3,0.993665715
4186,124,20698,10,10,0,0,0,20,2,10,10,0,0,22,nowin,win,dlbust,bust,20,0,20,202,0.47029703,0.064356436,0.584158416,3,0.899458193
4187,76,20698,7,10,0,0,0,17,2,10,10,0,0,22,nowin,win,dlbust,bust,20,0,17,189,0.534391534,0.079365079,0.608465608,3,1
4188,32,20699,4,7,8,0,0,19,4,3,10,0,0,17,nowin,win,plwin,beat,20,0,11,189,0.391534392,0.037037037,0.53968254,0,0.013579086
4189,48,20699,10,6,0,0,0,16,4,3,10,0,0,17,nowin,loss,beat,dlwin,0,10,16,203,0.413793103,0.019704433,0.600985222,2,0.577280801
4190,123,20699,2,2,9,0,0,13,4,3,10,0,0,17,nowin,loss,beat,dlwin,0,10,4,205,0.43902439,0.034146341,0.614634146,2,0.609962544
4191,4,20699,9,2,2,0,0,13,4,3,10,0,0,17,nowin,loss,beat,dlwin,0,10,11,217,0.460829493,0.036866359,0.562211982,1,0.315432839
4192,122,20699,11,4,5,0,0,20,4,3,10,0,0,17,nowin,win,plwin,beat,20,0,15,210,0.347619048,0.052380952,0.59047619,0,0.012873677
4193,114,20699,10,11,0,0,0,21,4,3,10,0,0,17,win,win,plwin,beat,25,0,21,198,0.47979798,0.025252525,0.611111111,3,0.937232995
4194,68,20700,10,2,0,8,0,20,7,4,10,0,0,21,nowin,loss,beat,dlwin,0,10,12,205,0.434146341,0.029268293,0.6,2,0.59483189
4195,36,20700,10,9,0,0,0,19,7,4,10,0,0,21,nowin,loss,beat,dlwin,0,10,19,229,0.445414847,0.056768559,0.655021834,2,0.645370571
4196,81,20700,8,10,0,0,0,18,7,4,10,0,0,21,nowin,loss,beat,dlwin,0,10,18,182,0.395604396,0.043956044,0.60989011,2,0.567491261
4197,32,20700,4,7,1,3,10,25,7,4,10,0,0,21,nowin,loss,bust,plbust,0,10,11,189,0.391534392,0.037037037,0.53968254,0,0.013579086
4198,40,20700,5,10,0,1,8,24,7,4,10,0,0,21,nowin,loss,bust,plbust,0,10,15,196,0.367346939,0.030612245,0.617346939,0,0.025358183
4199,6,20700,10,5,0,10,0,25,7,4,10,0,0,21,nowin,loss,bust,plbust,0,10,15,191,0.439790576,0.047120419,0.581151832,1,0.31211505
4200,60,20701,6,10,0,10,0,26,11,7,0,0,0,18,nowin,loss,bust,plbust,0,10,16,227,0.418502203,0.022026432,0.559471366,0,0.026496258
4201,17,20701,4,8,0,10,0,22,11,7,0,0,0,18,nowin,loss,bust,plbust,0,10,12,171,0.444444444,0.070175439,0.555555556,1,0.302364894
4202,59,20701,10,9,0,0,0,19,11,7,0,0,0,18,nowin,win,plwin,beat,20,0,19,228,0.429824561,0.048245614,0.543859649,1,0.287885446
4203,48,20701,9,8,0,0,0,17,11,7,0,0,0,18,nowin,loss,beat,dlwin,0,10,17,203,0.413793103,0.019704433,0.600985222,2,0.577280801
4204,96,20701,8,10,0,0,0,18,11,7,0,0,0,18,nowin,push,push,push,10,0,18,190,0.468421053,0.057894737,0.584210526,3,0.897263354
4205,136,20701,2,2,9,10,0,23,11,7,0,0,0,18,nowin,loss,bust,plbust,0,10,4,194,0.396907216,0.025773196,0.597938144,0,0.029452644
4206,12,20702,4,10,0,0,0,14,4,2,5,4,9,24,nowin,win,dlbust,bust,20,0,14,189,0.470899471,0.015873016,0.613756614,3,0.929171178
4207,11,20702,8,3,9,0,0,20,4,2,5,4,9,24,nowin,win,dlbust,bust,20,0,11,236,0.457627119,0.016949153,0.588983051,3,0.889015813
4208,147,20702,3,2,10,0,0,15,4,2,5,4,9,24,nowin,win,dlbust,bust,20,0,5,205,0.380487805,0.014634146,0.536585366,0,0.00951447
4209,19,20702,7,4,4,0,0,15,4,2,5,4,9,24,nowin,win,dlbust,bust,20,0,11,237,0.41350211,0.054852321,0.628691983,2,0.597373826
4210,96,20702,4,7,10,0,0,21,4,2,5,4,9,24,nowin,win,dlbust,bust,20,0,11,190,0.468421053,0.057894737,0.584210526,3,0.897263354
4211,90,20702,10,2,0,0,0,12,4,2,5,4,9,24,nowin,win,dlbust,bust,20,0,12,201,0.447761194,0.049751244,0.60199005,3,0.889945023
4212,26,20703,5,4,10,0,0,19,6,10,7,0,0,23,nowin,win,dlbust,bust,20,0,9,203,0.463054187,0.0591133,0.541871921,1,0.306802864
4213,6,20703,10,10,0,0,0,20,6,10,7,0,0,23,nowin,win,dlbust,bust,20,0,20,191,0.439790576,0.047120419,0.581151832,1,0.31211505
4214,74,20703,10,4,0,0,0,14,6,10,7,0,0,23,nowin,win,dlbust,bust,20,0,14,209,0.411483254,0.04784689,0.531100478,0,0.017448125
4215,56,20703,10,10,0,0,0,20,6,10,7,0,0,23,nowin,win,dlbust,bust,20,0,20,175,0.4,0.057142857,0.582857143,0,0.026685297
4216,132,20703,10,10,0,0,0,20,6,10,7,0,0,23,nowin,win,dlbust,bust,20,0,20,194,0.412371134,0.036082474,0.649484536,2,0.611633238
4217,116,20703,11,8,0,0,0,19,6,10,7,0,0,23,nowin,win,dlbust,bust,20,0,19,195,0.425641026,0.056410256,0.538461538,1,0.28273747
4218,36,20704,11,8,0,0,0,19,9,5,5,0,0,19,nowin,push,push,push,10,0,19,229,0.445414847,0.056768559,0.655021834,2,0.645370571
4219,145,20704,3,8,6,0,0,17,9,5,5,0,0,19,nowin,loss,beat,dlwin,0,10,11,188,0.441489362,0.031914894,0.622340426,2,0.617837093
4220,66,20704,2,9,6,0,0,17,9,5,5,0,0,19,nowin,loss,beat,dlwin,0,10,11,217,0.456221198,0.064516129,0.626728111,3,0.924304367
4221,40,20704,7,10,0,0,0,17,9,5,5,0,0,19,nowin,loss,beat,dlwin,0,10,17,196,0.367346939,0.030612245,0.617346939,0,0.025358183
4222,88,20704,10,5,0,1,4,20,9,5,5,0,0,19,nowin,win,plwin,beat,20,0,15,206,0.466019417,0.033980583,0.54368932,1,0.309467903
4223,69,20704,7,6,0,10,0,23,9,5,5,0,0,19,nowin,loss,bust,plbust,0,10,13,194,0.365979381,0.030927835,0.515463918,0,0
4224,146,20705,5,3,8,0,0,16,5,7,7,0,0,19,nowin,loss,beat,dlwin,0,10,8,221,0.43438914,0.040723982,0.542986425,1,0.290190091
4225,8,20705,7,10,0,0,0,17,5,7,7,0,0,19,nowin,loss,beat,dlwin,0,10,17,181,0.44198895,0.071823204,0.596685083,2,0.599438402
4226,58,20705,10,10,0,0,0,20,5,7,7,0,0,19,nowin,win,plwin,beat,20,0,20,195,0.430769231,0.041025641,0.584615385,2,0.580497586
4227,34,20705,3,1,10,0,0,14,5,7,7,0,0,19,nowin,loss,beat,dlwin,0,10,4,202,0.5,0.079207921,0.618811881,3,0.968961434
4228,126,20705,1,5,6,0,0,12,5,7,7,0,0,19,nowin,loss,beat,dlwin,0,10,6,188,0.457446809,0.074468085,0.60106383,3,0.900633203
4229,13,20705,5,10,0,0,0,15,5,7,7,0,0,19,nowin,loss,beat,dlwin,0,10,15,206,0.417475728,0.063106796,0.621359223,2,0.59555479
4230,121,20706,8,10,0,0,0,18,10,10,0,0,0,20,nowin,loss,beat,dlwin,0,10,18,195,0.456410256,0.025641026,0.512820513,1,0.288597791
4231,97,20706,10,10,0,0,0,20,10,10,0,0,0,20,nowin,push,push,push,10,0,20,182,0.450549451,0.06043956,0.692307692,2,0.677372279
4232,9,20706,10,9,0,0,0,19,10,10,0,0,0,20,nowin,loss,beat,dlwin,0,10,19,194,0.37628866,0.015463918,0.541237113,0,0.009396796
4233,30,20706,9,7,0,10,0,26,10,10,0,0,0,20,nowin,loss,bust,plbust,0,10,16,206,0.393203883,0.033980583,0.601941748,0,0.029324648
4234,13,20706,4,2,2,9,0,17,10,10,0,0,0,20,nowin,loss,beat,dlwin,0,10,6,206,0.417475728,0.063106796,0.621359223,2,0.59555479
4235,68,20706,10,8,0,0,0,18,10,10,0,0,0,20,nowin,loss,beat,dlwin,0,10,18,205,0.434146341,0.029268293,0.6,2,0.59483189
4236,141,20707,10,5,0,3,0,18,1,2,10,3,4,20,nowin,loss,beat,dlwin,0,10,15,202,0.420792079,0.074257426,0.564356436,0,0.028377851
4237,11,20707,10,2,0,4,10,26,1,2,10,3,4,20,nowin,loss,bust,plbust,0,10,12,236,0.457627119,0.016949153,0.588983051,3,0.889015813
4238,48,20707,6,10,0,6,0,22,1,2,10,3,4,20,nowin,loss,bust,plbust,0,10,16,203,0.413793103,0.019704433,0.600985222,2,0.577280801
4239,109,20707,3,3,3,3,1,13,1,2,10,3,4,20,nowin,loss,beat,dlwin,0,10,6,221,0.461538462,0.058823529,0.597285068,3,0.901830309
4240,81,20707,1,5,6,10,0,22,1,2,10,3,4,20,nowin,loss,bust,plbust,0,10,6,182,0.395604396,0.043956044,0.60989011,2,0.567491261
4241,25,20707,10,8,0,0,0,18,1,2,10,3,4,20,nowin,loss,beat,dlwin,0,10,18,190,0.463157895,0.063157895,0.536842105,1,0.304401563
4242,43,20708,9,6,0,0,0,15,3,4,3,10,0,20,nowin,loss,beat,dlwin,0,10,15,192,0.40625,0.041666667,0.609375,2,0.576671372
4243,89,20708,10,5,0,0,0,15,3,4,3,10,0,20,nowin,loss,beat,dlwin,0,10,15,212,0.537735849,0.047169811,0.594339623,3,0.990167191
4244,82,20708,7,6,0,0,0,13,3,4,3,10,0,20,nowin,loss,beat,dlwin,0,10,13,225,0.408888889,0.075555556,0.577777778,0,0.028101874
4245,77,20708,3,10,0,0,0,13,3,4,3,10,0,20,nowin,loss,beat,dlwin,0,10,13,200,0.455,0.04,0.62,3,0.916252116
4246,78,20708,11,7,0,0,0,18,3,4,3,10,0,20,nowin,loss,beat,dlwin,0,10,18,201,0.517412935,0.034825871,0.587064677,3,0.95871112
4247,150,20708,7,6,0,0,0,13,3,4,3,10,0,20,nowin,loss,beat,dlwin,0,10,13,192,0.401041667,0.036458333,0.567708333,0,0.023287458
4248,27,20709,10,10,0,0,0,20,3,9,10,0,0,22,nowin,win,dlbust,bust,20,0,20,178,0.370786517,0.016853933,0.573033708,0,0.015536309
4249,88,20709,4,10,0,0,0,14,3,9,10,0,0,22,nowin,win,dlbust,bust,20,0,14,206,0.466019417,0.033980583,0.54368932,1,0.309467903
4250,50,20709,10,7,0,0,0,17,3,9,10,0,0,22,nowin,win,dlbust,bust,20,0,17,202,0.405940594,0.04950495,0.54950495,0,0.020296079
4251,113,20709,6,8,0,0,0,14,3,9,10,0,0,22,nowin,win,dlbust,bust,20,0,14,199,0.407035176,0.055276382,0.668341709,2,0.620695264
4252,108,20709,10,10,0,0,0,20,3,9,10,0,0,22,nowin,win,dlbust,bust,20,0,20,193,0.435233161,0.056994819,0.559585492,1,0.298824795
4253,79,20709,11,10,0,0,0,21,3,9,10,0,0,22,win,win,dlbust,bust,25,0,21,211,0.436018957,0.028436019,0.672985782,2,0.650131054
4254,75,20710,11,9,0,0,0,20,10,4,2,10,0,26,nowin,win,dlbust,bust,20,0,20,191,0.418848168,0.052356021,0.570680628,0,0.029344702
4255,130,20710,4,2,11,0,0,17,10,4,2,10,0,26,nowin,win,dlbust,bust,20,0,6,219,0.410958904,0.03652968,0.566210046,0,0.025888739
4256,34,20710,5,10,0,10,0,25,10,4,2,10,0,26,nowin,loss,bust,plbust,0,10,15,202,0.5,0.079207921,0.618811881,3,0.968961434
4257,124,20710,9,5,0,3,0,17,10,4,2,10,0,26,nowin,win,dlbust,bust,20,0,14,202,0.47029703,0.064356436,0.584158416,3,0.899458193
4258,108,20710,9,5,0,7,0,21,10,4,2,10,0,26,nowin,win,dlbust,bust,20,0,14,193,0.435233161,0.056994819,0.559585492,1,0.298824795
4259,67,20710,5,4,10,0,0,19,10,4,2,10,0,26,nowin,win,dlbust,bust,20,0,9,195,0.369230769,0.041025641,0.569230769,0,0.014139427
4260,129,20711,8,5,0,1,10,24,10,11,0,0,0,21,nowin,loss,bust,plbust,0,10,13,201,0.422885572,0.064676617,0.55721393,0,0.027255383
4261,81,20711,10,5,0,3,0,18,10,11,0,0,0,21,nowin,loss,beat,dlwin,0,10,15,182,0.395604396,0.043956044,0.60989011,2,0.567491261
4262,48,20711,3,4,7,2,10,26,10,11,0,0,0,21,nowin,loss,bust,plbust,0,10,7,203,0.413793103,0.019704433,0.600985222,2,0.577280801
4263,27,20711,1,1,10,9,0,21,10,11,0,0,0,21,nowin,push,push,push,10,0,2,178,0.370786517,0.016853933,0.573033708,0,0.015536309
4264,42,20711,5,6,10,0,0,21,10,11,0,0,0,21,nowin,push,push,push,10,0,11,212,0.443396226,0.051886792,0.570754717,1,0.309181312
4265,55,20711,4,8,0,10,0,22,10,11,0,0,0,21,nowin,loss,bust,plbust,0,10,12,191,0.371727749,0.057591623,0.54973822,0,0.01011347
4266,131,20712,5,5,8,0,0,18,10,10,0,0,0,20,nowin,loss,beat,dlwin,0,10,10,217,0.410138249,0.069124424,0.543778802,0,0.02015021
4267,111,20712,5,4,10,0,0,19,10,10,0,0,0,20,nowin,loss,beat,dlwin,0,10,9,180,0.433333333,0.055555556,0.611111111,2,0.602264492
4268,39,20712,8,5,0,10,0,23,10,10,0,0,0,20,nowin,loss,bust,plbust,0,10,13,191,0.429319372,0.062827225,0.57591623,0,0.033760763
4269,27,20712,10,2,0,2,10,24,10,10,0,0,0,20,nowin,loss,bust,plbust,0,10,12,178,0.370786517,0.016853933,0.573033708,0,0.015536309
4270,122,20712,10,7,0,0,0,17,10,10,0,0,0,20,nowin,loss,beat,dlwin,0,10,17,210,0.347619048,0.052380952,0.59047619,0,0.012873677
4271,43,20712,11,10,0,0,0,21,10,10,0,0,0,20,win,win,plwin,beat,25,0,21,192,0.40625,0.041666667,0.609375,2,0.576671372
4272,88,20713,5,5,10,0,0,20,11,6,0,0,0,17,nowin,win,plwin,beat,20,0,10,206,0.466019417,0.033980583,0.54368932,1,0.309467903
4273,60,20713,10,4,0,9,0,23,11,6,0,0,0,17,nowin,loss,bust,plbust,0,10,14,227,0.418502203,0.022026432,0.559471366,0,0.026496258
4274,112,20713,2,9,6,0,0,17,11,6,0,0,0,17,nowin,push,push,push,10,0,11,203,0.448275862,0.054187192,0.600985222,3,0.889576933
4275,8,20713,4,10,0,10,0,24,11,6,0,0,0,17,nowin,loss,bust,plbust,0,10,14,181,0.44198895,0.071823204,0.596685083,2,0.599438402
4276,136,20713,7,7,0,3,0,17,11,6,0,0,0,17,nowin,push,push,push,10,0,14,194,0.396907216,0.025773196,0.597938144,0,0.029452644
4277,88,20713,4,3,10,0,0,17,11,6,0,0,0,17,nowin,push,push,push,10,0,7,206,0.466019417,0.033980583,0.54368932,1,0.309467903
4278,49,20714,10,8,0,0,0,18,10,8,0,0,0,18,nowin,push,push,push,10,0,18,207,0.396135266,0.053140097,0.594202899,0,0.028306925
4279,53,20714,7,3,3,10,0,23,10,8,0,0,0,18,nowin,loss,bust,plbust,0,10,10,250,0.372,0.064,0.564,0,0.013687345
4280,23,20714,6,10,0,10,0,26,10,8,0,0,0,18,nowin,loss,bust,plbust,0,10,16,208,0.427884615,0.0625,0.552884615,1,0.29114424
4281,74,20714,5,10,0,6,0,21,10,8,0,0,0,18,nowin,win,plwin,beat,20,0,15,209,0.411483254,0.04784689,0.531100478,0,0.017448125
4282,17,20714,9,10,0,0,0,19,10,8,0,0,0,18,nowin,win,plwin,beat,20,0,19,171,0.444444444,0.070175439,0.555555556,1,0.302364894
4283,83,20714,7,8,0,7,0,22,10,8,0,0,0,18,nowin,loss,bust,plbust,0,10,15,193,0.424870466,0.051813472,0.678756477,2,0.644360335
4284,9,20715,10,4,0,10,0,24,7,10,0,0,0,17,nowin,loss,bust,plbust,0,10,14,194,0.37628866,0.015463918,0.541237113,0,0.009396796
4285,127,20715,10,10,0,0,0,20,7,10,0,0,0,17,nowin,win,plwin,beat,20,0,20,201,0.402985075,0.029850746,0.60199005,0,0.032263937
4286,15,20715,6,10,0,1,0,17,7,10,0,0,0,17,nowin,push,push,push,10,0,16,212,0.410377358,0.051886792,0.561320755,0,0.024517408
4287,30,20715,10,10,0,0,0,20,7,10,0,0,0,17,nowin,win,plwin,beat,20,0,20,206,0.393203883,0.033980583,0.601941748,0,0.029324648
4288,32,20715,6,8,0,10,0,24,7,10,0,0,0,17,nowin,loss,bust,plbust,0,10,14,189,0.391534392,0.037037037,0.53968254,0,0.013579086
4289,140,20715,8,5,0,9,0,22,7,10,0,0,0,17,nowin,loss,bust,plbust,0,10,13,210,0.466666667,0.023809524,0.604761905,3,0.915293335
4290,57,20716,11,9,0,0,0,20,5,7,10,0,0,22,nowin,win,dlbust,bust,20,0,20,192,0.46875,0.052083333,0.59375,3,0.907001181
4291,5,20716,2,5,7,0,0,14,5,7,10,0,0,22,nowin,win,dlbust,bust,20,0,7,203,0.42364532,0.02955665,0.596059113,2,0.582508076
4292,60,20716,2,10,0,0,0,12,5,7,10,0,0,22,nowin,win,dlbust,bust,20,0,12,227,0.418502203,0.022026432,0.559471366,0,0.026496258
4293,10,20716,3,10,0,0,0,13,5,7,10,0,0,22,nowin,win,dlbust,bust,20,0,13,191,0.413612565,0.057591623,0.596858639,2,0.574087175
4294,115,20716,4,10,0,0,0,14,5,7,10,0,0,22,nowin,win,dlbust,bust,20,0,14,194,0.427835052,0.041237113,0.592783505,2,0.583863602
4295,93,20716,10,7,0,0,0,17,5,7,10,0,0,22,nowin,win,dlbust,bust,20,0,17,175,0.485714286,0.051428571,0.548571429,1,0.323648091
4296,72,20717,6,11,2,0,0,19,10,7,0,0,0,17,nowin,win,plwin,beat,20,0,17,185,0.394594595,0.032432432,0.508108108,0,0.006763115
4297,141,20717,6,10,0,3,0,19,10,7,0,0,0,17,nowin,win,plwin,beat,20,0,16,202,0.420792079,0.074257426,0.564356436,0,0.028377851
4298,133,20717,10,8,0,0,0,18,10,7,0,0,0,17,nowin,win,plwin,beat,20,0,18,201,0.47761194,0.064676617,0.611940299,3,0.935428111
4299,150,20717,6,10,0,10,0,26,10,7,0,0,0,17,nowin,loss,bust,plbust,0,10,16,192,0.401041667,0.036458333,0.567708333,0,0.023287458
4300,67,20717,3,5,2,3,5,18,10,7,0,0,0,17,nowin,win,plwin,beat,20,0,8,195,0.369230769,0.041025641,0.569230769,0,0.014139427
4301,15,20717,8,10,0,0,0,18,10,7,0,0,0,17,nowin,win,plwin,beat,20,0,18,212,0.410377358,0.051886792,0.561320755,0,0.024517408
4302,104,20718,10,8,0,0,0,18,3,10,3,1,0,17,nowin,win,plwin,beat,20,0,18,209,0.363636364,0.052631579,0.593301435,0,0.018359419
4303,74,20718,8,9,0,0,0,17,3,10,3,1,0,17,nowin,push,push,push,10,0,17,209,0.411483254,0.04784689,0.531100478,0,0.017448125
4304,94,20718,8,11,0,0,0,19,3,10,3,1,0,17,nowin,win,plwin,beat,20,0,19,183,0.43715847,0.043715847,0.540983607,1,0.290866892
4305,132,20718,9,4,0,0,0,13,3,10,3,1,0,17,nowin,loss,beat,dlwin,0,10,13,194,0.412371134,0.036082474,0.649484536,2,0.611633238
4306,44,20718,3,7,2,1,0,13,3,10,3,1,0,17,nowin,loss,beat,dlwin,0,10,10,219,0.433789954,0.050228311,0.534246575,1,0.285551035
4307,89,20718,2,11,1,0,0,14,3,10,3,1,0,17,nowin,loss,beat,dlwin,0,10,13,212,0.537735849,0.047169811,0.594339623,3,0.990167191
4308,136,20719,6,11,2,0,0,19,6,10,5,0,0,21,nowin,loss,beat,dlwin,0,10,17,194,0.396907216,0.025773196,0.597938144,0,0.029452644
4309,100,20719,11,2,1,0,0,14,6,10,5,0,0,21,nowin,loss,beat,dlwin,0,10,13,190,0.452631579,0.036842105,0.594736842,3,0.888671154
4310,131,20719,4,4,4,0,0,12,6,10,5,0,0,21,nowin,loss,beat,dlwin,0,10,8,217,0.410138249,0.069124424,0.543778802,0,0.02015021
4311,78,20719,6,7,0,0,0,13,6,10,5,0,0,21,nowin,loss,beat,dlwin,0,10,13,201,0.517412935,0.034825871,0.587064677,3,0.95871112
4312,88,20719,10,10,0,0,0,20,6,10,5,0,0,21,nowin,loss,beat,dlwin,0,10,20,206,0.466019417,0.033980583,0.54368932,1,0.309467903
4313,36,20719,8,3,2,0,0,13,6,10,5,0,0,21,nowin,loss,beat,dlwin,0,10,11,229,0.445414847,0.056768559,0.655021834,2,0.645370571
4314,73,20720,4,11,3,0,0,18,10,4,10,0,0,24,nowin,win,dlbust,bust,20,0,15,181,0.375690608,0.011049724,0.596685083,0,0.022795773
4315,108,20720,4,7,10,0,0,21,10,4,10,0,0,24,nowin,win,dlbust,bust,20,0,11,193,0.435233161,0.056994819,0.559585492,1,0.298824795
4316,81,20720,3,2,10,8,0,23,10,4,10,0,0,24,nowin,loss,bust,plbust,0,10,5,182,0.395604396,0.043956044,0.60989011,2,0.567491261
4317,4,20720,2,6,10,0,0,18,10,4,10,0,0,24,nowin,win,dlbust,bust,20,0,8,217,0.460829493,0.036866359,0.562211982,1,0.315432839
4318,117,20720,7,11,0,0,0,18,10,4,10,0,0,24,nowin,win,dlbust,bust,20,0,18,173,0.410404624,0.069364162,0.606936416,2,0.578610282
4319,79,20720,10,10,0,0,0,20,10,4,10,0,0,24,nowin,win,dlbust,bust,20,0,20,211,0.436018957,0.028436019,0.672985782,2,0.650131054
4320,139,20721,10,10,0,0,0,20,10,4,5,0,0,19,nowin,win,plwin,beat,20,0,20,192,0.380208333,0.036458333,0.59375,0,0.023429169
4321,36,20721,6,10,0,10,0,26,10,4,5,0,0,19,nowin,loss,bust,plbust,0,10,16,229,0.445414847,0.056768559,0.655021834,2,0.645370571
4322,146,20721,10,2,0,2,10,24,10,4,5,0,0,19,nowin,loss,bust,plbust,0,10,12,221,0.43438914,0.040723982,0.542986425,1,0.290190091
4323,138,20721,10,3,0,9,0,22,10,4,5,0,0,19,nowin,loss,bust,plbust,0,10,13,190,0.442105263,0.047368421,0.610526316,2,0.609711065
4324,140,20721,7,10,0,0,0,17,10,4,5,0,0,19,nowin,loss,beat,dlwin,0,10,17,210,0.466666667,0.023809524,0.604761905,3,0.915293335
4325,58,20721,10,10,0,0,0,20,10,4,5,0,0,19,nowin,win,plwin,beat,20,0,20,195,0.430769231,0.041025641,0.584615385,2,0.580497586
4326,150,20722,4,4,11,0,0,19,6,2,8,7,0,23,nowin,win,dlbust,bust,20,0,8,192,0.401041667,0.036458333,0.567708333,0,0.023287458
4327,10,20722,4,6,10,0,0,20,6,2,8,7,0,23,nowin,win,dlbust,bust,20,0,10,191,0.413612565,0.057591623,0.596858639,2,0.574087175
4328,116,20722,10,9,0,0,0,19,6,2,8,7,0,23,nowin,win,dlbust,bust,20,0,19,195,0.425641026,0.056410256,0.538461538,1,0.28273747
4329,135,20722,10,10,0,0,0,20,6,2,8,7,0,23,nowin,win,dlbust,bust,20,0,20,179,0.391061453,0.067039106,0.586592179,0,0.024924662
4330,38,20722,9,3,0,0,0,12,6,2,8,7,0,23,nowin,win,dlbust,bust,20,0,12,202,0.361386139,0.03960396,0.564356436,0,0.010597953
4331,98,20722,10,10,0,0,0,20,6,2,8,7,0,23,nowin,win,dlbust,bust,20,0,20,220,0.422727273,0.054545455,0.55,1,0.28664435
4332,32,20723,4,5,6,9,0,24,9,10,0,0,0,19,nowin,loss,bust,plbust,0,10,9,189,0.391534392,0.037037037,0.53968254,0,0.013579086
4333,19,20723,10,7,0,0,0,17,9,10,0,0,0,19,nowin,loss,beat,dlwin,0,10,17,237,0.41350211,0.054852321,0.628691983,2,0.597373826
4334,124,20723,10,11,0,0,0,21,9,10,0,0,0,19,win,win,plwin,beat,25,0,21,202,0.47029703,0.064356436,0.584158416,3,0.899458193
4335,13,20723,6,10,0,6,0,22,9,10,0,0,0,19,nowin,loss,bust,plbust,0,10,16,206,0.417475728,0.063106796,0.621359223,2,0.59555479
4336,75,20723,2,3,7,4,9,25,9,10,0,0,0,19,nowin,loss,bust,plbust,0,10,5,191,0.418848168,0.052356021,0.570680628,0,0.029344702
4337,61,20723,3,2,9,10,0,24,9,10,0,0,0,19,nowin,loss,bust,plbust,0,10,5,194,0.427835052,0.077319588,0.603092784,2,0.591437139
4338,37,20724,11,9,0,0,0,20,8,10,0,0,0,18,nowin,win,plwin,beat,20,0,20,208,0.394230769,0.038461538,0.581730769,0,0.024682772
4339,114,20724,2,4,7,5,0,18,8,10,0,0,0,18,nowin,push,push,push,10,0,6,198,0.47979798,0.025252525,0.611111111,3,0.937232995
4340,22,20724,2,8,10,0,0,20,8,10,0,0,0,18,nowin,win,plwin,beat,20,0,10,187,0.481283422,0.042780749,0.577540107,3,0.906128176
4341,89,20724,10,11,0,0,0,21,8,10,0,0,0,18,win,win,plwin,beat,25,0,21,212,0.537735849,0.047169811,0.594339623,3,0.990167191
4342,36,20724,10,3,0,10,0,23,8,10,0,0,0,18,nowin,loss,bust,plbust,0,10,13,229,0.445414847,0.056768559,0.655021834,2,0.645370571
4343,42,20724,9,2,6,0,0,17,8,10,0,0,0,18,nowin,loss,beat,dlwin,0,10,11,212,0.443396226,0.051886792,0.570754717,1,0.309181312
4344,26,20725,11,8,0,0,0,19,4,6,10,0,0,20,nowin,loss,beat,dlwin,0,10,19,203,0.463054187,0.0591133,0.541871921,1,0.306802864
4345,106,20725,9,10,0,0,0,19,4,6,10,0,0,20,nowin,loss,beat,dlwin,0,10,19,192,0.411458333,0.026041667,0.557291667,0,0.023854304
4346,71,20725,9,10,0,0,0,19,4,6,10,0,0,20,nowin,loss,beat,dlwin,0,10,19,193,0.352331606,0.046632124,0.585492228,0,0.013063661
4347,65,20725,10,11,0,0,0,21,4,6,10,0,0,20,win,win,plwin,beat,25,0,21,203,0.492610837,0.054187192,0.571428571,3,0.913702814
4348,122,20725,5,4,2,8,0,19,4,6,10,0,0,20,nowin,loss,beat,dlwin,0,10,9,210,0.347619048,0.052380952,0.59047619,0,0.012873677
4349,122,20725,11,7,0,0,0,18,4,6,10,0,0,20,nowin,loss,beat,dlwin,0,10,18,210,0.347619048,0.052380952,0.59047619,0,0.012873677
4350,106,20726,5,10,0,0,0,15,5,6,6,0,0,17,nowin,loss,beat,dlwin,0,10,15,192,0.411458333,0.026041667,0.557291667,0,0.023854304
4351,32,20726,2,10,0,0,0,12,5,6,6,0,0,17,nowin,loss,beat,dlwin,0,10,12,189,0.391534392,0.037037037,0.53968254,0,0.013579086
4352,42,20726,10,10,0,0,0,20,5,6,6,0,0,17,nowin,win,plwin,beat,20,0,20,212,0.443396226,0.051886792,0.570754717,1,0.309181312
4353,109,20726,6,4,6,0,0,16,5,6,6,0,0,17,nowin,loss,beat,dlwin,0,10,10,221,0.461538462,0.058823529,0.597285068,3,0.901830309
4354,68,20726,9,8,0,0,0,17,5,6,6,0,0,17,nowin,push,push,push,10,0,17,205,0.434146341,0.029268293,0.6,2,0.59483189
4355,149,20726,8,3,10,0,0,21,5,6,6,0,0,17,nowin,win,plwin,beat,20,0,11,225,0.457777778,0.057777778,0.648888889,2,0.651965595
4356,83,20727,2,10,0,10,0,22,7,10,0,0,0,17,nowin,loss,bust,plbust,0,10,12,193,0.424870466,0.051813472,0.678756477,2,0.644360335
4357,81,20727,10,11,0,0,0,21,7,10,0,0,0,17,win,win,plwin,beat,25,0,21,182,0.395604396,0.043956044,0.60989011,2,0.567491261
4358,150,20727,7,10,0,0,0,17,7,10,0,0,0,17,nowin,push,push,push,10,0,17,192,0.401041667,0.036458333,0.567708333,0,0.023287458
4359,65,20727,8,5,0,3,10,26,7,10,0,0,0,17,nowin,loss,bust,plbust,0,10,13,203,0.492610837,0.054187192,0.571428571,3,0.913702814
4360,56,20727,10,6,0,1,0,17,7,10,0,0,0,17,nowin,push,push,push,10,0,16,175,0.4,0.057142857,0.582857143,0,0.026685297
4361,31,20727,11,10,0,0,0,21,7,10,0,0,0,17,win,win,plwin,beat,25,0,21,188,0.473404255,0.058510638,0.515957447,1,0.300306557
4362,66,20728,11,7,0,0,0,18,8,3,7,0,0,18,nowin,push,push,push,10,0,18,217,0.456221198,0.064516129,0.626728111,3,0.924304367
4363,44,20728,4,2,3,7,7,23,8,3,7,0,0,18,nowin,loss,bust,plbust,0,10,6,219,0.433789954,0.050228311,0.534246575,1,0.285551035
4364,46,20728,2,3,10,8,0,23,8,3,7,0,0,18,nowin,loss,bust,plbust,0,10,5,186,0.403225806,0.048387097,0.591397849,0,0.029742194
4365,53,20728,4,8,0,9,0,21,8,3,7,0,0,18,nowin,win,plwin,beat,20,0,12,250,0.372,0.064,0.564,0,0.013687345
4366,50,20728,2,10,0,4,5,21,8,3,7,0,0,18,nowin,win,plwin,beat,20,0,12,202,0.405940594,0.04950495,0.54950495,0,0.020296079
4367,27,20728,9,10,0,0,0,19,8,3,7,0,0,18,nowin,win,plwin,beat,20,0,19,178,0.370786517,0.016853933,0.573033708,0,0.015536309
4368,68,20729,8,10,0,0,0,18,11,6,0,0,0,17,nowin,win,plwin,beat,20,0,18,205,0.434146341,0.029268293,0.6,2,0.59483189
4369,129,20729,10,4,0,7,0,21,11,6,0,0,0,17,nowin,win,plwin,beat,20,0,14,201,0.422885572,0.064676617,0.55721393,0,0.027255383
4370,49,20729,5,2,6,2,1,16,11,6,0,0,0,17,nowin,loss,beat,dlwin,0,10,7,207,0.396135266,0.053140097,0.594202899,0,0.028306925
4371,31,20729,9,5,0,4,0,18,11,6,0,0,0,17,nowin,win,plwin,beat,20,0,14,188,0.473404255,0.058510638,0.515957447,1,0.300306557
4372,74,20729,8,10,0,0,0,18,11,6,0,0,0,17,nowin,win,plwin,beat,20,0,18,209,0.411483254,0.04784689,0.531100478,0,0.017448125
4373,36,20729,6,10,0,7,0,23,11,6,0,0,0,17,nowin,loss,bust,plbust,0,10,16,229,0.445414847,0.056768559,0.655021834,2,0.645370571
4374,33,20730,2,7,7,10,0,26,8,11,0,0,0,19,nowin,loss,bust,plbust,0,10,9,192,0.4375,0.057291667,0.625,2,0.616208916
4375,3,20730,10,10,0,0,0,20,8,11,0,0,0,19,nowin,win,plwin,beat,20,0,20,190,0.431578947,0.026315789,0.542105263,1,0.288076384
4376,147,20730,8,10,0,0,0,18,8,11,0,0,0,19,nowin,loss,beat,dlwin,0,10,18,205,0.380487805,0.014634146,0.536585366,0,0.00951447
4377,23,20730,8,10,0,0,0,18,8,11,0,0,0,19,nowin,loss,beat,dlwin,0,10,18,208,0.427884615,0.0625,0.552884615,1,0.29114424
4378,5,20730,4,7,10,0,0,21,8,11,0,0,0,19,nowin,win,plwin,beat,20,0,11,203,0.42364532,0.02955665,0.596059113,2,0.582508076
4379,74,20730,11,7,0,0,0,18,8,11,0,0,0,19,nowin,loss,beat,dlwin,0,10,18,209,0.411483254,0.04784689,0.531100478,0,0.017448125
4380,52,20731,3,4,8,1,10,26,7,2,10,0,0,19,nowin,loss,bust,plbust,0,10,7,217,0.414746544,0.02764977,0.599078341,2,0.576736024
4381,11,20731,7,7,0,10,0,24,7,2,10,0,0,19,nowin,loss,bust,plbust,0,10,14,236,0.457627119,0.016949153,0.588983051,3,0.889015813
4382,31,20731,10,8,0,0,0,18,7,2,10,0,0,19,nowin,loss,beat,dlwin,0,10,18,188,0.473404255,0.058510638,0.515957447,1,0.300306557
4383,128,20731,10,3,0,10,0,23,7,2,10,0,0,19,nowin,loss,bust,plbust,0,10,13,227,0.356828194,0.052863436,0.577092511,0,0.012352564
4384,31,20731,5,6,5,8,0,24,7,2,10,0,0,19,nowin,loss,bust,plbust,0,10,11,188,0.473404255,0.058510638,0.515957447,1,0.300306557
4385,147,20731,10,6,0,8,0,24,7,2,10,0,0,19,nowin,loss,bust,plbust,0,10,16,205,0.380487805,0.014634146,0.536585366,0,0.00951447
4386,10,20732,3,9,0,4,7,23,9,2,10,0,0,21,nowin,loss,bust,plbust,0,10,12,191,0.413612565,0.057591623,0.596858639,2,0.574087175
4387,128,20732,11,10,0,0,0,21,9,2,10,0,0,21,win,push,push,push,10,0,21,227,0.356828194,0.052863436,0.577092511,0,0.012352564
4388,119,20732,10,4,0,10,0,24,9,2,10,0,0,21,nowin,loss,bust,plbust,0,10,14,190,0.405263158,0.068421053,0.515789474,0,0.011837158
4389,98,20732,9,10,0,0,0,19,9,2,10,0,0,21,nowin,loss,beat,dlwin,0,10,19,220,0.422727273,0.054545455,0.55,1,0.28664435
4390,105,20732,4,5,4,7,0,20,9,2,10,0,0,21,nowin,loss,beat,dlwin,0,10,9,198,0.414141414,0.070707071,0.590909091,0,0.032889494
4391,128,20732,10,9,0,0,0,19,9,2,10,0,0,21,nowin,loss,beat,dlwin,0,10,19,227,0.356828194,0.052863436,0.577092511,0,0.012352564
4392,2,20733,10,10,0,0,0,20,6,11,0,0,0,17,nowin,win,plwin,beat,20,0,20,200,0.445,0.035,0.64,2,0.633962549
4393,70,20733,5,10,0,0,0,15,6,11,0,0,0,17,nowin,loss,beat,dlwin,0,10,15,228,0.385964912,0.039473684,0.557017544,0,0.016157125
4394,87,20733,8,10,0,0,0,18,6,11,0,0,0,17,nowin,win,plwin,beat,20,0,18,202,0.405940594,0.054455446,0.628712871,2,0.590599801
4395,118,20733,5,4,4,0,0,13,6,11,0,0,0,17,nowin,loss,beat,dlwin,0,10,9,216,0.393518519,0.037037037,0.555555556,0,0.018059873
4396,104,20733,10,11,0,0,0,21,6,11,0,0,0,17,win,win,plwin,beat,25,0,21,209,0.363636364,0.052631579,0.593301435,0,0.018359419
4397,76,20733,10,10,0,0,0,20,6,11,0,0,0,17,nowin,win,plwin,beat,20,0,20,189,0.534391534,0.079365079,0.608465608,3,1
4398,96,20734,2,5,3,3,4,17,10,10,0,0,0,20,nowin,loss,beat,dlwin,0,10,7,190,0.468421053,0.057894737,0.584210526,3,0.897263354
4399,51,20734,10,8,0,0,0,18,10,10,0,0,0,20,nowin,loss,beat,dlwin,0,10,18,189,0.529100529,0.068783069,0.608465608,3,0.993665715
4400,136,20734,1,1,10,9,0,21,10,10,0,0,0,20,nowin,win,plwin,beat,20,0,2,194,0.396907216,0.025773196,0.597938144,0,0.029452644
4401,15,20734,10,5,0,9,0,24,10,10,0,0,0,20,nowin,loss,bust,plbust,0,10,15,212,0.410377358,0.051886792,0.561320755,0,0.024517408
4402,70,20734,10,10,0,0,0,20,10,10,0,0,0,20,nowin,push,push,push,10,0,20,228,0.385964912,0.039473684,0.557017544,0,0.016157125
4403,34,20734,3,8,10,0,0,21,10,10,0,0,0,20,nowin,win,plwin,beat,20,0,11,202,0.5,0.079207921,0.618811881,3,0.968961434
4404,134,20735,3,10,0,8,0,21,8,11,0,0,0,19,nowin,win,plwin,beat,20,0,13,185,0.443243243,0.021621622,0.545945946,1,0.296939509
4405,137,20735,9,8,0,0,0,17,8,11,0,0,0,19,nowin,loss,beat,dlwin,0,10,17,194,0.417525773,0.046391753,0.536082474,1,0.276714602
4406,116,20735,6,1,10,0,0,17,8,11,0,0,0,19,nowin,loss,beat,dlwin,0,10,7,195,0.425641026,0.056410256,0.538461538,1,0.28273747
4407,49,20735,9,9,0,0,0,18,8,11,0,0,0,19,nowin,loss,beat,dlwin,0,10,18,207,0.396135266,0.053140097,0.594202899,0,0.028306925
4408,104,20735,10,5,0,4,0,19,8,11,0,0,0,19,nowin,push,push,push,10,0,15,209,0.363636364,0.052631579,0.593301435,0,0.018359419
4409,79,20735,10,9,0,0,0,19,8,11,0,0,0,19,nowin,push,push,push,10,0,19,211,0.436018957,0.028436019,0.672985782,2,0.650131054
4410,144,20736,7,2,2,3,4,18,10,3,9,0,0,22,nowin,win,dlbust,bust,20,0,9,202,0.386138614,0.054455446,0.564356436,0,0.018006244
4411,95,20736,7,8,0,5,0,20,10,3,9,0,0,22,nowin,win,dlbust,bust,20,0,15,218,0.412844037,0.04587156,0.559633028,0,0.024842385
4412,89,20736,6,8,0,6,0,20,10,3,9,0,0,22,nowin,win,dlbust,bust,20,0,14,212,0.537735849,0.047169811,0.594339623,3,0.990167191
4413,96,20736,4,10,0,10,0,24,10,3,9,0,0,22,nowin,loss,bust,plbust,0,10,14,190,0.468421053,0.057894737,0.584210526,3,0.897263354
4414,119,20736,8,5,0,6,0,19,10,3,9,0,0,22,nowin,win,dlbust,bust,20,0,13,190,0.405263158,0.068421053,0.515789474,0,0.011837158
4415,43,20736,4,2,10,10,0,26,10,3,9,0,0,22,nowin,loss,bust,plbust,0,10,6,192,0.40625,0.041666667,0.609375,2,0.576671372
4416,108,20737,5,4,8,0,0,17,4,10,1,10,0,25,nowin,win,dlbust,bust,20,0,9,193,0.435233161,0.056994819,0.559585492,1,0.298824795
4417,9,20737,9,7,0,0,0,16,4,10,1,10,0,25,nowin,win,dlbust,bust,20,0,16,194,0.37628866,0.015463918,0.541237113,0,0.009396796
4418,125,20737,10,5,0,0,0,15,4,10,1,10,0,25,nowin,win,dlbust,bust,20,0,15,219,0.438356164,0.050228311,0.575342466,1,0.308411257
4419,149,20737,10,8,0,0,0,18,4,10,1,10,0,25,nowin,win,dlbust,bust,20,0,18,225,0.457777778,0.057777778,0.648888889,2,0.651965595
4420,150,20737,11,8,0,0,0,19,4,10,1,10,0,25,nowin,win,dlbust,bust,20,0,19,192,0.401041667,0.036458333,0.567708333,0,0.023287458
4421,85,20737,10,9,0,0,0,19,4,10,1,10,0,25,nowin,win,dlbust,bust,20,0,19,195,0.41025641,0.066666667,0.594871795,0,0.03269711
4422,8,20738,10,4,0,4,0,18,10,5,7,0,0,22,nowin,win,dlbust,bust,20,0,14,181,0.44198895,0.071823204,0.596685083,2,0.599438402
4423,36,20738,9,10,0,0,0,19,10,5,7,0,0,22,nowin,win,dlbust,bust,20,0,19,229,0.445414847,0.056768559,0.655021834,2,0.645370571
4424,97,20738,11,7,0,0,0,18,10,5,7,0,0,22,nowin,win,dlbust,bust,20,0,18,182,0.450549451,0.06043956,0.692307692,2,0.677372279
4425,42,20738,10,10,0,0,0,20,10,5,7,0,0,22,nowin,win,dlbust,bust,20,0,20,212,0.443396226,0.051886792,0.570754717,1,0.309181312
4426,81,20738,10,7,0,0,0,17,10,5,7,0,0,22,nowin,win,dlbust,bust,20,0,17,182,0.395604396,0.043956044,0.60989011,2,0.567491261
4427,36,20738,3,10,0,10,0,23,10,5,7,0,0,22,nowin,loss,bust,plbust,0,10,13,229,0.445414847,0.056768559,0.655021834,2,0.645370571
4428,91,20739,5,10,0,1,7,23,9,2,8,0,0,19,nowin,loss,bust,plbust,0,10,15,194,0.417525773,0.046391753,0.515463918,1,0.266616552
4429,139,20739,5,4,10,0,0,19,9,2,8,0,0,19,nowin,push,push,push,10,0,9,192,0.380208333,0.036458333,0.59375,0,0.023429169
4430,128,20739,8,10,0,0,0,18,9,2,8,0,0,19,nowin,loss,beat,dlwin,0,10,18,227,0.356828194,0.052863436,0.577092511,0,0.012352564
4431,74,20739,7,3,8,0,0,18,9,2,8,0,0,19,nowin,loss,beat,dlwin,0,10,10,209,0.411483254,0.04784689,0.531100478,0,0.017448125
4432,111,20739,3,10,0,6,0,19,9,2,8,0,0,19,nowin,push,push,push,10,0,13,180,0.433333333,0.055555556,0.611111111,2,0.602264492
4433,105,20739,11,9,0,0,0,20,9,2,8,0,0,19,nowin,win,plwin,beat,20,0,20,198,0.414141414,0.070707071,0.590909091,0,0.032889494
4434,46,20740,2,11,1,10,0,24,7,7,9,0,0,23,nowin,loss,bust,plbust,0,10,13,186,0.403225806,0.048387097,0.591397849,0,0.029742194
4435,65,20740,3,5,10,0,0,18,7,7,9,0,0,23,nowin,win,dlbust,bust,20,0,8,203,0.492610837,0.054187192,0.571428571,3,0.913702814
4436,60,20740,3,10,0,5,0,18,7,7,9,0,0,23,nowin,win,dlbust,bust,20,0,13,227,0.418502203,0.022026432,0.559471366,0,0.026496258
4437,16,20740,3,11,5,0,0,19,7,7,9,0,0,23,nowin,win,dlbust,bust,20,0,14,220,0.427272727,0.081818182,0.6,2,0.588660176
4438,85,20740,10,4,0,1,8,23,7,7,9,0,0,23,nowin,loss,bust,plbust,0,10,14,195,0.41025641,0.066666667,0.594871795,0,0.03269711
4439,136,20740,7,10,0,0,0,17,7,7,9,0,0,23,nowin,win,dlbust,bust,20,0,17,194,0.396907216,0.025773196,0.597938144,0,0.029452644
4440,126,20741,2,10,0,0,0,12,6,10,1,0,0,17,nowin,loss,beat,dlwin,0,10,12,188,0.457446809,0.074468085,0.60106383,3,0.900633203
4441,123,20741,11,4,2,0,0,17,6,10,1,0,0,17,nowin,push,push,push,10,0,15,205,0.43902439,0.034146341,0.614634146,2,0.609962544
4442,76,20741,3,7,2,0,0,12,6,10,1,0,0,17,nowin,loss,beat,dlwin,0,10,10,189,0.534391534,0.079365079,0.608465608,3,1
4443,136,20741,3,9,0,0,0,12,6,10,1,0,0,17,nowin,loss,beat,dlwin,0,10,12,194,0.396907216,0.025773196,0.597938144,0,0.029452644
4444,24,20741,7,4,9,0,0,20,6,10,1,0,0,17,nowin,win,plwin,beat,20,0,11,207,0.458937198,0.048309179,0.570048309,1,0.318138014
4445,30,20741,10,3,0,0,0,13,6,10,1,0,0,17,nowin,loss,beat,dlwin,0,10,13,206,0.393203883,0.033980583,0.601941748,0,0.029324648
4446,37,20742,7,10,0,0,0,17,10,3,10,0,0,23,nowin,win,dlbust,bust,20,0,17,208,0.394230769,0.038461538,0.581730769,0,0.024682772
4447,52,20742,3,6,10,0,0,19,10,3,10,0,0,23,nowin,win,dlbust,bust,20,0,9,217,0.414746544,0.02764977,0.599078341,2,0.576736024
4448,86,20742,9,10,0,0,0,19,10,3,10,0,0,23,nowin,win,dlbust,bust,20,0,19,196,0.454081633,0.040816327,0.591836735,3,0.887566443
4449,122,20742,2,10,0,10,0,22,10,3,10,0,0,23,nowin,loss,bust,plbust,0,10,12,210,0.347619048,0.052380952,0.59047619,0,0.012873677
4450,88,20742,10,7,0,0,0,17,10,3,10,0,0,23,nowin,win,dlbust,bust,20,0,17,206,0.466019417,0.033980583,0.54368932,1,0.309467903
4451,126,20742,10,10,0,0,0,20,10,3,10,0,0,23,nowin,win,dlbust,bust,20,0,20,188,0.457446809,0.074468085,0.60106383,3,0.900633203
4452,92,20743,6,7,0,0,0,13,4,9,10,0,0,23,nowin,win,dlbust,bust,20,0,13,186,0.446236559,0.059139785,0.564516129,1,0.307826125
4453,124,20743,8,5,0,0,0,13,4,9,10,0,0,23,nowin,win,dlbust,bust,20,0,13,202,0.47029703,0.064356436,0.584158416,3,0.899458193
4454,110,20743,10,2,0,0,0,12,4,9,10,0,0,23,nowin,win,dlbust,bust,20,0,12,192,0.416666667,0.046875,0.557291667,0,0.025413132
4455,9,20743,11,6,1,0,0,18,4,9,10,0,0,23,nowin,win,dlbust,bust,20,0,17,194,0.37628866,0.015463918,0.541237113,0,0.009396796
4456,60,20743,3,9,0,0,0,12,4,9,10,0,0,23,nowin,win,dlbust,bust,20,0,12,227,0.418502203,0.022026432,0.559471366,0,0.026496258
4457,49,20743,9,4,0,0,0,13,4,9,10,0,0,23,nowin,win,dlbust,bust,20,0,13,207,0.396135266,0.053140097,0.594202899,0,0.028306925
4458,66,20744,7,6,0,0,0,13,3,3,4,10,0,20,nowin,loss,beat,dlwin,0,10,13,217,0.456221198,0.064516129,0.626728111,3,0.924304367
4459,150,20744,5,10,0,0,0,15,3,3,4,10,0,20,nowin,loss,beat,dlwin,0,10,15,192,0.401041667,0.036458333,0.567708333,0,0.023287458
4460,90,20744,10,7,0,0,0,17,3,3,4,10,0,20,nowin,loss,beat,dlwin,0,10,17,201,0.447761194,0.049751244,0.60199005,3,0.889945023
4461,106,20744,8,10,0,0,0,18,3,3,4,10,0,20,nowin,loss,beat,dlwin,0,10,18,192,0.411458333,0.026041667,0.557291667,0,0.023854304
4462,95,20744,9,8,0,0,0,17,3,3,4,10,0,20,nowin,loss,beat,dlwin,0,10,17,218,0.412844037,0.04587156,0.559633028,0,0.024842385
4463,44,20744,2,10,0,7,0,19,3,3,4,10,0,20,nowin,loss,beat,dlwin,0,10,12,219,0.433789954,0.050228311,0.534246575,1,0.285551035
4464,74,20745,2,10,0,0,0,12,5,7,10,0,0,22,nowin,win,dlbust,bust,20,0,12,209,0.411483254,0.04784689,0.531100478,0,0.017448125
4465,94,20745,11,2,7,0,0,20,5,7,10,0,0,22,nowin,win,dlbust,bust,20,0,13,183,0.43715847,0.043715847,0.540983607,1,0.290866892
4466,81,20745,3,6,9,0,0,18,5,7,10,0,0,22,nowin,win,dlbust,bust,20,0,9,182,0.395604396,0.043956044,0.60989011,2,0.567491261
4467,28,20745,6,1,10,0,0,17,5,7,10,0,0,22,nowin,win,dlbust,bust,20,0,7,199,0.422110553,0.045226131,0.542713568,1,0.282706618
4468,4,20745,5,11,1,0,0,17,5,7,10,0,0,22,nowin,win,dlbust,bust,20,0,16,217,0.460829493,0.036866359,0.562211982,1,0.315432839
4469,103,20745,7,3,8,0,0,18,5,7,10,0,0,22,nowin,win,dlbust,bust,20,0,10,203,0.379310345,0.064039409,0.551724138,0,0.012869209
4470,126,20746,9,6,0,10,0,25,8,5,8,0,0,21,nowin,loss,bust,plbust,0,10,15,188,0.457446809,0.074468085,0.60106383,3,0.900633203
4471,68,20746,3,10,0,7,0,20,8,5,8,0,0,21,nowin,loss,beat,dlwin,0,10,13,205,0.434146341,0.029268293,0.6,2,0.59483189
4472,100,20746,8,4,0,1,10,23,8,5,8,0,0,21,nowin,loss,bust,plbust,0,10,12,190,0.452631579,0.036842105,0.594736842,3,0.888671154
4473,141,20746,4,10,0,1,10,25,8,5,8,0,0,21,nowin,loss,bust,plbust,0,10,14,202,0.420792079,0.074257426,0.564356436,0,0.028377851
4474,45,20746,9,10,0,0,0,19,8,5,8,0,0,21,nowin,loss,beat,dlwin,0,10,19,196,0.428571429,0.051020408,0.612244898,2,0.598821767
4475,59,20746,11,10,0,0,0,21,8,5,8,0,0,21,win,push,push,push,10,0,21,228,0.429824561,0.048245614,0.543859649,1,0.287885446
4476,4,20747,7,10,0,0,0,17,10,6,6,0,0,22,nowin,win,dlbust,bust,20,0,17,217,0.460829493,0.036866359,0.562211982,1,0.315432839
4477,24,20747,10,3,0,8,0,21,10,6,6,0,0,22,nowin,win,dlbust,bust,20,0,13,207,0.458937198,0.048309179,0.570048309,1,0.318138014
4478,38,20747,10,3,0,8,0,21,10,6,6,0,0,22,nowin,win,dlbust,bust,20,0,13,202,0.361386139,0.03960396,0.564356436,0,0.010597953
4479,37,20747,10,10,0,0,0,20,10,6,6,0,0,22,nowin,win,dlbust,bust,20,0,20,208,0.394230769,0.038461538,0.581730769,0,0.024682772
4480,77,20747,10,10,0,0,0,20,10,6,6,0,0,22,nowin,win,dlbust,bust,20,0,20,200,0.455,0.04,0.62,3,0.916252116
4481,54,20747,6,4,9,0,0,19,10,6,6,0,0,22,nowin,win,dlbust,bust,20,0,10,185,0.437837838,0.032432432,0.556756757,1,0.29899854
4482,7,20748,9,10,0,0,0,19,8,9,0,0,0,17,nowin,win,plwin,beat,20,0,19,183,0.442622951,0.06010929,0.62295082,2,0.619303341
4483,56,20748,7,10,0,0,0,17,8,9,0,0,0,17,nowin,push,push,push,10,0,17,175,0.4,0.057142857,0.582857143,0,0.026685297
4484,59,20748,10,10,0,0,0,20,8,9,0,0,0,17,nowin,win,plwin,beat,20,0,20,228,0.429824561,0.048245614,0.543859649,1,0.287885446
4485,66,20748,10,7,0,0,0,17,8,9,0,0,0,17,nowin,push,push,push,10,0,17,217,0.456221198,0.064516129,0.626728111,3,0.924304367
4486,22,20748,10,6,0,9,0,25,8,9,0,0,0,17,nowin,loss,bust,plbust,0,10,16,187,0.481283422,0.042780749,0.577540107,3,0.906128176
4487,38,20748,9,11,0,0,0,20,8,9,0,0,0,17,nowin,win,plwin,beat,20,0,20,202,0.361386139,0.03960396,0.564356436,0,0.010597953
4488,101,20749,6,10,0,0,0,16,6,3,3,5,0,17,nowin,loss,beat,dlwin,0,10,16,205,0.424390244,0.068292683,0.63902439,2,0.614740646
4489,136,20749,5,9,0,0,0,14,6,3,3,5,0,17,nowin,loss,beat,dlwin,0,10,14,194,0.396907216,0.025773196,0.597938144,0,0.029452644
4490,102,20749,10,7,0,0,0,17,6,3,3,5,0,17,nowin,push,push,push,10,0,17,192,0.338541667,0.046875,0.5625,0,0.003306118
4491,139,20749,3,8,9,0,0,20,6,3,3,5,0,17,nowin,win,plwin,beat,20,0,11,192,0.380208333,0.036458333,0.59375,0,0.023429169
4492,69,20749,4,9,0,0,0,13,6,3,3,5,0,17,nowin,loss,beat,dlwin,0,10,13,194,0.365979381,0.030927835,0.515463918,0,0
4493,44,20749,6,10,0,0,0,16,6,3,3,5,0,17,nowin,loss,beat,dlwin,0,10,16,219,0.433789954,0.050228311,0.534246575,1,0.285551035
4494,93,20750,9,10,0,0,0,19,1,3,10,10,0,24,nowin,win,dlbust,bust,20,0,19,175,0.485714286,0.051428571,0.548571429,1,0.323648091
4495,19,20750,10,5,0,4,0,19,1,3,10,10,0,24,nowin,win,dlbust,bust,20,0,15,237,0.41350211,0.054852321,0.628691983,2,0.597373826
4496,143,20750,10,2,0,3,3,18,1,3,10,10,0,24,nowin,win,dlbust,bust,20,0,12,203,0.463054187,0.044334975,0.57635468,3,0.883143365
4497,65,20750,9,5,0,9,0,23,1,3,10,10,0,24,nowin,loss,bust,plbust,0,10,14,203,0.492610837,0.054187192,0.571428571,3,0.913702814
4498,132,20750,5,3,10,0,0,18,1,3,10,10,0,24,nowin,win,dlbust,bust,20,0,8,194,0.412371134,0.036082474,0.649484536,2,0.611633238
4499,39,20750,6,10,0,4,0,20,1,3,10,10,0,24,nowin,win,dlbust,bust,20,0,16,191,0.429319372,0.062827225,0.57591623,0,0.033760763
4500,102,20751,11,1,1,0,0,13,5,7,6,0,0,18,nowin,loss,beat,dlwin,0,10,12,192,0.338541667,0.046875,0.5625,0,0.003306118
4501,80,20751,9,11,0,0,0,20,5,7,6,0,0,18,nowin,win,plwin,beat,20,0,20,186,0.419354839,0.059139785,0.623655914,2,0.59892924
4502,84,20751,6,10,0,0,0,16,5,7,6,0,0,18,nowin,loss,beat,dlwin,0,10,16,195,0.379487179,0.056410256,0.569230769,0,0.017209119
4503,58,20751,10,3,0,0,0,13,5,7,6,0,0,18,nowin,loss,beat,dlwin,0,10,13,195,0.430769231,0.041025641,0.584615385,2,0.580497586
4504,19,20751,6,3,10,0,0,19,5,7,6,0,0,18,nowin,win,plwin,beat,20,0,9,237,0.41350211,0.054852321,0.628691983,2,0.597373826
4505,44,20751,11,7,0,0,0,18,5,7,6,0,0,18,nowin,push,push,push,10,0,18,219,0.433789954,0.050228311,0.534246575,1,0.285551035
4506,119,20752,10,6,0,7,0,23,10,7,0,0,0,17,nowin,loss,bust,plbust,0,10,16,190,0.405263158,0.068421053,0.515789474,0,0.011837158
4507,114,20752,6,6,0,6,0,18,10,7,0,0,0,17,nowin,win,plwin,beat,20,0,12,198,0.47979798,0.025252525,0.611111111,3,0.937232995
4508,8,20752,9,10,0,0,0,19,10,7,0,0,0,17,nowin,win,plwin,beat,20,0,19,181,0.44198895,0.071823204,0.596685083,2,0.599438402
4509,98,20752,10,2,0,4,9,25,10,7,0,0,0,17,nowin,loss,bust,plbust,0,10,12,220,0.422727273,0.054545455,0.55,1,0.28664435
4510,106,20752,10,10,0,0,0,20,10,7,0,0,0,17,nowin,win,plwin,beat,20,0,20,192,0.411458333,0.026041667,0.557291667,0,0.023854304
4511,28,20752,9,3,0,4,4,20,10,7,0,0,0,17,nowin,win,plwin,beat,20,0,12,199,0.422110553,0.045226131,0.542713568,1,0.282706618
4512,107,20753,10,7,0,0,0,17,8,10,0,0,0,18,nowin,loss,beat,dlwin,0,10,17,218,0.444954128,0.073394495,0.600917431,2,0.605210014
4513,126,20753,9,2,9,0,0,20,8,10,0,0,0,18,nowin,win,plwin,beat,20,0,11,188,0.457446809,0.074468085,0.60106383,3,0.900633203
4514,34,20753,9,8,0,0,0,17,8,10,0,0,0,18,nowin,loss,beat,dlwin,0,10,17,202,0.5,0.079207921,0.618811881,3,0.968961434
4515,140,20753,9,11,0,0,0,20,8,10,0,0,0,18,nowin,win,plwin,beat,20,0,20,210,0.466666667,0.023809524,0.604761905,3,0.915293335
4516,116,20753,10,11,0,0,0,21,8,10,0,0,0,18,win,win,plwin,beat,25,0,21,195,0.425641026,0.056410256,0.538461538,1,0.28273747
4517,134,20753,9,5,0,3,0,17,8,10,0,0,0,18,nowin,loss,beat,dlwin,0,10,14,185,0.443243243,0.021621622,0.545945946,1,0.296939509
4518,124,20754,7,9,0,0,0,16,6,10,5,0,0,21,nowin,loss,beat,dlwin,0,10,16,202,0.47029703,0.064356436,0.584158416,3,0.899458193
4519,137,20754,3,7,10,0,0,20,6,10,5,0,0,21,nowin,loss,beat,dlwin,0,10,10,194,0.417525773,0.046391753,0.536082474,1,0.276714602
4520,78,20754,10,9,0,0,0,19,6,10,5,0,0,21,nowin,loss,beat,dlwin,0,10,19,201,0.517412935,0.034825871,0.587064677,3,0.95871112
4521,91,20754,9,9,0,0,0,18,6,10,5,0,0,21,nowin,loss,beat,dlwin,0,10,18,194,0.417525773,0.046391753,0.515463918,1,0.266616552
4522,38,20754,10,10,0,0,0,20,6,10,5,0,0,21,nowin,loss,beat,dlwin,0,10,20,202,0.361386139,0.03960396,0.564356436,0,0.010597953
4523,2,20754,10,4,0,0,0,14,6,10,5,0,0,21,nowin,loss,beat,dlwin,0,10,14,200,0.445,0.035,0.64,2,0.633962549
4524,57,20755,7,10,0,0,0,17,11,10,0,0,0,21,nowin,loss,beat,dlwin,0,10,17,192,0.46875,0.052083333,0.59375,3,0.907001181
4525,45,20755,10,10,0,0,0,20,11,10,0,0,0,21,nowin,loss,beat,dlwin,0,10,20,196,0.428571429,0.051020408,0.612244898,2,0.598821767
4526,56,20755,11,7,0,0,0,18,11,10,0,0,0,21,nowin,loss,beat,dlwin,0,10,18,175,0.4,0.057142857,0.582857143,0,0.026685297
4527,84,20755,7,10,0,0,0,17,11,10,0,0,0,21,nowin,loss,beat,dlwin,0,10,17,195,0.379487179,0.056410256,0.569230769,0,0.017209119
4528,145,20755,8,4,0,4,10,26,11,10,0,0,0,21,nowin,loss,bust,plbust,0,10,12,188,0.441489362,0.031914894,0.622340426,2,0.617837093
4529,149,20755,7,2,10,0,0,19,11,10,0,0,0,21,nowin,loss,beat,dlwin,0,10,9,225,0.457777778,0.057777778,0.648888889,2,0.651965595
4530,134,20756,7,9,0,5,0,21,10,10,0,0,0,20,nowin,win,plwin,beat,20,0,16,185,0.443243243,0.021621622,0.545945946,1,0.296939509
4531,2,20756,9,7,0,10,0,26,10,10,0,0,0,20,nowin,loss,bust,plbust,0,10,16,200,0.445,0.035,0.64,2,0.633962549
4532,68,20756,7,7,0,5,0,19,10,10,0,0,0,20,nowin,loss,beat,dlwin,0,10,14,205,0.434146341,0.029268293,0.6,2,0.59483189
4533,55,20756,10,10,0,0,0,20,10,10,0,0,0,20,nowin,push,push,push,10,0,20,191,0.371727749,0.057591623,0.54973822,0,0.01011347
4534,60,20756,7,7,0,5,0,19,10,10,0,0,0,20,nowin,loss,beat,dlwin,0,10,14,227,0.418502203,0.022026432,0.559471366,0,0.026496258
4535,56,20756,4,10,0,8,0,22,10,10,0,0,0,20,nowin,loss,bust,plbust,0,10,14,175,0.4,0.057142857,0.582857143,0,0.026685297
4536,33,20757,4,9,0,0,0,13,2,1,9,10,0,22,nowin,win,dlbust,bust,20,0,13,192,0.4375,0.057291667,0.625,2,0.616208916
4537,137,20757,7,5,0,10,0,22,2,1,9,10,0,22,nowin,loss,bust,plbust,0,10,12,194,0.417525773,0.046391753,0.536082474,1,0.276714602
4538,115,20757,10,2,0,2,0,14,2,1,9,10,0,22,nowin,win,dlbust,bust,20,0,12,194,0.427835052,0.041237113,0.592783505,2,0.583863602
4539,18,20757,10,9,0,0,0,19,2,1,9,10,0,22,nowin,win,dlbust,bust,20,0,19,182,0.461538462,0.043956044,0.587912088,3,0.892649374
4540,34,20757,6,10,0,0,0,16,2,1,9,10,0,22,nowin,win,dlbust,bust,20,0,16,202,0.5,0.079207921,0.618811881,3,0.968961434
4541,23,20757,10,5,0,0,0,15,2,1,9,10,0,22,nowin,win,dlbust,bust,20,0,15,208,0.427884615,0.0625,0.552884615,1,0.29114424
4542,102,20758,11,10,0,0,0,21,8,5,6,0,0,19,win,win,plwin,beat,25,0,21,192,0.338541667,0.046875,0.5625,0,0.003306118
4543,109,20758,11,10,0,0,0,21,8,5,6,0,0,19,win,win,plwin,beat,25,0,21,221,0.461538462,0.058823529,0.597285068,3,0.901830309
4544,33,20758,10,7,0,0,0,17,8,5,6,0,0,19,nowin,loss,beat,dlwin,0,10,17,192,0.4375,0.057291667,0.625,2,0.616208916
4545,43,20758,10,3,0,5,0,18,8,5,6,0,0,19,nowin,loss,beat,dlwin,0,10,13,192,0.40625,0.041666667,0.609375,2,0.576671372
4546,114,20758,10,8,0,0,0,18,8,5,6,0,0,19,nowin,loss,beat,dlwin,0,10,18,198,0.47979798,0.025252525,0.611111111,3,0.937232995
4547,119,20758,8,10,0,0,0,18,8,5,6,0,0,19,nowin,loss,beat,dlwin,0,10,18,190,0.405263158,0.068421053,0.515789474,0,0.011837158
4548,39,20759,5,10,0,0,0,15,3,1,9,5,0,18,nowin,loss,beat,dlwin,0,10,15,191,0.429319372,0.062827225,0.57591623,0,0.033760763
4549,22,20759,9,10,0,0,0,19,3,1,9,5,0,18,nowin,win,plwin,beat,20,0,19,187,0.481283422,0.042780749,0.577540107,3,0.906128176
4550,39,20759,10,10,0,0,0,20,3,1,9,5,0,18,nowin,win,plwin,beat,20,0,20,191,0.429319372,0.062827225,0.57591623,0,0.033760763
4551,69,20759,10,8,0,0,0,18,3,1,9,5,0,18,nowin,push,push,push,10,0,18,194,0.365979381,0.030927835,0.515463918,0,0
4552,113,20759,10,8,0,0,0,18,3,1,9,5,0,18,nowin,push,push,push,10,0,18,199,0.407035176,0.055276382,0.668341709,2,0.620695264
4553,55,20759,3,9,0,4,0,16,3,1,9,5,0,18,nowin,loss,beat,dlwin,0,10,12,191,0.371727749,0.057591623,0.54973822,0,0.01011347
4554,131,20760,4,10,0,7,0,21,9,10,0,0,0,19,nowin,win,plwin,beat,20,0,14,217,0.410138249,0.069124424,0.543778802,0,0.02015021
4555,127,20760,4,5,9,0,0,18,9,10,0,0,0,19,nowin,loss,beat,dlwin,0,10,9,201,0.402985075,0.029850746,0.60199005,0,0.032263937
4556,92,20760,8,9,0,0,0,17,9,10,0,0,0,19,nowin,loss,beat,dlwin,0,10,17,186,0.446236559,0.059139785,0.564516129,1,0.307826125
4557,121,20760,8,9,0,0,0,17,9,10,0,0,0,19,nowin,loss,beat,dlwin,0,10,17,195,0.456410256,0.025641026,0.512820513,1,0.288597791
4558,30,20760,10,5,0,9,0,24,9,10,0,0,0,19,nowin,loss,bust,plbust,0,10,15,206,0.393203883,0.033980583,0.601941748,0,0.029324648
4559,99,20760,8,11,0,0,0,19,9,10,0,0,0,19,nowin,push,push,push,10,0,19,207,0.47826087,0.062801932,0.637681159,3,0.961418446
4560,99,20761,10,2,0,10,0,22,2,6,9,0,0,17,nowin,loss,bust,plbust,0,10,12,207,0.47826087,0.062801932,0.637681159,3,0.961418446
4561,87,20761,10,5,0,0,0,15,2,6,9,0,0,17,nowin,loss,beat,dlwin,0,10,15,202,0.405940594,0.054455446,0.628712871,2,0.590599801
4562,134,20761,11,9,0,0,0,20,2,6,9,0,0,17,nowin,win,plwin,beat,20,0,20,185,0.443243243,0.021621622,0.545945946,1,0.296939509
4563,21,20761,9,8,0,0,0,17,2,6,9,0,0,17,nowin,push,push,push,10,0,17,214,0.359813084,0.042056075,0.626168224,0,0.025263474
4564,12,20761,9,10,0,0,0,19,2,6,9,0,0,17,nowin,win,plwin,beat,20,0,19,189,0.470899471,0.015873016,0.613756614,3,0.929171178
4565,9,20761,7,10,0,0,0,17,2,6,9,0,0,17,nowin,push,push,push,10,0,17,194,0.37628866,0.015463918,0.541237113,0,0.009396796
4566,139,20762,3,3,10,10,0,26,10,2,10,0,0,22,nowin,loss,bust,plbust,0,10,6,192,0.380208333,0.036458333,0.59375,0,0.023429169
4567,149,20762,7,10,0,0,0,17,10,2,10,0,0,22,nowin,win,dlbust,bust,20,0,17,225,0.457777778,0.057777778,0.648888889,2,0.651965595
4568,118,20762,6,11,1,0,0,18,10,2,10,0,0,22,nowin,win,dlbust,bust,20,0,17,216,0.393518519,0.037037037,0.555555556,0,0.018059873
4569,110,20762,8,4,0,4,10,26,10,2,10,0,0,22,nowin,loss,bust,plbust,0,10,12,192,0.416666667,0.046875,0.557291667,0,0.025413132
4570,116,20762,2,10,0,8,0,20,10,2,10,0,0,22,nowin,win,dlbust,bust,20,0,12,195,0.425641026,0.056410256,0.538461538,1,0.28273747
4571,29,20762,9,8,0,0,0,17,10,2,10,0,0,22,nowin,win,dlbust,bust,20,0,17,189,0.44973545,0.058201058,0.544973545,1,0.300349439
4572,130,20763,11,10,0,0,0,21,6,10,2,0,0,18,win,win,plwin,beat,25,0,21,219,0.410958904,0.03652968,0.566210046,0,0.025888739
4573,148,20763,7,6,0,0,0,13,6,10,2,0,0,18,nowin,loss,beat,dlwin,0,10,13,204,0.401960784,0.078431373,0.593137255,0,0.029789521
4574,60,20763,10,10,0,0,0,20,6,10,2,0,0,18,nowin,win,plwin,beat,20,0,20,227,0.418502203,0.022026432,0.559471366,0,0.026496258
4575,55,20763,10,2,0,0,0,12,6,10,2,0,0,18,nowin,loss,beat,dlwin,0,10,12,191,0.371727749,0.057591623,0.54973822,0,0.01011347
4576,83,20763,10,8,0,0,0,18,6,10,2,0,0,18,nowin,push,push,push,10,0,18,193,0.424870466,0.051813472,0.678756477,2,0.644360335
4577,88,20763,5,2,11,0,0,18,6,10,2,0,0,18,nowin,push,push,push,10,0,7,206,0.466019417,0.033980583,0.54368932,1,0.309467903
4578,68,20764,10,8,0,0,0,18,7,10,0,0,0,17,nowin,win,plwin,beat,20,0,18,205,0.434146341,0.029268293,0.6,2,0.59483189
4579,84,20764,11,6,2,0,0,19,7,10,0,0,0,17,nowin,win,plwin,beat,20,0,17,195,0.379487179,0.056410256,0.569230769,0,0.017209119
4580,123,20764,7,11,0,0,0,18,7,10,0,0,0,17,nowin,win,plwin,beat,20,0,18,205,0.43902439,0.034146341,0.614634146,2,0.609962544
4581,85,20764,5,10,0,1,10,26,7,10,0,0,0,17,nowin,loss,bust,plbust,0,10,15,195,0.41025641,0.066666667,0.594871795,0,0.03269711
4582,89,20764,1,5,10,2,0,18,7,10,0,0,0,17,nowin,win,plwin,beat,20,0,6,212,0.537735849,0.047169811,0.594339623,3,0.990167191
4583,2,20764,10,10,0,0,0,20,7,10,0,0,0,17,nowin,win,plwin,beat,20,0,20,200,0.445,0.035,0.64,2,0.633962549
4584,18,20765,6,6,0,2,10,24,7,5,3,1,1,17,nowin,loss,bust,plbust,0,10,12,182,0.461538462,0.043956044,0.587912088,3,0.892649374
4585,130,20765,1,5,9,10,0,25,7,5,3,1,1,17,nowin,loss,bust,plbust,0,10,6,219,0.410958904,0.03652968,0.566210046,0,0.025888739
4586,145,20765,1,5,8,7,0,21,7,5,3,1,1,17,nowin,win,plwin,beat,20,0,6,188,0.441489362,0.031914894,0.622340426,2,0.617837093
4587,141,20765,10,10,0,0,0,20,7,5,3,1,1,17,nowin,win,plwin,beat,20,0,20,202,0.420792079,0.074257426,0.564356436,0,0.028377851
4588,134,20765,10,10,0,0,0,20,7,5,3,1,1,17,nowin,win,plwin,beat,20,0,20,185,0.443243243,0.021621622,0.545945946,1,0.296939509
4589,61,20765,7,5,0,3,3,18,7,5,3,1,1,17,nowin,win,plwin,beat,20,0,12,194,0.427835052,0.077319588,0.603092784,2,0.591437139
4590,49,20766,5,8,0,0,0,13,2,10,5,0,0,17,nowin,loss,beat,dlwin,0,10,13,207,0.396135266,0.053140097,0.594202899,0,0.028306925
4591,108,20766,6,4,10,0,0,20,2,10,5,0,0,17,nowin,win,plwin,beat,20,0,10,193,0.435233161,0.056994819,0.559585492,1,0.298824795
4592,133,20766,3,9,0,5,0,17,2,10,5,0,0,17,nowin,push,push,push,10,0,12,201,0.47761194,0.064676617,0.611940299,3,0.935428111
4593,62,20766,3,1,10,0,0,14,2,10,5,0,0,17,nowin,loss,beat,dlwin,0,10,4,178,0.370786517,0.028089888,0.54494382,0,0.008657722
4594,76,20766,10,10,0,0,0,20,2,10,5,0,0,17,nowin,win,plwin,beat,20,0,20,189,0.534391534,0.079365079,0.608465608,3,1
4595,63,20766,6,3,6,0,0,15,2,10,5,0,0,17,nowin,loss,beat,dlwin,0,10,9,216,0.467592593,0.037037037,0.62037037,3,0.931690496
4596,45,20767,10,10,0,0,0,20,11,10,0,0,0,21,nowin,loss,beat,dlwin,0,10,20,196,0.428571429,0.051020408,0.612244898,2,0.598821767
4597,7,20767,10,9,0,0,0,19,11,10,0,0,0,21,nowin,loss,beat,dlwin,0,10,19,183,0.442622951,0.06010929,0.62295082,2,0.619303341
4598,34,20767,10,6,0,10,0,26,11,10,0,0,0,21,nowin,loss,bust,plbust,0,10,16,202,0.5,0.079207921,0.618811881,3,0.968961434
4599,40,20767,3,10,0,8,0,21,11,10,0,0,0,21,nowin,push,push,push,10,0,13,196,0.367346939,0.030612245,0.617346939,0,0.025358183
4600,117,20767,5,10,0,8,0,23,11,10,0,0,0,21,nowin,loss,bust,plbust,0,10,15,173,0.410404624,0.069364162,0.606936416,2,0.578610282
4601,32,20767,2,10,0,5,0,17,11,10,0,0,0,21,nowin,loss,beat,dlwin,0,10,12,189,0.391534392,0.037037037,0.53968254,0,0.013579086
4602,141,20768,3,9,0,10,0,22,10,8,0,0,0,18,nowin,loss,bust,plbust,0,10,12,202,0.420792079,0.074257426,0.564356436,0,0.028377851
4603,42,20768,8,9,0,0,0,17,10,8,0,0,0,18,nowin,loss,beat,dlwin,0,10,17,212,0.443396226,0.051886792,0.570754717,1,0.309181312
4604,10,20768,9,7,0,10,0,26,10,8,0,0,0,18,nowin,loss,bust,plbust,0,10,16,191,0.413612565,0.057591623,0.596858639,2,0.574087175
4605,54,20768,11,10,0,0,0,21,10,8,0,0,0,18,win,win,plwin,beat,25,0,21,185,0.437837838,0.032432432,0.556756757,1,0.29899854
4606,92,20768,5,10,0,1,2,18,10,8,0,0,0,18,nowin,push,push,push,10,0,15,186,0.446236559,0.059139785,0.564516129,1,0.307826125
4607,70,20768,10,9,0,0,0,19,10,8,0,0,0,18,nowin,win,plwin,beat,20,0,19,228,0.385964912,0.039473684,0.557017544,0,0.016157125
4608,84,20769,4,10,0,0,0,14,6,7,3,5,0,21,nowin,loss,beat,dlwin,0,10,14,195,0.379487179,0.056410256,0.569230769,0,0.017209119
4609,49,20769,10,3,0,0,0,13,6,7,3,5,0,21,nowin,loss,beat,dlwin,0,10,13,207,0.396135266,0.053140097,0.594202899,0,0.028306925
4610,77,20769,6,10,0,0,0,16,6,7,3,5,0,21,nowin,loss,beat,dlwin,0,10,16,200,0.455,0.04,0.62,3,0.916252116
4611,131,20769,9,10,0,0,0,19,6,7,3,5,0,21,nowin,loss,beat,dlwin,0,10,19,217,0.410138249,0.069124424,0.543778802,0,0.02015021
4612,13,20769,7,11,0,0,0,18,6,7,3,5,0,21,nowin,loss,beat,dlwin,0,10,18,206,0.417475728,0.063106796,0.621359223,2,0.59555479
4613,69,20769,5,7,0,0,0,12,6,7,3,5,0,21,nowin,loss,beat,dlwin,0,10,12,194,0.365979381,0.030927835,0.515463918,0,0
4614,123,20770,10,10,0,0,0,20,2,10,5,0,0,17,nowin,win,plwin,beat,20,0,20,205,0.43902439,0.034146341,0.614634146,2,0.609962544
4615,130,20770,8,5,0,0,0,13,2,10,5,0,0,17,nowin,loss,beat,dlwin,0,10,13,219,0.410958904,0.03652968,0.566210046,0,0.025888739
4616,86,20770,11,9,0,0,0,20,2,10,5,0,0,17,nowin,win,plwin,beat,20,0,20,196,0.454081633,0.040816327,0.591836735,3,0.887566443
4617,23,20770,2,8,11,0,0,21,2,10,5,0,0,17,nowin,win,plwin,beat,20,0,10,208,0.427884615,0.0625,0.552884615,1,0.29114424
4618,132,20770,7,10,0,0,0,17,2,10,5,0,0,17,nowin,push,push,push,10,0,17,194,0.412371134,0.036082474,0.649484536,2,0.611633238
4619,56,20770,4,10,0,0,0,14,2,10,5,0,0,17,nowin,loss,beat,dlwin,0,10,14,175,0.4,0.057142857,0.582857143,0,0.026685297
4620,29,20771,10,6,0,0,0,16,5,2,8,10,0,25,nowin,win,dlbust,bust,20,0,16,189,0.44973545,0.058201058,0.544973545,1,0.300349439
4621,108,20771,2,7,2,8,0,19,5,2,8,10,0,25,nowin,win,dlbust,bust,20,0,9,193,0.435233161,0.056994819,0.559585492,1,0.298824795
4622,5,20771,10,2,0,0,0,12,5,2,8,10,0,25,nowin,win,dlbust,bust,20,0,12,203,0.42364532,0.02955665,0.596059113,2,0.582508076
4623,103,20771,4,4,10,0,0,18,5,2,8,10,0,25,nowin,win,dlbust,bust,20,0,8,203,0.379310345,0.064039409,0.551724138,0,0.012869209
4624,83,20771,10,10,0,0,0,20,5,2,8,10,0,25,nowin,win,dlbust,bust,20,0,20,193,0.424870466,0.051813472,0.678756477,2,0.644360335
4625,36,20771,7,4,10,0,0,21,5,2,8,10,0,25,nowin,win,dlbust,bust,20,0,11,229,0.445414847,0.056768559,0.655021834,2,0.645370571
4626,50,20772,10,5,0,2,0,17,10,4,10,0,0,24,nowin,win,dlbust,bust,20,0,15,202,0.405940594,0.04950495,0.54950495,0,0.020296079
4627,84,20772,4,6,6,5,0,21,10,4,10,0,0,24,nowin,win,dlbust,bust,20,0,10,195,0.379487179,0.056410256,0.569230769,0,0.017209119
4628,22,20772,10,8,0,0,0,18,10,4,10,0,0,24,nowin,win,dlbust,bust,20,0,18,187,0.481283422,0.042780749,0.577540107,3,0.906128176
4629,91,20772,2,10,0,3,7,22,10,4,10,0,0,24,nowin,loss,bust,plbust,0,10,12,194,0.417525773,0.046391753,0.515463918,1,0.266616552
4630,21,20772,10,4,0,10,0,24,10,4,10,0,0,24,nowin,loss,bust,plbust,0,10,14,214,0.359813084,0.042056075,0.626168224,0,0.025263474
4631,28,20772,11,3,4,0,0,18,10,4,10,0,0,24,nowin,win,dlbust,bust,20,0,14,199,0.422110553,0.045226131,0.542713568,1,0.282706618
4632,51,20773,3,10,0,10,0,23,1,4,10,3,0,18,nowin,loss,bust,plbust,0,10,13,189,0.529100529,0.068783069,0.608465608,3,0.993665715
4633,11,20773,4,1,10,10,0,25,1,4,10,3,0,18,nowin,loss,bust,plbust,0,10,5,236,0.457627119,0.016949153,0.588983051,3,0.889015813
4634,76,20773,10,2,0,5,0,17,1,4,10,3,0,18,nowin,loss,beat,dlwin,0,10,12,189,0.534391534,0.079365079,0.608465608,3,1
4635,83,20773,7,10,0,0,0,17,1,4,10,3,0,18,nowin,loss,beat,dlwin,0,10,17,193,0.424870466,0.051813472,0.678756477,2,0.644360335
4636,142,20773,3,10,0,3,7,23,1,4,10,3,0,18,nowin,loss,bust,plbust,0,10,13,211,0.417061611,0.047393365,0.526066351,1,0.271531309
4637,92,20773,2,10,0,2,6,20,1,4,10,3,0,18,nowin,win,plwin,beat,20,0,12,186,0.446236559,0.059139785,0.564516129,1,0.307826125
4638,14,20774,4,10,0,1,3,18,9,2,10,0,0,21,nowin,loss,beat,dlwin,0,10,14,202,0.391089109,0.01980198,0.628712871,2,0.577264877
4639,149,20774,10,11,0,0,0,21,9,2,10,0,0,21,win,push,push,push,10,0,21,225,0.457777778,0.057777778,0.648888889,2,0.651965595
4640,21,20774,10,6,0,2,0,18,9,2,10,0,0,21,nowin,loss,beat,dlwin,0,10,16,214,0.359813084,0.042056075,0.626168224,0,0.025263474
4641,24,20774,10,7,0,0,0,17,9,2,10,0,0,21,nowin,loss,beat,dlwin,0,10,17,207,0.458937198,0.048309179,0.570048309,1,0.318138014
4642,28,20774,4,7,6,0,0,17,9,2,10,0,0,21,nowin,loss,beat,dlwin,0,10,11,199,0.422110553,0.045226131,0.542713568,1,0.282706618
4643,115,20774,10,11,0,0,0,21,9,2,10,0,0,21,win,push,push,push,10,0,21,194,0.427835052,0.041237113,0.592783505,2,0.583863602
4644,121,20775,8,5,0,1,2,16,9,10,0,0,0,19,nowin,loss,beat,dlwin,0,10,13,195,0.456410256,0.025641026,0.512820513,1,0.288597791
4645,24,20775,10,11,0,0,0,21,9,10,0,0,0,19,win,win,plwin,beat,25,0,21,207,0.458937198,0.048309179,0.570048309,1,0.318138014
4646,35,20775,7,9,0,8,0,24,9,10,0,0,0,19,nowin,loss,bust,plbust,0,10,16,202,0.410891089,0.044554455,0.633663366,2,0.598681573
4647,51,20775,3,3,5,6,0,17,9,10,0,0,0,19,nowin,loss,beat,dlwin,0,10,6,189,0.529100529,0.068783069,0.608465608,3,0.993665715
4648,142,20775,5,10,0,4,0,19,9,10,0,0,0,19,nowin,push,push,push,10,0,15,211,0.417061611,0.047393365,0.526066351,1,0.271531309
4649,20,20775,4,2,9,10,0,25,9,10,0,0,0,19,nowin,loss,bust,plbust,0,10,6,186,0.456989247,0.037634409,0.537634409,1,0.301097108
4650,138,20776,9,10,0,0,0,19,8,8,10,0,0,26,nowin,win,dlbust,bust,20,0,19,190,0.442105263,0.047368421,0.610526316,2,0.609711065
4651,126,20776,8,10,0,0,0,18,8,8,10,0,0,26,nowin,win,dlbust,bust,20,0,18,188,0.457446809,0.074468085,0.60106383,3,0.900633203
4652,121,20776,4,8,0,8,0,20,8,8,10,0,0,26,nowin,win,dlbust,bust,20,0,12,195,0.456410256,0.025641026,0.512820513,1,0.288597791
4653,93,20776,2,9,7,0,0,18,8,8,10,0,0,26,nowin,win,dlbust,bust,20,0,11,175,0.485714286,0.051428571,0.548571429,1,0.323648091
4654,143,20776,6,9,0,7,0,22,8,8,10,0,0,26,nowin,loss,bust,plbust,0,10,15,203,0.463054187,0.044334975,0.57635468,3,0.883143365
4655,30,20776,10,10,0,0,0,20,8,8,10,0,0,26,nowin,win,dlbust,bust,20,0,20,206,0.393203883,0.033980583,0.601941748,0,0.029324648
4656,62,20777,3,10,0,6,0,19,10,2,3,4,0,19,nowin,push,push,push,10,0,13,178,0.370786517,0.028089888,0.54494382,0,0.008657722
4657,84,20777,4,6,10,0,0,20,10,2,3,4,0,19,nowin,win,plwin,beat,20,0,10,195,0.379487179,0.056410256,0.569230769,0,0.017209119
4658,28,20777,10,10,0,0,0,20,10,2,3,4,0,19,nowin,win,plwin,beat,20,0,20,199,0.422110553,0.045226131,0.542713568,1,0.282706618
4659,59,20777,10,4,0,7,0,21,10,2,3,4,0,19,nowin,win,plwin,beat,20,0,14,228,0.429824561,0.048245614,0.543859649,1,0.287885446
4660,72,20777,10,5,0,10,0,25,10,2,3,4,0,19,nowin,loss,bust,plbust,0,10,15,185,0.394594595,0.032432432,0.508108108,0,0.006763115
4661,130,20777,4,5,8,0,0,17,10,2,3,4,0,19,nowin,loss,beat,dlwin,0,10,9,219,0.410958904,0.03652968,0.566210046,0,0.025888739
4662,134,20778,2,10,0,0,0,12,6,11,0,0,0,17,nowin,loss,beat,dlwin,0,10,12,185,0.443243243,0.021621622,0.545945946,1,0.296939509
4663,144,20778,1,3,10,0,0,14,6,11,0,0,0,17,nowin,loss,beat,dlwin,0,10,4,202,0.386138614,0.054455446,0.564356436,0,0.018006244
4664,28,20778,10,10,0,0,0,20,6,11,0,0,0,17,nowin,win,plwin,beat,20,0,20,199,0.422110553,0.045226131,0.542713568,1,0.282706618
4665,102,20778,10,7,0,0,0,17,6,11,0,0,0,17,nowin,push,push,push,10,0,17,192,0.338541667,0.046875,0.5625,0,0.003306118
4666,75,20778,10,3,0,0,0,13,6,11,0,0,0,17,nowin,loss,beat,dlwin,0,10,13,191,0.418848168,0.052356021,0.570680628,0,0.029344702
4667,46,20778,10,10,0,0,0,20,6,11,0,0,0,17,nowin,win,plwin,beat,20,0,20,186,0.403225806,0.048387097,0.591397849,0,0.029742194
4668,23,20779,10,10,0,0,0,20,8,6,2,10,0,26,nowin,win,dlbust,bust,20,0,20,208,0.427884615,0.0625,0.552884615,1,0.29114424
4669,46,20779,10,10,0,0,0,20,8,6,2,10,0,26,nowin,win,dlbust,bust,20,0,20,186,0.403225806,0.048387097,0.591397849,0,0.029742194
4670,110,20779,2,8,3,7,0,20,8,6,2,10,0,26,nowin,win,dlbust,bust,20,0,10,192,0.416666667,0.046875,0.557291667,0,0.025413132
4671,12,20779,10,3,0,6,0,19,8,6,2,10,0,26,nowin,win,dlbust,bust,20,0,13,189,0.470899471,0.015873016,0.613756614,3,0.929171178
4672,98,20779,8,2,11,0,0,21,8,6,2,10,0,26,nowin,win,dlbust,bust,20,0,10,220,0.422727273,0.054545455,0.55,1,0.28664435
4673,18,20779,1,2,10,7,0,20,8,6,2,10,0,26,nowin,win,dlbust,bust,20,0,3,182,0.461538462,0.043956044,0.587912088,3,0.892649374
4674,3,20780,9,4,0,3,4,20,9,9,0,0,0,18,nowin,win,plwin,beat,20,0,13,190,0.431578947,0.026315789,0.542105263,1,0.288076384
4675,14,20780,5,8,0,7,0,20,9,9,0,0,0,18,nowin,win,plwin,beat,20,0,13,202,0.391089109,0.01980198,0.628712871,2,0.577264877
4676,124,20780,10,6,0,10,0,26,9,9,0,0,0,18,nowin,loss,bust,plbust,0,10,16,202,0.47029703,0.064356436,0.584158416,3,0.899458193
4677,4,20780,5,3,10,0,0,18,9,9,0,0,0,18,nowin,push,push,push,10,0,8,217,0.460829493,0.036866359,0.562211982,1,0.315432839
4678,83,20780,10,3,0,8,0,21,9,9,0,0,0,18,nowin,win,plwin,beat,20,0,13,193,0.424870466,0.051813472,0.678756477,2,0.644360335
4679,87,20780,10,10,0,0,0,20,9,9,0,0,0,18,nowin,win,plwin,beat,20,0,20,202,0.405940594,0.054455446,0.628712871,2,0.590599801
4680,42,20781,5,3,8,0,0,16,2,10,3,8,0,23,nowin,win,dlbust,bust,20,0,8,212,0.443396226,0.051886792,0.570754717,1,0.309181312
4681,57,20781,3,2,10,0,0,15,2,10,3,8,0,23,nowin,win,dlbust,bust,20,0,5,192,0.46875,0.052083333,0.59375,3,0.907001181
4682,109,20781,3,2,7,1,0,13,2,10,3,8,0,23,nowin,win,dlbust,bust,20,0,5,221,0.461538462,0.058823529,0.597285068,3,0.901830309
4683,92,20781,10,10,0,0,0,20,2,10,3,8,0,23,nowin,win,dlbust,bust,20,0,20,186,0.446236559,0.059139785,0.564516129,1,0.307826125
4684,122,20781,4,10,0,0,0,14,2,10,3,8,0,23,nowin,win,dlbust,bust,20,0,14,210,0.347619048,0.052380952,0.59047619,0,0.012873677
4685,147,20781,3,2,2,3,9,19,2,10,3,8,0,23,nowin,win,dlbust,bust,20,0,5,205,0.380487805,0.014634146,0.536585366,0,0.00951447
4686,95,20782,10,8,0,0,0,18,10,4,2,7,0,23,nowin,win,dlbust,bust,20,0,18,218,0.412844037,0.04587156,0.559633028,0,0.024842385
4687,67,20782,10,2,0,10,0,22,10,4,2,7,0,23,nowin,loss,bust,plbust,0,10,12,195,0.369230769,0.041025641,0.569230769,0,0.014139427
4688,18,20782,2,2,8,10,0,22,10,4,2,7,0,23,nowin,loss,bust,plbust,0,10,4,182,0.461538462,0.043956044,0.587912088,3,0.892649374
4689,22,20782,10,10,0,0,0,20,10,4,2,7,0,23,nowin,win,dlbust,bust,20,0,20,187,0.481283422,0.042780749,0.577540107,3,0.906128176
4690,32,20782,4,8,0,3,10,25,10,4,2,7,0,23,nowin,loss,bust,plbust,0,10,12,189,0.391534392,0.037037037,0.53968254,0,0.013579086
4691,88,20782,10,5,0,4,0,19,10,4,2,7,0,23,nowin,win,dlbust,bust,20,0,15,206,0.466019417,0.033980583,0.54368932,1,0.309467903
4692,96,20783,9,3,0,7,0,19,2,4,4,10,0,20,nowin,loss,beat,dlwin,0,10,12,190,0.468421053,0.057894737,0.584210526,3,0.897263354
4693,103,20783,9,6,0,0,0,15,2,4,4,10,0,20,nowin,loss,beat,dlwin,0,10,15,203,0.379310345,0.064039409,0.551724138,0,0.012869209
4694,74,20783,2,10,0,8,0,20,2,4,4,10,0,20,nowin,push,push,push,10,0,12,209,0.411483254,0.04784689,0.531100478,0,0.017448125
4695,105,20783,10,6,0,0,0,16,2,4,4,10,0,20,nowin,loss,beat,dlwin,0,10,16,198,0.414141414,0.070707071,0.590909091,0,0.032889494
4696,115,20783,8,5,0,0,0,13,2,4,4,10,0,20,nowin,loss,beat,dlwin,0,10,13,194,0.427835052,0.041237113,0.592783505,2,0.583863602
4697,146,20783,10,5,0,0,0,15,2,4,4,10,0,20,nowin,loss,beat,dlwin,0,10,15,221,0.43438914,0.040723982,0.542986425,1,0.290190091
4698,139,20784,10,10,0,0,0,20,6,3,6,9,0,24,nowin,win,dlbust,bust,20,0,20,192,0.380208333,0.036458333,0.59375,0,0.023429169
4699,105,20784,9,3,0,0,0,12,6,3,6,9,0,24,nowin,win,dlbust,bust,20,0,12,198,0.414141414,0.070707071,0.590909091,0,0.032889494
4700,91,20784,3,7,10,0,0,20,6,3,6,9,0,24,nowin,win,dlbust,bust,20,0,10,194,0.417525773,0.046391753,0.515463918,1,0.266616552
4701,22,20784,10,4,0,0,0,14,6,3,6,9,0,24,nowin,win,dlbust,bust,20,0,14,187,0.481283422,0.042780749,0.577540107,3,0.906128176
4702,13,20784,8,2,9,0,0,19,6,3,6,9,0,24,nowin,win,dlbust,bust,20,0,10,206,0.417475728,0.063106796,0.621359223,2,0.59555479
4703,136,20784,7,11,0,0,0,18,6,3,6,9,0,24,nowin,win,dlbust,bust,20,0,18,194,0.396907216,0.025773196,0.597938144,0,0.029452644
4704,126,20785,10,9,0,0,0,19,8,10,0,0,0,18,nowin,win,plwin,beat,20,0,19,188,0.457446809,0.074468085,0.60106383,3,0.900633203
4705,130,20785,10,3,0,10,0,23,8,10,0,0,0,18,nowin,loss,bust,plbust,0,10,13,219,0.410958904,0.03652968,0.566210046,0,0.025888739
4706,92,20785,6,9,0,6,0,21,8,10,0,0,0,18,nowin,win,plwin,beat,20,0,15,186,0.446236559,0.059139785,0.564516129,1,0.307826125
4707,150,20785,2,10,0,5,0,17,8,10,0,0,0,18,nowin,loss,beat,dlwin,0,10,12,192,0.401041667,0.036458333,0.567708333,0,0.023287458
4708,45,20785,5,9,0,10,0,24,8,10,0,0,0,18,nowin,loss,bust,plbust,0,10,14,196,0.428571429,0.051020408,0.612244898,2,0.598821767
4709,90,20785,10,10,0,0,0,20,8,10,0,0,0,18,nowin,win,plwin,beat,20,0,20,201,0.447761194,0.049751244,0.60199005,3,0.889945023
4710,89,20786,9,3,0,3,0,15,3,10,10,0,0,23,nowin,win,dlbust,bust,20,0,12,212,0.537735849,0.047169811,0.594339623,3,0.990167191
4711,123,20786,2,10,0,6,0,18,3,10,10,0,0,23,nowin,win,dlbust,bust,20,0,12,205,0.43902439,0.034146341,0.614634146,2,0.609962544
4712,66,20786,10,7,0,0,0,17,3,10,10,0,0,23,nowin,win,dlbust,bust,20,0,17,217,0.456221198,0.064516129,0.626728111,3,0.924304367
4713,124,20786,1,1,10,5,0,17,3,10,10,0,0,23,nowin,win,dlbust,bust,20,0,2,202,0.47029703,0.064356436,0.584158416,3,0.899458193
4714,117,20786,10,9,0,0,0,19,3,10,10,0,0,23,nowin,win,dlbust,bust,20,0,19,173,0.410404624,0.069364162,0.606936416,2,0.578610282
4715,130,20786,1,6,10,0,0,17,3,10,10,0,0,23,nowin,win,dlbust,bust,20,0,7,219,0.410958904,0.03652968,0.566210046,0,0.025888739
4716,16,20787,8,2,2,4,10,26,8,3,7,0,0,18,nowin,loss,bust,plbust,0,10,10,220,0.427272727,0.081818182,0.6,2,0.588660176
4717,23,20787,10,5,0,9,0,24,8,3,7,0,0,18,nowin,loss,bust,plbust,0,10,15,208,0.427884615,0.0625,0.552884615,1,0.29114424
4718,75,20787,11,10,0,0,0,21,8,3,7,0,0,18,win,win,plwin,beat,25,0,21,191,0.418848168,0.052356021,0.570680628,0,0.029344702
4719,147,20787,4,3,3,10,0,20,8,3,7,0,0,18,nowin,win,plwin,beat,20,0,7,205,0.380487805,0.014634146,0.536585366,0,0.00951447
4720,34,20787,10,10,0,0,0,20,8,3,7,0,0,18,nowin,win,plwin,beat,20,0,20,202,0.5,0.079207921,0.618811881,3,0.968961434
4721,149,20787,9,10,0,0,0,19,8,3,7,0,0,18,nowin,win,plwin,beat,20,0,19,225,0.457777778,0.057777778,0.648888889,2,0.651965595
4722,31,20788,7,6,0,7,0,20,10,10,0,0,0,20,nowin,push,push,push,10,0,13,188,0.473404255,0.058510638,0.515957447,1,0.300306557
4723,107,20788,9,10,0,0,0,19,10,10,0,0,0,20,nowin,loss,beat,dlwin,0,10,19,218,0.444954128,0.073394495,0.600917431,2,0.605210014
4724,8,20788,4,8,0,10,0,22,10,10,0,0,0,20,nowin,loss,bust,plbust,0,10,12,181,0.44198895,0.071823204,0.596685083,2,0.599438402
4725,6,20788,10,2,0,6,0,18,10,10,0,0,0,20,nowin,loss,beat,dlwin,0,10,12,191,0.439790576,0.047120419,0.581151832,1,0.31211505
4726,100,20788,6,10,0,10,0,26,10,10,0,0,0,20,nowin,loss,bust,plbust,0,10,16,190,0.452631579,0.036842105,0.594736842,3,0.888671154
4727,84,20788,10,8,0,0,0,18,10,10,0,0,0,20,nowin,loss,beat,dlwin,0,10,18,195,0.379487179,0.056410256,0.569230769,0,0.017209119
4728,52,20789,4,3,10,0,0,17,4,7,9,0,0,20,nowin,loss,beat,dlwin,0,10,7,217,0.414746544,0.02764977,0.599078341,2,0.576736024
4729,146,20789,11,10,0,0,0,21,4,7,9,0,0,20,win,win,plwin,beat,25,0,21,221,0.43438914,0.040723982,0.542986425,1,0.290190091
4730,110,20789,8,7,0,0,0,15,4,7,9,0,0,20,nowin,loss,beat,dlwin,0,10,15,192,0.416666667,0.046875,0.557291667,0,0.025413132
4731,102,20789,10,8,0,0,0,18,4,7,9,0,0,20,nowin,loss,beat,dlwin,0,10,18,192,0.338541667,0.046875,0.5625,0,0.003306118
4732,79,20789,11,9,0,0,0,20,4,7,9,0,0,20,nowin,push,push,push,10,0,20,211,0.436018957,0.028436019,0.672985782,2,0.650131054
4733,148,20789,11,10,0,0,0,21,4,7,9,0,0,20,win,win,plwin,beat,25,0,21,204,0.401960784,0.078431373,0.593137255,0,0.029789521
4734,6,20790,10,5,0,6,0,21,10,11,0,0,0,21,nowin,push,push,push,10,0,15,191,0.439790576,0.047120419,0.581151832,1,0.31211505
4735,26,20790,10,4,0,1,3,18,10,11,0,0,0,21,nowin,loss,beat,dlwin,0,10,14,203,0.463054187,0.0591133,0.541871921,1,0.306802864
4736,137,20790,4,5,4,8,0,21,10,11,0,0,0,21,nowin,push,push,push,10,0,9,194,0.417525773,0.046391753,0.536082474,1,0.276714602
4737,117,20790,5,10,0,5,0,20,10,11,0,0,0,21,nowin,loss,beat,dlwin,0,10,15,173,0.410404624,0.069364162,0.606936416,2,0.578610282
4738,70,20790,2,6,10,0,0,18,10,11,0,0,0,21,nowin,loss,beat,dlwin,0,10,8,228,0.385964912,0.039473684,0.557017544,0,0.016157125
4739,35,20790,10,11,0,0,0,21,10,11,0,0,0,21,win,push,push,push,10,0,21,202,0.410891089,0.044554455,0.633663366,2,0.598681573
4740,18,20791,11,10,0,0,0,21,2,10,2,10,0,24,win,win,dlbust,bust,25,0,21,182,0.461538462,0.043956044,0.587912088,3,0.892649374
4741,99,20791,7,10,0,0,0,17,2,10,2,10,0,24,nowin,win,dlbust,bust,20,0,17,207,0.47826087,0.062801932,0.637681159,3,0.961418446
4742,42,20791,4,10,0,0,0,14,2,10,2,10,0,24,nowin,win,dlbust,bust,20,0,14,212,0.443396226,0.051886792,0.570754717,1,0.309181312
4743,89,20791,7,7,0,0,0,14,2,10,2,10,0,24,nowin,win,dlbust,bust,20,0,14,212,0.537735849,0.047169811,0.594339623,3,0.990167191
4744,38,20791,4,2,7,0,0,13,2,10,2,10,0,24,nowin,win,dlbust,bust,20,0,6,202,0.361386139,0.03960396,0.564356436,0,0.010597953
4745,98,20791,4,10,0,0,0,14,2,10,2,10,0,24,nowin,win,dlbust,bust,20,0,14,220,0.422727273,0.054545455,0.55,1,0.28664435
4746,29,20792,10,10,0,0,0,20,10,2,6,0,0,18,nowin,win,plwin,beat,20,0,20,189,0.44973545,0.058201058,0.544973545,1,0.300349439
4747,36,20792,11,8,0,0,0,19,10,2,6,0,0,18,nowin,win,plwin,beat,20,0,19,229,0.445414847,0.056768559,0.655021834,2,0.645370571
4748,113,20792,4,4,4,9,0,21,10,2,6,0,0,18,nowin,win,plwin,beat,20,0,8,199,0.407035176,0.055276382,0.668341709,2,0.620695264
4749,100,20792,10,5,0,10,0,25,10,2,6,0,0,18,nowin,loss,bust,plbust,0,10,15,190,0.452631579,0.036842105,0.594736842,3,0.888671154
4750,145,20792,4,2,10,8,0,24,10,2,6,0,0,18,nowin,loss,bust,plbust,0,10,6,188,0.441489362,0.031914894,0.622340426,2,0.617837093
4751,123,20792,4,2,10,1,0,17,10,2,6,0,0,18,nowin,loss,beat,dlwin,0,10,6,205,0.43902439,0.034146341,0.614634146,2,0.609962544
4752,15,20793,8,5,0,2,6,21,8,9,0,0,0,17,nowin,win,plwin,beat,20,0,13,212,0.410377358,0.051886792,0.561320755,0,0.024517408
4753,34,20793,5,1,9,10,0,25,8,9,0,0,0,17,nowin,loss,bust,plbust,0,10,6,202,0.5,0.079207921,0.618811881,3,0.968961434
4754,59,20793,10,10,0,0,0,20,8,9,0,0,0,17,nowin,win,plwin,beat,20,0,20,228,0.429824561,0.048245614,0.543859649,1,0.287885446
4755,114,20793,10,3,0,5,0,18,8,9,0,0,0,17,nowin,win,plwin,beat,20,0,13,198,0.47979798,0.025252525,0.611111111,3,0.937232995
4756,140,20793,11,9,0,0,0,20,8,9,0,0,0,17,nowin,win,plwin,beat,20,0,20,210,0.466666667,0.023809524,0.604761905,3,0.915293335
4757,141,20793,10,11,0,0,0,21,8,9,0,0,0,17,win,win,plwin,beat,25,0,21,202,0.420792079,0.074257426,0.564356436,0,0.028377851
4758,148,20794,10,10,0,0,0,20,10,7,0,0,0,17,nowin,win,plwin,beat,20,0,20,204,0.401960784,0.078431373,0.593137255,0,0.029789521
4759,39,20794,5,11,1,0,0,17,10,7,0,0,0,17,nowin,push,push,push,10,0,16,191,0.429319372,0.062827225,0.57591623,0,0.033760763
4760,58,20794,10,10,0,0,0,20,10,7,0,0,0,17,nowin,win,plwin,beat,20,0,20,195,0.430769231,0.041025641,0.584615385,2,0.580497586
4761,105,20794,10,10,0,0,0,20,10,7,0,0,0,17,nowin,win,plwin,beat,20,0,20,198,0.414141414,0.070707071,0.590909091,0,0.032889494
4762,37,20794,10,7,0,0,0,17,10,7,0,0,0,17,nowin,push,push,push,10,0,17,208,0.394230769,0.038461538,0.581730769,0,0.024682772
4763,104,20794,10,10,0,0,0,20,10,7,0,0,0,17,nowin,win,plwin,beat,20,0,20,209,0.363636364,0.052631579,0.593301435,0,0.018359419
4764,79,20795,2,1,10,10,0,23,8,10,0,0,0,18,nowin,loss,bust,plbust,0,10,3,211,0.436018957,0.028436019,0.672985782,2,0.650131054
4765,142,20795,4,10,0,10,0,24,8,10,0,0,0,18,nowin,loss,bust,plbust,0,10,14,211,0.417061611,0.047393365,0.526066351,1,0.271531309
4766,26,20795,10,7,0,0,0,17,8,10,0,0,0,18,nowin,loss,beat,dlwin,0,10,17,203,0.463054187,0.0591133,0.541871921,1,0.306802864
4767,65,20795,6,11,3,0,0,20,8,10,0,0,0,18,nowin,win,plwin,beat,20,0,17,203,0.492610837,0.054187192,0.571428571,3,0.913702814
4768,110,20795,9,10,0,0,0,19,8,10,0,0,0,18,nowin,win,plwin,beat,20,0,19,192,0.416666667,0.046875,0.557291667,0,0.025413132
4769,38,20795,8,5,0,2,9,24,8,10,0,0,0,18,nowin,loss,bust,plbust,0,10,13,202,0.361386139,0.03960396,0.564356436,0,0.010597953
4770,120,20796,9,10,0,0,0,19,4,9,3,10,0,26,nowin,win,dlbust,bust,20,0,19,202,0.440594059,0.034653465,0.618811881,2,0.614441029
4771,137,20796,5,1,10,0,0,16,4,9,3,10,0,26,nowin,win,dlbust,bust,20,0,6,194,0.417525773,0.046391753,0.536082474,1,0.276714602
4772,132,20796,7,10,0,0,0,17,4,9,3,10,0,26,nowin,win,dlbust,bust,20,0,17,194,0.412371134,0.036082474,0.649484536,2,0.611633238
4773,115,20796,6,4,10,0,0,20,4,9,3,10,0,26,nowin,win,dlbust,bust,20,0,10,194,0.427835052,0.041237113,0.592783505,2,0.583863602
4774,25,20796,6,9,0,0,0,15,4,9,3,10,0,26,nowin,win,dlbust,bust,20,0,15,190,0.463157895,0.063157895,0.536842105,1,0.304401563
4775,128,20796,10,10,0,0,0,20,4,9,3,10,0,26,nowin,win,dlbust,bust,20,0,20,227,0.356828194,0.052863436,0.577092511,0,0.012352564
4776,109,20797,7,8,0,6,0,21,8,5,1,10,0,24,nowin,win,dlbust,bust,20,0,15,221,0.461538462,0.058823529,0.597285068,3,0.901830309
4777,56,20797,10,8,0,0,0,18,8,5,1,10,0,24,nowin,win,dlbust,bust,20,0,18,175,0.4,0.057142857,0.582857143,0,0.026685297
4778,106,20797,3,10,0,1,5,19,8,5,1,10,0,24,nowin,win,dlbust,bust,20,0,13,192,0.411458333,0.026041667,0.557291667,0,0.023854304
4779,117,20797,10,10,0,0,0,20,8,5,1,10,0,24,nowin,win,dlbust,bust,20,0,20,173,0.410404624,0.069364162,0.606936416,2,0.578610282
4780,140,20797,3,10,0,9,0,22,8,5,1,10,0,24,nowin,loss,bust,plbust,0,10,13,210,0.466666667,0.023809524,0.604761905,3,0.915293335
4781,60,20797,3,10,0,3,6,22,8,5,1,10,0,24,nowin,loss,bust,plbust,0,10,13,227,0.418502203,0.022026432,0.559471366,0,0.026496258
4782,143,20798,10,10,0,0,0,20,10,8,0,0,0,18,nowin,win,plwin,beat,20,0,20,203,0.463054187,0.044334975,0.57635468,3,0.883143365
4783,13,20798,10,10,0,0,0,20,10,8,0,0,0,18,nowin,win,plwin,beat,20,0,20,206,0.417475728,0.063106796,0.621359223,2,0.59555479
4784,86,20798,9,11,0,0,0,20,10,8,0,0,0,18,nowin,win,plwin,beat,20,0,20,196,0.454081633,0.040816327,0.591836735,3,0.887566443
4785,29,20798,11,10,0,0,0,21,10,8,0,0,0,18,win,win,plwin,beat,25,0,21,189,0.44973545,0.058201058,0.544973545,1,0.300349439
4786,141,20798,5,10,0,5,0,20,10,8,0,0,0,18,nowin,win,plwin,beat,20,0,15,202,0.420792079,0.074257426,0.564356436,0,0.028377851
4787,53,20798,9,8,0,0,0,17,10,8,0,0,0,18,nowin,loss,beat,dlwin,0,10,17,250,0.372,0.064,0.564,0,0.013687345
4788,15,20799,2,5,8,10,0,25,11,1,2,10,0,24,nowin,loss,bust,plbust,0,10,7,212,0.410377358,0.051886792,0.561320755,0,0.024517408
4789,60,20799,7,10,0,0,0,17,11,1,2,10,0,24,nowin,win,dlbust,bust,20,0,17,227,0.418502203,0.022026432,0.559471366,0,0.026496258
4790,12,20799,9,5,0,10,0,24,11,1,2,10,0,24,nowin,loss,bust,plbust,0,10,14,189,0.470899471,0.015873016,0.613756614,3,0.929171178
4791,8,20799,2,10,0,10,0,22,11,1,2,10,0,24,nowin,loss,bust,plbust,0,10,12,181,0.44198895,0.071823204,0.596685083,2,0.599438402
4792,55,20799,10,9,0,0,0,19,11,1,2,10,0,24,nowin,win,dlbust,bust,20,0,19,191,0.371727749,0.057591623,0.54973822,0,0.01011347
4793,96,20799,4,2,11,0,0,17,11,1,2,10,0,24,nowin,win,dlbust,bust,20,0,6,190,0.468421053,0.057894737,0.584210526,3,0.897263354
4794,38,20800,10,2,0,10,0,22,2,4,4,1,7,18,nowin,loss,bust,plbust,0,10,12,202,0.361386139,0.03960396,0.564356436,0,0.010597953
4795,79,20800,9,4,0,0,0,13,2,4,4,1,7,18,nowin,loss,beat,dlwin,0,10,13,211,0.436018957,0.028436019,0.672985782,2,0.650131054
4796,34,20800,9,11,0,0,0,20,2,4,4,1,7,18,nowin,win,plwin,beat,20,0,20,202,0.5,0.079207921,0.618811881,3,0.968961434
4797,58,20800,8,10,0,0,0,18,2,4,4,1,7,18,nowin,push,push,push,10,0,18,195,0.430769231,0.041025641,0.584615385,2,0.580497586
4798,97,20800,3,10,0,0,0,13,2,4,4,1,7,18,nowin,loss,beat,dlwin,0,10,13,182,0.450549451,0.06043956,0.692307692,2,0.677372279
4799,49,20800,7,3,11,0,0,21,2,4,4,1,7,18,nowin,win,plwin,beat,20,0,10,207,0.396135266,0.053140097,0.594202899,0,0.028306925
4800,135,20801,3,4,10,0,0,17,9,3,10,0,0,22,nowin,win,dlbust,bust,20,0,7,179,0.391061453,0.067039106,0.586592179,0,0.024924662
4801,138,20801,7,3,4,5,0,19,9,3,10,0,0,22,nowin,win,dlbust,bust,20,0,10,190,0.442105263,0.047368421,0.610526316,2,0.609711065
4802,96,20801,7,10,0,0,0,17,9,3,10,0,0,22,nowin,win,dlbust,bust,20,0,17,190,0.468421053,0.057894737,0.584210526,3,0.897263354
4803,33,20801,10,3,0,8,0,21,9,3,10,0,0,22,nowin,win,dlbust,bust,20,0,13,192,0.4375,0.057291667,0.625,2,0.616208916
4804,148,20801,8,11,0,0,0,19,9,3,10,0,0,22,nowin,win,dlbust,bust,20,0,19,204,0.401960784,0.078431373,0.593137255,0,0.029789521
4805,23,20801,3,11,3,0,0,17,9,3,10,0,0,22,nowin,win,dlbust,bust,20,0,14,208,0.427884615,0.0625,0.552884615,1,0.29114424
4806,134,20802,3,5,10,0,0,18,6,2,2,9,0,19,nowin,loss,beat,dlwin,0,10,8,185,0.443243243,0.021621622,0.545945946,1,0.296939509
4807,72,20802,11,3,7,0,0,21,6,2,2,9,0,19,nowin,win,plwin,beat,20,0,14,185,0.394594595,0.032432432,0.508108108,0,0.006763115
4808,73,20802,9,10,0,0,0,19,6,2,2,9,0,19,nowin,push,push,push,10,0,19,181,0.375690608,0.011049724,0.596685083,0,0.022795773
4809,115,20802,11,10,0,0,0,21,6,2,2,9,0,19,win,win,plwin,beat,25,0,21,194,0.427835052,0.041237113,0.592783505,2,0.583863602
4810,83,20802,4,5,5,0,0,14,6,2,2,9,0,19,nowin,loss,beat,dlwin,0,10,9,193,0.424870466,0.051813472,0.678756477,2,0.644360335
4811,46,20802,10,3,0,0,0,13,6,2,2,9,0,19,nowin,loss,beat,dlwin,0,10,13,186,0.403225806,0.048387097,0.591397849,0,0.029742194
4812,41,20803,10,6,0,10,0,26,10,3,9,0,0,22,nowin,loss,bust,plbust,0,10,16,192,0.364583333,0.036458333,0.520833333,0,0.00089702
4813,56,20803,2,11,4,0,0,17,10,3,9,0,0,22,nowin,win,dlbust,bust,20,0,13,175,0.4,0.057142857,0.582857143,0,0.026685297
4814,13,20803,6,10,0,10,0,26,10,3,9,0,0,22,nowin,loss,bust,plbust,0,10,16,206,0.417475728,0.063106796,0.621359223,2,0.59555479
4815,132,20803,10,9,0,0,0,19,10,3,9,0,0,22,nowin,win,dlbust,bust,20,0,19,194,0.412371134,0.036082474,0.649484536,2,0.611633238
4816,91,20803,9,10,0,0,0,19,10,3,9,0,0,22,nowin,win,dlbust,bust,20,0,19,194,0.417525773,0.046391753,0.515463918,1,0.266616552
4817,85,20803,7,9,0,4,0,20,10,3,9,0,0,22,nowin,win,dlbust,bust,20,0,16,195,0.41025641,0.066666667,0.594871795,0,0.03269711
4818,97,20804,6,8,0,1,9,24,7,8,10,0,0,25,nowin,loss,bust,plbust,0,10,14,182,0.450549451,0.06043956,0.692307692,2,0.677372279
4819,12,20804,7,10,0,0,0,17,7,8,10,0,0,25,nowin,win,dlbust,bust,20,0,17,189,0.470899471,0.015873016,0.613756614,3,0.929171178
4820,131,20804,2,6,10,0,0,18,7,8,10,0,0,25,nowin,win,dlbust,bust,20,0,8,217,0.410138249,0.069124424,0.543778802,0,0.02015021
4821,12,20804,8,9,0,0,0,17,7,8,10,0,0,25,nowin,win,dlbust,bust,20,0,17,189,0.470899471,0.015873016,0.613756614,3,0.929171178
4822,127,20804,10,9,0,0,0,19,7,8,10,0,0,25,nowin,win,dlbust,bust,20,0,19,201,0.402985075,0.029850746,0.60199005,0,0.032263937
4823,90,20804,6,2,10,0,0,18,7,8,10,0,0,25,nowin,win,dlbust,bust,20,0,8,201,0.447761194,0.049751244,0.60199005,3,0.889945023
4824,88,20805,9,9,0,0,0,18,6,10,7,0,0,23,nowin,win,dlbust,bust,20,0,18,206,0.466019417,0.033980583,0.54368932,1,0.309467903
4825,14,20805,11,9,0,0,0,20,6,10,7,0,0,23,nowin,win,dlbust,bust,20,0,20,202,0.391089109,0.01980198,0.628712871,2,0.577264877
4826,84,20805,4,1,10,0,0,15,6,10,7,0,0,23,nowin,win,dlbust,bust,20,0,5,195,0.379487179,0.056410256,0.569230769,0,0.017209119
4827,142,20805,4,4,10,0,0,18,6,10,7,0,0,23,nowin,win,dlbust,bust,20,0,8,211,0.417061611,0.047393365,0.526066351,1,0.271531309
4828,26,20805,2,10,0,0,0,12,6,10,7,0,0,23,nowin,win,dlbust,bust,20,0,12,203,0.463054187,0.0591133,0.541871921,1,0.306802864
4829,111,20805,4,7,8,0,0,19,6,10,7,0,0,23,nowin,win,dlbust,bust,20,0,11,180,0.433333333,0.055555556,0.611111111,2,0.602264492
4830,88,20806,3,2,10,0,0,15,5,9,10,0,0,24,nowin,win,dlbust,bust,20,0,5,206,0.466019417,0.033980583,0.54368932,1,0.309467903
4831,63,20806,1,1,10,0,0,12,5,9,10,0,0,24,nowin,win,dlbust,bust,20,0,2,216,0.467592593,0.037037037,0.62037037,3,0.931690496
4832,40,20806,5,11,5,0,0,21,5,9,10,0,0,24,nowin,win,dlbust,bust,20,0,16,196,0.367346939,0.030612245,0.617346939,0,0.025358183
4833,91,20806,10,10,0,0,0,20,5,9,10,0,0,24,nowin,win,dlbust,bust,20,0,20,194,0.417525773,0.046391753,0.515463918,1,0.266616552
4834,42,20806,9,10,0,0,0,19,5,9,10,0,0,24,nowin,win,dlbust,bust,20,0,19,212,0.443396226,0.051886792,0.570754717,1,0.309181312
4835,130,20806,2,7,6,0,0,15,5,9,10,0,0,24,nowin,win,dlbust,bust,20,0,9,219,0.410958904,0.03652968,0.566210046,0,0.025888739
4836,142,20807,3,10,0,3,10,26,10,7,0,0,0,17,nowin,loss,bust,plbust,0,10,13,211,0.417061611,0.047393365,0.526066351,1,0.271531309
4837,78,20807,10,8,0,0,0,18,10,7,0,0,0,17,nowin,win,plwin,beat,20,0,18,201,0.517412935,0.034825871,0.587064677,3,0.95871112
4838,127,20807,4,3,10,0,0,17,10,7,0,0,0,17,nowin,push,push,push,10,0,7,201,0.402985075,0.029850746,0.60199005,0,0.032263937
4839,24,20807,9,2,4,7,0,22,10,7,0,0,0,17,nowin,loss,bust,plbust,0,10,11,207,0.458937198,0.048309179,0.570048309,1,0.318138014
4840,57,20807,6,5,1,1,6,19,10,7,0,0,0,17,nowin,win,plwin,beat,20,0,11,192,0.46875,0.052083333,0.59375,3,0.907001181
4841,60,20807,6,3,2,10,0,21,10,7,0,0,0,17,nowin,win,plwin,beat,20,0,9,227,0.418502203,0.022026432,0.559471366,0,0.026496258
4842,72,20808,10,4,0,0,0,14,4,3,7,10,0,24,nowin,win,dlbust,bust,20,0,14,185,0.394594595,0.032432432,0.508108108,0,0.006763115
4843,80,20808,10,10,0,0,0,20,4,3,7,10,0,24,nowin,win,dlbust,bust,20,0,20,186,0.419354839,0.059139785,0.623655914,2,0.59892924
4844,40,20808,8,5,0,0,0,13,4,3,7,10,0,24,nowin,win,dlbust,bust,20,0,13,196,0.367346939,0.030612245,0.617346939,0,0.025358183
4845,69,20808,6,1,10,0,0,17,4,3,7,10,0,24,nowin,win,dlbust,bust,20,0,7,194,0.365979381,0.030927835,0.515463918,0,0
4846,126,20808,10,5,0,0,0,15,4,3,7,10,0,24,nowin,win,dlbust,bust,20,0,15,188,0.457446809,0.074468085,0.60106383,3,0.900633203
4847,9,20808,5,9,0,0,0,14,4,3,7,10,0,24,nowin,win,dlbust,bust,20,0,14,194,0.37628866,0.015463918,0.541237113,0,0.009396796
4848,77,20809,11,10,0,0,0,21,9,3,10,0,0,22,win,win,dlbust,bust,25,0,21,200,0.455,0.04,0.62,3,0.916252116
4849,4,20809,6,9,0,10,0,25,9,3,10,0,0,22,nowin,loss,bust,plbust,0,10,15,217,0.460829493,0.036866359,0.562211982,1,0.315432839
4850,26,20809,9,3,0,7,0,19,9,3,10,0,0,22,nowin,win,dlbust,bust,20,0,12,203,0.463054187,0.0591133,0.541871921,1,0.306802864
4851,99,20809,4,3,10,0,0,17,9,3,10,0,0,22,nowin,win,dlbust,bust,20,0,7,207,0.47826087,0.062801932,0.637681159,3,0.961418446
4852,110,20809,11,10,0,0,0,21,9,3,10,0,0,22,win,win,dlbust,bust,25,0,21,192,0.416666667,0.046875,0.557291667,0,0.025413132
4853,78,20809,10,5,0,1,2,18,9,3,10,0,0,22,nowin,win,dlbust,bust,20,0,15,201,0.517412935,0.034825871,0.587064677,3,0.95871112
4854,106,20810,5,6,1,0,0,12,6,6,10,0,0,22,nowin,win,dlbust,bust,20,0,11,192,0.411458333,0.026041667,0.557291667,0,0.023854304
4855,54,20810,9,6,0,0,0,15,6,6,10,0,0,22,nowin,win,dlbust,bust,20,0,15,185,0.437837838,0.032432432,0.556756757,1,0.29899854
4856,11,20810,10,6,0,0,0,16,6,6,10,0,0,22,nowin,win,dlbust,bust,20,0,16,236,0.457627119,0.016949153,0.588983051,3,0.889015813
4857,74,20810,10,10,0,0,0,20,6,6,10,0,0,22,nowin,win,dlbust,bust,20,0,20,209,0.411483254,0.04784689,0.531100478,0,0.017448125
4858,88,20810,8,6,0,0,0,14,6,6,10,0,0,22,nowin,win,dlbust,bust,20,0,14,206,0.466019417,0.033980583,0.54368932,1,0.309467903
4859,55,20810,8,5,0,0,0,13,6,6,10,0,0,22,nowin,win,dlbust,bust,20,0,13,191,0.371727749,0.057591623,0.54973822,0,0.01011347
4860,107,20811,10,4,0,1,10,25,10,4,1,10,0,25,nowin,loss,bust,plbust,0,10,14,218,0.444954128,0.073394495,0.600917431,2,0.605210014
4861,100,20811,10,10,0,0,0,20,10,4,1,10,0,25,nowin,win,dlbust,bust,20,0,20,190,0.452631579,0.036842105,0.594736842,3,0.888671154
4862,75,20811,10,4,0,10,0,24,10,4,1,10,0,25,nowin,loss,bust,plbust,0,10,14,191,0.418848168,0.052356021,0.570680628,0,0.029344702
4863,33,20811,3,5,5,4,0,17,10,4,1,10,0,25,nowin,win,dlbust,bust,20,0,8,192,0.4375,0.057291667,0.625,2,0.616208916
4864,46,20811,6,7,0,2,10,25,10,4,1,10,0,25,nowin,loss,bust,plbust,0,10,13,186,0.403225806,0.048387097,0.591397849,0,0.029742194
4865,53,20811,11,7,0,0,0,18,10,4,1,10,0,25,nowin,win,dlbust,bust,20,0,18,250,0.372,0.064,0.564,0,0.013687345
4866,78,20812,3,3,10,0,0,16,3,10,9,0,0,22,nowin,win,dlbust,bust,20,0,6,201,0.517412935,0.034825871,0.587064677,3,0.95871112
4867,48,20812,8,5,0,0,0,13,3,10,9,0,0,22,nowin,win,dlbust,bust,20,0,13,203,0.413793103,0.019704433,0.600985222,2,0.577280801
4868,52,20812,10,5,0,0,0,15,3,10,9,0,0,22,nowin,win,dlbust,bust,20,0,15,217,0.414746544,0.02764977,0.599078341,2,0.576736024
4869,123,20812,10,11,0,0,0,21,3,10,9,0,0,22,win,win,dlbust,bust,25,0,21,205,0.43902439,0.034146341,0.614634146,2,0.609962544
4870,111,20812,10,7,0,0,0,17,3,10,9,0,0,22,nowin,win,dlbust,bust,20,0,17,180,0.433333333,0.055555556,0.611111111,2,0.602264492
4871,32,20812,2,5,7,0,0,14,3,10,9,0,0,22,nowin,win,dlbust,bust,20,0,7,189,0.391534392,0.037037037,0.53968254,0,0.013579086
4872,132,20813,10,10,0,0,0,20,10,10,0,0,0,20,nowin,push,push,push,10,0,20,194,0.412371134,0.036082474,0.649484536,2,0.611633238
4873,64,20813,10,10,0,0,0,20,10,10,0,0,0,20,nowin,push,push,push,10,0,20,187,0.363636364,0.048128342,0.631016043,0,0.027594885
4874,110,20813,8,8,0,5,0,21,10,10,0,0,0,20,nowin,win,plwin,beat,20,0,16,192,0.416666667,0.046875,0.557291667,0,0.025413132
4875,1,20813,7,7,0,2,6,22,10,10,0,0,0,20,nowin,loss,bust,plbust,0,10,14,197,0.406091371,0.025380711,0.649746193,2,0.606186955
4876,70,20813,10,7,0,0,0,17,10,10,0,0,0,20,nowin,loss,beat,dlwin,0,10,17,228,0.385964912,0.039473684,0.557017544,0,0.016157125
4877,121,20813,7,6,0,10,0,23,10,10,0,0,0,20,nowin,loss,bust,plbust,0,10,13,195,0.456410256,0.025641026,0.512820513,1,0.288597791
4878,2,20814,5,3,2,8,0,18,10,4,7,0,0,21,nowin,loss,beat,dlwin,0,10,8,200,0.445,0.035,0.64,2,0.633962549
4879,59,20814,5,8,0,7,0,20,10,4,7,0,0,21,nowin,loss,beat,dlwin,0,10,13,228,0.429824561,0.048245614,0.543859649,1,0.287885446
4880,73,20814,10,5,0,10,0,25,10,4,7,0,0,21,nowin,loss,bust,plbust,0,10,15,181,0.375690608,0.011049724,0.596685083,0,0.022795773
4881,54,20814,6,10,0,1,0,17,10,4,7,0,0,21,nowin,loss,beat,dlwin,0,10,16,185,0.437837838,0.032432432,0.556756757,1,0.29899854
4882,69,20814,5,9,0,7,0,21,10,4,7,0,0,21,nowin,push,push,push,10,0,14,194,0.365979381,0.030927835,0.515463918,0,0
4883,113,20814,8,3,3,10,0,24,10,4,7,0,0,21,nowin,loss,bust,plbust,0,10,11,199,0.407035176,0.055276382,0.668341709,2,0.620695264
4884,140,20815,5,10,0,10,0,25,10,8,0,0,0,18,nowin,loss,bust,plbust,0,10,15,210,0.466666667,0.023809524,0.604761905,3,0.915293335
4885,77,20815,11,7,0,0,0,18,10,8,0,0,0,18,nowin,push,push,push,10,0,18,200,0.455,0.04,0.62,3,0.916252116
4886,2,20815,10,10,0,0,0,20,10,8,0,0,0,18,nowin,win,plwin,beat,20,0,20,200,0.445,0.035,0.64,2,0.633962549
4887,54,20815,2,7,5,10,0,24,10,8,0,0,0,18,nowin,loss,bust,plbust,0,10,9,185,0.437837838,0.032432432,0.556756757,1,0.29899854
4888,20,20815,10,10,0,0,0,20,10,8,0,0,0,18,nowin,win,plwin,beat,20,0,20,186,0.456989247,0.037634409,0.537634409,1,0.301097108
4889,20,20815,10,2,0,6,0,18,10,8,0,0,0,18,nowin,push,push,push,10,0,12,186,0.456989247,0.037634409,0.537634409,1,0.301097108
4890,49,20816,7,6,0,8,0,21,7,4,10,0,0,21,nowin,push,push,push,10,0,13,207,0.396135266,0.053140097,0.594202899,0,0.028306925
4891,148,20816,7,11,0,0,0,18,7,4,10,0,0,21,nowin,loss,beat,dlwin,0,10,18,204,0.401960784,0.078431373,0.593137255,0,0.029789521
4892,49,20816,3,6,5,5,0,19,7,4,10,0,0,21,nowin,loss,beat,dlwin,0,10,9,207,0.396135266,0.053140097,0.594202899,0,0.028306925
4893,125,20816,4,5,10,0,0,19,7,4,10,0,0,21,nowin,loss,beat,dlwin,0,10,9,219,0.438356164,0.050228311,0.575342466,1,0.308411257
4894,57,20816,10,10,0,0,0,20,7,4,10,0,0,21,nowin,loss,beat,dlwin,0,10,20,192,0.46875,0.052083333,0.59375,3,0.907001181
4895,59,20816,7,10,0,0,0,17,7,4,10,0,0,21,nowin,loss,beat,dlwin,0,10,17,228,0.429824561,0.048245614,0.543859649,1,0.287885446
4896,126,20817,10,9,0,0,0,19,5,10,10,0,0,25,nowin,win,dlbust,bust,20,0,19,188,0.457446809,0.074468085,0.60106383,3,0.900633203
4897,91,20817,2,6,6,0,0,14,5,10,10,0,0,25,nowin,win,dlbust,bust,20,0,8,194,0.417525773,0.046391753,0.515463918,1,0.266616552
4898,61,20817,7,10,0,0,0,17,5,10,10,0,0,25,nowin,win,dlbust,bust,20,0,17,194,0.427835052,0.077319588,0.603092784,2,0.591437139
4899,83,20817,6,10,0,0,0,16,5,10,10,0,0,25,nowin,win,dlbust,bust,20,0,16,193,0.424870466,0.051813472,0.678756477,2,0.644360335
4900,145,20817,3,2,8,0,0,13,5,10,10,0,0,25,nowin,win,dlbust,bust,20,0,5,188,0.441489362,0.031914894,0.622340426,2,0.617837093
4901,145,20817,10,10,0,0,0,20,5,10,10,0,0,25,nowin,win,dlbust,bust,20,0,20,188,0.441489362,0.031914894,0.622340426,2,0.617837093
4902,128,20818,7,8,0,10,0,25,7,10,0,0,0,17,nowin,loss,bust,plbust,0,10,15,227,0.356828194,0.052863436,0.577092511,0,0.012352564
4903,72,20818,8,5,0,1,10,24,7,10,0,0,0,17,nowin,loss,bust,plbust,0,10,13,185,0.394594595,0.032432432,0.508108108,0,0.006763115
4904,34,20818,7,11,0,0,0,18,7,10,0,0,0,17,nowin,win,plwin,beat,20,0,18,202,0.5,0.079207921,0.618811881,3,0.968961434
4905,95,20818,10,2,0,4,6,22,7,10,0,0,0,17,nowin,loss,bust,plbust,0,10,12,218,0.412844037,0.04587156,0.559633028,0,0.024842385
4906,126,20818,6,4,9,0,0,19,7,10,0,0,0,17,nowin,win,plwin,beat,20,0,10,188,0.457446809,0.074468085,0.60106383,3,0.900633203
4907,48,20818,10,3,0,1,6,20,7,10,0,0,0,17,nowin,win,plwin,beat,20,0,13,203,0.413793103,0.019704433,0.600985222,2,0.577280801
4908,103,20819,8,5,0,2,9,24,8,10,0,0,0,18,nowin,loss,bust,plbust,0,10,13,203,0.379310345,0.064039409,0.551724138,0,0.012869209
4909,92,20819,3,8,1,9,0,21,8,10,0,0,0,18,nowin,win,plwin,beat,20,0,11,186,0.446236559,0.059139785,0.564516129,1,0.307826125
4910,34,20819,10,2,0,9,0,21,8,10,0,0,0,18,nowin,win,plwin,beat,20,0,12,202,0.5,0.079207921,0.618811881,3,0.968961434
4911,58,20819,8,4,0,10,0,22,8,10,0,0,0,18,nowin,loss,bust,plbust,0,10,12,195,0.430769231,0.041025641,0.584615385,2,0.580497586
4912,118,20819,6,1,10,0,0,17,8,10,0,0,0,18,nowin,loss,beat,dlwin,0,10,7,216,0.393518519,0.037037037,0.555555556,0,0.018059873
4913,1,20819,6,1,6,7,0,20,8,10,0,0,0,18,nowin,win,plwin,beat,20,0,7,197,0.406091371,0.025380711,0.649746193,2,0.606186955
4914,51,20820,10,4,0,0,0,14,2,10,10,0,0,22,nowin,win,dlbust,bust,20,0,14,189,0.529100529,0.068783069,0.608465608,3,0.993665715
4915,67,20820,10,9,0,0,0,19,2,10,10,0,0,22,nowin,win,dlbust,bust,20,0,19,195,0.369230769,0.041025641,0.569230769,0,0.014139427
4916,65,20820,5,6,10,0,0,21,2,10,10,0,0,22,nowin,win,dlbust,bust,20,0,11,203,0.492610837,0.054187192,0.571428571,3,0.913702814
4917,137,20820,10,3,0,0,0,13,2,10,10,0,0,22,nowin,win,dlbust,bust,20,0,13,194,0.417525773,0.046391753,0.536082474,1,0.276714602
4918,48,20820,1,6,10,0,0,17,2,10,10,0,0,22,nowin,win,dlbust,bust,20,0,7,203,0.413793103,0.019704433,0.600985222,2,0.577280801
4919,146,20820,3,10,0,0,0,13,2,10,10,0,0,22,nowin,win,dlbust,bust,20,0,13,221,0.43438914,0.040723982,0.542986425,1,0.290190091
4920,76,20821,10,10,0,0,0,20,9,10,0,0,0,19,nowin,win,plwin,beat,20,0,20,189,0.534391534,0.079365079,0.608465608,3,1
4921,88,20821,11,1,6,0,0,18,9,10,0,0,0,19,nowin,loss,beat,dlwin,0,10,12,206,0.466019417,0.033980583,0.54368932,1,0.309467903
4922,35,20821,3,10,0,9,0,22,9,10,0,0,0,19,nowin,loss,bust,plbust,0,10,13,202,0.410891089,0.044554455,0.633663366,2,0.598681573
4923,67,20821,6,5,1,4,7,23,9,10,0,0,0,19,nowin,loss,bust,plbust,0,10,11,195,0.369230769,0.041025641,0.569230769,0,0.014139427
4924,119,20821,3,8,2,8,0,21,9,10,0,0,0,19,nowin,win,plwin,beat,20,0,11,190,0.405263158,0.068421053,0.515789474,0,0.011837158
4925,76,20821,5,10,0,5,0,20,9,10,0,0,0,19,nowin,win,plwin,beat,20,0,15,189,0.534391534,0.079365079,0.608465608,3,1
4926,98,20822,6,10,0,10,0,26,8,10,0,0,0,18,nowin,loss,bust,plbust,0,10,16,220,0.422727273,0.054545455,0.55,1,0.28664435
4927,24,20822,7,10,0,0,0,17,8,10,0,0,0,18,nowin,loss,beat,dlwin,0,10,17,207,0.458937198,0.048309179,0.570048309,1,0.318138014
4928,105,20822,2,3,5,2,3,15,8,10,0,0,0,18,nowin,loss,beat,dlwin,0,10,5,198,0.414141414,0.070707071,0.590909091,0,0.032889494
4929,21,20822,10,2,0,5,0,17,8,10,0,0,0,18,nowin,loss,beat,dlwin,0,10,12,214,0.359813084,0.042056075,0.626168224,0,0.025263474
4930,57,20822,10,8,0,0,0,18,8,10,0,0,0,18,nowin,push,push,push,10,0,18,192,0.46875,0.052083333,0.59375,3,0.907001181
4931,83,20822,10,10,0,0,0,20,8,10,0,0,0,18,nowin,win,plwin,beat,20,0,20,193,0.424870466,0.051813472,0.678756477,2,0.644360335
4932,148,20823,4,5,2,10,0,21,6,9,10,0,0,25,nowin,win,dlbust,bust,20,0,9,204,0.401960784,0.078431373,0.593137255,0,0.029789521
4933,11,20823,7,8,0,0,0,15,6,9,10,0,0,25,nowin,win,dlbust,bust,20,0,15,236,0.457627119,0.016949153,0.588983051,3,0.889015813
4934,123,20823,9,10,0,0,0,19,6,9,10,0,0,25,nowin,win,dlbust,bust,20,0,19,205,0.43902439,0.034146341,0.614634146,2,0.609962544
4935,140,20823,10,9,0,0,0,19,6,9,10,0,0,25,nowin,win,dlbust,bust,20,0,19,210,0.466666667,0.023809524,0.604761905,3,0.915293335
4936,5,20823,9,10,0,0,0,19,6,9,10,0,0,25,nowin,win,dlbust,bust,20,0,19,203,0.42364532,0.02955665,0.596059113,2,0.582508076
4937,36,20823,10,2,0,0,0,12,6,9,10,0,0,25,nowin,win,dlbust,bust,20,0,12,229,0.445414847,0.056768559,0.655021834,2,0.645370571
4938,19,20824,6,10,0,0,0,16,4,10,10,0,0,24,nowin,win,dlbust,bust,20,0,16,237,0.41350211,0.054852321,0.628691983,2,0.597373826
4939,55,20824,10,4,0,0,0,14,4,10,10,0,0,24,nowin,win,dlbust,bust,20,0,14,191,0.371727749,0.057591623,0.54973822,0,0.01011347
4940,67,20824,11,7,0,0,0,18,4,10,10,0,0,24,nowin,win,dlbust,bust,20,0,18,195,0.369230769,0.041025641,0.569230769,0,0.014139427
4941,66,20824,5,10,0,0,0,15,4,10,10,0,0,24,nowin,win,dlbust,bust,20,0,15,217,0.456221198,0.064516129,0.626728111,3,0.924304367
4942,87,20824,10,9,0,0,0,19,4,10,10,0,0,24,nowin,win,dlbust,bust,20,0,19,202,0.405940594,0.054455446,0.628712871,2,0.590599801
4943,107,20824,10,10,0,0,0,20,4,10,10,0,0,24,nowin,win,dlbust,bust,20,0,20,218,0.444954128,0.073394495,0.600917431,2,0.605210014
4944,146,20825,2,10,0,4,10,26,10,10,0,0,0,20,nowin,loss,bust,plbust,0,10,12,221,0.43438914,0.040723982,0.542986425,1,0.290190091
4945,29,20825,8,6,0,10,0,24,10,10,0,0,0,20,nowin,loss,bust,plbust,0,10,14,189,0.44973545,0.058201058,0.544973545,1,0.300349439
4946,71,20825,10,10,0,0,0,20,10,10,0,0,0,20,nowin,push,push,push,10,0,20,193,0.352331606,0.046632124,0.585492228,0,0.013063661
4947,68,20825,5,6,10,0,0,21,10,10,0,0,0,20,nowin,win,plwin,beat,20,0,11,205,0.434146341,0.029268293,0.6,2,0.59483189
4948,111,20825,5,10,0,10,0,25,10,10,0,0,0,20,nowin,loss,bust,plbust,0,10,15,180,0.433333333,0.055555556,0.611111111,2,0.602264492
4949,73,20825,11,9,0,0,0,20,10,10,0,0,0,20,nowin,push,push,push,10,0,20,181,0.375690608,0.011049724,0.596685083,0,0.022795773
4950,130,20826,6,3,10,0,0,19,5,10,7,0,0,22,nowin,win,dlbust,bust,20,0,9,219,0.410958904,0.03652968,0.566210046,0,0.025888739
4951,137,20826,10,4,0,0,0,14,5,10,7,0,0,22,nowin,win,dlbust,bust,20,0,14,194,0.417525773,0.046391753,0.536082474,1,0.276714602
4952,95,20826,2,10,0,0,0,12,5,10,7,0,0,22,nowin,win,dlbust,bust,20,0,12,218,0.412844037,0.04587156,0.559633028,0,0.024842385
4953,102,20826,10,4,0,0,0,14,5,10,7,0,0,22,nowin,win,dlbust,bust,20,0,14,192,0.338541667,0.046875,0.5625,0,0.003306118
4954,58,20826,5,8,0,0,0,13,5,10,7,0,0,22,nowin,win,dlbust,bust,20,0,13,195,0.430769231,0.041025641,0.584615385,2,0.580497586
4955,104,20826,5,10,0,0,0,15,5,10,7,0,0,22,nowin,win,dlbust,bust,20,0,15,209,0.363636364,0.052631579,0.593301435,0,0.018359419
4956,1,20827,10,6,0,7,0,23,9,10,0,0,0,19,nowin,loss,bust,plbust,0,10,16,197,0.406091371,0.025380711,0.649746193,2,0.606186955
4957,57,20827,4,10,0,7,0,21,9,10,0,0,0,19,nowin,win,plwin,beat,20,0,14,192,0.46875,0.052083333,0.59375,3,0.907001181
4958,104,20827,10,3,0,10,0,23,9,10,0,0,0,19,nowin,loss,bust,plbust,0,10,13,209,0.363636364,0.052631579,0.593301435,0,0.018359419
4959,125,20827,4,11,3,0,0,18,9,10,0,0,0,19,nowin,loss,beat,dlwin,0,10,15,219,0.438356164,0.050228311,0.575342466,1,0.308411257
4960,81,20827,3,3,2,10,0,18,9,10,0,0,0,19,nowin,loss,beat,dlwin,0,10,6,182,0.395604396,0.043956044,0.60989011,2,0.567491261
4961,144,20827,10,8,0,0,0,18,9,10,0,0,0,19,nowin,loss,beat,dlwin,0,10,18,202,0.386138614,0.054455446,0.564356436,0,0.018006244
4962,135,20828,10,11,0,0,0,21,10,6,1,0,0,17,win,win,plwin,beat,25,0,21,179,0.391061453,0.067039106,0.586592179,0,0.024924662
4963,22,20828,3,2,10,6,0,21,10,6,1,0,0,17,nowin,win,plwin,beat,20,0,5,187,0.481283422,0.042780749,0.577540107,3,0.906128176
4964,105,20828,10,5,0,8,0,23,10,6,1,0,0,17,nowin,loss,bust,plbust,0,10,15,198,0.414141414,0.070707071,0.590909091,0,0.032889494
4965,120,20828,7,10,0,0,0,17,10,6,1,0,0,17,nowin,push,push,push,10,0,17,202,0.440594059,0.034653465,0.618811881,2,0.614441029
4966,143,20828,5,10,0,9,0,24,10,6,1,0,0,17,nowin,loss,bust,plbust,0,10,15,203,0.463054187,0.044334975,0.57635468,3,0.883143365
4967,82,20828,4,10,0,4,0,18,10,6,1,0,0,17,nowin,win,plwin,beat,20,0,14,225,0.408888889,0.075555556,0.577777778,0,0.028101874
4968,87,20829,4,4,10,0,0,18,10,10,0,0,0,20,nowin,loss,beat,dlwin,0,10,8,202,0.405940594,0.054455446,0.628712871,2,0.590599801
4969,46,20829,2,10,0,10,0,22,10,10,0,0,0,20,nowin,loss,bust,plbust,0,10,12,186,0.403225806,0.048387097,0.591397849,0,0.029742194
4970,29,20829,7,10,0,0,0,17,10,10,0,0,0,20,nowin,loss,beat,dlwin,0,10,17,189,0.44973545,0.058201058,0.544973545,1,0.300349439
4971,26,20829,4,2,10,7,0,23,10,10,0,0,0,20,nowin,loss,bust,plbust,0,10,6,203,0.463054187,0.0591133,0.541871921,1,0.306802864
4972,29,20829,10,10,0,0,0,20,10,10,0,0,0,20,nowin,push,push,push,10,0,20,189,0.44973545,0.058201058,0.544973545,1,0.300349439
4973,52,20829,7,3,6,5,0,21,10,10,0,0,0,20,nowin,win,plwin,beat,20,0,10,217,0.414746544,0.02764977,0.599078341,2,0.576736024
4974,44,20830,4,10,0,6,0,20,11,10,0,0,0,21,nowin,loss,beat,dlwin,0,10,14,219,0.433789954,0.050228311,0.534246575,1,0.285551035
4975,117,20830,1,2,10,7,0,20,11,10,0,0,0,21,nowin,loss,beat,dlwin,0,10,3,173,0.410404624,0.069364162,0.606936416,2,0.578610282
4976,100,20830,3,6,4,10,0,23,11,10,0,0,0,21,nowin,loss,bust,plbust,0,10,9,190,0.452631579,0.036842105,0.594736842,3,0.888671154
4977,135,20830,4,6,9,0,0,19,11,10,0,0,0,21,nowin,loss,beat,dlwin,0,10,10,179,0.391061453,0.067039106,0.586592179,0,0.024924662
4978,149,20830,4,10,0,9,0,23,11,10,0,0,0,21,nowin,loss,bust,plbust,0,10,14,225,0.457777778,0.057777778,0.648888889,2,0.651965595
4979,102,20830,10,8,0,0,0,18,11,10,0,0,0,21,nowin,loss,beat,dlwin,0,10,18,192,0.338541667,0.046875,0.5625,0,0.003306118
4980,95,20831,10,3,0,0,0,13,5,4,10,0,0,19,nowin,loss,beat,dlwin,0,10,13,218,0.412844037,0.04587156,0.559633028,0,0.024842385
4981,41,20831,2,3,3,10,0,18,5,4,10,0,0,19,nowin,loss,beat,dlwin,0,10,5,192,0.364583333,0.036458333,0.520833333,0,0.00089702
4982,6,20831,5,6,10,0,0,21,5,4,10,0,0,19,nowin,win,plwin,beat,20,0,11,191,0.439790576,0.047120419,0.581151832,1,0.31211505
4983,64,20831,4,10,0,0,0,14,5,4,10,0,0,19,nowin,loss,beat,dlwin,0,10,14,187,0.363636364,0.048128342,0.631016043,0,0.027594885
4984,22,20831,9,5,0,0,0,14,5,4,10,0,0,19,nowin,loss,beat,dlwin,0,10,14,187,0.481283422,0.042780749,0.577540107,3,0.906128176
4985,48,20831,10,10,0,0,0,20,5,4,10,0,0,19,nowin,win,plwin,beat,20,0,20,203,0.413793103,0.019704433,0.600985222,2,0.577280801
4986,72,20832,10,6,0,2,0,18,9,6,10,0,0,25,nowin,win,dlbust,bust,20,0,16,185,0.394594595,0.032432432,0.508108108,0,0.006763115
4987,139,20832,8,10,0,0,0,18,9,6,10,0,0,25,nowin,win,dlbust,bust,20,0,18,192,0.380208333,0.036458333,0.59375,0,0.023429169
4988,89,20832,10,4,0,7,0,21,9,6,10,0,0,25,nowin,win,dlbust,bust,20,0,14,212,0.537735849,0.047169811,0.594339623,3,0.990167191
4989,19,20832,9,10,0,0,0,19,9,6,10,0,0,25,nowin,win,dlbust,bust,20,0,19,237,0.41350211,0.054852321,0.628691983,2,0.597373826
4990,3,20832,9,7,0,10,0,26,9,6,10,0,0,25,nowin,loss,bust,plbust,0,10,16,190,0.431578947,0.026315789,0.542105263,1,0.288076384
4991,133,20832,10,6,0,8,0,24,9,6,10,0,0,25,nowin,loss,bust,plbust,0,10,16,201,0.47761194,0.064676617,0.611940299,3,0.935428111
4992,49,20833,5,9,0,2,10,26,11,7,0,0,0,18,nowin,loss,bust,plbust,0,10,14,207,0.396135266,0.053140097,0.594202899,0,0.028306925
4993,107,20833,10,11,0,0,0,21,11,7,0,0,0,18,win,win,plwin,beat,25,0,21,218,0.444954128,0.073394495,0.600917431,2,0.605210014
4994,100,20833,8,8,0,7,0,23,11,7,0,0,0,18,nowin,loss,bust,plbust,0,10,16,190,0.452631579,0.036842105,0.594736842,3,0.888671154
4995,139,20833,8,9,0,0,0,17,11,7,0,0,0,18,nowin,loss,beat,dlwin,0,10,17,192,0.380208333,0.036458333,0.59375,0,0.023429169
4996,146,20833,10,5,0,6,0,21,11,7,0,0,0,18,nowin,win,plwin,beat,20,0,15,221,0.43438914,0.040723982,0.542986425,1,0.290190091
4997,19,20833,2,10,0,10,0,22,11,7,0,0,0,18,nowin,loss,bust,plbust,0,10,12,237,0.41350211,0.054852321,0.628691983,2,0.597373826
4998,35,20834,2,5,10,0,0,17,9,7,6,0,0,22,nowin,win,dlbust,bust,20,0,7,202,0.410891089,0.044554455,0.633663366,2,0.598681573
4999,92,20834,9,7,0,4,0,20,9,7,6,0,0,22,nowin,win,dlbust,bust,20,0,16,186,0.446236559,0.059139785,0.564516129,1,0.307826125
5000,114,20834,10,9,0,0,0,19,9,7,6,0,0,22,nowin,win,dlbust,bust,20,0,19,198,0.47979798,0.025252525,0.611111111,3,0.937232995
5001,30,20834,3,2,4,10,0,19,9,7,6,0,0,22,nowin,win,dlbust,bust,20,0,5,206,0.393203883,0.033980583,0.601941748,0,0.029324648
5002,21,20834,11,10,0,0,0,21,9,7,6,0,0,22,win,win,dlbust,bust,25,0,21,214,0.359813084,0.042056075,0.626168224,0,0.025263474
5003,124,20834,10,5,0,4,0,19,9,7,6,0,0,22,nowin,win,dlbust,bust,20,0,15,202,0.47029703,0.064356436,0.584158416,3,0.899458193
5004,54,20835,5,7,0,1,0,13,3,4,10,0,0,17,nowin,loss,beat,dlwin,0,10,12,185,0.437837838,0.032432432,0.556756757,1,0.29899854
5005,141,20835,3,9,0,6,0,18,3,4,10,0,0,17,nowin,win,plwin,beat,20,0,12,202,0.420792079,0.074257426,0.564356436,0,0.028377851
5006,12,20835,8,3,8,0,0,19,3,4,10,0,0,17,nowin,win,plwin,beat,20,0,11,189,0.470899471,0.015873016,0.613756614,3,0.929171178
5007,75,20835,11,10,0,0,0,21,3,4,10,0,0,17,win,win,plwin,beat,25,0,21,191,0.418848168,0.052356021,0.570680628,0,0.029344702
5008,33,20835,10,6,0,0,0,16,3,4,10,0,0,17,nowin,loss,beat,dlwin,0,10,16,192,0.4375,0.057291667,0.625,2,0.616208916
5009,71,20835,7,10,0,0,0,17,3,4,10,0,0,17,nowin,push,push,push,10,0,17,193,0.352331606,0.046632124,0.585492228,0,0.013063661
5010,81,20836,5,3,8,0,0,16,4,10,7,0,0,21,nowin,loss,beat,dlwin,0,10,8,182,0.395604396,0.043956044,0.60989011,2,0.567491261
5011,103,20836,10,4,0,0,0,14,4,10,7,0,0,21,nowin,loss,beat,dlwin,0,10,14,203,0.379310345,0.064039409,0.551724138,0,0.012869209
5012,97,20836,3,2,9,0,0,14,4,10,7,0,0,21,nowin,loss,beat,dlwin,0,10,5,182,0.450549451,0.06043956,0.692307692,2,0.677372279
5013,28,20836,6,5,4,0,0,15,4,10,7,0,0,21,nowin,loss,beat,dlwin,0,10,11,199,0.422110553,0.045226131,0.542713568,1,0.282706618
5014,99,20836,5,4,11,0,0,20,4,10,7,0,0,21,nowin,loss,beat,dlwin,0,10,9,207,0.47826087,0.062801932,0.637681159,3,0.961418446
5015,42,20836,7,10,0,0,0,17,4,10,7,0,0,21,nowin,loss,beat,dlwin,0,10,17,212,0.443396226,0.051886792,0.570754717,1,0.309181312
5016,134,20837,10,8,0,0,0,18,10,8,0,0,0,18,nowin,push,push,push,10,0,18,185,0.443243243,0.021621622,0.545945946,1,0.296939509
5017,87,20837,3,10,0,9,0,22,10,8,0,0,0,18,nowin,loss,bust,plbust,0,10,13,202,0.405940594,0.054455446,0.628712871,2,0.590599801
5018,22,20837,7,5,0,9,0,21,10,8,0,0,0,18,nowin,win,plwin,beat,20,0,12,187,0.481283422,0.042780749,0.577540107,3,0.906128176
5019,138,20837,9,7,0,10,0,26,10,8,0,0,0,18,nowin,loss,bust,plbust,0,10,16,190,0.442105263,0.047368421,0.610526316,2,0.609711065
5020,100,20837,6,9,0,9,0,24,10,8,0,0,0,18,nowin,loss,bust,plbust,0,10,15,190,0.452631579,0.036842105,0.594736842,3,0.888671154
5021,32,20837,10,9,0,0,0,19,10,8,0,0,0,18,nowin,win,plwin,beat,20,0,19,189,0.391534392,0.037037037,0.53968254,0,0.013579086
5022,99,20838,8,3,10,0,0,21,4,3,10,0,0,17,nowin,win,plwin,beat,20,0,11,207,0.47826087,0.062801932,0.637681159,3,0.961418446
5023,129,20838,10,10,0,0,0,20,4,3,10,0,0,17,nowin,win,plwin,beat,20,0,20,201,0.422885572,0.064676617,0.55721393,0,0.027255383
5024,88,20838,4,3,11,0,0,18,4,3,10,0,0,17,nowin,win,plwin,beat,20,0,7,206,0.466019417,0.033980583,0.54368932,1,0.309467903
5025,56,20838,6,2,11,0,0,19,4,3,10,0,0,17,nowin,win,plwin,beat,20,0,8,175,0.4,0.057142857,0.582857143,0,0.026685297
5026,43,20838,11,10,0,0,0,21,4,3,10,0,0,17,win,win,plwin,beat,25,0,21,192,0.40625,0.041666667,0.609375,2,0.576671372
5027,78,20838,10,7,0,0,0,17,4,3,10,0,0,17,nowin,push,push,push,10,0,17,201,0.517412935,0.034825871,0.587064677,3,0.95871112
5028,19,20839,8,7,0,3,0,18,8,11,0,0,0,19,nowin,loss,beat,dlwin,0,10,15,237,0.41350211,0.054852321,0.628691983,2,0.597373826
5029,79,20839,11,10,0,0,0,21,8,11,0,0,0,19,win,win,plwin,beat,25,0,21,211,0.436018957,0.028436019,0.672985782,2,0.650131054
5030,103,20839,3,7,10,0,0,20,8,11,0,0,0,19,nowin,win,plwin,beat,20,0,10,203,0.379310345,0.064039409,0.551724138,0,0.012869209
5031,85,20839,10,8,0,0,0,18,8,11,0,0,0,19,nowin,loss,beat,dlwin,0,10,18,195,0.41025641,0.066666667,0.594871795,0,0.03269711
5032,116,20839,3,1,10,10,0,24,8,11,0,0,0,19,nowin,loss,bust,plbust,0,10,4,195,0.425641026,0.056410256,0.538461538,1,0.28273747
5033,142,20839,10,6,0,10,0,26,8,11,0,0,0,19,nowin,loss,bust,plbust,0,10,16,211,0.417061611,0.047393365,0.526066351,1,0.271531309
5034,73,20840,2,5,4,3,10,24,7,10,0,0,0,17,nowin,loss,bust,plbust,0,10,7,181,0.375690608,0.011049724,0.596685083,0,0.022795773
5035,28,20840,5,10,0,4,0,19,7,10,0,0,0,17,nowin,win,plwin,beat,20,0,15,199,0.422110553,0.045226131,0.542713568,1,0.282706618
5036,145,20840,10,10,0,0,0,20,7,10,0,0,0,17,nowin,win,plwin,beat,20,0,20,188,0.441489362,0.031914894,0.622340426,2,0.617837093
5037,57,20840,7,4,8,0,0,19,7,10,0,0,0,17,nowin,win,plwin,beat,20,0,11,192,0.46875,0.052083333,0.59375,3,0.907001181
5038,33,20840,6,4,11,0,0,21,7,10,0,0,0,17,nowin,win,plwin,beat,20,0,10,192,0.4375,0.057291667,0.625,2,0.616208916
5039,90,20840,8,3,8,0,0,19,7,10,0,0,0,17,nowin,win,plwin,beat,20,0,11,201,0.447761194,0.049751244,0.60199005,3,0.889945023
5040,64,20841,6,7,0,0,0,13,6,7,10,0,0,23,nowin,win,dlbust,bust,20,0,13,187,0.363636364,0.048128342,0.631016043,0,0.027594885
5041,89,20841,6,11,1,0,0,18,6,7,10,0,0,23,nowin,win,dlbust,bust,20,0,17,212,0.537735849,0.047169811,0.594339623,3,0.990167191
5042,128,20841,4,6,5,0,0,15,6,7,10,0,0,23,nowin,win,dlbust,bust,20,0,10,227,0.356828194,0.052863436,0.577092511,0,0.012352564
5043,24,20841,10,10,0,0,0,20,6,7,10,0,0,23,nowin,win,dlbust,bust,20,0,20,207,0.458937198,0.048309179,0.570048309,1,0.318138014
5044,22,20841,10,3,0,0,0,13,6,7,10,0,0,23,nowin,win,dlbust,bust,20,0,13,187,0.481283422,0.042780749,0.577540107,3,0.906128176
5045,128,20841,3,5,10,0,0,18,6,7,10,0,0,23,nowin,win,dlbust,bust,20,0,8,227,0.356828194,0.052863436,0.577092511,0,0.012352564
5046,63,20842,10,5,0,1,10,26,10,3,8,0,0,21,nowin,loss,bust,plbust,0,10,15,216,0.467592593,0.037037037,0.62037037,3,0.931690496
5047,130,20842,10,9,0,0,0,19,10,3,8,0,0,21,nowin,loss,beat,dlwin,0,10,19,219,0.410958904,0.03652968,0.566210046,0,0.025888739
5048,116,20842,5,6,2,7,0,20,10,3,8,0,0,21,nowin,loss,beat,dlwin,0,10,11,195,0.425641026,0.056410256,0.538461538,1,0.28273747
5049,44,20842,9,10,0,0,0,19,10,3,8,0,0,21,nowin,loss,beat,dlwin,0,10,19,219,0.433789954,0.050228311,0.534246575,1,0.285551035
5050,79,20842,6,10,0,10,0,26,10,3,8,0,0,21,nowin,loss,bust,plbust,0,10,16,211,0.436018957,0.028436019,0.672985782,2,0.650131054
5051,103,20842,2,5,8,2,0,17,10,3,8,0,0,21,nowin,loss,beat,dlwin,0,10,7,203,0.379310345,0.064039409,0.551724138,0,0.012869209
5052,33,20843,9,10,0,0,0,19,10,3,10,0,0,23,nowin,win,dlbust,bust,20,0,19,192,0.4375,0.057291667,0.625,2,0.616208916
5053,3,20843,4,3,3,8,0,18,10,3,10,0,0,23,nowin,win,dlbust,bust,20,0,7,190,0.431578947,0.026315789,0.542105263,1,0.288076384
5054,22,20843,4,4,3,9,0,20,10,3,10,0,0,23,nowin,win,dlbust,bust,20,0,8,187,0.481283422,0.042780749,0.577540107,3,0.906128176
5055,21,20843,10,9,0,0,0,19,10,3,10,0,0,23,nowin,win,dlbust,bust,20,0,19,214,0.359813084,0.042056075,0.626168224,0,0.025263474
5056,40,20843,10,10,0,0,0,20,10,3,10,0,0,23,nowin,win,dlbust,bust,20,0,20,196,0.367346939,0.030612245,0.617346939,0,0.025358183
5057,80,20843,8,10,0,0,0,18,10,3,10,0,0,23,nowin,win,dlbust,bust,20,0,18,186,0.419354839,0.059139785,0.623655914,2,0.59892924
5058,49,20844,2,7,7,10,0,26,10,10,0,0,0,20,nowin,loss,bust,plbust,0,10,9,207,0.396135266,0.053140097,0.594202899,0,0.028306925
5059,40,20844,3,9,0,10,0,22,10,10,0,0,0,20,nowin,loss,bust,plbust,0,10,12,196,0.367346939,0.030612245,0.617346939,0,0.025358183
5060,82,20844,10,6,0,10,0,26,10,10,0,0,0,20,nowin,loss,bust,plbust,0,10,16,225,0.408888889,0.075555556,0.577777778,0,0.028101874
5061,144,20844,4,10,0,10,0,24,10,10,0,0,0,20,nowin,loss,bust,plbust,0,10,14,202,0.386138614,0.054455446,0.564356436,0,0.018006244
5062,60,20844,5,2,10,0,0,17,10,10,0,0,0,20,nowin,loss,beat,dlwin,0,10,7,227,0.418502203,0.022026432,0.559471366,0,0.026496258
5063,150,20844,2,10,0,4,5,21,10,10,0,0,0,20,nowin,win,plwin,beat,20,0,12,192,0.401041667,0.036458333,0.567708333,0,0.023287458
5064,7,20845,5,3,10,0,0,18,11,7,0,0,0,18,nowin,push,push,push,10,0,8,183,0.442622951,0.06010929,0.62295082,2,0.619303341
5065,134,20845,9,10,0,0,0,19,11,7,0,0,0,18,nowin,win,plwin,beat,20,0,19,185,0.443243243,0.021621622,0.545945946,1,0.296939509
5066,114,20845,7,7,0,1,6,21,11,7,0,0,0,18,nowin,win,plwin,beat,20,0,14,198,0.47979798,0.025252525,0.611111111,3,0.937232995
5067,23,20845,5,5,4,4,0,18,11,7,0,0,0,18,nowin,push,push,push,10,0,10,208,0.427884615,0.0625,0.552884615,1,0.29114424
5068,15,20845,7,10,0,0,0,17,11,7,0,0,0,18,nowin,loss,beat,dlwin,0,10,17,212,0.410377358,0.051886792,0.561320755,0,0.024517408
5069,104,20845,8,8,0,1,0,17,11,7,0,0,0,18,nowin,loss,beat,dlwin,0,10,16,209,0.363636364,0.052631579,0.593301435,0,0.018359419
5070,132,20846,10,11,0,0,0,21,11,10,0,0,0,21,win,push,push,push,10,0,21,194,0.412371134,0.036082474,0.649484536,2,0.611633238
5071,147,20846,8,10,0,0,0,18,11,10,0,0,0,21,nowin,loss,beat,dlwin,0,10,18,205,0.380487805,0.014634146,0.536585366,0,0.00951447
5072,77,20846,3,2,10,1,10,26,11,10,0,0,0,21,nowin,loss,bust,plbust,0,10,5,200,0.455,0.04,0.62,3,0.916252116
5073,101,20846,7,6,0,10,0,23,11,10,0,0,0,21,nowin,loss,bust,plbust,0,10,13,205,0.424390244,0.068292683,0.63902439,2,0.614740646
5074,133,20846,11,10,0,0,0,21,11,10,0,0,0,21,win,push,push,push,10,0,21,201,0.47761194,0.064676617,0.611940299,3,0.935428111
5075,133,20846,9,3,0,10,0,22,11,10,0,0,0,21,nowin,loss,bust,plbust,0,10,12,201,0.47761194,0.064676617,0.611940299,3,0.935428111
5076,18,20847,9,10,0,0,0,19,2,1,10,10,0,23,nowin,win,dlbust,bust,20,0,19,182,0.461538462,0.043956044,0.587912088,3,0.892649374
5077,132,20847,4,1,9,0,0,14,2,1,10,10,0,23,nowin,win,dlbust,bust,20,0,5,194,0.412371134,0.036082474,0.649484536,2,0.611633238
5078,68,20847,10,6,0,0,0,16,2,1,10,10,0,23,nowin,win,dlbust,bust,20,0,16,205,0.434146341,0.029268293,0.6,2,0.59483189
5079,87,20847,9,10,0,0,0,19,2,1,10,10,0,23,nowin,win,dlbust,bust,20,0,19,202,0.405940594,0.054455446,0.628712871,2,0.590599801
5080,104,20847,7,11,0,0,0,18,2,1,10,10,0,23,nowin,win,dlbust,bust,20,0,18,209,0.363636364,0.052631579,0.593301435,0,0.018359419
5081,51,20847,6,8,0,0,0,14,2,1,10,10,0,23,nowin,win,dlbust,bust,20,0,14,189,0.529100529,0.068783069,0.608465608,3,0.993665715
5082,42,20848,10,9,0,0,0,19,8,5,9,0,0,22,nowin,win,dlbust,bust,20,0,19,212,0.443396226,0.051886792,0.570754717,1,0.309181312
5083,64,20848,2,4,8,6,0,20,8,5,9,0,0,22,nowin,win,dlbust,bust,20,0,6,187,0.363636364,0.048128342,0.631016043,0,0.027594885
5084,82,20848,11,5,2,0,0,18,8,5,9,0,0,22,nowin,win,dlbust,bust,20,0,16,225,0.408888889,0.075555556,0.577777778,0,0.028101874
5085,84,20848,10,7,0,0,0,17,8,5,9,0,0,22,nowin,win,dlbust,bust,20,0,17,195,0.379487179,0.056410256,0.569230769,0,0.017209119
5086,24,20848,2,5,11,0,0,18,8,5,9,0,0,22,nowin,win,dlbust,bust,20,0,7,207,0.458937198,0.048309179,0.570048309,1,0.318138014
5087,28,20848,6,3,10,0,0,19,8,5,9,0,0,22,nowin,win,dlbust,bust,20,0,9,199,0.422110553,0.045226131,0.542713568,1,0.282706618
5088,44,20849,2,11,1,10,0,24,8,10,0,0,0,18,nowin,loss,bust,plbust,0,10,13,219,0.433789954,0.050228311,0.534246575,1,0.285551035
5089,35,20849,11,3,1,10,0,25,8,10,0,0,0,18,nowin,loss,bust,plbust,0,10,14,202,0.410891089,0.044554455,0.633663366,2,0.598681573
5090,6,20849,4,7,3,6,0,20,8,10,0,0,0,18,nowin,win,plwin,beat,20,0,11,191,0.439790576,0.047120419,0.581151832,1,0.31211505
5091,132,20849,9,9,0,0,0,18,8,10,0,0,0,18,nowin,push,push,push,10,0,18,194,0.412371134,0.036082474,0.649484536,2,0.611633238
5092,22,20849,7,5,0,10,0,22,8,10,0,0,0,18,nowin,loss,bust,plbust,0,10,12,187,0.481283422,0.042780749,0.577540107,3,0.906128176
5093,38,20849,10,5,0,10,0,25,8,10,0,0,0,18,nowin,loss,bust,plbust,0,10,15,202,0.361386139,0.03960396,0.564356436,0,0.010597953
5094,140,20850,5,1,10,10,0,26,10,5,4,0,0,19,nowin,loss,bust,plbust,0,10,6,210,0.466666667,0.023809524,0.604761905,3,0.915293335
5095,58,20850,3,10,0,7,0,20,10,5,4,0,0,19,nowin,win,plwin,beat,20,0,13,195,0.430769231,0.041025641,0.584615385,2,0.580497586
5096,41,20850,9,8,0,0,0,17,10,5,4,0,0,19,nowin,loss,beat,dlwin,0,10,17,192,0.364583333,0.036458333,0.520833333,0,0.00089702
5097,91,20850,9,10,0,0,0,19,10,5,4,0,0,19,nowin,push,push,push,10,0,19,194,0.417525773,0.046391753,0.515463918,1,0.266616552
5098,97,20850,3,10,0,5,0,18,10,5,4,0,0,19,nowin,loss,beat,dlwin,0,10,13,182,0.450549451,0.06043956,0.692307692,2,0.677372279
5099,110,20850,5,10,0,3,0,18,10,5,4,0,0,19,nowin,loss,beat,dlwin,0,10,15,192,0.416666667,0.046875,0.557291667,0,0.025413132
5100,50,20851,4,10,0,10,0,24,10,5,10,0,0,25,nowin,loss,bust,plbust,0,10,14,202,0.405940594,0.04950495,0.54950495,0,0.020296079
5101,55,20851,8,5,0,10,0,23,10,5,10,0,0,25,nowin,loss,bust,plbust,0,10,13,191,0.371727749,0.057591623,0.54973822,0,0.01011347
5102,70,20851,2,6,4,10,0,22,10,5,10,0,0,25,nowin,loss,bust,plbust,0,10,8,228,0.385964912,0.039473684,0.557017544,0,0.016157125
5103,47,20851,8,6,0,4,0,18,10,5,10,0,0,25,nowin,win,dlbust,bust,20,0,14,210,0.438095238,0.057142857,0.623809524,2,0.615868808
5104,50,20851,9,10,0,0,0,19,10,5,10,0,0,25,nowin,win,dlbust,bust,20,0,19,202,0.405940594,0.04950495,0.54950495,0,0.020296079
5105,137,20851,2,10,0,10,0,22,10,5,10,0,0,25,nowin,loss,bust,plbust,0,10,12,194,0.417525773,0.046391753,0.536082474,1,0.276714602
5106,41,20852,2,1,9,10,0,22,2,1,10,7,0,20,nowin,loss,bust,plbust,0,10,3,192,0.364583333,0.036458333,0.520833333,0,0.00089702
5107,81,20852,10,3,0,0,0,13,2,1,10,7,0,20,nowin,loss,beat,dlwin,0,10,13,182,0.395604396,0.043956044,0.60989011,2,0.567491261
5108,106,20852,5,6,5,0,0,16,2,1,10,7,0,20,nowin,loss,beat,dlwin,0,10,11,192,0.411458333,0.026041667,0.557291667,0,0.023854304
5109,126,20852,6,7,0,0,0,13,2,1,10,7,0,20,nowin,loss,beat,dlwin,0,10,13,188,0.457446809,0.074468085,0.60106383,3,0.900633203
5110,36,20852,5,11,1,0,0,17,2,1,10,7,0,20,nowin,loss,beat,dlwin,0,10,16,229,0.445414847,0.056768559,0.655021834,2,0.645370571
5111,88,20852,10,7,0,0,0,17,2,1,10,7,0,20,nowin,loss,beat,dlwin,0,10,17,206,0.466019417,0.033980583,0.54368932,1,0.309467903
5112,42,20853,9,8,0,0,0,17,10,9,0,0,0,19,nowin,loss,beat,dlwin,0,10,17,212,0.443396226,0.051886792,0.570754717,1,0.309181312
5113,42,20853,2,7,11,0,0,20,10,9,0,0,0,19,nowin,win,plwin,beat,20,0,9,212,0.443396226,0.051886792,0.570754717,1,0.309181312
5114,135,20853,10,7,0,0,0,17,10,9,0,0,0,19,nowin,loss,beat,dlwin,0,10,17,179,0.391061453,0.067039106,0.586592179,0,0.024924662
5115,58,20853,2,1,10,2,3,18,10,9,0,0,0,19,nowin,loss,beat,dlwin,0,10,3,195,0.430769231,0.041025641,0.584615385,2,0.580497586
5116,19,20853,1,4,9,3,0,17,10,9,0,0,0,19,nowin,loss,beat,dlwin,0,10,5,237,0.41350211,0.054852321,0.628691983,2,0.597373826
5117,129,20853,11,10,0,0,0,21,10,9,0,0,0,19,win,win,plwin,beat,25,0,21,201,0.422885572,0.064676617,0.55721393,0,0.027255383
5118,138,20854,3,1,10,10,0,24,1,4,7,7,0,19,nowin,loss,bust,plbust,0,10,4,190,0.442105263,0.047368421,0.610526316,2,0.609711065
5119,115,20854,5,9,0,10,0,24,1,4,7,7,0,19,nowin,loss,bust,plbust,0,10,14,194,0.427835052,0.041237113,0.592783505,2,0.583863602
5120,107,20854,3,10,0,10,0,23,1,4,7,7,0,19,nowin,loss,bust,plbust,0,10,13,218,0.444954128,0.073394495,0.600917431,2,0.605210014
5121,45,20854,3,5,10,0,0,18,1,4,7,7,0,19,nowin,loss,beat,dlwin,0,10,8,196,0.428571429,0.051020408,0.612244898,2,0.598821767
5122,54,20854,8,8,0,8,0,24,1,4,7,7,0,19,nowin,loss,bust,plbust,0,10,16,185,0.437837838,0.032432432,0.556756757,1,0.29899854
5123,78,20854,6,5,7,0,0,18,1,4,7,7,0,19,nowin,loss,beat,dlwin,0,10,11,201,0.517412935,0.034825871,0.587064677,3,0.95871112
5124,78,20855,6,10,0,0,0,16,6,6,10,0,0,22,nowin,win,dlbust,bust,20,0,16,201,0.517412935,0.034825871,0.587064677,3,0.95871112
5125,137,20855,8,5,0,0,0,13,6,6,10,0,0,22,nowin,win,dlbust,bust,20,0,13,194,0.417525773,0.046391753,0.536082474,1,0.276714602
5126,56,20855,10,11,0,0,0,21,6,6,10,0,0,22,win,win,dlbust,bust,25,0,21,175,0.4,0.057142857,0.582857143,0,0.026685297
5127,98,20855,4,10,0,0,0,14,6,6,10,0,0,22,nowin,win,dlbust,bust,20,0,14,220,0.422727273,0.054545455,0.55,1,0.28664435
5128,132,20855,8,8,0,0,0,16,6,6,10,0,0,22,nowin,win,dlbust,bust,20,0,16,194,0.412371134,0.036082474,0.649484536,2,0.611633238
5129,39,20855,2,10,0,0,0,12,6,6,10,0,0,22,nowin,win,dlbust,bust,20,0,12,191,0.429319372,0.062827225,0.57591623,0,0.033760763
5130,13,20856,5,2,4,8,0,19,2,9,10,0,0,21,nowin,loss,beat,dlwin,0,10,7,206,0.417475728,0.063106796,0.621359223,2,0.59555479
5131,106,20856,6,7,0,0,0,13,2,9,10,0,0,21,nowin,loss,beat,dlwin,0,10,13,192,0.411458333,0.026041667,0.557291667,0,0.023854304
5132,146,20856,10,10,0,0,0,20,2,9,10,0,0,21,nowin,loss,beat,dlwin,0,10,20,221,0.43438914,0.040723982,0.542986425,1,0.290190091
5133,139,20856,8,10,0,0,0,18,2,9,10,0,0,21,nowin,loss,beat,dlwin,0,10,18,192,0.380208333,0.036458333,0.59375,0,0.023429169
5134,79,20856,9,6,0,0,0,15,2,9,10,0,0,21,nowin,loss,beat,dlwin,0,10,15,211,0.436018957,0.028436019,0.672985782,2,0.650131054
5135,105,20856,5,9,0,0,0,14,2,9,10,0,0,21,nowin,loss,beat,dlwin,0,10,14,198,0.414141414,0.070707071,0.590909091,0,0.032889494
5136,148,20857,10,6,0,0,0,16,6,10,6,0,0,22,nowin,win,dlbust,bust,20,0,16,204,0.401960784,0.078431373,0.593137255,0,0.029789521
5137,149,20857,6,3,11,0,0,20,6,10,6,0,0,22,nowin,win,dlbust,bust,20,0,9,225,0.457777778,0.057777778,0.648888889,2,0.651965595
5138,45,20857,10,8,0,0,0,18,6,10,6,0,0,22,nowin,win,dlbust,bust,20,0,18,196,0.428571429,0.051020408,0.612244898,2,0.598821767
5139,147,20857,6,8,0,0,0,14,6,10,6,0,0,22,nowin,win,dlbust,bust,20,0,14,205,0.380487805,0.014634146,0.536585366,0,0.00951447
5140,131,20857,2,8,5,0,0,15,6,10,6,0,0,22,nowin,win,dlbust,bust,20,0,10,217,0.410138249,0.069124424,0.543778802,0,0.02015021
5141,130,20857,6,10,0,0,0,16,6,10,6,0,0,22,nowin,win,dlbust,bust,20,0,16,219,0.410958904,0.03652968,0.566210046,0,0.025888739
5142,20,20858,11,5,1,0,0,17,7,10,0,0,0,17,nowin,push,push,push,10,0,16,186,0.456989247,0.037634409,0.537634409,1,0.301097108
5143,130,20858,3,10,0,5,0,18,7,10,0,0,0,17,nowin,win,plwin,beat,20,0,13,219,0.410958904,0.03652968,0.566210046,0,0.025888739
5144,65,20858,8,10,0,0,0,18,7,10,0,0,0,17,nowin,win,plwin,beat,20,0,18,203,0.492610837,0.054187192,0.571428571,3,0.913702814
5145,106,20858,5,10,0,2,0,17,7,10,0,0,0,17,nowin,push,push,push,10,0,15,192,0.411458333,0.026041667,0.557291667,0,0.023854304
5146,72,20858,11,10,0,0,0,21,7,10,0,0,0,17,win,win,plwin,beat,25,0,21,185,0.394594595,0.032432432,0.508108108,0,0.006763115
5147,148,20858,5,1,10,6,0,22,7,10,0,0,0,17,nowin,loss,bust,plbust,0,10,6,204,0.401960784,0.078431373,0.593137255,0,0.029789521
5148,124,20859,4,8,0,3,3,18,9,3,4,10,0,26,nowin,win,dlbust,bust,20,0,12,202,0.47029703,0.064356436,0.584158416,3,0.899458193
5149,34,20859,11,10,0,0,0,21,9,3,4,10,0,26,win,win,dlbust,bust,25,0,21,202,0.5,0.079207921,0.618811881,3,0.968961434
5150,28,20859,5,4,7,4,0,20,9,3,4,10,0,26,nowin,win,dlbust,bust,20,0,9,199,0.422110553,0.045226131,0.542713568,1,0.282706618
5151,107,20859,10,10,0,0,0,20,9,3,4,10,0,26,nowin,win,dlbust,bust,20,0,20,218,0.444954128,0.073394495,0.600917431,2,0.605210014
5152,36,20859,10,9,0,0,0,19,9,3,4,10,0,26,nowin,win,dlbust,bust,20,0,19,229,0.445414847,0.056768559,0.655021834,2,0.645370571
5153,127,20859,4,4,3,8,0,19,9,3,4,10,0,26,nowin,win,dlbust,bust,20,0,8,201,0.402985075,0.029850746,0.60199005,0,0.032263937
5154,126,20860,2,9,6,0,0,17,4,10,10,0,0,24,nowin,win,dlbust,bust,20,0,11,188,0.457446809,0.074468085,0.60106383,3,0.900633203
5155,51,20860,6,1,10,0,0,17,4,10,10,0,0,24,nowin,win,dlbust,bust,20,0,7,189,0.529100529,0.068783069,0.608465608,3,0.993665715
5156,61,20860,9,10,0,0,0,19,4,10,10,0,0,24,nowin,win,dlbust,bust,20,0,19,194,0.427835052,0.077319588,0.603092784,2,0.591437139
5157,8,20860,6,8,0,0,0,14,4,10,10,0,0,24,nowin,win,dlbust,bust,20,0,14,181,0.44198895,0.071823204,0.596685083,2,0.599438402
5158,143,20860,10,9,0,0,0,19,4,10,10,0,0,24,nowin,win,dlbust,bust,20,0,19,203,0.463054187,0.044334975,0.57635468,3,0.883143365
5159,52,20860,5,10,0,0,0,15,4,10,10,0,0,24,nowin,win,dlbust,bust,20,0,15,217,0.414746544,0.02764977,0.599078341,2,0.576736024
5160,2,20861,8,10,0,0,0,18,10,9,0,0,0,19,nowin,loss,beat,dlwin,0,10,18,200,0.445,0.035,0.64,2,0.633962549
5161,147,20861,3,5,4,9,0,21,10,9,0,0,0,19,nowin,win,plwin,beat,20,0,8,205,0.380487805,0.014634146,0.536585366,0,0.00951447
5162,43,20861,9,10,0,0,0,19,10,9,0,0,0,19,nowin,push,push,push,10,0,19,192,0.40625,0.041666667,0.609375,2,0.576671372
5163,44,20861,6,10,0,6,0,22,10,9,0,0,0,19,nowin,loss,bust,plbust,0,10,16,219,0.433789954,0.050228311,0.534246575,1,0.285551035
5164,124,20861,4,5,10,0,0,19,10,9,0,0,0,19,nowin,push,push,push,10,0,9,202,0.47029703,0.064356436,0.584158416,3,0.899458193
5165,33,20861,1,4,10,4,0,19,10,9,0,0,0,19,nowin,push,push,push,10,0,5,192,0.4375,0.057291667,0.625,2,0.616208916
5166,75,20862,10,6,0,0,0,16,3,10,6,0,0,19,nowin,loss,beat,dlwin,0,10,16,191,0.418848168,0.052356021,0.570680628,0,0.029344702
5167,98,20862,4,10,0,0,0,14,3,10,6,0,0,19,nowin,loss,beat,dlwin,0,10,14,220,0.422727273,0.054545455,0.55,1,0.28664435
5168,95,20862,7,5,0,10,0,22,3,10,6,0,0,19,nowin,loss,bust,plbust,0,10,12,218,0.412844037,0.04587156,0.559633028,0,0.024842385
5169,70,20862,2,3,10,0,0,15,3,10,6,0,0,19,nowin,loss,beat,dlwin,0,10,5,228,0.385964912,0.039473684,0.557017544,0,0.016157125
5170,4,20862,8,10,0,0,0,18,3,10,6,0,0,19,nowin,loss,beat,dlwin,0,10,18,217,0.460829493,0.036866359,0.562211982,1,0.315432839
5171,13,20862,9,10,0,0,0,19,3,10,6,0,0,19,nowin,push,push,push,10,0,19,206,0.417475728,0.063106796,0.621359223,2,0.59555479
5172,50,20863,10,9,0,0,0,19,2,10,8,0,0,20,nowin,loss,beat,dlwin,0,10,19,202,0.405940594,0.04950495,0.54950495,0,0.020296079
5173,70,20863,3,10,0,0,0,13,2,10,8,0,0,20,nowin,loss,beat,dlwin,0,10,13,228,0.385964912,0.039473684,0.557017544,0,0.016157125
5174,5,20863,10,10,0,0,0,20,2,10,8,0,0,20,nowin,push,push,push,10,0,20,203,0.42364532,0.02955665,0.596059113,2,0.582508076
5175,84,20863,10,9,0,0,0,19,2,10,8,0,0,20,nowin,loss,beat,dlwin,0,10,19,195,0.379487179,0.056410256,0.569230769,0,0.017209119
5176,76,20863,3,7,11,0,0,21,2,10,8,0,0,20,nowin,win,plwin,beat,20,0,10,189,0.534391534,0.079365079,0.608465608,3,1
5177,96,20863,8,10,0,0,0,18,2,10,8,0,0,20,nowin,loss,beat,dlwin,0,10,18,190,0.468421053,0.057894737,0.584210526,3,0.897263354
5178,87,20864,9,8,0,0,0,17,1,4,8,10,0,23,nowin,win,dlbust,bust,20,0,17,202,0.405940594,0.054455446,0.628712871,2,0.590599801
5179,89,20864,9,7,0,10,0,26,1,4,8,10,0,23,nowin,loss,bust,plbust,0,10,16,212,0.537735849,0.047169811,0.594339623,3,0.990167191
5180,73,20864,6,5,2,10,0,23,1,4,8,10,0,23,nowin,loss,bust,plbust,0,10,11,181,0.375690608,0.011049724,0.596685083,0,0.022795773
5181,121,20864,3,5,5,10,0,23,1,4,8,10,0,23,nowin,loss,bust,plbust,0,10,8,195,0.456410256,0.025641026,0.512820513,1,0.288597791
5182,17,20864,2,6,10,0,0,18,1,4,8,10,0,23,nowin,win,dlbust,bust,20,0,8,171,0.444444444,0.070175439,0.555555556,1,0.302364894
5183,138,20864,10,7,0,0,0,17,1,4,8,10,0,23,nowin,win,dlbust,bust,20,0,17,190,0.442105263,0.047368421,0.610526316,2,0.609711065
5184,99,20865,4,9,0,3,1,17,10,2,10,0,0,22,nowin,win,dlbust,bust,20,0,13,207,0.47826087,0.062801932,0.637681159,3,0.961418446
5185,3,20865,10,5,0,6,0,21,10,2,10,0,0,22,nowin,win,dlbust,bust,20,0,15,190,0.431578947,0.026315789,0.542105263,1,0.288076384
5186,22,20865,9,11,0,0,0,20,10,2,10,0,0,22,nowin,win,dlbust,bust,20,0,20,187,0.481283422,0.042780749,0.577540107,3,0.906128176
5187,23,20865,8,4,0,8,0,20,10,2,10,0,0,22,nowin,win,dlbust,bust,20,0,12,208,0.427884615,0.0625,0.552884615,1,0.29114424
5188,48,20865,10,4,0,2,10,26,10,2,10,0,0,22,nowin,loss,bust,plbust,0,10,14,203,0.413793103,0.019704433,0.600985222,2,0.577280801
5189,129,20865,2,9,10,0,0,21,10,2,10,0,0,22,nowin,win,dlbust,bust,20,0,11,201,0.422885572,0.064676617,0.55721393,0,0.027255383
5190,39,20866,10,6,0,10,0,26,7,11,0,0,0,18,nowin,loss,bust,plbust,0,10,16,191,0.429319372,0.062827225,0.57591623,0,0.033760763
5191,1,20866,10,8,0,0,0,18,7,11,0,0,0,18,nowin,push,push,push,10,0,18,197,0.406091371,0.025380711,0.649746193,2,0.606186955
5192,116,20866,6,9,0,4,0,19,7,11,0,0,0,18,nowin,win,plwin,beat,20,0,15,195,0.425641026,0.056410256,0.538461538,1,0.28273747
5193,60,20866,10,10,0,0,0,20,7,11,0,0,0,18,nowin,win,plwin,beat,20,0,20,227,0.418502203,0.022026432,0.559471366,0,0.026496258
5194,88,20866,10,11,0,0,0,21,7,11,0,0,0,18,win,win,plwin,beat,25,0,21,206,0.466019417,0.033980583,0.54368932,1,0.309467903
5195,63,20866,6,7,0,10,0,23,7,11,0,0,0,18,nowin,loss,bust,plbust,0,10,13,216,0.467592593,0.037037037,0.62037037,3,0.931690496
5196,84,20867,1,1,10,0,0,12,4,10,10,0,0,24,nowin,win,dlbust,bust,20,0,2,195,0.379487179,0.056410256,0.569230769,0,0.017209119
5197,66,20867,10,9,0,0,0,19,4,10,10,0,0,24,nowin,win,dlbust,bust,20,0,19,217,0.456221198,0.064516129,0.626728111,3,0.924304367
5198,6,20867,8,6,0,0,0,14,4,10,10,0,0,24,nowin,win,dlbust,bust,20,0,14,191,0.439790576,0.047120419,0.581151832,1,0.31211505
5199,98,20867,10,10,0,0,0,20,4,10,10,0,0,24,nowin,win,dlbust,bust,20,0,20,220,0.422727273,0.054545455,0.55,1,0.28664435
5200,62,20867,10,5,0,0,0,15,4,10,10,0,0,24,nowin,win,dlbust,bust,20,0,15,178,0.370786517,0.028089888,0.54494382,0,0.008657722
5201,141,20867,2,2,2,3,1,10,4,10,10,0,0,24,nowin,win,dlbust,bust,20,0,4,202,0.420792079,0.074257426,0.564356436,0,0.028377851
5202,95,20868,4,10,0,0,0,14,4,3,2,2,6,17,nowin,loss,beat,dlwin,0,10,14,218,0.412844037,0.04587156,0.559633028,0,0.024842385
5203,125,20868,1,6,8,0,0,15,4,3,2,2,6,17,nowin,loss,beat,dlwin,0,10,7,219,0.438356164,0.050228311,0.575342466,1,0.308411257
5204,80,20868,7,2,10,0,0,19,4,3,2,2,6,17,nowin,win,plwin,beat,20,0,9,186,0.419354839,0.059139785,0.623655914,2,0.59892924
5205,39,20868,10,10,0,0,0,20,4,3,2,2,6,17,nowin,win,plwin,beat,20,0,20,191,0.429319372,0.062827225,0.57591623,0,0.033760763
5206,6,20868,10,2,0,0,0,12,4,3,2,2,6,17,nowin,loss,beat,dlwin,0,10,12,191,0.439790576,0.047120419,0.581151832,1,0.31211505
5207,98,20868,10,4,0,0,0,14,4,3,2,2,6,17,nowin,loss,beat,dlwin,0,10,14,220,0.422727273,0.054545455,0.55,1,0.28664435
5208,103,20869,11,9,0,0,0,20,10,3,10,0,0,23,nowin,win,dlbust,bust,20,0,20,203,0.379310345,0.064039409,0.551724138,0,0.012869209
5209,17,20869,10,10,0,0,0,20,10,3,10,0,0,23,nowin,win,dlbust,bust,20,0,20,171,0.444444444,0.070175439,0.555555556,1,0.302364894
5210,55,20869,4,1,7,7,0,19,10,3,10,0,0,23,nowin,win,dlbust,bust,20,0,5,191,0.371727749,0.057591623,0.54973822,0,0.01011347
5211,112,20869,11,10,0,0,0,21,10,3,10,0,0,23,win,win,dlbust,bust,25,0,21,203,0.448275862,0.054187192,0.600985222,3,0.889576933
5212,125,20869,3,3,6,10,0,22,10,3,10,0,0,23,nowin,loss,bust,plbust,0,10,6,219,0.438356164,0.050228311,0.575342466,1,0.308411257
5213,15,20869,4,10,0,5,0,19,10,3,10,0,0,23,nowin,win,dlbust,bust,20,0,14,212,0.410377358,0.051886792,0.561320755,0,0.024517408
5214,59,20870,6,1,7,0,0,14,2,10,7,0,0,19,nowin,loss,beat,dlwin,0,10,7,228,0.429824561,0.048245614,0.543859649,1,0.287885446
5215,129,20870,5,8,0,0,0,13,2,10,7,0,0,19,nowin,loss,beat,dlwin,0,10,13,201,0.422885572,0.064676617,0.55721393,0,0.027255383
5216,28,20870,10,9,0,0,0,19,2,10,7,0,0,19,nowin,push,push,push,10,0,19,199,0.422110553,0.045226131,0.542713568,1,0.282706618
5217,119,20870,6,7,0,0,0,13,2,10,7,0,0,19,nowin,loss,beat,dlwin,0,10,13,190,0.405263158,0.068421053,0.515789474,0,0.011837158
5218,79,20870,3,10,0,0,0,13,2,10,7,0,0,19,nowin,loss,beat,dlwin,0,10,13,211,0.436018957,0.028436019,0.672985782,2,0.650131054
5219,28,20870,8,6,0,0,0,14,2,10,7,0,0,19,nowin,loss,beat,dlwin,0,10,14,199,0.422110553,0.045226131,0.542713568,1,0.282706618
5220,19,20871,8,6,0,0,0,14,5,10,9,0,0,24,nowin,win,dlbust,bust,20,0,14,237,0.41350211,0.054852321,0.628691983,2,0.597373826
5221,27,20871,10,6,0,0,0,16,5,10,9,0,0,24,nowin,win,dlbust,bust,20,0,16,178,0.370786517,0.016853933,0.573033708,0,0.015536309
5222,80,20871,7,6,0,0,0,13,5,10,9,0,0,24,nowin,win,dlbust,bust,20,0,13,186,0.419354839,0.059139785,0.623655914,2,0.59892924
5223,137,20871,7,8,0,0,0,15,5,10,9,0,0,24,nowin,win,dlbust,bust,20,0,15,194,0.417525773,0.046391753,0.536082474,1,0.276714602
5224,150,20871,10,7,0,0,0,17,5,10,9,0,0,24,nowin,win,dlbust,bust,20,0,17,192,0.401041667,0.036458333,0.567708333,0,0.023287458
5225,108,20871,2,5,4,6,0,17,5,10,9,0,0,24,nowin,win,dlbust,bust,20,0,7,193,0.435233161,0.056994819,0.559585492,1,0.298824795
5226,114,20872,2,7,10,0,0,19,10,4,2,10,0,26,nowin,win,dlbust,bust,20,0,9,198,0.47979798,0.025252525,0.611111111,3,0.937232995
5227,120,20872,7,10,0,0,0,17,10,4,2,10,0,26,nowin,win,dlbust,bust,20,0,17,202,0.440594059,0.034653465,0.618811881,2,0.614441029
5228,20,20872,2,10,0,8,0,20,10,4,2,10,0,26,nowin,win,dlbust,bust,20,0,12,186,0.456989247,0.037634409,0.537634409,1,0.301097108
5229,69,20872,10,3,0,7,0,20,10,4,2,10,0,26,nowin,win,dlbust,bust,20,0,13,194,0.365979381,0.030927835,0.515463918,0,0
5230,6,20872,6,10,0,1,0,17,10,4,2,10,0,26,nowin,win,dlbust,bust,20,0,16,191,0.439790576,0.047120419,0.581151832,1,0.31211505
5231,60,20872,8,11,0,0,0,19,10,4,2,10,0,26,nowin,win,dlbust,bust,20,0,19,227,0.418502203,0.022026432,0.559471366,0,0.026496258
5232,86,20873,6,10,0,0,0,16,4,10,5,0,0,19,nowin,loss,beat,dlwin,0,10,16,196,0.454081633,0.040816327,0.591836735,3,0.887566443
5233,127,20873,10,10,0,0,0,20,4,10,5,0,0,19,nowin,win,plwin,beat,20,0,20,201,0.402985075,0.029850746,0.60199005,0,0.032263937
5234,63,20873,3,2,10,0,0,15,4,10,5,0,0,19,nowin,loss,beat,dlwin,0,10,5,216,0.467592593,0.037037037,0.62037037,3,0.931690496
5235,45,20873,4,10,0,0,0,14,4,10,5,0,0,19,nowin,loss,beat,dlwin,0,10,14,196,0.428571429,0.051020408,0.612244898,2,0.598821767
5236,98,20873,10,10,0,0,0,20,4,10,5,0,0,19,nowin,win,plwin,beat,20,0,20,220,0.422727273,0.054545455,0.55,1,0.28664435
5237,68,20873,3,11,5,0,0,19,4,10,5,0,0,19,nowin,push,push,push,10,0,14,205,0.434146341,0.029268293,0.6,2,0.59483189
5238,41,20874,6,10,0,5,0,21,10,5,3,0,0,18,nowin,win,plwin,beat,20,0,16,192,0.364583333,0.036458333,0.520833333,0,0.00089702
5239,11,20874,10,7,0,0,0,17,10,5,3,0,0,18,nowin,loss,beat,dlwin,0,10,17,236,0.457627119,0.016949153,0.588983051,3,0.889015813
5240,111,20874,6,10,0,7,0,23,10,5,3,0,0,18,nowin,loss,bust,plbust,0,10,16,180,0.433333333,0.055555556,0.611111111,2,0.602264492
5241,13,20874,3,7,10,0,0,20,10,5,3,0,0,18,nowin,win,plwin,beat,20,0,10,206,0.417475728,0.063106796,0.621359223,2,0.59555479
5242,89,20874,10,7,0,0,0,17,10,5,3,0,0,18,nowin,loss,beat,dlwin,0,10,17,212,0.537735849,0.047169811,0.594339623,3,0.990167191
5243,112,20874,10,9,0,0,0,19,10,5,3,0,0,18,nowin,win,plwin,beat,20,0,19,203,0.448275862,0.054187192,0.600985222,3,0.889576933
5244,60,20875,5,3,10,0,0,18,3,1,10,9,0,23,nowin,win,dlbust,bust,20,0,8,227,0.418502203,0.022026432,0.559471366,0,0.026496258
5245,42,20875,10,3,0,0,0,13,3,1,10,9,0,23,nowin,win,dlbust,bust,20,0,13,212,0.443396226,0.051886792,0.570754717,1,0.309181312
5246,30,20875,6,5,7,0,0,18,3,1,10,9,0,23,nowin,win,dlbust,bust,20,0,11,206,0.393203883,0.033980583,0.601941748,0,0.029324648
5247,90,20875,9,10,0,0,0,19,3,1,10,9,0,23,nowin,win,dlbust,bust,20,0,19,201,0.447761194,0.049751244,0.60199005,3,0.889945023
5248,16,20875,10,11,0,0,0,21,3,1,10,9,0,23,win,win,dlbust,bust,25,0,21,220,0.427272727,0.081818182,0.6,2,0.588660176
5249,132,20875,9,3,0,3,0,15,3,1,10,9,0,23,nowin,win,dlbust,bust,20,0,12,194,0.412371134,0.036082474,0.649484536,2,0.611633238
5250,68,20876,10,3,0,2,7,22,10,10,0,0,0,20,nowin,loss,bust,plbust,0,10,13,205,0.434146341,0.029268293,0.6,2,0.59483189
5251,31,20876,9,3,0,10,0,22,10,10,0,0,0,20,nowin,loss,bust,plbust,0,10,12,188,0.473404255,0.058510638,0.515957447,1,0.300306557
5252,6,20876,6,4,10,0,0,20,10,10,0,0,0,20,nowin,push,push,push,10,0,10,191,0.439790576,0.047120419,0.581151832,1,0.31211505
5253,136,20876,2,9,7,0,0,18,10,10,0,0,0,20,nowin,loss,beat,dlwin,0,10,11,194,0.396907216,0.025773196,0.597938144,0,0.029452644
5254,95,20876,7,9,0,10,0,26,10,10,0,0,0,20,nowin,loss,bust,plbust,0,10,16,218,0.412844037,0.04587156,0.559633028,0,0.024842385
5255,2,20876,10,8,0,0,0,18,10,10,0,0,0,20,nowin,loss,beat,dlwin,0,10,18,200,0.445,0.035,0.64,2,0.633962549
5256,89,20877,3,2,7,6,0,18,10,10,0,0,0,20,nowin,loss,beat,dlwin,0,10,5,212,0.537735849,0.047169811,0.594339623,3,0.990167191
5257,104,20877,8,5,0,10,0,23,10,10,0,0,0,20,nowin,loss,bust,plbust,0,10,13,209,0.363636364,0.052631579,0.593301435,0,0.018359419
5258,70,20877,5,10,0,10,0,25,10,10,0,0,0,20,nowin,loss,bust,plbust,0,10,15,228,0.385964912,0.039473684,0.557017544,0,0.016157125
5259,106,20877,11,1,4,2,0,18,10,10,0,0,0,20,nowin,loss,beat,dlwin,0,10,12,192,0.411458333,0.026041667,0.557291667,0,0.023854304
5260,22,20877,2,10,0,4,4,20,10,10,0,0,0,20,nowin,push,push,push,10,0,12,187,0.481283422,0.042780749,0.577540107,3,0.906128176
5261,16,20877,8,10,0,0,0,18,10,10,0,0,0,20,nowin,loss,beat,dlwin,0,10,18,220,0.427272727,0.081818182,0.6,2,0.588660176
5262,68,20878,9,10,0,0,0,19,10,10,0,0,0,20,nowin,loss,beat,dlwin,0,10,19,205,0.434146341,0.029268293,0.6,2,0.59483189
5263,92,20878,6,9,0,8,0,23,10,10,0,0,0,20,nowin,loss,bust,plbust,0,10,15,186,0.446236559,0.059139785,0.564516129,1,0.307826125
5264,100,20878,10,3,0,1,4,18,10,10,0,0,0,20,nowin,loss,beat,dlwin,0,10,13,190,0.452631579,0.036842105,0.594736842,3,0.888671154
5265,138,20878,1,6,7,6,0,20,10,10,0,0,0,20,nowin,push,push,push,10,0,7,190,0.442105263,0.047368421,0.610526316,2,0.609711065
5266,31,20878,6,10,0,9,0,25,10,10,0,0,0,20,nowin,loss,bust,plbust,0,10,16,188,0.473404255,0.058510638,0.515957447,1,0.300306557
5267,33,20878,5,10,0,7,0,22,10,10,0,0,0,20,nowin,loss,bust,plbust,0,10,15,192,0.4375,0.057291667,0.625,2,0.616208916
5268,16,20879,5,10,0,10,0,25,10,10,0,0,0,20,nowin,loss,bust,plbust,0,10,15,220,0.427272727,0.081818182,0.6,2,0.588660176
5269,16,20879,5,10,0,9,0,24,10,10,0,0,0,20,nowin,loss,bust,plbust,0,10,15,220,0.427272727,0.081818182,0.6,2,0.588660176
5270,93,20879,6,7,0,1,7,21,10,10,0,0,0,20,nowin,win,plwin,beat,20,0,13,175,0.485714286,0.051428571,0.548571429,1,0.323648091
5271,109,20879,2,2,7,6,0,17,10,10,0,0,0,20,nowin,loss,beat,dlwin,0,10,4,221,0.461538462,0.058823529,0.597285068,3,0.901830309
5272,10,20879,10,10,0,0,0,20,10,10,0,0,0,20,nowin,push,push,push,10,0,20,191,0.413612565,0.057591623,0.596858639,2,0.574087175
5273,16,20879,6,6,0,3,10,25,10,10,0,0,0,20,nowin,loss,bust,plbust,0,10,12,220,0.427272727,0.081818182,0.6,2,0.588660176
5274,49,20880,3,10,0,5,0,18,11,8,0,0,0,19,nowin,loss,beat,dlwin,0,10,13,207,0.396135266,0.053140097,0.594202899,0,0.028306925
5275,29,20880,2,4,9,10,0,25,11,8,0,0,0,19,nowin,loss,bust,plbust,0,10,6,189,0.44973545,0.058201058,0.544973545,1,0.300349439
5276,82,20880,10,2,0,2,2,16,11,8,0,0,0,19,nowin,loss,beat,dlwin,0,10,12,225,0.408888889,0.075555556,0.577777778,0,0.028101874
5277,133,20880,10,4,0,5,0,19,11,8,0,0,0,19,nowin,push,push,push,10,0,14,201,0.47761194,0.064676617,0.611940299,3,0.935428111
5278,53,20880,7,6,0,10,0,23,11,8,0,0,0,19,nowin,loss,bust,plbust,0,10,13,250,0.372,0.064,0.564,0,0.013687345
5279,51,20880,6,6,0,6,0,18,11,8,0,0,0,19,nowin,loss,beat,dlwin,0,10,12,189,0.529100529,0.068783069,0.608465608,3,0.993665715
5280,15,20881,8,6,0,0,0,14,4,3,7,10,0,24,nowin,win,dlbust,bust,20,0,14,212,0.410377358,0.051886792,0.561320755,0,0.024517408
5281,136,20881,8,10,0,0,0,18,4,3,7,10,0,24,nowin,win,dlbust,bust,20,0,18,194,0.396907216,0.025773196,0.597938144,0,0.029452644
5282,4,20881,8,10,0,0,0,18,4,3,7,10,0,24,nowin,win,dlbust,bust,20,0,18,217,0.460829493,0.036866359,0.562211982,1,0.315432839
5283,35,20881,7,4,1,0,0,12,4,3,7,10,0,24,nowin,win,dlbust,bust,20,0,11,202,0.410891089,0.044554455,0.633663366,2,0.598681573
5284,140,20881,3,6,3,0,0,12,4,3,7,10,0,24,nowin,win,dlbust,bust,20,0,9,210,0.466666667,0.023809524,0.604761905,3,0.915293335
5285,31,20881,10,10,0,0,0,20,4,3,7,10,0,24,nowin,win,dlbust,bust,20,0,20,188,0.473404255,0.058510638,0.515957447,1,0.300306557
5286,149,20882,4,4,8,10,0,26,10,10,0,0,0,20,nowin,loss,bust,plbust,0,10,8,225,0.457777778,0.057777778,0.648888889,2,0.651965595
5287,122,20882,8,2,10,0,0,20,10,10,0,0,0,20,nowin,push,push,push,10,0,10,210,0.347619048,0.052380952,0.59047619,0,0.012873677
5288,33,20882,7,11,0,0,0,18,10,10,0,0,0,20,nowin,loss,beat,dlwin,0,10,18,192,0.4375,0.057291667,0.625,2,0.616208916
5289,73,20882,5,3,10,0,0,18,10,10,0,0,0,20,nowin,loss,beat,dlwin,0,10,8,181,0.375690608,0.011049724,0.596685083,0,0.022795773
5290,1,20882,9,8,0,0,0,17,10,10,0,0,0,20,nowin,loss,beat,dlwin,0,10,17,197,0.406091371,0.025380711,0.649746193,2,0.606186955
5291,147,20882,10,9,0,0,0,19,10,10,0,0,0,20,nowin,loss,beat,dlwin,0,10,19,205,0.380487805,0.014634146,0.536585366,0,0.00951447
5292,101,20883,7,10,0,0,0,17,4,3,4,10,0,21,nowin,loss,beat,dlwin,0,10,17,205,0.424390244,0.068292683,0.63902439,2,0.614740646
5293,129,20883,10,10,0,0,0,20,4,3,4,10,0,21,nowin,loss,beat,dlwin,0,10,20,201,0.422885572,0.064676617,0.55721393,0,0.027255383
5294,22,20883,10,10,0,0,0,20,4,3,4,10,0,21,nowin,loss,beat,dlwin,0,10,20,187,0.481283422,0.042780749,0.577540107,3,0.906128176
5295,108,20883,6,7,0,0,0,13,4,3,4,10,0,21,nowin,loss,beat,dlwin,0,10,13,193,0.435233161,0.056994819,0.559585492,1,0.298824795
5296,61,20883,10,11,0,0,0,21,4,3,4,10,0,21,win,push,push,push,10,0,21,194,0.427835052,0.077319588,0.603092784,2,0.591437139
5297,101,20883,4,3,5,0,0,12,4,3,4,10,0,21,nowin,loss,beat,dlwin,0,10,7,205,0.424390244,0.068292683,0.63902439,2,0.614740646
5298,117,20884,8,2,8,0,0,18,7,11,0,0,0,18,nowin,push,push,push,10,0,10,173,0.410404624,0.069364162,0.606936416,2,0.578610282
5299,16,20884,10,6,0,3,0,19,7,11,0,0,0,18,nowin,win,plwin,beat,20,0,16,220,0.427272727,0.081818182,0.6,2,0.588660176
5300,89,20884,10,5,0,10,0,25,7,11,0,0,0,18,nowin,loss,bust,plbust,0,10,15,212,0.537735849,0.047169811,0.594339623,3,0.990167191
5301,82,20884,9,5,0,6,0,20,7,11,0,0,0,18,nowin,win,plwin,beat,20,0,14,225,0.408888889,0.075555556,0.577777778,0,0.028101874
5302,150,20884,9,6,0,6,0,21,7,11,0,0,0,18,nowin,win,plwin,beat,20,0,15,192,0.401041667,0.036458333,0.567708333,0,0.023287458
5303,75,20884,11,1,1,6,0,19,7,11,0,0,0,18,nowin,win,plwin,beat,20,0,12,191,0.418848168,0.052356021,0.570680628,0,0.029344702
5304,51,20885,7,2,8,0,0,17,6,3,5,10,0,24,nowin,win,dlbust,bust,20,0,9,189,0.529100529,0.068783069,0.608465608,3,0.993665715
5305,114,20885,8,6,0,0,0,14,6,3,5,10,0,24,nowin,win,dlbust,bust,20,0,14,198,0.47979798,0.025252525,0.611111111,3,0.937232995
5306,2,20885,10,8,0,0,0,18,6,3,5,10,0,24,nowin,win,dlbust,bust,20,0,18,200,0.445,0.035,0.64,2,0.633962549
5307,74,20885,9,10,0,0,0,19,6,3,5,10,0,24,nowin,win,dlbust,bust,20,0,19,209,0.411483254,0.04784689,0.531100478,0,0.017448125
5308,11,20885,8,10,0,0,0,18,6,3,5,10,0,24,nowin,win,dlbust,bust,20,0,18,236,0.457627119,0.016949153,0.588983051,3,0.889015813
5309,113,20885,10,10,0,0,0,20,6,3,5,10,0,24,nowin,win,dlbust,bust,20,0,20,199,0.407035176,0.055276382,0.668341709,2,0.620695264
5310,59,20886,4,10,0,7,0,21,8,11,0,0,0,19,nowin,win,plwin,beat,20,0,14,228,0.429824561,0.048245614,0.543859649,1,0.287885446
5311,107,20886,8,3,10,0,0,21,8,11,0,0,0,19,nowin,win,plwin,beat,20,0,11,218,0.444954128,0.073394495,0.600917431,2,0.605210014
5312,38,20886,10,3,0,5,0,18,8,11,0,0,0,19,nowin,loss,beat,dlwin,0,10,13,202,0.361386139,0.03960396,0.564356436,0,0.010597953
5313,31,20886,7,2,6,8,0,23,8,11,0,0,0,19,nowin,loss,bust,plbust,0,10,9,188,0.473404255,0.058510638,0.515957447,1,0.300306557
5314,146,20886,3,10,0,10,0,23,8,11,0,0,0,19,nowin,loss,bust,plbust,0,10,13,221,0.43438914,0.040723982,0.542986425,1,0.290190091
5315,56,20886,10,5,0,8,0,23,8,11,0,0,0,19,nowin,loss,bust,plbust,0,10,15,175,0.4,0.057142857,0.582857143,0,0.026685297
5316,52,20887,7,9,0,0,0,16,3,9,10,0,0,22,nowin,win,dlbust,bust,20,0,16,217,0.414746544,0.02764977,0.599078341,2,0.576736024
5317,4,20887,10,9,0,0,0,19,3,9,10,0,0,22,nowin,win,dlbust,bust,20,0,19,217,0.460829493,0.036866359,0.562211982,1,0.315432839
5318,82,20887,11,10,0,0,0,21,3,9,10,0,0,22,win,win,dlbust,bust,25,0,21,225,0.408888889,0.075555556,0.577777778,0,0.028101874
5319,71,20887,9,10,0,0,0,19,3,9,10,0,0,22,nowin,win,dlbust,bust,20,0,19,193,0.352331606,0.046632124,0.585492228,0,0.013063661
5320,28,20887,2,7,8,0,0,17,3,9,10,0,0,22,nowin,win,dlbust,bust,20,0,9,199,0.422110553,0.045226131,0.542713568,1,0.282706618
5321,37,20887,4,1,10,0,0,15,3,9,10,0,0,22,nowin,win,dlbust,bust,20,0,5,208,0.394230769,0.038461538,0.581730769,0,0.024682772
5322,103,20888,7,9,0,0,0,16,3,4,3,2,10,22,nowin,win,dlbust,bust,20,0,16,203,0.379310345,0.064039409,0.551724138,0,0.012869209
5323,89,20888,7,5,0,2,0,14,3,4,3,2,10,22,nowin,win,dlbust,bust,20,0,12,212,0.537735849,0.047169811,0.594339623,3,0.990167191
5324,124,20888,10,10,0,0,0,20,3,4,3,2,10,22,nowin,win,dlbust,bust,20,0,20,202,0.47029703,0.064356436,0.584158416,3,0.899458193
5325,18,20888,8,10,0,0,0,18,3,4,3,2,10,22,nowin,win,dlbust,bust,20,0,18,182,0.461538462,0.043956044,0.587912088,3,0.892649374
5326,25,20888,10,9,0,0,0,19,3,4,3,2,10,22,nowin,win,dlbust,bust,20,0,19,190,0.463157895,0.063157895,0.536842105,1,0.304401563
5327,95,20888,3,10,0,0,0,13,3,4,3,2,10,22,nowin,win,dlbust,bust,20,0,13,218,0.412844037,0.04587156,0.559633028,0,0.024842385
5328,144,20889,10,6,0,0,0,16,3,10,4,0,0,17,nowin,loss,beat,dlwin,0,10,16,202,0.386138614,0.054455446,0.564356436,0,0.018006244
5329,20,20889,8,10,0,0,0,18,3,10,4,0,0,17,nowin,win,plwin,beat,20,0,18,186,0.456989247,0.037634409,0.537634409,1,0.301097108
5330,122,20889,2,7,10,0,0,19,3,10,4,0,0,17,nowin,win,plwin,beat,20,0,9,210,0.347619048,0.052380952,0.59047619,0,0.012873677
5331,12,20889,9,5,0,0,0,14,3,10,4,0,0,17,nowin,loss,beat,dlwin,0,10,14,189,0.470899471,0.015873016,0.613756614,3,0.929171178
5332,85,20889,10,10,0,0,0,20,3,10,4,0,0,17,nowin,win,plwin,beat,20,0,20,195,0.41025641,0.066666667,0.594871795,0,0.03269711
5333,132,20889,11,8,0,0,0,19,3,10,4,0,0,17,nowin,win,plwin,beat,20,0,19,194,0.412371134,0.036082474,0.649484536,2,0.611633238
5334,17,20890,9,7,0,0,0,16,2,10,10,0,0,22,nowin,win,dlbust,bust,20,0,16,171,0.444444444,0.070175439,0.555555556,1,0.302364894
5335,79,20890,11,10,0,0,0,21,2,10,10,0,0,22,win,win,dlbust,bust,25,0,21,211,0.436018957,0.028436019,0.672985782,2,0.650131054
5336,43,20890,5,10,0,0,0,15,2,10,10,0,0,22,nowin,win,dlbust,bust,20,0,15,192,0.40625,0.041666667,0.609375,2,0.576671372
5337,78,20890,9,10,0,0,0,19,2,10,10,0,0,22,nowin,win,dlbust,bust,20,0,19,201,0.517412935,0.034825871,0.587064677,3,0.95871112
5338,58,20890,9,5,0,0,0,14,2,10,10,0,0,22,nowin,win,dlbust,bust,20,0,14,195,0.430769231,0.041025641,0.584615385,2,0.580497586
5339,6,20890,10,10,0,0,0,20,2,10,10,0,0,22,nowin,win,dlbust,bust,20,0,20,191,0.439790576,0.047120419,0.581151832,1,0.31211505
5340,113,20891,6,11,1,0,0,18,10,10,0,0,0,20,nowin,loss,beat,dlwin,0,10,17,199,0.407035176,0.055276382,0.668341709,2,0.620695264
5341,107,20891,2,10,0,1,10,23,10,10,0,0,0,20,nowin,loss,bust,plbust,0,10,12,218,0.444954128,0.073394495,0.600917431,2,0.605210014
5342,60,20891,8,10,0,0,0,18,10,10,0,0,0,20,nowin,loss,beat,dlwin,0,10,18,227,0.418502203,0.022026432,0.559471366,0,0.026496258
5343,54,20891,5,6,3,10,0,24,10,10,0,0,0,20,nowin,loss,bust,plbust,0,10,11,185,0.437837838,0.032432432,0.556756757,1,0.29899854
5344,136,20891,7,6,0,10,0,23,10,10,0,0,0,20,nowin,loss,bust,plbust,0,10,13,194,0.396907216,0.025773196,0.597938144,0,0.029452644
5345,143,20891,10,10,0,0,0,20,10,10,0,0,0,20,nowin,push,push,push,10,0,20,203,0.463054187,0.044334975,0.57635468,3,0.883143365
5346,113,20892,9,10,0,0,0,19,10,9,0,0,0,19,nowin,push,push,push,10,0,19,199,0.407035176,0.055276382,0.668341709,2,0.620695264
5347,147,20892,4,10,0,6,0,20,10,9,0,0,0,19,nowin,win,plwin,beat,20,0,14,205,0.380487805,0.014634146,0.536585366,0,0.00951447
5348,39,20892,6,10,0,8,0,24,10,9,0,0,0,19,nowin,loss,bust,plbust,0,10,16,191,0.429319372,0.062827225,0.57591623,0,0.033760763
5349,109,20892,4,10,0,10,0,24,10,9,0,0,0,19,nowin,loss,bust,plbust,0,10,14,221,0.461538462,0.058823529,0.597285068,3,0.901830309
5350,106,20892,5,2,11,0,0,18,10,9,0,0,0,19,nowin,loss,beat,dlwin,0,10,7,192,0.411458333,0.026041667,0.557291667,0,0.023854304
5351,103,20892,6,3,9,0,0,18,10,9,0,0,0,19,nowin,loss,beat,dlwin,0,10,9,203,0.379310345,0.064039409,0.551724138,0,0.012869209
5352,72,20893,10,4,0,5,0,19,11,10,0,0,0,21,nowin,loss,beat,dlwin,0,10,14,185,0.394594595,0.032432432,0.508108108,0,0.006763115
5353,39,20893,9,3,0,2,10,24,11,10,0,0,0,21,nowin,loss,bust,plbust,0,10,12,191,0.429319372,0.062827225,0.57591623,0,0.033760763
5354,59,20893,3,10,0,2,3,18,11,10,0,0,0,21,nowin,loss,beat,dlwin,0,10,13,228,0.429824561,0.048245614,0.543859649,1,0.287885446
5355,137,20893,3,11,5,0,0,19,11,10,0,0,0,21,nowin,loss,beat,dlwin,0,10,14,194,0.417525773,0.046391753,0.536082474,1,0.276714602
5356,26,20893,3,8,8,0,0,19,11,10,0,0,0,21,nowin,loss,beat,dlwin,0,10,11,203,0.463054187,0.0591133,0.541871921,1,0.306802864
5357,66,20893,10,10,0,0,0,20,11,10,0,0,0,21,nowin,loss,beat,dlwin,0,10,20,217,0.456221198,0.064516129,0.626728111,3,0.924304367
5358,117,20894,11,10,0,0,0,21,10,11,0,0,0,21,win,push,push,push,10,0,21,173,0.410404624,0.069364162,0.606936416,2,0.578610282
5359,37,20894,10,9,0,0,0,19,10,11,0,0,0,21,nowin,loss,beat,dlwin,0,10,19,208,0.394230769,0.038461538,0.581730769,0,0.024682772
5360,51,20894,10,9,0,0,0,19,10,11,0,0,0,21,nowin,loss,beat,dlwin,0,10,19,189,0.529100529,0.068783069,0.608465608,3,0.993665715
5361,85,20894,11,8,0,0,0,19,10,11,0,0,0,21,nowin,loss,beat,dlwin,0,10,19,195,0.41025641,0.066666667,0.594871795,0,0.03269711
5362,48,20894,7,3,3,8,0,21,10,11,0,0,0,21,nowin,push,push,push,10,0,10,203,0.413793103,0.019704433,0.600985222,2,0.577280801
5363,7,20894,10,3,0,7,0,20,10,11,0,0,0,21,nowin,loss,beat,dlwin,0,10,13,183,0.442622951,0.06010929,0.62295082,2,0.619303341
5364,118,20895,9,10,0,0,0,19,10,10,0,0,0,20,nowin,loss,beat,dlwin,0,10,19,216,0.393518519,0.037037037,0.555555556,0,0.018059873
5365,36,20895,11,7,0,0,0,18,10,10,0,0,0,20,nowin,loss,beat,dlwin,0,10,18,229,0.445414847,0.056768559,0.655021834,2,0.645370571
5366,142,20895,10,6,0,2,0,18,10,10,0,0,0,20,nowin,loss,beat,dlwin,0,10,16,211,0.417061611,0.047393365,0.526066351,1,0.271531309
5367,130,20895,6,6,0,1,2,15,10,10,0,0,0,20,nowin,loss,beat,dlwin,0,10,12,219,0.410958904,0.03652968,0.566210046,0,0.025888739
5368,90,20895,4,10,0,6,0,20,10,10,0,0,0,20,nowin,push,push,push,10,0,14,201,0.447761194,0.049751244,0.60199005,3,0.889945023
5369,87,20895,11,8,0,0,0,19,10,10,0,0,0,20,nowin,loss,beat,dlwin,0,10,19,202,0.405940594,0.054455446,0.628712871,2,0.590599801
5370,116,20896,7,10,0,0,0,17,10,2,4,6,0,22,nowin,win,dlbust,bust,20,0,17,195,0.425641026,0.056410256,0.538461538,1,0.28273747
5371,135,20896,8,4,0,6,0,18,10,2,4,6,0,22,nowin,win,dlbust,bust,20,0,12,179,0.391061453,0.067039106,0.586592179,0,0.024924662
5372,52,20896,9,6,0,10,0,25,10,2,4,6,0,22,nowin,loss,bust,plbust,0,10,15,217,0.414746544,0.02764977,0.599078341,2,0.576736024
5373,14,20896,7,2,8,0,0,17,10,2,4,6,0,22,nowin,win,dlbust,bust,20,0,9,202,0.391089109,0.01980198,0.628712871,2,0.577264877
5374,117,20896,7,10,0,0,0,17,10,2,4,6,0,22,nowin,win,dlbust,bust,20,0,17,173,0.410404624,0.069364162,0.606936416,2,0.578610282
5375,130,20896,10,11,0,0,0,21,10,2,4,6,0,22,win,win,dlbust,bust,25,0,21,219,0.410958904,0.03652968,0.566210046,0,0.025888739
5376,59,20897,4,10,0,0,0,14,3,7,10,0,0,20,nowin,loss,beat,dlwin,0,10,14,228,0.429824561,0.048245614,0.543859649,1,0.287885446
5377,118,20897,7,7,0,0,0,14,3,7,10,0,0,20,nowin,loss,beat,dlwin,0,10,14,216,0.393518519,0.037037037,0.555555556,0,0.018059873
5378,74,20897,9,6,0,0,0,15,3,7,10,0,0,20,nowin,loss,beat,dlwin,0,10,15,209,0.411483254,0.04784689,0.531100478,0,0.017448125
5379,122,20897,3,6,7,0,0,16,3,7,10,0,0,20,nowin,loss,beat,dlwin,0,10,9,210,0.347619048,0.052380952,0.59047619,0,0.012873677
5380,64,20897,8,10,0,0,0,18,3,7,10,0,0,20,nowin,loss,beat,dlwin,0,10,18,187,0.363636364,0.048128342,0.631016043,0,0.027594885
5381,24,20897,2,7,2,10,0,21,3,7,10,0,0,20,nowin,win,plwin,beat,20,0,9,207,0.458937198,0.048309179,0.570048309,1,0.318138014
5382,140,20898,5,9,0,0,0,14,4,8,1,7,0,20,nowin,loss,beat,dlwin,0,10,14,210,0.466666667,0.023809524,0.604761905,3,0.915293335
5383,95,20898,9,2,10,0,0,21,4,8,1,7,0,20,nowin,win,plwin,beat,20,0,11,218,0.412844037,0.04587156,0.559633028,0,0.024842385
5384,28,20898,10,10,0,0,0,20,4,8,1,7,0,20,nowin,push,push,push,10,0,20,199,0.422110553,0.045226131,0.542713568,1,0.282706618
5385,38,20898,1,4,10,0,0,15,4,8,1,7,0,20,nowin,loss,beat,dlwin,0,10,5,202,0.361386139,0.03960396,0.564356436,0,0.010597953
5386,129,20898,9,8,0,0,0,17,4,8,1,7,0,20,nowin,loss,beat,dlwin,0,10,17,201,0.422885572,0.064676617,0.55721393,0,0.027255383
5387,16,20898,7,6,0,0,0,13,4,8,1,7,0,20,nowin,loss,beat,dlwin,0,10,13,220,0.427272727,0.081818182,0.6,2,0.588660176
5388,126,20899,10,10,0,0,0,20,7,10,0,0,0,17,nowin,win,plwin,beat,20,0,20,188,0.457446809,0.074468085,0.60106383,3,0.900633203
5389,31,20899,9,6,0,10,0,25,7,10,0,0,0,17,nowin,loss,bust,plbust,0,10,15,188,0.473404255,0.058510638,0.515957447,1,0.300306557
5390,53,20899,1,6,10,0,0,17,7,10,0,0,0,17,nowin,push,push,push,10,0,7,250,0.372,0.064,0.564,0,0.013687345
5391,70,20899,7,8,0,3,0,18,7,10,0,0,0,17,nowin,win,plwin,beat,20,0,15,228,0.385964912,0.039473684,0.557017544,0,0.016157125
5392,60,20899,11,5,5,0,0,21,7,10,0,0,0,17,nowin,win,plwin,beat,20,0,16,227,0.418502203,0.022026432,0.559471366,0,0.026496258
5393,70,20899,11,7,0,0,0,18,7,10,0,0,0,17,nowin,win,plwin,beat,20,0,18,228,0.385964912,0.039473684,0.557017544,0,0.016157125
5394,114,20900,2,10,0,1,10,23,11,10,0,0,0,21,nowin,loss,bust,plbust,0,10,12,198,0.47979798,0.025252525,0.611111111,3,0.937232995
5395,19,20900,6,3,6,7,0,22,11,10,0,0,0,21,nowin,loss,bust,plbust,0,10,9,237,0.41350211,0.054852321,0.628691983,2,0.597373826
5396,148,20900,8,8,0,10,0,26,11,10,0,0,0,21,nowin,loss,bust,plbust,0,10,16,204,0.401960784,0.078431373,0.593137255,0,0.029789521
5397,97,20900,6,3,10,0,0,19,11,10,0,0,0,21,nowin,loss,beat,dlwin,0,10,9,182,0.450549451,0.06043956,0.692307692,2,0.677372279
5398,125,20900,9,5,0,10,0,24,11,10,0,0,0,21,nowin,loss,bust,plbust,0,10,14,219,0.438356164,0.050228311,0.575342466,1,0.308411257
5399,29,20900,10,5,0,7,0,22,11,10,0,0,0,21,nowin,loss,bust,plbust,0,10,15,189,0.44973545,0.058201058,0.544973545,1,0.300349439
5400,64,20901,8,10,0,0,0,18,7,11,0,0,0,18,nowin,push,push,push,10,0,18,187,0.363636364,0.048128342,0.631016043,0,0.027594885
5401,46,20901,3,10,0,5,0,18,7,11,0,0,0,18,nowin,push,push,push,10,0,13,186,0.403225806,0.048387097,0.591397849,0,0.029742194
5402,52,20901,10,3,0,8,0,21,7,11,0,0,0,18,nowin,win,plwin,beat,20,0,13,217,0.414746544,0.02764977,0.599078341,2,0.576736024
5403,88,20901,7,7,0,7,0,21,7,11,0,0,0,18,nowin,win,plwin,beat,20,0,14,206,0.466019417,0.033980583,0.54368932,1,0.309467903
5404,125,20901,10,7,0,0,0,17,7,11,0,0,0,18,nowin,loss,beat,dlwin,0,10,17,219,0.438356164,0.050228311,0.575342466,1,0.308411257
5405,9,20901,6,10,0,10,0,26,7,11,0,0,0,18,nowin,loss,bust,plbust,0,10,16,194,0.37628866,0.015463918,0.541237113,0,0.009396796
5406,104,20902,9,10,0,0,0,19,3,10,4,0,0,17,nowin,win,plwin,beat,20,0,19,209,0.363636364,0.052631579,0.593301435,0,0.018359419
5407,42,20902,3,8,8,0,0,19,3,10,4,0,0,17,nowin,win,plwin,beat,20,0,11,212,0.443396226,0.051886792,0.570754717,1,0.309181312
5408,106,20902,10,10,0,0,0,20,3,10,4,0,0,17,nowin,win,plwin,beat,20,0,20,192,0.411458333,0.026041667,0.557291667,0,0.023854304
5409,144,20902,8,6,0,0,0,14,3,10,4,0,0,17,nowin,loss,beat,dlwin,0,10,14,202,0.386138614,0.054455446,0.564356436,0,0.018006244
5410,48,20902,4,9,0,0,0,13,3,10,4,0,0,17,nowin,loss,beat,dlwin,0,10,13,203,0.413793103,0.019704433,0.600985222,2,0.577280801
5411,3,20902,8,10,0,0,0,18,3,10,4,0,0,17,nowin,win,plwin,beat,20,0,18,190,0.431578947,0.026315789,0.542105263,1,0.288076384
5412,29,20903,3,10,0,0,0,13,4,10,8,0,0,22,nowin,win,dlbust,bust,20,0,13,189,0.44973545,0.058201058,0.544973545,1,0.300349439
5413,97,20903,4,3,11,0,0,18,4,10,8,0,0,22,nowin,win,dlbust,bust,20,0,7,182,0.450549451,0.06043956,0.692307692,2,0.677372279
5414,76,20903,10,5,0,0,0,15,4,10,8,0,0,22,nowin,win,dlbust,bust,20,0,15,189,0.534391534,0.079365079,0.608465608,3,1
5415,119,20903,6,10,0,0,0,16,4,10,8,0,0,22,nowin,win,dlbust,bust,20,0,16,190,0.405263158,0.068421053,0.515789474,0,0.011837158
5416,96,20903,11,10,0,0,0,21,4,10,8,0,0,22,win,win,dlbust,bust,25,0,21,190,0.468421053,0.057894737,0.584210526,3,0.897263354
5417,18,20903,9,5,0,0,0,14,4,10,8,0,0,22,nowin,win,dlbust,bust,20,0,14,182,0.461538462,0.043956044,0.587912088,3,0.892649374
5418,77,20904,3,10,0,4,0,17,10,3,4,0,0,17,nowin,push,push,push,10,0,13,200,0.455,0.04,0.62,3,0.916252116
5419,101,20904,8,10,0,0,0,18,10,3,4,0,0,17,nowin,win,plwin,beat,20,0,18,205,0.424390244,0.068292683,0.63902439,2,0.614740646
5420,6,20904,10,3,0,4,0,17,10,3,4,0,0,17,nowin,push,push,push,10,0,13,191,0.439790576,0.047120419,0.581151832,1,0.31211505
5421,97,20904,3,5,11,0,0,19,10,3,4,0,0,17,nowin,win,plwin,beat,20,0,8,182,0.450549451,0.06043956,0.692307692,2,0.677372279
5422,121,20904,10,2,0,6,0,18,10,3,4,0,0,17,nowin,win,plwin,beat,20,0,12,195,0.456410256,0.025641026,0.512820513,1,0.288597791
5423,4,20904,6,10,0,1,0,17,10,3,4,0,0,17,nowin,push,push,push,10,0,16,217,0.460829493,0.036866359,0.562211982,1,0.315432839
5424,60,20905,10,6,0,0,0,16,6,3,4,4,0,17,nowin,loss,beat,dlwin,0,10,16,227,0.418502203,0.022026432,0.559471366,0,0.026496258
5425,131,20905,10,10,0,0,0,20,6,3,4,4,0,17,nowin,win,plwin,beat,20,0,20,217,0.410138249,0.069124424,0.543778802,0,0.02015021
5426,127,20905,2,1,9,0,0,12,6,3,4,4,0,17,nowin,loss,beat,dlwin,0,10,3,201,0.402985075,0.029850746,0.60199005,0,0.032263937
5427,14,20905,10,4,0,0,0,14,6,3,4,4,0,17,nowin,loss,beat,dlwin,0,10,14,202,0.391089109,0.01980198,0.628712871,2,0.577264877
5428,132,20905,1,4,10,0,0,15,6,3,4,4,0,17,nowin,loss,beat,dlwin,0,10,5,194,0.412371134,0.036082474,0.649484536,2,0.611633238
5429,58,20905,8,10,0,0,0,18,6,3,4,4,0,17,nowin,win,plwin,beat,20,0,18,195,0.430769231,0.041025641,0.584615385,2,0.580497586
5430,60,20906,8,9,0,0,0,17,9,5,5,0,0,19,nowin,loss,beat,dlwin,0,10,17,227,0.418502203,0.022026432,0.559471366,0,0.026496258
5431,143,20906,10,10,0,0,0,20,9,5,5,0,0,19,nowin,win,plwin,beat,20,0,20,203,0.463054187,0.044334975,0.57635468,3,0.883143365
5432,27,20906,6,9,0,10,0,25,9,5,5,0,0,19,nowin,loss,bust,plbust,0,10,15,178,0.370786517,0.016853933,0.573033708,0,0.015536309
5433,148,20906,8,6,0,5,0,19,9,5,5,0,0,19,nowin,push,push,push,10,0,14,204,0.401960784,0.078431373,0.593137255,0,0.029789521
5434,97,20906,3,3,2,10,0,18,9,5,5,0,0,19,nowin,loss,beat,dlwin,0,10,6,182,0.450549451,0.06043956,0.692307692,2,0.677372279
5435,93,20906,9,4,0,4,0,17,9,5,5,0,0,19,nowin,loss,beat,dlwin,0,10,13,175,0.485714286,0.051428571,0.548571429,1,0.323648091
5436,61,20907,9,2,10,0,0,21,2,6,3,7,0,18,nowin,win,plwin,beat,20,0,11,194,0.427835052,0.077319588,0.603092784,2,0.591437139
5437,38,20907,8,10,0,0,0,18,2,6,3,7,0,18,nowin,push,push,push,10,0,18,202,0.361386139,0.03960396,0.564356436,0,0.010597953
5438,140,20907,10,5,0,0,0,15,2,6,3,7,0,18,nowin,loss,beat,dlwin,0,10,15,210,0.466666667,0.023809524,0.604761905,3,0.915293335
5439,132,20907,9,2,10,0,0,21,2,6,3,7,0,18,nowin,win,plwin,beat,20,0,11,194,0.412371134,0.036082474,0.649484536,2,0.611633238
5440,2,20907,10,9,0,0,0,19,2,6,3,7,0,18,nowin,win,plwin,beat,20,0,19,200,0.445,0.035,0.64,2,0.633962549
5441,137,20907,5,10,0,0,0,15,2,6,3,7,0,18,nowin,loss,beat,dlwin,0,10,15,194,0.417525773,0.046391753,0.536082474,1,0.276714602
5442,130,20908,3,1,10,9,0,23,10,2,10,0,0,22,nowin,loss,bust,plbust,0,10,4,219,0.410958904,0.03652968,0.566210046,0,0.025888739
5443,61,20908,4,10,0,8,0,22,10,2,10,0,0,22,nowin,loss,bust,plbust,0,10,14,194,0.427835052,0.077319588,0.603092784,2,0.591437139
5444,33,20908,5,10,0,7,0,22,10,2,10,0,0,22,nowin,loss,bust,plbust,0,10,15,192,0.4375,0.057291667,0.625,2,0.616208916
5445,39,20908,10,10,0,0,0,20,10,2,10,0,0,22,nowin,win,dlbust,bust,20,0,20,191,0.429319372,0.062827225,0.57591623,0,0.033760763
5446,134,20908,6,10,0,7,0,23,10,2,10,0,0,22,nowin,loss,bust,plbust,0,10,16,185,0.443243243,0.021621622,0.545945946,1,0.296939509
5447,13,20908,11,5,5,0,0,21,10,2,10,0,0,22,nowin,win,dlbust,bust,20,0,16,206,0.417475728,0.063106796,0.621359223,2,0.59555479
5448,88,20909,10,10,0,0,0,20,10,5,7,0,0,22,nowin,win,dlbust,bust,20,0,20,206,0.466019417,0.033980583,0.54368932,1,0.309467903
5449,26,20909,10,5,0,3,0,18,10,5,7,0,0,22,nowin,win,dlbust,bust,20,0,15,203,0.463054187,0.0591133,0.541871921,1,0.306802864
5450,33,20909,11,8,0,0,0,19,10,5,7,0,0,22,nowin,win,dlbust,bust,20,0,19,192,0.4375,0.057291667,0.625,2,0.616208916
5451,81,20909,9,3,0,10,0,22,10,5,7,0,0,22,nowin,loss,bust,plbust,0,10,12,182,0.395604396,0.043956044,0.60989011,2,0.567491261
5452,96,20909,8,4,0,1,5,18,10,5,7,0,0,22,nowin,win,dlbust,bust,20,0,12,190,0.468421053,0.057894737,0.584210526,3,0.897263354
5453,29,20909,4,11,4,0,0,19,10,5,7,0,0,22,nowin,win,dlbust,bust,20,0,15,189,0.44973545,0.058201058,0.544973545,1,0.300349439
5454,93,20910,10,5,0,0,0,15,6,10,1,0,0,17,nowin,loss,beat,dlwin,0,10,15,175,0.485714286,0.051428571,0.548571429,1,0.323648091
5455,18,20910,9,10,0,0,0,19,6,10,1,0,0,17,nowin,win,plwin,beat,20,0,19,182,0.461538462,0.043956044,0.587912088,3,0.892649374
5456,94,20910,7,8,0,0,0,15,6,10,1,0,0,17,nowin,loss,beat,dlwin,0,10,15,183,0.43715847,0.043715847,0.540983607,1,0.290866892
5457,60,20910,10,3,0,0,0,13,6,10,1,0,0,17,nowin,loss,beat,dlwin,0,10,13,227,0.418502203,0.022026432,0.559471366,0,0.026496258
5458,73,20910,11,4,6,0,0,21,6,10,1,0,0,17,nowin,win,plwin,beat,20,0,15,181,0.375690608,0.011049724,0.596685083,0,0.022795773
5459,19,20910,6,10,0,0,0,16,6,10,1,0,0,17,nowin,loss,beat,dlwin,0,10,16,237,0.41350211,0.054852321,0.628691983,2,0.597373826
5460,80,20911,2,5,10,0,0,17,10,7,0,0,0,17,nowin,push,push,push,10,0,7,186,0.419354839,0.059139785,0.623655914,2,0.59892924
5461,36,20911,7,10,0,0,0,17,10,7,0,0,0,17,nowin,push,push,push,10,0,17,229,0.445414847,0.056768559,0.655021834,2,0.645370571
5462,100,20911,11,3,3,0,0,17,10,7,0,0,0,17,nowin,push,push,push,10,0,14,190,0.452631579,0.036842105,0.594736842,3,0.888671154
5463,115,20911,9,5,0,1,2,17,10,7,0,0,0,17,nowin,push,push,push,10,0,14,194,0.427835052,0.041237113,0.592783505,2,0.583863602
5464,80,20911,10,4,0,1,6,21,10,7,0,0,0,17,nowin,win,plwin,beat,20,0,14,186,0.419354839,0.059139785,0.623655914,2,0.59892924
5465,129,20911,10,10,0,0,0,20,10,7,0,0,0,17,nowin,win,plwin,beat,20,0,20,201,0.422885572,0.064676617,0.55721393,0,0.027255383
5466,100,20912,7,7,0,3,0,17,10,7,0,0,0,17,nowin,push,push,push,10,0,14,190,0.452631579,0.036842105,0.594736842,3,0.888671154
5467,86,20912,11,9,0,0,0,20,10,7,0,0,0,17,nowin,win,plwin,beat,20,0,20,196,0.454081633,0.040816327,0.591836735,3,0.887566443
5468,65,20912,11,8,0,0,0,19,10,7,0,0,0,17,nowin,win,plwin,beat,20,0,19,203,0.492610837,0.054187192,0.571428571,3,0.913702814
5469,13,20912,10,10,0,0,0,20,10,7,0,0,0,17,nowin,win,plwin,beat,20,0,20,206,0.417475728,0.063106796,0.621359223,2,0.59555479
5470,124,20912,4,10,0,5,0,19,10,7,0,0,0,17,nowin,win,plwin,beat,20,0,14,202,0.47029703,0.064356436,0.584158416,3,0.899458193
5471,112,20912,10,3,0,10,0,23,10,7,0,0,0,17,nowin,loss,bust,plbust,0,10,13,203,0.448275862,0.054187192,0.600985222,3,0.889576933
5472,108,20913,11,10,0,0,0,21,10,10,0,0,0,20,win,win,plwin,beat,25,0,21,193,0.435233161,0.056994819,0.559585492,1,0.298824795
5473,95,20913,10,11,0,0,0,21,10,10,0,0,0,20,win,win,plwin,beat,25,0,21,218,0.412844037,0.04587156,0.559633028,0,0.024842385
5474,31,20913,10,9,0,0,0,19,10,10,0,0,0,20,nowin,loss,beat,dlwin,0,10,19,188,0.473404255,0.058510638,0.515957447,1,0.300306557
5475,43,20913,10,7,0,0,0,17,10,10,0,0,0,20,nowin,loss,beat,dlwin,0,10,17,192,0.40625,0.041666667,0.609375,2,0.576671372
5476,121,20913,10,11,0,0,0,21,10,10,0,0,0,20,win,win,plwin,beat,25,0,21,195,0.456410256,0.025641026,0.512820513,1,0.288597791
5477,130,20913,10,6,0,7,0,23,10,10,0,0,0,20,nowin,loss,bust,plbust,0,10,16,219,0.410958904,0.03652968,0.566210046,0,0.025888739
5478,134,20914,2,8,10,0,0,20,11,9,0,0,0,20,nowin,push,push,push,10,0,10,185,0.443243243,0.021621622,0.545945946,1,0.296939509
5479,85,20914,2,9,3,10,0,24,11,9,0,0,0,20,nowin,loss,bust,plbust,0,10,11,195,0.41025641,0.066666667,0.594871795,0,0.03269711
5480,6,20914,10,2,0,5,0,17,11,9,0,0,0,20,nowin,loss,beat,dlwin,0,10,12,191,0.439790576,0.047120419,0.581151832,1,0.31211505
5481,148,20914,10,11,0,0,0,21,11,9,0,0,0,20,win,win,plwin,beat,25,0,21,204,0.401960784,0.078431373,0.593137255,0,0.029789521
5482,39,20914,6,8,0,10,0,24,11,9,0,0,0,20,nowin,loss,bust,plbust,0,10,14,191,0.429319372,0.062827225,0.57591623,0,0.033760763
5483,102,20914,3,10,0,7,0,20,11,9,0,0,0,20,nowin,push,push,push,10,0,13,192,0.338541667,0.046875,0.5625,0,0.003306118
5484,123,20915,10,8,0,0,0,18,7,9,5,0,0,21,nowin,loss,beat,dlwin,0,10,18,205,0.43902439,0.034146341,0.614634146,2,0.609962544
5485,58,20915,10,9,0,0,0,19,7,9,5,0,0,21,nowin,loss,beat,dlwin,0,10,19,195,0.430769231,0.041025641,0.584615385,2,0.580497586
5486,44,20915,3,6,4,10,0,23,7,9,5,0,0,21,nowin,loss,bust,plbust,0,10,9,219,0.433789954,0.050228311,0.534246575,1,0.285551035
5487,128,20915,10,11,0,0,0,21,7,9,5,0,0,21,win,push,push,push,10,0,21,227,0.356828194,0.052863436,0.577092511,0,0.012352564
5488,26,20915,10,10,0,0,0,20,7,9,5,0,0,21,nowin,loss,beat,dlwin,0,10,20,203,0.463054187,0.0591133,0.541871921,1,0.306802864
5489,130,20915,7,10,0,0,0,17,7,9,5,0,0,21,nowin,loss,beat,dlwin,0,10,17,219,0.410958904,0.03652968,0.566210046,0,0.025888739
5490,67,20916,9,10,0,0,0,19,10,4,8,0,0,22,nowin,win,dlbust,bust,20,0,19,195,0.369230769,0.041025641,0.569230769,0,0.014139427
5491,24,20916,8,10,0,0,0,18,10,4,8,0,0,22,nowin,win,dlbust,bust,20,0,18,207,0.458937198,0.048309179,0.570048309,1,0.318138014
5492,144,20916,7,10,0,0,0,17,10,4,8,0,0,22,nowin,win,dlbust,bust,20,0,17,202,0.386138614,0.054455446,0.564356436,0,0.018006244
5493,64,20916,10,8,0,0,0,18,10,4,8,0,0,22,nowin,win,dlbust,bust,20,0,18,187,0.363636364,0.048128342,0.631016043,0,0.027594885
5494,121,20916,8,10,0,0,0,18,10,4,8,0,0,22,nowin,win,dlbust,bust,20,0,18,195,0.456410256,0.025641026,0.512820513,1,0.288597791
5495,147,20916,4,6,3,9,0,22,10,4,8,0,0,22,nowin,loss,bust,plbust,0,10,10,205,0.380487805,0.014634146,0.536585366,0,0.00951447
5496,130,20917,11,1,4,0,0,16,2,6,11,0,0,19,nowin,loss,beat,dlwin,0,10,12,219,0.410958904,0.03652968,0.566210046,0,0.025888739
5497,66,20917,8,10,0,0,0,18,2,6,11,0,0,19,nowin,loss,beat,dlwin,0,10,18,217,0.456221198,0.064516129,0.626728111,3,0.924304367
5498,116,20917,10,5,0,0,0,15,2,6,11,0,0,19,nowin,loss,beat,dlwin,0,10,15,195,0.425641026,0.056410256,0.538461538,1,0.28273747
5499,40,20917,5,4,5,0,0,14,2,6,11,0,0,19,nowin,loss,beat,dlwin,0,10,9,196,0.367346939,0.030612245,0.617346939,0,0.025358183
5500,120,20917,4,10,0,0,0,14,2,6,11,0,0,19,nowin,loss,beat,dlwin,0,10,14,202,0.440594059,0.034653465,0.618811881,2,0.614441029
5501,2,20917,10,5,0,0,0,15,2,6,11,0,0,19,nowin,loss,beat,dlwin,0,10,15,200,0.445,0.035,0.64,2,0.633962549
5502,59,20918,10,3,0,10,0,23,10,3,2,6,0,21,nowin,loss,bust,plbust,0,10,13,228,0.429824561,0.048245614,0.543859649,1,0.287885446
5503,146,20918,10,10,0,0,0,20,10,3,2,6,0,21,nowin,loss,beat,dlwin,0,10,20,221,0.43438914,0.040723982,0.542986425,1,0.290190091
5504,79,20918,10,8,0,0,0,18,10,3,2,6,0,21,nowin,loss,beat,dlwin,0,10,18,211,0.436018957,0.028436019,0.672985782,2,0.650131054
5505,150,20918,9,3,0,7,0,19,10,3,2,6,0,21,nowin,loss,beat,dlwin,0,10,12,192,0.401041667,0.036458333,0.567708333,0,0.023287458
5506,121,20918,4,9,0,1,1,15,10,3,2,6,0,21,nowin,loss,beat,dlwin,0,10,13,195,0.456410256,0.025641026,0.512820513,1,0.288597791
5507,143,20918,10,3,0,10,0,23,10,3,2,6,0,21,nowin,loss,bust,plbust,0,10,13,203,0.463054187,0.044334975,0.57635468,3,0.883143365
5508,14,20919,10,4,0,0,0,14,6,8,10,0,0,24,nowin,win,dlbust,bust,20,0,14,202,0.391089109,0.01980198,0.628712871,2,0.577264877
5509,4,20919,7,9,0,0,0,16,6,8,10,0,0,24,nowin,win,dlbust,bust,20,0,16,217,0.460829493,0.036866359,0.562211982,1,0.315432839
5510,11,20919,6,6,0,0,0,12,6,8,10,0,0,24,nowin,win,dlbust,bust,20,0,12,236,0.457627119,0.016949153,0.588983051,3,0.889015813
5511,92,20919,9,10,0,0,0,19,6,8,10,0,0,24,nowin,win,dlbust,bust,20,0,19,186,0.446236559,0.059139785,0.564516129,1,0.307826125
5512,140,20919,6,8,0,0,0,14,6,8,10,0,0,24,nowin,win,dlbust,bust,20,0,14,210,0.466666667,0.023809524,0.604761905,3,0.915293335
5513,122,20919,6,5,1,0,0,12,6,8,10,0,0,24,nowin,win,dlbust,bust,20,0,11,210,0.347619048,0.052380952,0.59047619,0,0.012873677
5514,31,20920,10,11,0,0,0,21,5,9,7,0,0,21,win,push,push,push,10,0,21,188,0.473404255,0.058510638,0.515957447,1,0.300306557
5515,125,20920,8,4,0,0,0,12,5,9,7,0,0,21,nowin,loss,beat,dlwin,0,10,12,219,0.438356164,0.050228311,0.575342466,1,0.308411257
5516,42,20920,8,3,9,0,0,20,5,9,7,0,0,21,nowin,loss,beat,dlwin,0,10,11,212,0.443396226,0.051886792,0.570754717,1,0.309181312
5517,100,20920,9,10,0,0,0,19,5,9,7,0,0,21,nowin,loss,beat,dlwin,0,10,19,190,0.452631579,0.036842105,0.594736842,3,0.888671154
5518,85,20920,4,8,0,0,0,12,5,9,7,0,0,21,nowin,loss,beat,dlwin,0,10,12,195,0.41025641,0.066666667,0.594871795,0,0.03269711
5519,55,20920,10,5,0,0,0,15,5,9,7,0,0,21,nowin,loss,beat,dlwin,0,10,15,191,0.371727749,0.057591623,0.54973822,0,0.01011347
5520,143,20921,11,2,5,0,0,18,10,4,1,2,0,17,nowin,win,plwin,beat,20,0,13,203,0.463054187,0.044334975,0.57635468,3,0.883143365
5521,57,20921,2,6,8,1,0,17,10,4,1,2,0,17,nowin,push,push,push,10,0,8,192,0.46875,0.052083333,0.59375,3,0.907001181
5522,130,20921,3,5,6,8,0,22,10,4,1,2,0,17,nowin,loss,bust,plbust,0,10,8,219,0.410958904,0.03652968,0.566210046,0,0.025888739
5523,97,20921,10,10,0,0,0,20,10,4,1,2,0,17,nowin,win,plwin,beat,20,0,20,182,0.450549451,0.06043956,0.692307692,2,0.677372279
5524,56,20921,10,11,0,0,0,21,10,4,1,2,0,17,win,win,plwin,beat,25,0,21,175,0.4,0.057142857,0.582857143,0,0.026685297
5525,49,20921,8,10,0,0,0,18,10,4,1,2,0,17,nowin,win,plwin,beat,20,0,18,207,0.396135266,0.053140097,0.594202899,0,0.028306925
5526,122,20922,7,7,0,0,0,14,6,8,5,0,0,19,nowin,loss,beat,dlwin,0,10,14,210,0.347619048,0.052380952,0.59047619,0,0.012873677
5527,50,20922,11,7,0,0,0,18,6,8,5,0,0,19,nowin,loss,beat,dlwin,0,10,18,202,0.405940594,0.04950495,0.54950495,0,0.020296079
5528,88,20922,2,10,0,0,0,12,6,8,5,0,0,19,nowin,loss,beat,dlwin,0,10,12,206,0.466019417,0.033980583,0.54368932,1,0.309467903
5529,34,20922,10,5,0,0,0,15,6,8,5,0,0,19,nowin,loss,beat,dlwin,0,10,15,202,0.5,0.079207921,0.618811881,3,0.968961434
5530,58,20922,4,2,11,0,0,17,6,8,5,0,0,19,nowin,loss,beat,dlwin,0,10,6,195,0.430769231,0.041025641,0.584615385,2,0.580497586
5531,131,20922,10,4,0,0,0,14,6,8,5,0,0,19,nowin,loss,beat,dlwin,0,10,14,217,0.410138249,0.069124424,0.543778802,0,0.02015021
5532,49,20923,3,2,9,3,0,17,7,10,0,0,0,17,nowin,push,push,push,10,0,5,207,0.396135266,0.053140097,0.594202899,0,0.028306925
5533,40,20923,10,10,0,0,0,20,7,10,0,0,0,17,nowin,win,plwin,beat,20,0,20,196,0.367346939,0.030612245,0.617346939,0,0.025358183
5534,79,20923,4,2,6,10,0,22,7,10,0,0,0,17,nowin,loss,bust,plbust,0,10,6,211,0.436018957,0.028436019,0.672985782,2,0.650131054
5535,24,20923,10,10,0,0,0,20,7,10,0,0,0,17,nowin,win,plwin,beat,20,0,20,207,0.458937198,0.048309179,0.570048309,1,0.318138014
5536,144,20923,11,10,0,0,0,21,7,10,0,0,0,17,win,win,plwin,beat,25,0,21,202,0.386138614,0.054455446,0.564356436,0,0.018006244
5537,105,20923,11,7,0,0,0,18,7,10,0,0,0,17,nowin,win,plwin,beat,20,0,18,198,0.414141414,0.070707071,0.590909091,0,0.032889494
5538,114,20924,9,10,0,0,0,19,8,10,0,0,0,18,nowin,win,plwin,beat,20,0,19,198,0.47979798,0.025252525,0.611111111,3,0.937232995
5539,5,20924,10,10,0,0,0,20,8,10,0,0,0,18,nowin,win,plwin,beat,20,0,20,203,0.42364532,0.02955665,0.596059113,2,0.582508076
5540,16,20924,9,10,0,0,0,19,8,10,0,0,0,18,nowin,win,plwin,beat,20,0,19,220,0.427272727,0.081818182,0.6,2,0.588660176
5541,137,20924,7,8,0,10,0,25,8,10,0,0,0,18,nowin,loss,bust,plbust,0,10,15,194,0.417525773,0.046391753,0.536082474,1,0.276714602
5542,68,20924,10,10,0,0,0,20,8,10,0,0,0,18,nowin,win,plwin,beat,20,0,20,205,0.434146341,0.029268293,0.6,2,0.59483189
5543,133,20924,10,8,0,0,0,18,8,10,0,0,0,18,nowin,push,push,push,10,0,18,201,0.47761194,0.064676617,0.611940299,3,0.935428111
5544,84,20925,10,4,0,0,0,14,3,1,10,5,0,19,nowin,loss,beat,dlwin,0,10,14,195,0.379487179,0.056410256,0.569230769,0,0.017209119
5545,114,20925,6,8,0,0,0,14,3,1,10,5,0,19,nowin,loss,beat,dlwin,0,10,14,198,0.47979798,0.025252525,0.611111111,3,0.937232995
5546,5,20925,10,5,0,0,0,15,3,1,10,5,0,19,nowin,loss,beat,dlwin,0,10,15,203,0.42364532,0.02955665,0.596059113,2,0.582508076
5547,62,20925,2,11,7,0,0,20,3,1,10,5,0,19,nowin,win,plwin,beat,20,0,13,178,0.370786517,0.028089888,0.54494382,0,0.008657722
5548,20,20925,4,9,0,0,0,13,3,1,10,5,0,19,nowin,loss,beat,dlwin,0,10,13,186,0.456989247,0.037634409,0.537634409,1,0.301097108
5549,125,20925,5,8,0,0,0,13,3,1,10,5,0,19,nowin,loss,beat,dlwin,0,10,13,219,0.438356164,0.050228311,0.575342466,1,0.308411257
5550,30,20926,4,10,0,6,0,20,10,10,0,0,0,20,nowin,push,push,push,10,0,14,206,0.393203883,0.033980583,0.601941748,0,0.029324648
5551,91,20926,3,9,0,10,0,22,10,10,0,0,0,20,nowin,loss,bust,plbust,0,10,12,194,0.417525773,0.046391753,0.515463918,1,0.266616552
5552,83,20926,10,3,0,10,0,23,10,10,0,0,0,20,nowin,loss,bust,plbust,0,10,13,193,0.424870466,0.051813472,0.678756477,2,0.644360335
5553,108,20926,8,9,0,0,0,17,10,10,0,0,0,20,nowin,loss,beat,dlwin,0,10,17,193,0.435233161,0.056994819,0.559585492,1,0.298824795
5554,63,20926,8,3,10,0,0,21,10,10,0,0,0,20,nowin,win,plwin,beat,20,0,11,216,0.467592593,0.037037037,0.62037037,3,0.931690496
5555,121,20926,3,6,10,0,0,19,10,10,0,0,0,20,nowin,loss,beat,dlwin,0,10,9,195,0.456410256,0.025641026,0.512820513,1,0.288597791
5556,91,20927,10,11,0,0,0,21,2,10,10,0,0,22,win,win,dlbust,bust,25,0,21,194,0.417525773,0.046391753,0.515463918,1,0.266616552
5557,64,20927,10,6,0,0,0,16,2,10,10,0,0,22,nowin,win,dlbust,bust,20,0,16,187,0.363636364,0.048128342,0.631016043,0,0.027594885
5558,12,20927,10,6,0,0,0,16,2,10,10,0,0,22,nowin,win,dlbust,bust,20,0,16,189,0.470899471,0.015873016,0.613756614,3,0.929171178
5559,23,20927,10,3,0,0,0,13,2,10,10,0,0,22,nowin,win,dlbust,bust,20,0,13,208,0.427884615,0.0625,0.552884615,1,0.29114424
5560,24,20927,10,4,0,0,0,14,2,10,10,0,0,22,nowin,win,dlbust,bust,20,0,14,207,0.458937198,0.048309179,0.570048309,1,0.318138014
5561,117,20927,1,6,5,3,0,15,2,10,10,0,0,22,nowin,win,dlbust,bust,20,0,7,173,0.410404624,0.069364162,0.606936416,2,0.578610282
5562,51,20928,8,3,10,0,0,21,4,2,8,5,0,19,nowin,win,plwin,beat,20,0,11,189,0.529100529,0.068783069,0.608465608,3,0.993665715
5563,93,20928,10,7,0,0,0,17,4,2,8,5,0,19,nowin,loss,beat,dlwin,0,10,17,175,0.485714286,0.051428571,0.548571429,1,0.323648091
5564,110,20928,6,6,0,0,0,12,4,2,8,5,0,19,nowin,loss,beat,dlwin,0,10,12,192,0.416666667,0.046875,0.557291667,0,0.025413132
5565,29,20928,9,3,0,0,0,12,4,2,8,5,0,19,nowin,loss,beat,dlwin,0,10,12,189,0.44973545,0.058201058,0.544973545,1,0.300349439
5566,147,20928,6,10,0,0,0,16,4,2,8,5,0,19,nowin,loss,beat,dlwin,0,10,16,205,0.380487805,0.014634146,0.536585366,0,0.00951447
5567,143,20928,7,3,10,0,0,20,4,2,8,5,0,19,nowin,win,plwin,beat,20,0,10,203,0.463054187,0.044334975,0.57635468,3,0.883143365
5568,49,20929,10,6,0,10,0,26,10,4,4,0,0,18,nowin,loss,bust,plbust,0,10,16,207,0.396135266,0.053140097,0.594202899,0,0.028306925
5569,84,20929,5,8,0,8,0,21,10,4,4,0,0,18,nowin,win,plwin,beat,20,0,13,195,0.379487179,0.056410256,0.569230769,0,0.017209119
5570,13,20929,3,10,0,10,0,23,10,4,4,0,0,18,nowin,loss,bust,plbust,0,10,13,206,0.417475728,0.063106796,0.621359223,2,0.59555479
5571,74,20929,10,10,0,0,0,20,10,4,4,0,0,18,nowin,win,plwin,beat,20,0,20,209,0.411483254,0.04784689,0.531100478,0,0.017448125
5572,96,20929,10,10,0,0,0,20,10,4,4,0,0,18,nowin,win,plwin,beat,20,0,20,190,0.468421053,0.057894737,0.584210526,3,0.897263354
5573,61,20929,4,7,1,1,8,21,10,4,4,0,0,18,nowin,win,plwin,beat,20,0,11,194,0.427835052,0.077319588,0.603092784,2,0.591437139
5574,41,20930,8,7,0,8,0,23,8,2,6,4,0,20,nowin,loss,bust,plbust,0,10,15,192,0.364583333,0.036458333,0.520833333,0,0.00089702
5575,150,20930,5,10,0,10,0,25,8,2,6,4,0,20,nowin,loss,bust,plbust,0,10,15,192,0.401041667,0.036458333,0.567708333,0,0.023287458
5576,21,20930,6,10,0,9,0,25,8,2,6,4,0,20,nowin,loss,bust,plbust,0,10,16,214,0.359813084,0.042056075,0.626168224,0,0.025263474
5577,74,20930,4,5,10,0,0,19,8,2,6,4,0,20,nowin,loss,beat,dlwin,0,10,9,209,0.411483254,0.04784689,0.531100478,0,0.017448125
5578,28,20930,10,7,0,0,0,17,8,2,6,4,0,20,nowin,loss,beat,dlwin,0,10,17,199,0.422110553,0.045226131,0.542713568,1,0.282706618
5579,16,20930,10,2,0,10,0,22,8,2,6,4,0,20,nowin,loss,bust,plbust,0,10,12,220,0.427272727,0.081818182,0.6,2,0.588660176
5580,122,20931,2,3,10,2,0,17,9,6,10,0,0,25,nowin,win,dlbust,bust,20,0,5,210,0.347619048,0.052380952,0.59047619,0,0.012873677
5581,32,20931,10,4,0,4,0,18,9,6,10,0,0,25,nowin,win,dlbust,bust,20,0,14,189,0.391534392,0.037037037,0.53968254,0,0.013579086
5582,140,20931,10,3,0,2,4,19,9,6,10,0,0,25,nowin,win,dlbust,bust,20,0,13,210,0.466666667,0.023809524,0.604761905,3,0.915293335
5583,3,20931,8,7,0,4,0,19,9,6,10,0,0,25,nowin,win,dlbust,bust,20,0,15,190,0.431578947,0.026315789,0.542105263,1,0.288076384
5584,90,20931,6,9,0,1,4,20,9,6,10,0,0,25,nowin,win,dlbust,bust,20,0,15,201,0.447761194,0.049751244,0.60199005,3,0.889945023
5585,107,20931,5,5,4,9,0,23,9,6,10,0,0,25,nowin,loss,bust,plbust,0,10,10,218,0.444954128,0.073394495,0.600917431,2,0.605210014
5586,30,20932,5,11,2,0,0,18,10,11,0,0,0,21,nowin,loss,beat,dlwin,0,10,16,206,0.393203883,0.033980583,0.601941748,0,0.029324648
5587,91,20932,10,5,0,6,0,21,10,11,0,0,0,21,nowin,push,push,push,10,0,15,194,0.417525773,0.046391753,0.515463918,1,0.266616552
5588,136,20932,6,5,1,5,0,17,10,11,0,0,0,21,nowin,loss,beat,dlwin,0,10,11,194,0.396907216,0.025773196,0.597938144,0,0.029452644
5589,60,20932,7,4,6,0,0,17,10,11,0,0,0,21,nowin,loss,beat,dlwin,0,10,11,227,0.418502203,0.022026432,0.559471366,0,0.026496258
5590,113,20932,7,10,0,0,0,17,10,11,0,0,0,21,nowin,loss,beat,dlwin,0,10,17,199,0.407035176,0.055276382,0.668341709,2,0.620695264
5591,6,20932,4,4,4,10,0,22,10,11,0,0,0,21,nowin,loss,bust,plbust,0,10,8,191,0.439790576,0.047120419,0.581151832,1,0.31211505
5592,12,20933,10,7,0,0,0,17,8,8,10,0,0,26,nowin,win,dlbust,bust,20,0,17,189,0.470899471,0.015873016,0.613756614,3,0.929171178
5593,37,20933,4,4,3,10,0,21,8,8,10,0,0,26,nowin,win,dlbust,bust,20,0,8,208,0.394230769,0.038461538,0.581730769,0,0.024682772
5594,145,20933,10,8,0,0,0,18,8,8,10,0,0,26,nowin,win,dlbust,bust,20,0,18,188,0.441489362,0.031914894,0.622340426,2,0.617837093
5595,118,20933,3,2,6,8,0,19,8,8,10,0,0,26,nowin,win,dlbust,bust,20,0,5,216,0.393518519,0.037037037,0.555555556,0,0.018059873
5596,149,20933,3,3,8,4,0,18,8,8,10,0,0,26,nowin,win,dlbust,bust,20,0,6,225,0.457777778,0.057777778,0.648888889,2,0.651965595
5597,147,20933,2,7,7,4,0,20,8,8,10,0,0,26,nowin,win,dlbust,bust,20,0,9,205,0.380487805,0.014634146,0.536585366,0,0.00951447
5598,72,20934,4,10,0,0,0,14,5,5,9,0,0,19,nowin,loss,beat,dlwin,0,10,14,185,0.394594595,0.032432432,0.508108108,0,0.006763115
5599,131,20934,6,10,0,0,0,16,5,5,9,0,0,19,nowin,loss,beat,dlwin,0,10,16,217,0.410138249,0.069124424,0.543778802,0,0.02015021
5600,148,20934,4,9,0,0,0,13,5,5,9,0,0,19,nowin,loss,beat,dlwin,0,10,13,204,0.401960784,0.078431373,0.593137255,0,0.029789521
5601,141,20934,11,10,0,0,0,21,5,5,9,0,0,19,win,win,plwin,beat,25,0,21,202,0.420792079,0.074257426,0.564356436,0,0.028377851
5602,136,20934,4,8,0,0,0,12,5,5,9,0,0,19,nowin,loss,beat,dlwin,0,10,12,194,0.396907216,0.025773196,0.597938144,0,0.029452644
5603,113,20934,1,5,9,0,0,15,5,5,9,0,0,19,nowin,loss,beat,dlwin,0,10,6,199,0.407035176,0.055276382,0.668341709,2,0.620695264
5604,133,20935,9,10,0,0,0,19,4,10,5,0,0,19,nowin,push,push,push,10,0,19,201,0.47761194,0.064676617,0.611940299,3,0.935428111
5605,83,20935,10,8,0,0,0,18,4,10,5,0,0,19,nowin,loss,beat,dlwin,0,10,18,193,0.424870466,0.051813472,0.678756477,2,0.644360335
5606,65,20935,6,1,5,0,0,12,4,10,5,0,0,19,nowin,loss,beat,dlwin,0,10,7,203,0.492610837,0.054187192,0.571428571,3,0.913702814
5607,48,20935,9,2,2,0,0,13,4,10,5,0,0,19,nowin,loss,beat,dlwin,0,10,11,203,0.413793103,0.019704433,0.600985222,2,0.577280801
5608,45,20935,10,7,0,0,0,17,4,10,5,0,0,19,nowin,loss,beat,dlwin,0,10,17,196,0.428571429,0.051020408,0.612244898,2,0.598821767
5609,72,20935,3,10,0,0,0,13,4,10,5,0,0,19,nowin,loss,beat,dlwin,0,10,13,185,0.394594595,0.032432432,0.508108108,0,0.006763115
5610,21,20936,5,7,0,8,0,20,8,7,5,0,0,20,nowin,push,push,push,10,0,12,214,0.359813084,0.042056075,0.626168224,0,0.025263474
5611,139,20936,2,4,4,6,10,26,8,7,5,0,0,20,nowin,loss,bust,plbust,0,10,6,192,0.380208333,0.036458333,0.59375,0,0.023429169
5612,15,20936,8,10,0,0,0,18,8,7,5,0,0,20,nowin,loss,beat,dlwin,0,10,18,212,0.410377358,0.051886792,0.561320755,0,0.024517408
5613,127,20936,5,7,0,8,0,20,8,7,5,0,0,20,nowin,push,push,push,10,0,12,201,0.402985075,0.029850746,0.60199005,0,0.032263937
5614,105,20936,10,11,0,0,0,21,8,7,5,0,0,20,win,win,plwin,beat,25,0,21,198,0.414141414,0.070707071,0.590909091,0,0.032889494
5615,70,20936,8,3,4,10,0,25,8,7,5,0,0,20,nowin,loss,bust,plbust,0,10,11,228,0.385964912,0.039473684,0.557017544,0,0.016157125
5616,130,20937,10,8,0,0,0,18,10,10,0,0,0,20,nowin,loss,beat,dlwin,0,10,18,219,0.410958904,0.03652968,0.566210046,0,0.025888739
5617,123,20937,10,10,0,0,0,20,10,10,0,0,0,20,nowin,push,push,push,10,0,20,205,0.43902439,0.034146341,0.614634146,2,0.609962544
5618,52,20937,10,9,0,0,0,19,10,10,0,0,0,20,nowin,loss,beat,dlwin,0,10,19,217,0.414746544,0.02764977,0.599078341,2,0.576736024
5619,131,20937,9,5,0,3,0,17,10,10,0,0,0,20,nowin,loss,beat,dlwin,0,10,14,217,0.410138249,0.069124424,0.543778802,0,0.02015021
5620,146,20937,3,9,0,6,0,18,10,10,0,0,0,20,nowin,loss,beat,dlwin,0,10,12,221,0.43438914,0.040723982,0.542986425,1,0.290190091
5621,75,20937,7,8,0,2,0,17,10,10,0,0,0,20,nowin,loss,beat,dlwin,0,10,15,191,0.418848168,0.052356021,0.570680628,0,0.029344702
5622,11,20938,4,6,7,0,0,17,3,3,10,10,0,26,nowin,win,dlbust,bust,20,0,10,236,0.457627119,0.016949153,0.588983051,3,0.889015813
5623,81,20938,10,4,0,0,0,14,3,3,10,10,0,26,nowin,win,dlbust,bust,20,0,14,182,0.395604396,0.043956044,0.60989011,2,0.567491261
5624,54,20938,7,10,0,0,0,17,3,3,10,10,0,26,nowin,win,dlbust,bust,20,0,17,185,0.437837838,0.032432432,0.556756757,1,0.29899854
5625,117,20938,11,10,0,0,0,21,3,3,10,10,0,26,win,win,dlbust,bust,25,0,21,173,0.410404624,0.069364162,0.606936416,2,0.578610282
5626,125,20938,8,5,0,0,0,13,3,3,10,10,0,26,nowin,win,dlbust,bust,20,0,13,219,0.438356164,0.050228311,0.575342466,1,0.308411257
5627,20,20938,3,7,6,0,0,16,3,3,10,10,0,26,nowin,win,dlbust,bust,20,0,10,186,0.456989247,0.037634409,0.537634409,1,0.301097108
5628,96,20939,4,5,5,8,0,22,8,10,0,0,0,18,nowin,loss,bust,plbust,0,10,9,190,0.468421053,0.057894737,0.584210526,3,0.897263354
5629,77,20939,11,4,2,0,0,17,8,10,0,0,0,18,nowin,loss,beat,dlwin,0,10,15,200,0.455,0.04,0.62,3,0.916252116
5630,132,20939,10,9,0,0,0,19,8,10,0,0,0,18,nowin,win,plwin,beat,20,0,19,194,0.412371134,0.036082474,0.649484536,2,0.611633238
5631,76,20939,9,7,0,1,0,17,8,10,0,0,0,18,nowin,loss,beat,dlwin,0,10,16,189,0.534391534,0.079365079,0.608465608,3,1
5632,63,20939,5,10,0,7,0,22,8,10,0,0,0,18,nowin,loss,bust,plbust,0,10,15,216,0.467592593,0.037037037,0.62037037,3,0.931690496
5633,4,20939,10,10,0,0,0,20,8,10,0,0,0,18,nowin,win,plwin,beat,20,0,20,217,0.460829493,0.036866359,0.562211982,1,0.315432839
5634,124,20940,5,7,0,10,0,22,11,2,6,0,0,19,nowin,loss,bust,plbust,0,10,12,202,0.47029703,0.064356436,0.584158416,3,0.899458193
5635,133,20940,11,10,0,0,0,21,11,2,6,0,0,19,win,win,plwin,beat,25,0,21,201,0.47761194,0.064676617,0.611940299,3,0.935428111
5636,118,20940,3,10,0,10,0,23,11,2,6,0,0,19,nowin,loss,bust,plbust,0,10,13,216,0.393518519,0.037037037,0.555555556,0,0.018059873
5637,36,20940,5,1,9,3,0,18,11,2,6,0,0,19,nowin,loss,beat,dlwin,0,10,6,229,0.445414847,0.056768559,0.655021834,2,0.645370571
5638,1,20940,10,8,0,0,0,18,11,2,6,0,0,19,nowin,loss,beat,dlwin,0,10,18,197,0.406091371,0.025380711,0.649746193,2,0.606186955
5639,17,20940,10,8,0,0,0,18,11,2,6,0,0,19,nowin,loss,beat,dlwin,0,10,18,171,0.444444444,0.070175439,0.555555556,1,0.302364894
5640,128,20941,5,10,0,0,0,15,3,5,10,0,0,18,nowin,loss,beat,dlwin,0,10,15,227,0.356828194,0.052863436,0.577092511,0,0.012352564
5641,45,20941,2,6,2,10,0,20,3,5,10,0,0,18,nowin,win,plwin,beat,20,0,8,196,0.428571429,0.051020408,0.612244898,2,0.598821767
5642,108,20941,4,10,0,0,0,14,3,5,10,0,0,18,nowin,loss,beat,dlwin,0,10,14,193,0.435233161,0.056994819,0.559585492,1,0.298824795
5643,20,20941,10,10,0,0,0,20,3,5,10,0,0,18,nowin,win,plwin,beat,20,0,20,186,0.456989247,0.037634409,0.537634409,1,0.301097108
5644,110,20941,9,9,0,0,0,18,3,5,10,0,0,18,nowin,push,push,push,10,0,18,192,0.416666667,0.046875,0.557291667,0,0.025413132
5645,71,20941,5,10,0,0,0,15,3,5,10,0,0,18,nowin,loss,beat,dlwin,0,10,15,193,0.352331606,0.046632124,0.585492228,0,0.013063661
5646,43,20942,9,2,6,0,0,17,4,9,2,5,0,20,nowin,loss,beat,dlwin,0,10,11,192,0.40625,0.041666667,0.609375,2,0.576671372
5647,138,20942,2,10,0,0,0,12,4,9,2,5,0,20,nowin,loss,beat,dlwin,0,10,12,190,0.442105263,0.047368421,0.610526316,2,0.609711065
5648,8,20942,10,3,0,0,0,13,4,9,2,5,0,20,nowin,loss,beat,dlwin,0,10,13,181,0.44198895,0.071823204,0.596685083,2,0.599438402
5649,90,20942,5,4,9,0,0,18,4,9,2,5,0,20,nowin,loss,beat,dlwin,0,10,9,201,0.447761194,0.049751244,0.60199005,3,0.889945023
5650,118,20942,10,10,0,0,0,20,4,9,2,5,0,20,nowin,push,push,push,10,0,20,216,0.393518519,0.037037037,0.555555556,0,0.018059873
5651,125,20942,7,11,0,0,0,18,4,9,2,5,0,20,nowin,loss,beat,dlwin,0,10,18,219,0.438356164,0.050228311,0.575342466,1,0.308411257
5652,19,20943,6,8,0,1,7,22,10,10,0,0,0,20,nowin,loss,bust,plbust,0,10,14,237,0.41350211,0.054852321,0.628691983,2,0.597373826
5653,148,20943,3,6,7,8,0,24,10,10,0,0,0,20,nowin,loss,bust,plbust,0,10,9,204,0.401960784,0.078431373,0.593137255,0,0.029789521
5654,56,20943,6,10,0,6,0,22,10,10,0,0,0,20,nowin,loss,bust,plbust,0,10,16,175,0.4,0.057142857,0.582857143,0,0.026685297
5655,60,20943,10,2,0,10,0,22,10,10,0,0,0,20,nowin,loss,bust,plbust,0,10,12,227,0.418502203,0.022026432,0.559471366,0,0.026496258
5656,73,20943,8,8,0,10,0,26,10,10,0,0,0,20,nowin,loss,bust,plbust,0,10,16,181,0.375690608,0.011049724,0.596685083,0,0.022795773
5657,36,20943,6,5,4,4,0,19,10,10,0,0,0,20,nowin,loss,beat,dlwin,0,10,11,229,0.445414847,0.056768559,0.655021834,2,0.645370571
5658,136,20944,10,11,0,0,0,21,10,10,0,0,0,20,win,win,plwin,beat,25,0,21,194,0.396907216,0.025773196,0.597938144,0,0.029452644
5659,77,20944,5,1,10,5,0,21,10,10,0,0,0,20,nowin,win,plwin,beat,20,0,6,200,0.455,0.04,0.62,3,0.916252116
5660,127,20944,10,8,0,0,0,18,10,10,0,0,0,20,nowin,loss,beat,dlwin,0,10,18,201,0.402985075,0.029850746,0.60199005,0,0.032263937
5661,72,20944,3,3,11,0,0,17,10,10,0,0,0,20,nowin,loss,beat,dlwin,0,10,6,185,0.394594595,0.032432432,0.508108108,0,0.006763115
5662,46,20944,10,10,0,0,0,20,10,10,0,0,0,20,nowin,push,push,push,10,0,20,186,0.403225806,0.048387097,0.591397849,0,0.029742194
5663,140,20944,10,2,0,3,9,24,10,10,0,0,0,20,nowin,loss,bust,plbust,0,10,12,210,0.466666667,0.023809524,0.604761905,3,0.915293335
5664,84,20945,10,4,0,1,5,20,10,3,2,10,0,25,nowin,win,dlbust,bust,20,0,14,195,0.379487179,0.056410256,0.569230769,0,0.017209119
5665,21,20945,6,7,0,1,10,24,10,3,2,10,0,25,nowin,loss,bust,plbust,0,10,13,214,0.359813084,0.042056075,0.626168224,0,0.025263474
5666,121,20945,3,10,0,9,0,22,10,3,2,10,0,25,nowin,loss,bust,plbust,0,10,13,195,0.456410256,0.025641026,0.512820513,1,0.288597791
5667,78,20945,4,10,0,2,1,17,10,3,2,10,0,25,nowin,win,dlbust,bust,20,0,14,201,0.517412935,0.034825871,0.587064677,3,0.95871112
5668,27,20945,10,10,0,0,0,20,10,3,2,10,0,25,nowin,win,dlbust,bust,20,0,20,178,0.370786517,0.016853933,0.573033708,0,0.015536309
5669,95,20945,8,10,0,0,0,18,10,3,2,10,0,25,nowin,win,dlbust,bust,20,0,18,218,0.412844037,0.04587156,0.559633028,0,0.024842385
5670,55,20946,5,10,0,10,0,25,7,6,8,0,0,21,nowin,loss,bust,plbust,0,10,15,191,0.371727749,0.057591623,0.54973822,0,0.01011347
5671,70,20946,9,11,0,0,0,20,7,6,8,0,0,21,nowin,loss,beat,dlwin,0,10,20,228,0.385964912,0.039473684,0.557017544,0,0.016157125
5672,22,20946,11,2,8,0,0,21,7,6,8,0,0,21,nowin,push,push,push,10,0,13,187,0.481283422,0.042780749,0.577540107,3,0.906128176
5673,43,20946,2,4,10,10,0,26,7,6,8,0,0,21,nowin,loss,bust,plbust,0,10,6,192,0.40625,0.041666667,0.609375,2,0.576671372
5674,130,20946,10,10,0,0,0,20,7,6,8,0,0,21,nowin,loss,beat,dlwin,0,10,20,219,0.410958904,0.03652968,0.566210046,0,0.025888739
5675,110,20946,6,2,2,10,0,20,7,6,8,0,0,21,nowin,loss,beat,dlwin,0,10,8,192,0.416666667,0.046875,0.557291667,0,0.025413132
5676,27,20947,2,2,10,5,0,19,9,10,0,0,0,19,nowin,push,push,push,10,0,4,178,0.370786517,0.016853933,0.573033708,0,0.015536309
5677,113,20947,4,6,10,0,0,20,9,10,0,0,0,19,nowin,win,plwin,beat,20,0,10,199,0.407035176,0.055276382,0.668341709,2,0.620695264
5678,137,20947,5,10,0,1,4,20,9,10,0,0,0,19,nowin,win,plwin,beat,20,0,15,194,0.417525773,0.046391753,0.536082474,1,0.276714602
5679,78,20947,9,5,0,7,0,21,9,10,0,0,0,19,nowin,win,plwin,beat,20,0,14,201,0.517412935,0.034825871,0.587064677,3,0.95871112
5680,11,20947,3,3,10,10,0,26,9,10,0,0,0,19,nowin,loss,bust,plbust,0,10,6,236,0.457627119,0.016949153,0.588983051,3,0.889015813
5681,13,20947,10,8,0,0,0,18,9,10,0,0,0,19,nowin,loss,beat,dlwin,0,10,18,206,0.417475728,0.063106796,0.621359223,2,0.59555479
5682,73,20948,10,6,0,10,0,26,10,10,0,0,0,20,nowin,loss,bust,plbust,0,10,16,181,0.375690608,0.011049724,0.596685083,0,0.022795773
5683,106,20948,6,4,10,0,0,20,10,10,0,0,0,20,nowin,push,push,push,10,0,10,192,0.411458333,0.026041667,0.557291667,0,0.023854304
5684,13,20948,10,10,0,0,0,20,10,10,0,0,0,20,nowin,push,push,push,10,0,20,206,0.417475728,0.063106796,0.621359223,2,0.59555479
5685,52,20948,8,7,0,4,0,19,10,10,0,0,0,20,nowin,loss,beat,dlwin,0,10,15,217,0.414746544,0.02764977,0.599078341,2,0.576736024
5686,26,20948,9,10,0,0,0,19,10,10,0,0,0,20,nowin,loss,beat,dlwin,0,10,19,203,0.463054187,0.0591133,0.541871921,1,0.306802864
5687,2,20948,7,10,0,0,0,17,10,10,0,0,0,20,nowin,loss,beat,dlwin,0,10,17,200,0.445,0.035,0.64,2,0.633962549
5688,132,20949,10,9,0,0,0,19,9,10,0,0,0,19,nowin,push,push,push,10,0,19,194,0.412371134,0.036082474,0.649484536,2,0.611633238
5689,22,20949,7,2,9,0,0,18,9,10,0,0,0,19,nowin,loss,beat,dlwin,0,10,9,187,0.481283422,0.042780749,0.577540107,3,0.906128176
5690,144,20949,2,3,9,1,10,25,9,10,0,0,0,19,nowin,loss,bust,plbust,0,10,5,202,0.386138614,0.054455446,0.564356436,0,0.018006244
5691,87,20949,6,9,0,2,0,17,9,10,0,0,0,19,nowin,loss,beat,dlwin,0,10,15,202,0.405940594,0.054455446,0.628712871,2,0.590599801
5692,102,20949,6,3,4,10,0,23,9,10,0,0,0,19,nowin,loss,bust,plbust,0,10,9,192,0.338541667,0.046875,0.5625,0,0.003306118
5693,141,20949,9,10,0,0,0,19,9,10,0,0,0,19,nowin,push,push,push,10,0,19,202,0.420792079,0.074257426,0.564356436,0,0.028377851
5694,66,20950,7,4,1,7,0,19,10,10,0,0,0,20,nowin,loss,beat,dlwin,0,10,11,217,0.456221198,0.064516129,0.626728111,3,0.924304367
5695,97,20950,4,4,10,0,0,18,10,10,0,0,0,20,nowin,loss,beat,dlwin,0,10,8,182,0.450549451,0.06043956,0.692307692,2,0.677372279
5696,138,20950,2,10,0,3,10,25,10,10,0,0,0,20,nowin,loss,bust,plbust,0,10,12,190,0.442105263,0.047368421,0.610526316,2,0.609711065
5697,18,20950,10,10,0,0,0,20,10,10,0,0,0,20,nowin,push,push,push,10,0,20,182,0.461538462,0.043956044,0.587912088,3,0.892649374
5698,125,20950,3,9,0,9,0,21,10,10,0,0,0,20,nowin,win,plwin,beat,20,0,12,219,0.438356164,0.050228311,0.575342466,1,0.308411257
5699,117,20950,11,7,0,0,0,18,10,10,0,0,0,20,nowin,loss,beat,dlwin,0,10,18,173,0.410404624,0.069364162,0.606936416,2,0.578610282
5700,72,20951,3,8,5,4,0,20,11,4,1,10,0,26,nowin,win,dlbust,bust,20,0,11,185,0.394594595,0.032432432,0.508108108,0,0.006763115
5701,65,20951,5,8,0,4,0,17,11,4,1,10,0,26,nowin,win,dlbust,bust,20,0,13,203,0.492610837,0.054187192,0.571428571,3,0.913702814
5702,149,20951,10,10,0,0,0,20,11,4,1,10,0,26,nowin,win,dlbust,bust,20,0,20,225,0.457777778,0.057777778,0.648888889,2,0.651965595
5703,121,20951,9,7,0,10,0,26,11,4,1,10,0,26,nowin,loss,bust,plbust,0,10,16,195,0.456410256,0.025641026,0.512820513,1,0.288597791
5704,89,20951,8,10,0,0,0,18,11,4,1,10,0,26,nowin,win,dlbust,bust,20,0,18,212,0.537735849,0.047169811,0.594339623,3,0.990167191
5705,6,20951,10,5,0,2,0,17,11,4,1,10,0,26,nowin,win,dlbust,bust,20,0,15,191,0.439790576,0.047120419,0.581151832,1,0.31211505
5706,65,20952,10,3,0,7,0,20,7,7,10,0,0,24,nowin,win,dlbust,bust,20,0,13,203,0.492610837,0.054187192,0.571428571,3,0.913702814
5707,25,20952,6,10,0,8,0,24,7,7,10,0,0,24,nowin,loss,bust,plbust,0,10,16,190,0.463157895,0.063157895,0.536842105,1,0.304401563
5708,103,20952,10,10,0,0,0,20,7,7,10,0,0,24,nowin,win,dlbust,bust,20,0,20,203,0.379310345,0.064039409,0.551724138,0,0.012869209
5709,130,20952,2,10,0,5,0,17,7,7,10,0,0,24,nowin,win,dlbust,bust,20,0,12,219,0.410958904,0.03652968,0.566210046,0,0.025888739
5710,86,20952,2,3,10,5,0,20,7,7,10,0,0,24,nowin,win,dlbust,bust,20,0,5,196,0.454081633,0.040816327,0.591836735,3,0.887566443
5711,78,20952,10,9,0,0,0,19,7,7,10,0,0,24,nowin,win,dlbust,bust,20,0,19,201,0.517412935,0.034825871,0.587064677,3,0.95871112
5712,125,20953,5,3,10,0,0,18,5,4,10,0,0,19,nowin,loss,beat,dlwin,0,10,8,219,0.438356164,0.050228311,0.575342466,1,0.308411257
5713,67,20953,10,2,0,0,0,12,5,4,10,0,0,19,nowin,loss,beat,dlwin,0,10,12,195,0.369230769,0.041025641,0.569230769,0,0.014139427
5714,79,20953,8,8,0,0,0,16,5,4,10,0,0,19,nowin,loss,beat,dlwin,0,10,16,211,0.436018957,0.028436019,0.672985782,2,0.650131054
5715,60,20953,10,4,0,0,0,14,5,4,10,0,0,19,nowin,loss,beat,dlwin,0,10,14,227,0.418502203,0.022026432,0.559471366,0,0.026496258
5716,35,20953,8,9,0,0,0,17,5,4,10,0,0,19,nowin,loss,beat,dlwin,0,10,17,202,0.410891089,0.044554455,0.633663366,2,0.598681573
5717,10,20953,7,2,9,0,0,18,5,4,10,0,0,19,nowin,loss,beat,dlwin,0,10,9,191,0.413612565,0.057591623,0.596858639,2,0.574087175
5718,76,20954,4,1,9,8,0,22,11,3,4,0,0,18,nowin,loss,bust,plbust,0,10,5,189,0.534391534,0.079365079,0.608465608,3,1
5719,5,20954,7,10,0,0,0,17,11,3,4,0,0,18,nowin,loss,beat,dlwin,0,10,17,203,0.42364532,0.02955665,0.596059113,2,0.582508076
5720,124,20954,2,4,4,8,0,18,11,3,4,0,0,18,nowin,push,push,push,10,0,6,202,0.47029703,0.064356436,0.584158416,3,0.899458193
5721,119,20954,4,10,0,4,0,18,11,3,4,0,0,18,nowin,push,push,push,10,0,14,190,0.405263158,0.068421053,0.515789474,0,0.011837158
5722,30,20954,2,10,0,4,8,24,11,3,4,0,0,18,nowin,loss,bust,plbust,0,10,12,206,0.393203883,0.033980583,0.601941748,0,0.029324648
5723,27,20954,2,6,10,0,0,18,11,3,4,0,0,18,nowin,push,push,push,10,0,8,178,0.370786517,0.016853933,0.573033708,0,0.015536309
5724,65,20955,10,10,0,0,0,20,2,8,6,9,0,25,nowin,win,dlbust,bust,20,0,20,203,0.492610837,0.054187192,0.571428571,3,0.913702814
5725,40,20955,10,10,0,0,0,20,2,8,6,9,0,25,nowin,win,dlbust,bust,20,0,20,196,0.367346939,0.030612245,0.617346939,0,0.025358183
5726,57,20955,7,5,0,5,0,17,2,8,6,9,0,25,nowin,win,dlbust,bust,20,0,12,192,0.46875,0.052083333,0.59375,3,0.907001181
5727,96,20955,6,4,5,0,0,15,2,8,6,9,0,25,nowin,win,dlbust,bust,20,0,10,190,0.468421053,0.057894737,0.584210526,3,0.897263354
5728,18,20955,7,10,0,0,0,17,2,8,6,9,0,25,nowin,win,dlbust,bust,20,0,17,182,0.461538462,0.043956044,0.587912088,3,0.892649374
5729,90,20955,4,11,6,0,0,21,2,8,6,9,0,25,nowin,win,dlbust,bust,20,0,15,201,0.447761194,0.049751244,0.60199005,3,0.889945023
5730,12,20956,4,2,10,5,0,21,10,10,0,0,0,20,nowin,win,plwin,beat,20,0,6,189,0.470899471,0.015873016,0.613756614,3,0.929171178
5731,66,20956,11,10,0,0,0,21,10,10,0,0,0,20,win,win,plwin,beat,25,0,21,217,0.456221198,0.064516129,0.626728111,3,0.924304367
5732,109,20956,7,4,5,10,0,26,10,10,0,0,0,20,nowin,loss,bust,plbust,0,10,11,221,0.461538462,0.058823529,0.597285068,3,0.901830309
5733,12,20956,2,10,0,10,0,22,10,10,0,0,0,20,nowin,loss,bust,plbust,0,10,12,189,0.470899471,0.015873016,0.613756614,3,0.929171178
5734,54,20956,10,10,0,0,0,20,10,10,0,0,0,20,nowin,push,push,push,10,0,20,185,0.437837838,0.032432432,0.556756757,1,0.29899854
5735,54,20956,7,10,0,0,0,17,10,10,0,0,0,20,nowin,loss,beat,dlwin,0,10,17,185,0.437837838,0.032432432,0.556756757,1,0.29899854
5736,121,20957,9,3,0,0,0,12,4,11,4,0,0,19,nowin,loss,beat,dlwin,0,10,12,195,0.456410256,0.025641026,0.512820513,1,0.288597791
5737,33,20957,4,2,9,0,0,15,4,11,4,0,0,19,nowin,loss,beat,dlwin,0,10,6,192,0.4375,0.057291667,0.625,2,0.616208916
5738,87,20957,5,10,0,0,0,15,4,11,4,0,0,19,nowin,loss,beat,dlwin,0,10,15,202,0.405940594,0.054455446,0.628712871,2,0.590599801
5739,110,20957,8,11,0,0,0,19,4,11,4,0,0,19,nowin,push,push,push,10,0,19,192,0.416666667,0.046875,0.557291667,0,0.025413132
5740,39,20957,11,10,0,0,0,21,4,11,4,0,0,19,win,win,plwin,beat,25,0,21,191,0.429319372,0.062827225,0.57591623,0,0.033760763
5741,87,20957,6,4,10,0,0,20,4,11,4,0,0,19,nowin,win,plwin,beat,20,0,10,202,0.405940594,0.054455446,0.628712871,2,0.590599801
5742,108,20958,11,10,0,0,0,21,10,10,0,0,0,20,win,win,plwin,beat,25,0,21,193,0.435233161,0.056994819,0.559585492,1,0.298824795
5743,68,20958,7,11,0,0,0,18,10,10,0,0,0,20,nowin,loss,beat,dlwin,0,10,18,205,0.434146341,0.029268293,0.6,2,0.59483189
5744,36,20958,5,5,11,0,0,21,10,10,0,0,0,20,nowin,win,plwin,beat,20,0,10,229,0.445414847,0.056768559,0.655021834,2,0.645370571
5745,5,20958,8,7,0,9,0,24,10,10,0,0,0,20,nowin,loss,bust,plbust,0,10,15,203,0.42364532,0.02955665,0.596059113,2,0.582508076
5746,85,20958,6,8,0,10,0,24,10,10,0,0,0,20,nowin,loss,bust,plbust,0,10,14,195,0.41025641,0.066666667,0.594871795,0,0.03269711
5747,80,20958,9,4,0,1,6,20,10,10,0,0,0,20,nowin,push,push,push,10,0,13,186,0.419354839,0.059139785,0.623655914,2,0.59892924
5748,20,20959,9,5,0,7,0,21,8,9,0,0,0,17,nowin,win,plwin,beat,20,0,14,186,0.456989247,0.037634409,0.537634409,1,0.301097108
5749,39,20959,9,3,0,4,10,26,8,9,0,0,0,17,nowin,loss,bust,plbust,0,10,12,191,0.429319372,0.062827225,0.57591623,0,0.033760763
5750,48,20959,10,10,0,0,0,20,8,9,0,0,0,17,nowin,win,plwin,beat,20,0,20,203,0.413793103,0.019704433,0.600985222,2,0.577280801
5751,116,20959,5,2,5,5,0,17,8,9,0,0,0,17,nowin,push,push,push,10,0,7,195,0.425641026,0.056410256,0.538461538,1,0.28273747
5752,30,20959,6,5,10,0,0,21,8,9,0,0,0,17,nowin,win,plwin,beat,20,0,11,206,0.393203883,0.033980583,0.601941748,0,0.029324648
5753,104,20959,6,10,0,8,0,24,8,9,0,0,0,17,nowin,loss,bust,plbust,0,10,16,209,0.363636364,0.052631579,0.593301435,0,0.018359419
5754,99,20960,8,10,0,0,0,18,6,2,8,3,0,19,nowin,loss,beat,dlwin,0,10,18,207,0.47826087,0.062801932,0.637681159,3,0.961418446
5755,58,20960,10,10,0,0,0,20,6,2,8,3,0,19,nowin,win,plwin,beat,20,0,20,195,0.430769231,0.041025641,0.584615385,2,0.580497586
5756,124,20960,4,10,0,0,0,14,6,2,8,3,0,19,nowin,loss,beat,dlwin,0,10,14,202,0.47029703,0.064356436,0.584158416,3,0.899458193
5757,110,20960,4,7,5,0,0,16,6,2,8,3,0,19,nowin,loss,beat,dlwin,0,10,11,192,0.416666667,0.046875,0.557291667,0,0.025413132
5758,2,20960,3,9,0,0,0,12,6,2,8,3,0,19,nowin,loss,beat,dlwin,0,10,12,200,0.445,0.035,0.64,2,0.633962549
5759,106,20960,2,7,11,0,0,20,6,2,8,3,0,19,nowin,win,plwin,beat,20,0,9,192,0.411458333,0.026041667,0.557291667,0,0.023854304
5760,62,20961,6,3,11,0,0,20,2,10,7,0,0,19,nowin,win,plwin,beat,20,0,9,178,0.370786517,0.028089888,0.54494382,0,0.008657722
5761,6,20961,10,10,0,0,0,20,2,10,7,0,0,19,nowin,win,plwin,beat,20,0,20,191,0.439790576,0.047120419,0.581151832,1,0.31211505
5762,58,20961,10,5,0,0,0,15,2,10,7,0,0,19,nowin,loss,beat,dlwin,0,10,15,195,0.430769231,0.041025641,0.584615385,2,0.580497586
5763,119,20961,6,4,10,0,0,20,2,10,7,0,0,19,nowin,win,plwin,beat,20,0,10,190,0.405263158,0.068421053,0.515789474,0,0.011837158
5764,94,20961,4,10,0,0,0,14,2,10,7,0,0,19,nowin,loss,beat,dlwin,0,10,14,183,0.43715847,0.043715847,0.540983607,1,0.290866892
5765,105,20961,9,9,0,0,0,18,2,10,7,0,0,19,nowin,loss,beat,dlwin,0,10,18,198,0.414141414,0.070707071,0.590909091,0,0.032889494
5766,45,20962,10,6,0,10,0,26,10,10,0,0,0,20,nowin,loss,bust,plbust,0,10,16,196,0.428571429,0.051020408,0.612244898,2,0.598821767
5767,145,20962,4,10,0,7,0,21,10,10,0,0,0,20,nowin,win,plwin,beat,20,0,14,188,0.441489362,0.031914894,0.622340426,2,0.617837093
5768,31,20962,3,10,0,10,0,23,10,10,0,0,0,20,nowin,loss,bust,plbust,0,10,13,188,0.473404255,0.058510638,0.515957447,1,0.300306557
5769,97,20962,2,8,6,3,0,19,10,10,0,0,0,20,nowin,loss,beat,dlwin,0,10,10,182,0.450549451,0.06043956,0.692307692,2,0.677372279
5770,142,20962,10,10,0,0,0,20,10,10,0,0,0,20,nowin,push,push,push,10,0,20,211,0.417061611,0.047393365,0.526066351,1,0.271531309
5771,137,20962,5,11,2,0,0,18,10,10,0,0,0,20,nowin,loss,beat,dlwin,0,10,16,194,0.417525773,0.046391753,0.536082474,1,0.276714602
5772,4,20963,10,6,0,10,0,26,11,2,3,1,0,17,nowin,loss,bust,plbust,0,10,16,217,0.460829493,0.036866359,0.562211982,1,0.315432839
5773,107,20963,10,11,0,0,0,21,11,2,3,1,0,17,win,win,plwin,beat,25,0,21,218,0.444954128,0.073394495,0.600917431,2,0.605210014
5774,144,20963,11,10,0,0,0,21,11,2,3,1,0,17,win,win,plwin,beat,25,0,21,202,0.386138614,0.054455446,0.564356436,0,0.018006244
5775,99,20963,3,2,6,6,0,17,11,2,3,1,0,17,nowin,push,push,push,10,0,5,207,0.47826087,0.062801932,0.637681159,3,0.961418446
5776,94,20963,5,10,0,6,0,21,11,2,3,1,0,17,nowin,win,plwin,beat,20,0,15,183,0.43715847,0.043715847,0.540983607,1,0.290866892
5777,59,20963,2,10,0,1,3,16,11,2,3,1,0,17,nowin,loss,beat,dlwin,0,10,12,228,0.429824561,0.048245614,0.543859649,1,0.287885446
5778,41,20964,7,9,0,0,0,16,3,6,10,0,0,19,nowin,loss,beat,dlwin,0,10,16,192,0.364583333,0.036458333,0.520833333,0,0.00089702
5779,125,20964,10,6,0,0,0,16,3,6,10,0,0,19,nowin,loss,beat,dlwin,0,10,16,219,0.438356164,0.050228311,0.575342466,1,0.308411257
5780,105,20964,6,8,0,0,0,14,3,6,10,0,0,19,nowin,loss,beat,dlwin,0,10,14,198,0.414141414,0.070707071,0.590909091,0,0.032889494
5781,61,20964,6,10,0,0,0,16,3,6,10,0,0,19,nowin,loss,beat,dlwin,0,10,16,194,0.427835052,0.077319588,0.603092784,2,0.591437139
5782,92,20964,10,6,0,0,0,16,3,6,10,0,0,19,nowin,loss,beat,dlwin,0,10,16,186,0.446236559,0.059139785,0.564516129,1,0.307826125
5783,147,20964,11,4,3,0,0,18,3,6,10,0,0,19,nowin,loss,beat,dlwin,0,10,15,205,0.380487805,0.014634146,0.536585366,0,0.00951447
5784,140,20965,7,8,0,0,0,15,6,11,0,0,0,17,nowin,loss,beat,dlwin,0,10,15,210,0.466666667,0.023809524,0.604761905,3,0.915293335
5785,89,20965,4,10,0,0,0,14,6,11,0,0,0,17,nowin,loss,beat,dlwin,0,10,14,212,0.537735849,0.047169811,0.594339623,3,0.990167191
5786,67,20965,5,1,8,0,0,14,6,11,0,0,0,17,nowin,loss,beat,dlwin,0,10,6,195,0.369230769,0.041025641,0.569230769,0,0.014139427
5787,17,20965,2,10,0,0,0,12,6,11,0,0,0,17,nowin,loss,beat,dlwin,0,10,12,171,0.444444444,0.070175439,0.555555556,1,0.302364894
5788,143,20965,10,3,0,0,0,13,6,11,0,0,0,17,nowin,loss,beat,dlwin,0,10,13,203,0.463054187,0.044334975,0.57635468,3,0.883143365
5789,47,20965,6,10,0,0,0,16,6,11,0,0,0,17,nowin,loss,beat,dlwin,0,10,16,210,0.438095238,0.057142857,0.623809524,2,0.615868808
5790,6,20966,7,9,0,7,0,23,7,10,0,0,0,17,nowin,loss,bust,plbust,0,10,16,191,0.439790576,0.047120419,0.581151832,1,0.31211505
5791,70,20966,2,9,2,3,4,20,7,10,0,0,0,17,nowin,win,plwin,beat,20,0,11,228,0.385964912,0.039473684,0.557017544,0,0.016157125
5792,10,20966,8,4,0,10,0,22,7,10,0,0,0,17,nowin,loss,bust,plbust,0,10,12,191,0.413612565,0.057591623,0.596858639,2,0.574087175
5793,54,20966,10,9,0,0,0,19,7,10,0,0,0,17,nowin,win,plwin,beat,20,0,19,185,0.437837838,0.032432432,0.556756757,1,0.29899854
5794,115,20966,2,3,3,7,5,20,7,10,0,0,0,17,nowin,win,plwin,beat,20,0,5,194,0.427835052,0.041237113,0.592783505,2,0.583863602
5795,121,20966,9,10,0,0,0,19,7,10,0,0,0,17,nowin,win,plwin,beat,20,0,19,195,0.456410256,0.025641026,0.512820513,1,0.288597791
5796,135,20967,1,6,9,10,0,26,8,10,0,0,0,18,nowin,loss,bust,plbust,0,10,7,179,0.391061453,0.067039106,0.586592179,0,0.024924662
5797,95,20967,5,7,0,10,0,22,8,10,0,0,0,18,nowin,loss,bust,plbust,0,10,12,218,0.412844037,0.04587156,0.559633028,0,0.024842385
5798,10,20967,10,4,0,2,5,21,8,10,0,0,0,18,nowin,win,plwin,beat,20,0,14,191,0.413612565,0.057591623,0.596858639,2,0.574087175
5799,131,20967,10,9,0,0,0,19,8,10,0,0,0,18,nowin,win,plwin,beat,20,0,19,217,0.410138249,0.069124424,0.543778802,0,0.02015021
5800,98,20967,5,10,0,10,0,25,8,10,0,0,0,18,nowin,loss,bust,plbust,0,10,15,220,0.422727273,0.054545455,0.55,1,0.28664435
5801,9,20967,11,7,0,0,0,18,8,10,0,0,0,18,nowin,push,push,push,10,0,18,194,0.37628866,0.015463918,0.541237113,0,0.009396796
5802,81,20968,10,10,0,0,0,20,10,5,5,0,0,20,nowin,push,push,push,10,0,20,182,0.395604396,0.043956044,0.60989011,2,0.567491261
5803,67,20968,9,10,0,0,0,19,10,5,5,0,0,20,nowin,loss,beat,dlwin,0,10,19,195,0.369230769,0.041025641,0.569230769,0,0.014139427
5804,20,20968,3,2,4,10,0,19,10,5,5,0,0,20,nowin,loss,beat,dlwin,0,10,5,186,0.456989247,0.037634409,0.537634409,1,0.301097108
5805,66,20968,10,3,0,1,7,21,10,5,5,0,0,20,nowin,win,plwin,beat,20,0,13,217,0.456221198,0.064516129,0.626728111,3,0.924304367
5806,99,20968,10,7,0,0,0,17,10,5,5,0,0,20,nowin,loss,beat,dlwin,0,10,17,207,0.47826087,0.062801932,0.637681159,3,0.961418446
5807,42,20968,10,8,0,0,0,18,10,5,5,0,0,20,nowin,loss,beat,dlwin,0,10,18,212,0.443396226,0.051886792,0.570754717,1,0.309181312
5808,61,20969,10,10,0,0,0,20,11,9,0,0,0,20,nowin,push,push,push,10,0,20,194,0.427835052,0.077319588,0.603092784,2,0.591437139
5809,63,20969,8,8,0,4,0,20,11,9,0,0,0,20,nowin,push,push,push,10,0,16,216,0.467592593,0.037037037,0.62037037,3,0.931690496
5810,107,20969,4,10,0,10,0,24,11,9,0,0,0,20,nowin,loss,bust,plbust,0,10,14,218,0.444954128,0.073394495,0.600917431,2,0.605210014
5811,82,20969,9,10,0,0,0,19,11,9,0,0,0,20,nowin,loss,beat,dlwin,0,10,19,225,0.408888889,0.075555556,0.577777778,0,0.028101874
5812,8,20969,2,3,6,10,0,21,11,9,0,0,0,20,nowin,win,plwin,beat,20,0,5,181,0.44198895,0.071823204,0.596685083,2,0.599438402
5813,44,20969,8,10,0,0,0,18,11,9,0,0,0,20,nowin,loss,beat,dlwin,0,10,18,219,0.433789954,0.050228311,0.534246575,1,0.285551035
5814,123,20970,9,5,0,5,0,19,10,10,0,0,0,20,nowin,loss,beat,dlwin,0,10,14,205,0.43902439,0.034146341,0.614634146,2,0.609962544
5815,74,20970,11,1,4,6,0,22,10,10,0,0,0,20,nowin,loss,bust,plbust,0,10,12,209,0.411483254,0.04784689,0.531100478,0,0.017448125
5816,86,20970,7,10,0,0,0,17,10,10,0,0,0,20,nowin,loss,beat,dlwin,0,10,17,196,0.454081633,0.040816327,0.591836735,3,0.887566443
5817,23,20970,5,6,1,3,3,18,10,10,0,0,0,20,nowin,loss,beat,dlwin,0,10,11,208,0.427884615,0.0625,0.552884615,1,0.29114424
5818,37,20970,2,6,10,0,0,18,10,10,0,0,0,20,nowin,loss,beat,dlwin,0,10,8,208,0.394230769,0.038461538,0.581730769,0,0.024682772
5819,129,20970,5,10,0,4,0,19,10,10,0,0,0,20,nowin,loss,beat,dlwin,0,10,15,201,0.422885572,0.064676617,0.55721393,0,0.027255383
5820,60,20971,5,10,0,10,0,25,1,1,10,1,10,23,nowin,loss,bust,plbust,0,10,15,227,0.418502203,0.022026432,0.559471366,0,0.026496258
5821,32,20971,11,10,0,0,0,21,1,1,10,1,10,23,win,win,dlbust,bust,25,0,21,189,0.391534392,0.037037037,0.53968254,0,0.013579086
5822,144,20971,9,7,0,8,0,24,1,1,10,1,10,23,nowin,loss,bust,plbust,0,10,16,202,0.386138614,0.054455446,0.564356436,0,0.018006244
5823,55,20971,2,6,11,0,0,19,1,1,10,1,10,23,nowin,win,dlbust,bust,20,0,8,191,0.371727749,0.057591623,0.54973822,0,0.01011347
5824,38,20971,3,10,0,3,4,20,1,1,10,1,10,23,nowin,win,dlbust,bust,20,0,13,202,0.361386139,0.03960396,0.564356436,0,0.010597953
5825,109,20971,4,10,0,9,0,23,1,1,10,1,10,23,nowin,loss,bust,plbust,0,10,14,221,0.461538462,0.058823529,0.597285068,3,0.901830309
5826,98,20972,8,6,0,10,0,24,10,5,10,0,0,25,nowin,loss,bust,plbust,0,10,14,220,0.422727273,0.054545455,0.55,1,0.28664435
5827,6,20972,10,9,0,0,0,19,10,5,10,0,0,25,nowin,win,dlbust,bust,20,0,19,191,0.439790576,0.047120419,0.581151832,1,0.31211505
5828,87,20972,4,10,0,10,0,24,10,5,10,0,0,25,nowin,loss,bust,plbust,0,10,14,202,0.405940594,0.054455446,0.628712871,2,0.590599801
5829,4,20972,3,9,0,10,0,22,10,5,10,0,0,25,nowin,loss,bust,plbust,0,10,12,217,0.460829493,0.036866359,0.562211982,1,0.315432839
5830,99,20972,2,3,10,9,0,24,10,5,10,0,0,25,nowin,loss,bust,plbust,0,10,5,207,0.47826087,0.062801932,0.637681159,3,0.961418446
5831,133,20972,10,4,0,10,0,24,10,5,10,0,0,25,nowin,loss,bust,plbust,0,10,14,201,0.47761194,0.064676617,0.611940299,3,0.935428111
5832,135,20973,9,7,0,0,0,16,3,2,8,9,0,22,nowin,win,dlbust,bust,20,0,16,179,0.391061453,0.067039106,0.586592179,0,0.024924662
5833,98,20973,8,2,2,3,0,15,3,2,8,9,0,22,nowin,win,dlbust,bust,20,0,10,220,0.422727273,0.054545455,0.55,1,0.28664435
5834,139,20973,9,9,0,0,0,18,3,2,8,9,0,22,nowin,win,dlbust,bust,20,0,18,192,0.380208333,0.036458333,0.59375,0,0.023429169
5835,51,20973,10,10,0,0,0,20,3,2,8,9,0,22,nowin,win,dlbust,bust,20,0,20,189,0.529100529,0.068783069,0.608465608,3,0.993665715
5836,65,20973,11,7,0,0,0,18,3,2,8,9,0,22,nowin,win,dlbust,bust,20,0,18,203,0.492610837,0.054187192,0.571428571,3,0.913702814
5837,8,20973,8,10,0,0,0,18,3,2,8,9,0,22,nowin,win,dlbust,bust,20,0,18,181,0.44198895,0.071823204,0.596685083,2,0.599438402
5838,110,20974,6,9,0,0,0,15,2,6,7,5,0,20,nowin,loss,beat,dlwin,0,10,15,192,0.416666667,0.046875,0.557291667,0,0.025413132
5839,121,20974,2,6,4,3,0,15,2,6,7,5,0,20,nowin,loss,beat,dlwin,0,10,8,195,0.456410256,0.025641026,0.512820513,1,0.288597791
5840,149,20974,10,8,0,0,0,18,2,6,7,5,0,20,nowin,loss,beat,dlwin,0,10,18,225,0.457777778,0.057777778,0.648888889,2,0.651965595
5841,5,20974,8,10,0,0,0,18,2,6,7,5,0,20,nowin,loss,beat,dlwin,0,10,18,203,0.42364532,0.02955665,0.596059113,2,0.582508076
5842,54,20974,8,10,0,0,0,18,2,6,7,5,0,20,nowin,loss,beat,dlwin,0,10,18,185,0.437837838,0.032432432,0.556756757,1,0.29899854
5843,139,20974,4,11,2,0,0,17,2,6,7,5,0,20,nowin,loss,beat,dlwin,0,10,15,192,0.380208333,0.036458333,0.59375,0,0.023429169
5844,115,20975,9,10,0,0,0,19,3,4,7,5,0,19,nowin,push,push,push,10,0,19,194,0.427835052,0.041237113,0.592783505,2,0.583863602
5845,103,20975,7,5,0,4,0,16,3,4,7,5,0,19,nowin,loss,beat,dlwin,0,10,12,203,0.379310345,0.064039409,0.551724138,0,0.012869209
5846,141,20975,9,9,0,0,0,18,3,4,7,5,0,19,nowin,loss,beat,dlwin,0,10,18,202,0.420792079,0.074257426,0.564356436,0,0.028377851
5847,146,20975,6,3,10,0,0,19,3,4,7,5,0,19,nowin,push,push,push,10,0,9,221,0.43438914,0.040723982,0.542986425,1,0.290190091
5848,60,20975,4,4,9,0,0,17,3,4,7,5,0,19,nowin,loss,beat,dlwin,0,10,8,227,0.418502203,0.022026432,0.559471366,0,0.026496258
5849,64,20975,4,7,10,0,0,21,3,4,7,5,0,19,nowin,win,plwin,beat,20,0,11,187,0.363636364,0.048128342,0.631016043,0,0.027594885
5850,32,20976,10,8,0,0,0,18,10,11,0,0,0,21,nowin,loss,beat,dlwin,0,10,18,189,0.391534392,0.037037037,0.53968254,0,0.013579086
5851,43,20976,10,5,0,6,0,21,10,11,0,0,0,21,nowin,push,push,push,10,0,15,192,0.40625,0.041666667,0.609375,2,0.576671372
5852,61,20976,10,10,0,0,0,20,10,11,0,0,0,21,nowin,loss,beat,dlwin,0,10,20,194,0.427835052,0.077319588,0.603092784,2,0.591437139
5853,60,20976,7,10,0,0,0,17,10,11,0,0,0,21,nowin,loss,beat,dlwin,0,10,17,227,0.418502203,0.022026432,0.559471366,0,0.026496258
5854,104,20976,10,10,0,0,0,20,10,11,0,0,0,21,nowin,loss,beat,dlwin,0,10,20,209,0.363636364,0.052631579,0.593301435,0,0.018359419
5855,26,20976,5,8,0,2,10,25,10,11,0,0,0,21,nowin,loss,bust,plbust,0,10,13,203,0.463054187,0.0591133,0.541871921,1,0.306802864
5856,23,20977,8,10,0,0,0,18,11,2,6,0,0,19,nowin,loss,beat,dlwin,0,10,18,208,0.427884615,0.0625,0.552884615,1,0.29114424
5857,65,20977,10,4,0,10,0,24,11,2,6,0,0,19,nowin,loss,bust,plbust,0,10,14,203,0.492610837,0.054187192,0.571428571,3,0.913702814
5858,132,20977,4,10,0,4,0,18,11,2,6,0,0,19,nowin,loss,beat,dlwin,0,10,14,194,0.412371134,0.036082474,0.649484536,2,0.611633238
5859,25,20977,7,5,0,4,10,26,11,2,6,0,0,19,nowin,loss,bust,plbust,0,10,12,190,0.463157895,0.063157895,0.536842105,1,0.304401563
5860,86,20977,10,7,0,0,0,17,11,2,6,0,0,19,nowin,loss,beat,dlwin,0,10,17,196,0.454081633,0.040816327,0.591836735,3,0.887566443
5861,26,20977,4,8,0,10,0,22,11,2,6,0,0,19,nowin,loss,bust,plbust,0,10,12,203,0.463054187,0.0591133,0.541871921,1,0.306802864
5862,39,20978,9,11,0,0,0,20,2,10,2,8,0,22,nowin,win,dlbust,bust,20,0,20,191,0.429319372,0.062827225,0.57591623,0,0.033760763
5863,26,20978,6,10,0,0,0,16,2,10,2,8,0,22,nowin,win,dlbust,bust,20,0,16,203,0.463054187,0.0591133,0.541871921,1,0.306802864
5864,141,20978,11,7,0,0,0,18,2,10,2,8,0,22,nowin,win,dlbust,bust,20,0,18,202,0.420792079,0.074257426,0.564356436,0,0.028377851
5865,134,20978,2,9,5,0,0,16,2,10,2,8,0,22,nowin,win,dlbust,bust,20,0,11,185,0.443243243,0.021621622,0.545945946,1,0.296939509
5866,95,20978,10,10,0,0,0,20,2,10,2,8,0,22,nowin,win,dlbust,bust,20,0,20,218,0.412844037,0.04587156,0.559633028,0,0.024842385
5867,113,20978,11,10,0,0,0,21,2,10,2,8,0,22,win,win,dlbust,bust,25,0,21,199,0.407035176,0.055276382,0.668341709,2,0.620695264
5868,116,20979,10,11,0,0,0,21,11,4,1,7,0,23,win,win,dlbust,bust,25,0,21,195,0.425641026,0.056410256,0.538461538,1,0.28273747
5869,47,20979,10,8,0,0,0,18,11,4,1,7,0,23,nowin,win,dlbust,bust,20,0,18,210,0.438095238,0.057142857,0.623809524,2,0.615868808
5870,3,20979,3,1,10,1,8,23,11,4,1,7,0,23,nowin,loss,bust,plbust,0,10,4,190,0.431578947,0.026315789,0.542105263,1,0.288076384
5871,1,20979,11,8,0,0,0,19,11,4,1,7,0,23,nowin,win,dlbust,bust,20,0,19,197,0.406091371,0.025380711,0.649746193,2,0.606186955
5872,26,20979,10,10,0,0,0,20,11,4,1,7,0,23,nowin,win,dlbust,bust,20,0,20,203,0.463054187,0.0591133,0.541871921,1,0.306802864
5873,44,20979,11,7,0,0,0,18,11,4,1,7,0,23,nowin,win,dlbust,bust,20,0,18,219,0.433789954,0.050228311,0.534246575,1,0.285551035
5874,95,20980,11,3,2,1,0,17,8,5,4,0,0,17,nowin,push,push,push,10,0,14,218,0.412844037,0.04587156,0.559633028,0,0.024842385
5875,49,20980,5,7,0,4,2,18,8,5,4,0,0,17,nowin,win,plwin,beat,20,0,12,207,0.396135266,0.053140097,0.594202899,0,0.028306925
5876,17,20980,8,9,0,0,0,17,8,5,4,0,0,17,nowin,push,push,push,10,0,17,171,0.444444444,0.070175439,0.555555556,1,0.302364894
5877,112,20980,3,10,0,10,0,23,8,5,4,0,0,17,nowin,loss,bust,plbust,0,10,13,203,0.448275862,0.054187192,0.600985222,3,0.889576933
5878,59,20980,4,8,0,6,0,18,8,5,4,0,0,17,nowin,win,plwin,beat,20,0,12,228,0.429824561,0.048245614,0.543859649,1,0.287885446
5879,26,20980,8,5,0,4,0,17,8,5,4,0,0,17,nowin,push,push,push,10,0,13,203,0.463054187,0.0591133,0.541871921,1,0.306802864
5880,69,20981,5,10,0,2,0,17,7,5,10,0,0,22,nowin,win,dlbust,bust,20,0,15,194,0.365979381,0.030927835,0.515463918,0,0
5881,115,20981,2,2,9,10,0,23,7,5,10,0,0,22,nowin,loss,bust,plbust,0,10,4,194,0.427835052,0.041237113,0.592783505,2,0.583863602
5882,66,20981,10,10,0,0,0,20,7,5,10,0,0,22,nowin,win,dlbust,bust,20,0,20,217,0.456221198,0.064516129,0.626728111,3,0.924304367
5883,100,20981,10,8,0,0,0,18,7,5,10,0,0,22,nowin,win,dlbust,bust,20,0,18,190,0.452631579,0.036842105,0.594736842,3,0.888671154
5884,5,20981,10,10,0,0,0,20,7,5,10,0,0,22,nowin,win,dlbust,bust,20,0,20,203,0.42364532,0.02955665,0.596059113,2,0.582508076
5885,11,20981,10,10,0,0,0,20,7,5,10,0,0,22,nowin,win,dlbust,bust,20,0,20,236,0.457627119,0.016949153,0.588983051,3,0.889015813
5886,118,20982,10,4,0,8,0,22,9,10,0,0,0,19,nowin,loss,bust,plbust,0,10,14,216,0.393518519,0.037037037,0.555555556,0,0.018059873
5887,40,20982,6,2,5,3,10,26,9,10,0,0,0,19,nowin,loss,bust,plbust,0,10,8,196,0.367346939,0.030612245,0.617346939,0,0.025358183
5888,57,20982,7,4,1,7,0,19,9,10,0,0,0,19,nowin,push,push,push,10,0,11,192,0.46875,0.052083333,0.59375,3,0.907001181
5889,12,20982,11,9,0,0,0,20,9,10,0,0,0,19,nowin,win,plwin,beat,20,0,20,189,0.470899471,0.015873016,0.613756614,3,0.929171178
5890,141,20982,11,10,0,0,0,21,9,10,0,0,0,19,win,win,plwin,beat,25,0,21,202,0.420792079,0.074257426,0.564356436,0,0.028377851
5891,142,20982,10,10,0,0,0,20,9,10,0,0,0,19,nowin,win,plwin,beat,20,0,20,211,0.417061611,0.047393365,0.526066351,1,0.271531309
5892,55,20983,3,6,10,0,0,19,10,2,5,0,0,17,nowin,win,plwin,beat,20,0,9,191,0.371727749,0.057591623,0.54973822,0,0.01011347
5893,94,20983,10,3,0,1,7,21,10,2,5,0,0,17,nowin,win,plwin,beat,20,0,13,183,0.43715847,0.043715847,0.540983607,1,0.290866892
5894,24,20983,10,5,0,10,0,25,10,2,5,0,0,17,nowin,loss,bust,plbust,0,10,15,207,0.458937198,0.048309179,0.570048309,1,0.318138014
5895,145,20983,10,11,0,0,0,21,10,2,5,0,0,17,win,win,plwin,beat,25,0,21,188,0.441489362,0.031914894,0.622340426,2,0.617837093
5896,77,20983,5,4,10,0,0,19,10,2,5,0,0,17,nowin,win,plwin,beat,20,0,9,200,0.455,0.04,0.62,3,0.916252116
5897,26,20983,10,4,0,9,0,23,10,2,5,0,0,17,nowin,loss,bust,plbust,0,10,14,203,0.463054187,0.0591133,0.541871921,1,0.306802864
5898,147,20984,5,9,0,0,0,14,6,5,2,9,0,22,nowin,win,dlbust,bust,20,0,14,205,0.380487805,0.014634146,0.536585366,0,0.00951447
5899,55,20984,10,8,0,0,0,18,6,5,2,9,0,22,nowin,win,dlbust,bust,20,0,18,191,0.371727749,0.057591623,0.54973822,0,0.01011347
5900,137,20984,10,4,0,0,0,14,6,5,2,9,0,22,nowin,win,dlbust,bust,20,0,14,194,0.417525773,0.046391753,0.536082474,1,0.276714602
5901,10,20984,10,4,0,0,0,14,6,5,2,9,0,22,nowin,win,dlbust,bust,20,0,14,191,0.413612565,0.057591623,0.596858639,2,0.574087175
5902,123,20984,10,3,0,0,0,13,6,5,2,9,0,22,nowin,win,dlbust,bust,20,0,13,205,0.43902439,0.034146341,0.614634146,2,0.609962544
5903,61,20984,9,11,0,0,0,20,6,5,2,9,0,22,nowin,win,dlbust,bust,20,0,20,194,0.427835052,0.077319588,0.603092784,2,0.591437139
5904,37,20985,8,8,0,0,0,16,5,7,2,9,0,23,nowin,win,dlbust,bust,20,0,16,208,0.394230769,0.038461538,0.581730769,0,0.024682772
5905,110,20985,8,10,0,0,0,18,5,7,2,9,0,23,nowin,win,dlbust,bust,20,0,18,192,0.416666667,0.046875,0.557291667,0,0.025413132
5906,122,20985,7,10,0,0,0,17,5,7,2,9,0,23,nowin,win,dlbust,bust,20,0,17,210,0.347619048,0.052380952,0.59047619,0,0.012873677
5907,30,20985,6,5,1,0,0,12,5,7,2,9,0,23,nowin,win,dlbust,bust,20,0,11,206,0.393203883,0.033980583,0.601941748,0,0.029324648
5908,1,20985,10,6,0,0,0,16,5,7,2,9,0,23,nowin,win,dlbust,bust,20,0,16,197,0.406091371,0.025380711,0.649746193,2,0.606186955
5909,107,20985,10,10,0,0,0,20,5,7,2,9,0,23,nowin,win,dlbust,bust,20,0,20,218,0.444954128,0.073394495,0.600917431,2,0.605210014
5910,114,20986,6,7,0,0,0,13,2,10,9,0,0,21,nowin,loss,beat,dlwin,0,10,13,198,0.47979798,0.025252525,0.611111111,3,0.937232995
5911,131,20986,10,10,0,0,0,20,2,10,9,0,0,21,nowin,loss,beat,dlwin,0,10,20,217,0.410138249,0.069124424,0.543778802,0,0.02015021
5912,41,20986,2,8,5,0,0,15,2,10,9,0,0,21,nowin,loss,beat,dlwin,0,10,10,192,0.364583333,0.036458333,0.520833333,0,0.00089702
5913,37,20986,10,6,0,0,0,16,2,10,9,0,0,21,nowin,loss,beat,dlwin,0,10,16,208,0.394230769,0.038461538,0.581730769,0,0.024682772
5914,47,20986,7,6,0,0,0,13,2,10,9,0,0,21,nowin,loss,beat,dlwin,0,10,13,210,0.438095238,0.057142857,0.623809524,2,0.615868808
5915,78,20986,11,2,1,0,0,14,2,10,9,0,0,21,nowin,loss,beat,dlwin,0,10,13,201,0.517412935,0.034825871,0.587064677,3,0.95871112
5916,18,20987,10,10,0,0,0,20,10,8,0,0,0,18,nowin,win,plwin,beat,20,0,20,182,0.461538462,0.043956044,0.587912088,3,0.892649374
5917,144,20987,7,8,0,7,0,22,10,8,0,0,0,18,nowin,loss,bust,plbust,0,10,15,202,0.386138614,0.054455446,0.564356436,0,0.018006244
5918,64,20987,10,7,0,0,0,17,10,8,0,0,0,18,nowin,loss,beat,dlwin,0,10,17,187,0.363636364,0.048128342,0.631016043,0,0.027594885
5919,149,20987,6,6,0,4,8,24,10,8,0,0,0,18,nowin,loss,bust,plbust,0,10,12,225,0.457777778,0.057777778,0.648888889,2,0.651965595
5920,128,20987,2,11,7,0,0,20,10,8,0,0,0,18,nowin,win,plwin,beat,20,0,13,227,0.356828194,0.052863436,0.577092511,0,0.012352564
5921,91,20987,9,10,0,0,0,19,10,8,0,0,0,18,nowin,win,plwin,beat,20,0,19,194,0.417525773,0.046391753,0.515463918,1,0.266616552
5922,42,20988,9,10,0,0,0,19,2,10,5,0,0,17,nowin,win,plwin,beat,20,0,19,212,0.443396226,0.051886792,0.570754717,1,0.309181312
5923,93,20988,8,7,0,0,0,15,2,10,5,0,0,17,nowin,loss,beat,dlwin,0,10,15,175,0.485714286,0.051428571,0.548571429,1,0.323648091
5924,31,20988,9,4,0,0,0,13,2,10,5,0,0,17,nowin,loss,beat,dlwin,0,10,13,188,0.473404255,0.058510638,0.515957447,1,0.300306557
5925,129,20988,11,10,0,0,0,21,2,10,5,0,0,17,win,win,plwin,beat,25,0,21,201,0.422885572,0.064676617,0.55721393,0,0.027255383
5926,53,20988,4,1,7,10,0,22,2,10,5,0,0,17,nowin,loss,bust,plbust,0,10,5,250,0.372,0.064,0.564,0,0.013687345
5927,40,20988,5,2,3,10,0,20,2,10,5,0,0,17,nowin,win,plwin,beat,20,0,7,196,0.367346939,0.030612245,0.617346939,0,0.025358183
5928,123,20989,2,2,10,2,8,24,8,8,2,0,0,18,nowin,loss,bust,plbust,0,10,4,205,0.43902439,0.034146341,0.614634146,2,0.609962544
5929,65,20989,10,6,0,6,0,22,8,8,2,0,0,18,nowin,loss,bust,plbust,0,10,16,203,0.492610837,0.054187192,0.571428571,3,0.913702814
5930,114,20989,7,10,0,0,0,17,8,8,2,0,0,18,nowin,loss,beat,dlwin,0,10,17,198,0.47979798,0.025252525,0.611111111,3,0.937232995
5931,74,20989,2,1,10,1,9,23,8,8,2,0,0,18,nowin,loss,bust,plbust,0,10,3,209,0.411483254,0.04784689,0.531100478,0,0.017448125
5932,60,20989,2,2,10,10,0,24,8,8,2,0,0,18,nowin,loss,bust,plbust,0,10,4,227,0.418502203,0.022026432,0.559471366,0,0.026496258
5933,48,20989,10,4,0,9,0,23,8,8,2,0,0,18,nowin,loss,bust,plbust,0,10,14,203,0.413793103,0.019704433,0.600985222,2,0.577280801
5934,115,20990,10,7,0,0,0,17,9,9,0,0,0,18,nowin,loss,beat,dlwin,0,10,17,194,0.427835052,0.041237113,0.592783505,2,0.583863602
5935,11,20990,6,7,0,10,0,23,9,9,0,0,0,18,nowin,loss,bust,plbust,0,10,13,236,0.457627119,0.016949153,0.588983051,3,0.889015813
5936,134,20990,2,9,10,0,0,21,9,9,0,0,0,18,nowin,win,plwin,beat,20,0,11,185,0.443243243,0.021621622,0.545945946,1,0.296939509
5937,113,20990,8,10,0,0,0,18,9,9,0,0,0,18,nowin,push,push,push,10,0,18,199,0.407035176,0.055276382,0.668341709,2,0.620695264
5938,139,20990,2,8,8,0,0,18,9,9,0,0,0,18,nowin,push,push,push,10,0,10,192,0.380208333,0.036458333,0.59375,0,0.023429169
5939,72,20990,7,8,0,9,0,24,9,9,0,0,0,18,nowin,loss,bust,plbust,0,10,15,185,0.394594595,0.032432432,0.508108108,0,0.006763115
5940,121,20991,7,5,0,0,0,12,4,10,9,0,0,23,nowin,win,dlbust,bust,20,0,12,195,0.456410256,0.025641026,0.512820513,1,0.288597791
5941,127,20991,3,10,0,0,0,13,4,10,9,0,0,23,nowin,win,dlbust,bust,20,0,13,201,0.402985075,0.029850746,0.60199005,0,0.032263937
5942,51,20991,4,5,4,0,0,13,4,10,9,0,0,23,nowin,win,dlbust,bust,20,0,9,189,0.529100529,0.068783069,0.608465608,3,0.993665715
5943,25,20991,5,10,0,0,0,15,4,10,9,0,0,23,nowin,win,dlbust,bust,20,0,15,190,0.463157895,0.063157895,0.536842105,1,0.304401563
5944,55,20991,10,11,0,0,0,21,4,10,9,0,0,23,win,win,dlbust,bust,25,0,21,191,0.371727749,0.057591623,0.54973822,0,0.01011347
5945,87,20991,4,2,10,0,0,16,4,10,9,0,0,23,nowin,win,dlbust,bust,20,0,6,202,0.405940594,0.054455446,0.628712871,2,0.590599801
5946,23,20992,10,11,0,0,0,21,7,2,8,0,0,17,win,win,plwin,beat,25,0,21,208,0.427884615,0.0625,0.552884615,1,0.29114424
5947,115,20992,2,8,4,7,0,21,7,2,8,0,0,17,nowin,win,plwin,beat,20,0,10,194,0.427835052,0.041237113,0.592783505,2,0.583863602
5948,59,20992,11,3,7,0,0,21,7,2,8,0,0,17,nowin,win,plwin,beat,20,0,14,228,0.429824561,0.048245614,0.543859649,1,0.287885446
5949,97,20992,9,10,0,0,0,19,7,2,8,0,0,17,nowin,win,plwin,beat,20,0,19,182,0.450549451,0.06043956,0.692307692,2,0.677372279
5950,3,20992,4,10,0,10,0,24,7,2,8,0,0,17,nowin,loss,bust,plbust,0,10,14,190,0.431578947,0.026315789,0.542105263,1,0.288076384
5951,148,20992,7,5,0,8,0,20,7,2,8,0,0,17,nowin,win,plwin,beat,20,0,12,204,0.401960784,0.078431373,0.593137255,0,0.029789521
5952,10,20993,10,10,0,0,0,20,10,9,0,0,0,19,nowin,win,plwin,beat,20,0,20,191,0.413612565,0.057591623,0.596858639,2,0.574087175
5953,16,20993,10,10,0,0,0,20,10,9,0,0,0,19,nowin,win,plwin,beat,20,0,20,220,0.427272727,0.081818182,0.6,2,0.588660176
5954,20,20993,8,10,0,0,0,18,10,9,0,0,0,19,nowin,loss,beat,dlwin,0,10,18,186,0.456989247,0.037634409,0.537634409,1,0.301097108
5955,135,20993,2,10,0,6,0,18,10,9,0,0,0,19,nowin,loss,beat,dlwin,0,10,12,179,0.391061453,0.067039106,0.586592179,0,0.024924662
5956,113,20993,4,7,10,0,0,21,10,9,0,0,0,19,nowin,win,plwin,beat,20,0,11,199,0.407035176,0.055276382,0.668341709,2,0.620695264
5957,15,20993,6,10,0,5,0,21,10,9,0,0,0,19,nowin,win,plwin,beat,20,0,16,212,0.410377358,0.051886792,0.561320755,0,0.024517408
5958,12,20994,3,10,0,9,0,22,10,9,0,0,0,19,nowin,loss,bust,plbust,0,10,13,189,0.470899471,0.015873016,0.613756614,3,0.929171178
5959,12,20994,9,2,1,9,0,21,10,9,0,0,0,19,nowin,win,plwin,beat,20,0,11,189,0.470899471,0.015873016,0.613756614,3,0.929171178
5960,115,20994,3,4,11,0,0,18,10,9,0,0,0,19,nowin,loss,beat,dlwin,0,10,7,194,0.427835052,0.041237113,0.592783505,2,0.583863602
5961,115,20994,10,4,0,2,6,22,10,9,0,0,0,19,nowin,loss,bust,plbust,0,10,14,194,0.427835052,0.041237113,0.592783505,2,0.583863602
5962,3,20994,10,10,0,0,0,20,10,9,0,0,0,19,nowin,win,plwin,beat,20,0,20,190,0.431578947,0.026315789,0.542105263,1,0.288076384
5963,49,20994,9,8,0,0,0,17,10,9,0,0,0,19,nowin,loss,beat,dlwin,0,10,17,207,0.396135266,0.053140097,0.594202899,0,0.028306925
5964,73,20995,10,7,0,0,0,17,11,10,0,0,0,21,nowin,loss,beat,dlwin,0,10,17,181,0.375690608,0.011049724,0.596685083,0,0.022795773
5965,133,20995,10,11,0,0,0,21,11,10,0,0,0,21,win,push,push,push,10,0,21,201,0.47761194,0.064676617,0.611940299,3,0.935428111
5966,15,20995,5,2,2,7,8,24,11,10,0,0,0,21,nowin,loss,bust,plbust,0,10,7,212,0.410377358,0.051886792,0.561320755,0,0.024517408
5967,5,20995,5,9,0,6,0,20,11,10,0,0,0,21,nowin,loss,beat,dlwin,0,10,14,203,0.42364532,0.02955665,0.596059113,2,0.582508076
5968,13,20995,5,9,0,3,0,17,11,10,0,0,0,21,nowin,loss,beat,dlwin,0,10,14,206,0.417475728,0.063106796,0.621359223,2,0.59555479
5969,111,20995,6,3,5,7,0,21,11,10,0,0,0,21,nowin,push,push,push,10,0,9,180,0.433333333,0.055555556,0.611111111,2,0.602264492
5970,60,20996,7,9,0,0,0,16,2,9,9,0,0,20,nowin,loss,beat,dlwin,0,10,16,227,0.418502203,0.022026432,0.559471366,0,0.026496258
5971,127,20996,10,9,0,0,0,19,2,9,9,0,0,20,nowin,loss,beat,dlwin,0,10,19,201,0.402985075,0.029850746,0.60199005,0,0.032263937
5972,132,20996,9,6,0,0,0,15,2,9,9,0,0,20,nowin,loss,beat,dlwin,0,10,15,194,0.412371134,0.036082474,0.649484536,2,0.611633238
5973,63,20996,2,8,4,0,0,14,2,9,9,0,0,20,nowin,loss,beat,dlwin,0,10,10,216,0.467592593,0.037037037,0.62037037,3,0.931690496
5974,140,20996,1,3,10,0,0,14,2,9,9,0,0,20,nowin,loss,beat,dlwin,0,10,4,210,0.466666667,0.023809524,0.604761905,3,0.915293335
5975,37,20996,3,6,3,5,0,17,2,9,9,0,0,20,nowin,loss,beat,dlwin,0,10,9,208,0.394230769,0.038461538,0.581730769,0,0.024682772
5976,84,20997,4,3,9,0,0,16,5,4,10,0,0,19,nowin,loss,beat,dlwin,0,10,7,195,0.379487179,0.056410256,0.569230769,0,0.017209119
5977,146,20997,9,11,0,0,0,20,5,4,10,0,0,19,nowin,win,plwin,beat,20,0,20,221,0.43438914,0.040723982,0.542986425,1,0.290190091
5978,140,20997,4,4,2,2,0,12,5,4,10,0,0,19,nowin,loss,beat,dlwin,0,10,8,210,0.466666667,0.023809524,0.604761905,3,0.915293335
5979,82,20997,9,5,0,0,0,14,5,4,10,0,0,19,nowin,loss,beat,dlwin,0,10,14,225,0.408888889,0.075555556,0.577777778,0,0.028101874
5980,112,20997,10,10,0,0,0,20,5,4,10,0,0,19,nowin,win,plwin,beat,20,0,20,203,0.448275862,0.054187192,0.600985222,3,0.889576933
5981,30,20997,1,6,6,0,0,13,5,4,10,0,0,19,nowin,loss,beat,dlwin,0,10,7,206,0.393203883,0.033980583,0.601941748,0,0.029324648
5982,37,20998,10,4,0,10,0,24,7,10,0,0,0,17,nowin,loss,bust,plbust,0,10,14,208,0.394230769,0.038461538,0.581730769,0,0.024682772
5983,109,20998,11,9,0,0,0,20,7,10,0,0,0,17,nowin,win,plwin,beat,20,0,20,221,0.461538462,0.058823529,0.597285068,3,0.901830309
5984,13,20998,10,10,0,0,0,20,7,10,0,0,0,17,nowin,win,plwin,beat,20,0,20,206,0.417475728,0.063106796,0.621359223,2,0.59555479
5985,86,20998,10,10,0,0,0,20,7,10,0,0,0,17,nowin,win,plwin,beat,20,0,20,196,0.454081633,0.040816327,0.591836735,3,0.887566443
5986,142,20998,11,10,0,0,0,21,7,10,0,0,0,17,win,win,plwin,beat,25,0,21,211,0.417061611,0.047393365,0.526066351,1,0.271531309
5987,115,20998,3,6,10,0,0,19,7,10,0,0,0,17,nowin,win,plwin,beat,20,0,9,194,0.427835052,0.041237113,0.592783505,2,0.583863602
5988,142,20999,10,6,0,0,0,16,2,5,2,9,0,18,nowin,loss,beat,dlwin,0,10,16,211,0.417061611,0.047393365,0.526066351,1,0.271531309
5989,115,20999,4,1,7,10,0,22,2,5,2,9,0,18,nowin,loss,bust,plbust,0,10,5,194,0.427835052,0.041237113,0.592783505,2,0.583863602
5990,8,20999,10,5,0,0,0,15,2,5,2,9,0,18,nowin,loss,beat,dlwin,0,10,15,181,0.44198895,0.071823204,0.596685083,2,0.599438402
5991,144,20999,4,10,0,0,0,14,2,5,2,9,0,18,nowin,loss,beat,dlwin,0,10,14,202,0.386138614,0.054455446,0.564356436,0,0.018006244
5992,141,20999,2,7,6,0,0,15,2,5,2,9,0,18,nowin,loss,beat,dlwin,0,10,9,202,0.420792079,0.074257426,0.564356436,0,0.028377851
5993,82,20999,6,11,1,0,0,18,2,5,2,9,0,18,nowin,push,push,push,10,0,17,225,0.408888889,0.075555556,0.577777778,0,0.028101874
5994,65,21000,2,10,0,10,0,22,10,8,0,0,0,18,nowin,loss,bust,plbust,0,10,12,203,0.492610837,0.054187192,0.571428571,3,0.913702814
5995,103,21000,3,5,8,10,0,26,10,8,0,0,0,18,nowin,loss,bust,plbust,0,10,8,203,0.379310345,0.064039409,0.551724138,0,0.012869209
5996,143,21000,3,7,9,0,0,19,10,8,0,0,0,18,nowin,win,plwin,beat,20,0,10,203,0.463054187,0.044334975,0.57635468,3,0.883143365
5997,76,21000,10,11,0,0,0,21,10,8,0,0,0,18,win,win,plwin,beat,25,0,21,189,0.534391534,0.079365079,0.608465608,3,1
5998,102,21000,11,8,0,0,0,19,10,8,0,0,0,18,nowin,win,plwin,beat,20,0,19,192,0.338541667,0.046875,0.5625,0,0.003306118
5999,117,21000,5,2,4,10,0,21,10,8,0,0,0,18,nowin,win,plwin,beat,20,0,7,173,0.410404624,0.069364162,0.606936416,2,0.578610282
6000,139,21001,9,10,0,0,0,19,2,3,11,7,0,23,nowin,win,dlbust,bust,20,0,19,192,0.380208333,0.036458333,0.59375,0,0.023429169
6001,67,21001,11,2,8,0,0,21,2,3,11,7,0,23,nowin,win,dlbust,bust,20,0,13,195,0.369230769,0.041025641,0.569230769,0,0.014139427
6002,149,21001,7,10,0,0,0,17,2,3,11,7,0,23,nowin,win,dlbust,bust,20,0,17,225,0.457777778,0.057777778,0.648888889,2,0.651965595
6003,74,21001,9,4,0,0,0,13,2,3,11,7,0,23,nowin,win,dlbust,bust,20,0,13,209,0.411483254,0.04784689,0.531100478,0,0.017448125
6004,11,21001,10,5,0,0,0,15,2,3,11,7,0,23,nowin,win,dlbust,bust,20,0,15,236,0.457627119,0.016949153,0.588983051,3,0.889015813
6005,110,21001,10,10,0,0,0,20,2,3,11,7,0,23,nowin,win,dlbust,bust,20,0,20,192,0.416666667,0.046875,0.557291667,0,0.025413132
6006,133,21002,10,2,0,6,0,18,8,7,10,0,0,25,nowin,win,dlbust,bust,20,0,12,201,0.47761194,0.064676617,0.611940299,3,0.935428111
6007,61,21002,6,9,0,10,0,25,8,7,10,0,0,25,nowin,loss,bust,plbust,0,10,15,194,0.427835052,0.077319588,0.603092784,2,0.591437139
6008,134,21002,1,3,10,10,0,24,8,7,10,0,0,25,nowin,loss,bust,plbust,0,10,4,185,0.443243243,0.021621622,0.545945946,1,0.296939509
6009,37,21002,7,10,0,0,0,17,8,7,10,0,0,25,nowin,win,dlbust,bust,20,0,17,208,0.394230769,0.038461538,0.581730769,0,0.024682772
6010,101,21002,10,2,0,8,0,20,8,7,10,0,0,25,nowin,win,dlbust,bust,20,0,12,205,0.424390244,0.068292683,0.63902439,2,0.614740646
6011,30,21002,3,9,0,4,10,26,8,7,10,0,0,25,nowin,loss,bust,plbust,0,10,12,206,0.393203883,0.033980583,0.601941748,0,0.029324648
6012,105,21003,5,4,2,9,0,20,10,5,1,5,0,21,nowin,loss,beat,dlwin,0,10,9,198,0.414141414,0.070707071,0.590909091,0,0.032889494
6013,26,21003,3,1,10,5,0,19,10,5,1,5,0,21,nowin,loss,beat,dlwin,0,10,4,203,0.463054187,0.0591133,0.541871921,1,0.306802864
6014,98,21003,8,3,2,6,0,19,10,5,1,5,0,21,nowin,loss,beat,dlwin,0,10,11,220,0.422727273,0.054545455,0.55,1,0.28664435
6015,4,21003,4,10,0,2,3,19,10,5,1,5,0,21,nowin,loss,beat,dlwin,0,10,14,217,0.460829493,0.036866359,0.562211982,1,0.315432839
6016,36,21003,10,5,0,2,0,17,10,5,1,5,0,21,nowin,loss,beat,dlwin,0,10,15,229,0.445414847,0.056768559,0.655021834,2,0.645370571
6017,105,21003,3,10,0,10,0,23,10,5,1,5,0,21,nowin,loss,bust,plbust,0,10,13,198,0.414141414,0.070707071,0.590909091,0,0.032889494
6018,100,21004,10,2,0,1,9,22,10,10,0,0,0,20,nowin,loss,bust,plbust,0,10,12,190,0.452631579,0.036842105,0.594736842,3,0.888671154
6019,30,21004,2,10,0,1,6,19,10,10,0,0,0,20,nowin,loss,beat,dlwin,0,10,12,206,0.393203883,0.033980583,0.601941748,0,0.029324648
6020,123,21004,10,10,0,0,0,20,10,10,0,0,0,20,nowin,push,push,push,10,0,20,205,0.43902439,0.034146341,0.614634146,2,0.609962544
6021,84,21004,10,9,0,0,0,19,10,10,0,0,0,20,nowin,loss,beat,dlwin,0,10,19,195,0.379487179,0.056410256,0.569230769,0,0.017209119
6022,83,21004,9,10,0,0,0,19,10,10,0,0,0,20,nowin,loss,beat,dlwin,0,10,19,193,0.424870466,0.051813472,0.678756477,2,0.644360335
6023,13,21004,2,8,6,3,0,19,10,10,0,0,0,20,nowin,loss,beat,dlwin,0,10,10,206,0.417475728,0.063106796,0.621359223,2,0.59555479
6024,120,21005,10,5,0,0,0,15,3,5,10,0,0,18,nowin,loss,beat,dlwin,0,10,15,202,0.440594059,0.034653465,0.618811881,2,0.614441029
6025,26,21005,2,10,0,8,0,20,3,5,10,0,0,18,nowin,win,plwin,beat,20,0,12,203,0.463054187,0.0591133,0.541871921,1,0.306802864
6026,118,21005,10,10,0,0,0,20,3,5,10,0,0,18,nowin,win,plwin,beat,20,0,20,216,0.393518519,0.037037037,0.555555556,0,0.018059873
6027,11,21005,5,2,10,0,0,17,3,5,10,0,0,18,nowin,loss,beat,dlwin,0,10,7,236,0.457627119,0.016949153,0.588983051,3,0.889015813
6028,73,21005,11,10,0,0,0,21,3,5,10,0,0,18,win,win,plwin,beat,25,0,21,181,0.375690608,0.011049724,0.596685083,0,0.022795773
6029,115,21005,4,7,6,0,0,17,3,5,10,0,0,18,nowin,loss,beat,dlwin,0,10,11,194,0.427835052,0.041237113,0.592783505,2,0.583863602
6030,139,21006,4,7,2,7,0,20,10,5,10,0,0,25,nowin,win,dlbust,bust,20,0,11,192,0.380208333,0.036458333,0.59375,0,0.023429169
6031,112,21006,2,2,11,10,0,25,10,5,10,0,0,25,nowin,loss,bust,plbust,0,10,4,203,0.448275862,0.054187192,0.600985222,3,0.889576933
6032,120,21006,8,10,0,0,0,18,10,5,10,0,0,25,nowin,win,dlbust,bust,20,0,18,202,0.440594059,0.034653465,0.618811881,2,0.614441029
6033,85,21006,10,10,0,0,0,20,10,5,10,0,0,25,nowin,win,dlbust,bust,20,0,20,195,0.41025641,0.066666667,0.594871795,0,0.03269711
6034,148,21006,5,5,9,0,0,19,10,5,10,0,0,25,nowin,win,dlbust,bust,20,0,10,204,0.401960784,0.078431373,0.593137255,0,0.029789521
6035,141,21006,5,10,0,10,0,25,10,5,10,0,0,25,nowin,loss,bust,plbust,0,10,15,202,0.420792079,0.074257426,0.564356436,0,0.028377851
6036,19,21007,2,5,10,0,0,17,10,8,0,0,0,18,nowin,loss,beat,dlwin,0,10,7,237,0.41350211,0.054852321,0.628691983,2,0.597373826
6037,25,21007,2,4,8,6,0,20,10,8,0,0,0,18,nowin,win,plwin,beat,20,0,6,190,0.463157895,0.063157895,0.536842105,1,0.304401563
6038,70,21007,10,10,0,0,0,20,10,8,0,0,0,18,nowin,win,plwin,beat,20,0,20,228,0.385964912,0.039473684,0.557017544,0,0.016157125
6039,11,21007,10,6,0,3,0,19,10,8,0,0,0,18,nowin,win,plwin,beat,20,0,16,236,0.457627119,0.016949153,0.588983051,3,0.889015813
6040,47,21007,8,6,0,9,0,23,10,8,0,0,0,18,nowin,loss,bust,plbust,0,10,14,210,0.438095238,0.057142857,0.623809524,2,0.615868808
6041,9,21007,11,6,1,0,0,18,10,8,0,0,0,18,nowin,push,push,push,10,0,17,194,0.37628866,0.015463918,0.541237113,0,0.009396796
6042,65,21008,10,7,0,0,0,17,10,8,0,0,0,18,nowin,loss,beat,dlwin,0,10,17,203,0.492610837,0.054187192,0.571428571,3,0.913702814
6043,104,21008,10,2,0,7,0,19,10,8,0,0,0,18,nowin,win,plwin,beat,20,0,12,209,0.363636364,0.052631579,0.593301435,0,0.018359419
6044,8,21008,10,6,0,10,0,26,10,8,0,0,0,18,nowin,loss,bust,plbust,0,10,16,181,0.44198895,0.071823204,0.596685083,2,0.599438402
6045,147,21008,10,9,0,0,0,19,10,8,0,0,0,18,nowin,win,plwin,beat,20,0,19,205,0.380487805,0.014634146,0.536585366,0,0.00951447
6046,10,21008,10,10,0,0,0,20,10,8,0,0,0,18,nowin,win,plwin,beat,20,0,20,191,0.413612565,0.057591623,0.596858639,2,0.574087175
6047,75,21008,6,9,0,8,0,23,10,8,0,0,0,18,nowin,loss,bust,plbust,0,10,15,191,0.418848168,0.052356021,0.570680628,0,0.029344702
6048,85,21009,10,10,0,0,0,20,6,7,10,0,0,23,nowin,win,dlbust,bust,20,0,20,195,0.41025641,0.066666667,0.594871795,0,0.03269711
6049,136,21009,10,10,0,0,0,20,6,7,10,0,0,23,nowin,win,dlbust,bust,20,0,20,194,0.396907216,0.025773196,0.597938144,0,0.029452644
6050,76,21009,10,8,0,0,0,18,6,7,10,0,0,23,nowin,win,dlbust,bust,20,0,18,189,0.534391534,0.079365079,0.608465608,3,1
6051,126,21009,2,4,10,0,0,16,6,7,10,0,0,23,nowin,win,dlbust,bust,20,0,6,188,0.457446809,0.074468085,0.60106383,3,0.900633203
6052,89,21009,10,7,0,0,0,17,6,7,10,0,0,23,nowin,win,dlbust,bust,20,0,17,212,0.537735849,0.047169811,0.594339623,3,0.990167191
6053,36,21009,7,11,0,0,0,18,6,7,10,0,0,23,nowin,win,dlbust,bust,20,0,18,229,0.445414847,0.056768559,0.655021834,2,0.645370571
6054,64,21010,9,7,0,5,0,21,10,7,0,0,0,17,nowin,win,plwin,beat,20,0,16,187,0.363636364,0.048128342,0.631016043,0,0.027594885
6055,130,21010,10,5,0,4,0,19,10,7,0,0,0,17,nowin,win,plwin,beat,20,0,15,219,0.410958904,0.03652968,0.566210046,0,0.025888739
6056,127,21010,3,9,0,2,6,20,10,7,0,0,0,17,nowin,win,plwin,beat,20,0,12,201,0.402985075,0.029850746,0.60199005,0,0.032263937
6057,36,21010,3,8,10,0,0,21,10,7,0,0,0,17,nowin,win,plwin,beat,20,0,11,229,0.445414847,0.056768559,0.655021834,2,0.645370571
6058,41,21010,10,5,0,3,0,18,10,7,0,0,0,17,nowin,win,plwin,beat,20,0,15,192,0.364583333,0.036458333,0.520833333,0,0.00089702
6059,64,21010,7,10,0,0,0,17,10,7,0,0,0,17,nowin,push,push,push,10,0,17,187,0.363636364,0.048128342,0.631016043,0,0.027594885
6060,64,21011,10,6,0,0,0,16,5,10,5,0,0,20,nowin,loss,beat,dlwin,0,10,16,187,0.363636364,0.048128342,0.631016043,0,0.027594885
6061,32,21011,4,9,0,0,0,13,5,10,5,0,0,20,nowin,loss,beat,dlwin,0,10,13,189,0.391534392,0.037037037,0.53968254,0,0.013579086
6062,49,21011,3,6,8,0,0,17,5,10,5,0,0,20,nowin,loss,beat,dlwin,0,10,9,207,0.396135266,0.053140097,0.594202899,0,0.028306925
6063,109,21011,10,11,0,0,0,21,5,10,5,0,0,20,win,win,plwin,beat,25,0,21,221,0.461538462,0.058823529,0.597285068,3,0.901830309
6064,124,21011,10,9,0,0,0,19,5,10,5,0,0,20,nowin,loss,beat,dlwin,0,10,19,202,0.47029703,0.064356436,0.584158416,3,0.899458193
6065,19,21011,7,3,6,0,0,16,5,10,5,0,0,20,nowin,loss,beat,dlwin,0,10,10,237,0.41350211,0.054852321,0.628691983,2,0.597373826
6066,92,21012,1,5,7,0,0,13,5,4,3,10,0,22,nowin,win,dlbust,bust,20,0,6,186,0.446236559,0.059139785,0.564516129,1,0.307826125
6067,132,21012,11,10,0,0,0,21,5,4,3,10,0,22,win,win,dlbust,bust,25,0,21,194,0.412371134,0.036082474,0.649484536,2,0.611633238
6068,129,21012,2,10,0,0,0,12,5,4,3,10,0,22,nowin,win,dlbust,bust,20,0,12,201,0.422885572,0.064676617,0.55721393,0,0.027255383
6069,6,21012,10,3,0,0,0,13,5,4,3,10,0,22,nowin,win,dlbust,bust,20,0,13,191,0.439790576,0.047120419,0.581151832,1,0.31211505
6070,139,21012,7,9,0,0,0,16,5,4,3,10,0,22,nowin,win,dlbust,bust,20,0,16,192,0.380208333,0.036458333,0.59375,0,0.023429169
6071,16,21012,10,3,0,0,0,13,5,4,3,10,0,22,nowin,win,dlbust,bust,20,0,13,220,0.427272727,0.081818182,0.6,2,0.588660176
6072,45,21013,8,7,0,8,0,23,11,10,0,0,0,21,nowin,loss,bust,plbust,0,10,15,196,0.428571429,0.051020408,0.612244898,2,0.598821767
6073,76,21013,10,3,0,7,0,20,11,10,0,0,0,21,nowin,loss,beat,dlwin,0,10,13,189,0.534391534,0.079365079,0.608465608,3,1
6074,150,21013,3,4,10,0,0,17,11,10,0,0,0,21,nowin,loss,beat,dlwin,0,10,7,192,0.401041667,0.036458333,0.567708333,0,0.023287458
6075,109,21013,4,6,11,0,0,21,11,10,0,0,0,21,nowin,push,push,push,10,0,10,221,0.461538462,0.058823529,0.597285068,3,0.901830309
6076,14,21013,10,10,0,0,0,20,11,10,0,0,0,21,nowin,loss,beat,dlwin,0,10,20,202,0.391089109,0.01980198,0.628712871,2,0.577264877
6077,119,21013,10,10,0,0,0,20,11,10,0,0,0,21,nowin,loss,beat,dlwin,0,10,20,190,0.405263158,0.068421053,0.515789474,0,0.011837158
6078,126,21014,7,10,0,0,0,17,9,11,0,0,0,20,nowin,loss,beat,dlwin,0,10,17,188,0.457446809,0.074468085,0.60106383,3,0.900633203
6079,73,21014,5,5,10,0,0,20,9,11,0,0,0,20,nowin,push,push,push,10,0,10,181,0.375690608,0.011049724,0.596685083,0,0.022795773
6080,96,21014,4,4,3,10,0,21,9,11,0,0,0,20,nowin,win,plwin,beat,20,0,8,190,0.468421053,0.057894737,0.584210526,3,0.897263354
6081,82,21014,7,4,10,0,0,21,9,11,0,0,0,20,nowin,win,plwin,beat,20,0,11,225,0.408888889,0.075555556,0.577777778,0,0.028101874
6082,93,21014,8,3,4,10,0,25,9,11,0,0,0,20,nowin,loss,bust,plbust,0,10,11,175,0.485714286,0.051428571,0.548571429,1,0.323648091
6083,83,21014,10,10,0,0,0,20,9,11,0,0,0,20,nowin,push,push,push,10,0,20,193,0.424870466,0.051813472,0.678756477,2,0.644360335
6084,35,21015,4,5,8,0,0,17,10,7,0,0,0,17,nowin,push,push,push,10,0,9,202,0.410891089,0.044554455,0.633663366,2,0.598681573
6085,7,21015,5,1,10,10,0,26,10,7,0,0,0,17,nowin,loss,bust,plbust,0,10,6,183,0.442622951,0.06010929,0.62295082,2,0.619303341
6086,56,21015,7,10,0,0,0,17,10,7,0,0,0,17,nowin,push,push,push,10,0,17,175,0.4,0.057142857,0.582857143,0,0.026685297
6087,4,21015,6,5,6,0,0,17,10,7,0,0,0,17,nowin,push,push,push,10,0,11,217,0.460829493,0.036866359,0.562211982,1,0.315432839
6088,60,21015,6,6,0,4,4,20,10,7,0,0,0,17,nowin,win,plwin,beat,20,0,12,227,0.418502203,0.022026432,0.559471366,0,0.026496258
6089,145,21015,9,10,0,0,0,19,10,7,0,0,0,17,nowin,win,plwin,beat,20,0,19,188,0.441489362,0.031914894,0.622340426,2,0.617837093
6090,104,21016,11,1,6,0,0,18,6,6,7,0,0,19,nowin,loss,beat,dlwin,0,10,12,209,0.363636364,0.052631579,0.593301435,0,0.018359419
6091,85,21016,6,2,5,0,0,13,6,6,7,0,0,19,nowin,loss,beat,dlwin,0,10,8,195,0.41025641,0.066666667,0.594871795,0,0.03269711
6092,10,21016,9,3,0,0,0,12,6,6,7,0,0,19,nowin,loss,beat,dlwin,0,10,12,191,0.413612565,0.057591623,0.596858639,2,0.574087175
6093,105,21016,5,3,7,0,0,15,6,6,7,0,0,19,nowin,loss,beat,dlwin,0,10,8,198,0.414141414,0.070707071,0.590909091,0,0.032889494
6094,62,21016,3,2,10,0,0,15,6,6,7,0,0,19,nowin,loss,beat,dlwin,0,10,5,178,0.370786517,0.028089888,0.54494382,0,0.008657722
6095,57,21016,7,10,0,0,0,17,6,6,7,0,0,19,nowin,loss,beat,dlwin,0,10,17,192,0.46875,0.052083333,0.59375,3,0.907001181
6096,132,21017,6,7,0,6,0,19,11,10,0,0,0,21,nowin,loss,beat,dlwin,0,10,13,194,0.412371134,0.036082474,0.649484536,2,0.611633238
6097,54,21017,10,10,0,0,0,20,11,10,0,0,0,21,nowin,loss,beat,dlwin,0,10,20,185,0.437837838,0.032432432,0.556756757,1,0.29899854
6098,113,21017,4,5,11,0,0,20,11,10,0,0,0,21,nowin,loss,beat,dlwin,0,10,9,199,0.407035176,0.055276382,0.668341709,2,0.620695264
6099,121,21017,4,6,5,2,0,17,11,10,0,0,0,21,nowin,loss,beat,dlwin,0,10,10,195,0.456410256,0.025641026,0.512820513,1,0.288597791
6100,23,21017,9,4,0,7,0,20,11,10,0,0,0,21,nowin,loss,beat,dlwin,0,10,13,208,0.427884615,0.0625,0.552884615,1,0.29114424
6101,74,21017,9,6,0,2,0,17,11,10,0,0,0,21,nowin,loss,beat,dlwin,0,10,15,209,0.411483254,0.04784689,0.531100478,0,0.017448125
6102,50,21018,11,1,3,3,0,18,11,10,0,0,0,21,nowin,loss,beat,dlwin,0,10,12,202,0.405940594,0.04950495,0.54950495,0,0.020296079
6103,120,21018,4,10,0,10,0,24,11,10,0,0,0,21,nowin,loss,bust,plbust,0,10,14,202,0.440594059,0.034653465,0.618811881,2,0.614441029
6104,108,21018,7,10,0,0,0,17,11,10,0,0,0,21,nowin,loss,beat,dlwin,0,10,17,193,0.435233161,0.056994819,0.559585492,1,0.298824795
6105,126,21018,8,11,0,0,0,19,11,10,0,0,0,21,nowin,loss,beat,dlwin,0,10,19,188,0.457446809,0.074468085,0.60106383,3,0.900633203
6106,128,21018,10,9,0,0,0,19,11,10,0,0,0,21,nowin,loss,beat,dlwin,0,10,19,227,0.356828194,0.052863436,0.577092511,0,0.012352564
6107,111,21018,9,8,0,0,0,17,11,10,0,0,0,21,nowin,loss,beat,dlwin,0,10,17,180,0.433333333,0.055555556,0.611111111,2,0.602264492
6108,122,21019,5,3,11,0,0,19,10,7,0,0,0,17,nowin,win,plwin,beat,20,0,8,210,0.347619048,0.052380952,0.59047619,0,0.012873677
6109,59,21019,6,10,0,7,0,23,10,7,0,0,0,17,nowin,loss,bust,plbust,0,10,16,228,0.429824561,0.048245614,0.543859649,1,0.287885446
6110,85,21019,5,5,10,0,0,20,10,7,0,0,0,17,nowin,win,plwin,beat,20,0,10,195,0.41025641,0.066666667,0.594871795,0,0.03269711
6111,102,21019,10,7,0,0,0,17,10,7,0,0,0,17,nowin,push,push,push,10,0,17,192,0.338541667,0.046875,0.5625,0,0.003306118
6112,69,21019,4,3,5,3,3,18,10,7,0,0,0,17,nowin,win,plwin,beat,20,0,7,194,0.365979381,0.030927835,0.515463918,0,0
6113,98,21019,9,10,0,0,0,19,10,7,0,0,0,17,nowin,win,plwin,beat,20,0,19,220,0.422727273,0.054545455,0.55,1,0.28664435
6114,150,21020,3,7,10,0,0,20,6,3,8,0,0,17,nowin,win,plwin,beat,20,0,10,192,0.401041667,0.036458333,0.567708333,0,0.023287458
6115,10,21020,7,10,0,0,0,17,6,3,8,0,0,17,nowin,push,push,push,10,0,17,191,0.413612565,0.057591623,0.596858639,2,0.574087175
6116,52,21020,4,9,0,0,0,13,6,3,8,0,0,17,nowin,loss,beat,dlwin,0,10,13,217,0.414746544,0.02764977,0.599078341,2,0.576736024
6117,5,21020,7,5,0,0,0,12,6,3,8,0,0,17,nowin,loss,beat,dlwin,0,10,12,203,0.42364532,0.02955665,0.596059113,2,0.582508076
6118,135,21020,8,2,7,0,0,17,6,3,8,0,0,17,nowin,push,push,push,10,0,10,179,0.391061453,0.067039106,0.586592179,0,0.024924662
6119,10,21020,10,9,0,0,0,19,6,3,8,0,0,17,nowin,win,plwin,beat,20,0,19,191,0.413612565,0.057591623,0.596858639,2,0.574087175
6120,43,21021,2,5,10,0,0,17,10,3,6,0,0,19,nowin,loss,beat,dlwin,0,10,7,192,0.40625,0.041666667,0.609375,2,0.576671372
6121,149,21021,10,10,0,0,0,20,10,3,6,0,0,19,nowin,win,plwin,beat,20,0,20,225,0.457777778,0.057777778,0.648888889,2,0.651965595
6122,150,21021,10,7,0,0,0,17,10,3,6,0,0,19,nowin,loss,beat,dlwin,0,10,17,192,0.401041667,0.036458333,0.567708333,0,0.023287458
6123,30,21021,5,4,4,7,0,20,10,3,6,0,0,19,nowin,win,plwin,beat,20,0,9,206,0.393203883,0.033980583,0.601941748,0,0.029324648
6124,133,21021,9,6,0,6,0,21,10,3,6,0,0,19,nowin,win,plwin,beat,20,0,15,201,0.47761194,0.064676617,0.611940299,3,0.935428111
6125,28,21021,6,4,10,0,0,20,10,3,6,0,0,19,nowin,win,plwin,beat,20,0,10,199,0.422110553,0.045226131,0.542713568,1,0.282706618
6126,76,21022,2,8,10,0,0,20,5,4,8,0,0,17,nowin,win,plwin,beat,20,0,10,189,0.534391534,0.079365079,0.608465608,3,1
6127,149,21022,3,2,2,2,4,13,5,4,8,0,0,17,nowin,loss,beat,dlwin,0,10,5,225,0.457777778,0.057777778,0.648888889,2,0.651965595
6128,51,21022,7,4,10,0,0,21,5,4,8,0,0,17,nowin,win,plwin,beat,20,0,11,189,0.529100529,0.068783069,0.608465608,3,0.993665715
6129,128,21022,6,10,0,0,0,16,5,4,8,0,0,17,nowin,loss,beat,dlwin,0,10,16,227,0.356828194,0.052863436,0.577092511,0,0.012352564
6130,60,21022,10,5,0,0,0,15,5,4,8,0,0,17,nowin,loss,beat,dlwin,0,10,15,227,0.418502203,0.022026432,0.559471366,0,0.026496258
6131,4,21022,5,10,0,0,0,15,5,4,8,0,0,17,nowin,loss,beat,dlwin,0,10,15,217,0.460829493,0.036866359,0.562211982,1,0.315432839
6132,43,21023,10,10,0,0,0,20,7,8,10,0,0,25,nowin,win,dlbust,bust,20,0,20,192,0.40625,0.041666667,0.609375,2,0.576671372
6133,31,21023,10,3,0,8,0,21,7,8,10,0,0,25,nowin,win,dlbust,bust,20,0,13,188,0.473404255,0.058510638,0.515957447,1,0.300306557
6134,79,21023,10,5,0,10,0,25,7,8,10,0,0,25,nowin,loss,bust,plbust,0,10,15,211,0.436018957,0.028436019,0.672985782,2,0.650131054
6135,121,21023,3,8,6,0,0,17,7,8,10,0,0,25,nowin,win,dlbust,bust,20,0,11,195,0.456410256,0.025641026,0.512820513,1,0.288597791
6136,44,21023,10,10,0,0,0,20,7,8,10,0,0,25,nowin,win,dlbust,bust,20,0,20,219,0.433789954,0.050228311,0.534246575,1,0.285551035
6137,89,21023,10,10,0,0,0,20,7,8,10,0,0,25,nowin,win,dlbust,bust,20,0,20,212,0.537735849,0.047169811,0.594339623,3,0.990167191
6138,61,21024,7,4,10,0,0,21,10,8,0,0,0,18,nowin,win,plwin,beat,20,0,11,194,0.427835052,0.077319588,0.603092784,2,0.591437139
6139,56,21024,2,10,0,6,0,18,10,8,0,0,0,18,nowin,push,push,push,10,0,12,175,0.4,0.057142857,0.582857143,0,0.026685297
6140,103,21024,10,10,0,0,0,20,10,8,0,0,0,18,nowin,win,plwin,beat,20,0,20,203,0.379310345,0.064039409,0.551724138,0,0.012869209
6141,62,21024,5,4,5,2,10,26,10,8,0,0,0,18,nowin,loss,bust,plbust,0,10,9,178,0.370786517,0.028089888,0.54494382,0,0.008657722
6142,125,21024,4,10,0,4,0,18,10,8,0,0,0,18,nowin,push,push,push,10,0,14,219,0.438356164,0.050228311,0.575342466,1,0.308411257
6143,110,21024,11,10,0,0,0,21,10,8,0,0,0,18,win,win,plwin,beat,25,0,21,192,0.416666667,0.046875,0.557291667,0,0.025413132
6144,70,21025,7,4,10,0,0,21,7,10,0,0,0,17,nowin,win,plwin,beat,20,0,11,228,0.385964912,0.039473684,0.557017544,0,0.016157125
6145,40,21025,6,2,4,1,8,21,7,10,0,0,0,17,nowin,win,plwin,beat,20,0,8,196,0.367346939,0.030612245,0.617346939,0,0.025358183
6146,148,21025,11,10,0,0,0,21,7,10,0,0,0,17,win,win,plwin,beat,25,0,21,204,0.401960784,0.078431373,0.593137255,0,0.029789521
6147,137,21025,5,10,0,7,0,22,7,10,0,0,0,17,nowin,loss,bust,plbust,0,10,15,194,0.417525773,0.046391753,0.536082474,1,0.276714602
6148,107,21025,2,8,10,0,0,20,7,10,0,0,0,17,nowin,win,plwin,beat,20,0,10,218,0.444954128,0.073394495,0.600917431,2,0.605210014
6149,124,21025,10,10,0,0,0,20,7,10,0,0,0,17,nowin,win,plwin,beat,20,0,20,202,0.47029703,0.064356436,0.584158416,3,0.899458193
6150,99,21026,11,10,0,0,0,21,7,8,8,0,0,23,win,win,dlbust,bust,25,0,21,207,0.47826087,0.062801932,0.637681159,3,0.961418446
6151,46,21026,9,10,0,0,0,19,7,8,8,0,0,23,nowin,win,dlbust,bust,20,0,19,186,0.403225806,0.048387097,0.591397849,0,0.029742194
6152,28,21026,2,4,3,6,10,25,7,8,8,0,0,23,nowin,loss,bust,plbust,0,10,6,199,0.422110553,0.045226131,0.542713568,1,0.282706618
6153,150,21026,10,9,0,0,0,19,7,8,8,0,0,23,nowin,win,dlbust,bust,20,0,19,192,0.401041667,0.036458333,0.567708333,0,0.023287458
6154,140,21026,3,5,3,1,1,13,7,8,8,0,0,23,nowin,win,dlbust,bust,20,0,8,210,0.466666667,0.023809524,0.604761905,3,0.915293335
6155,127,21026,10,10,0,0,0,20,7,8,8,0,0,23,nowin,win,dlbust,bust,20,0,20,201,0.402985075,0.029850746,0.60199005,0,0.032263937
6156,113,21027,10,11,0,0,0,21,2,6,7,6,0,21,win,push,push,push,10,0,21,199,0.407035176,0.055276382,0.668341709,2,0.620695264
6157,102,21027,7,9,0,0,0,16,2,6,7,6,0,21,nowin,loss,beat,dlwin,0,10,16,192,0.338541667,0.046875,0.5625,0,0.003306118
6158,113,21027,10,5,0,0,0,15,2,6,7,6,0,21,nowin,loss,beat,dlwin,0,10,15,199,0.407035176,0.055276382,0.668341709,2,0.620695264
6159,91,21027,9,8,0,0,0,17,2,6,7,6,0,21,nowin,loss,beat,dlwin,0,10,17,194,0.417525773,0.046391753,0.515463918,1,0.266616552
6160,23,21027,6,10,0,0,0,16,2,6,7,6,0,21,nowin,loss,beat,dlwin,0,10,16,208,0.427884615,0.0625,0.552884615,1,0.29114424
6161,74,21027,10,10,0,0,0,20,2,6,7,6,0,21,nowin,loss,beat,dlwin,0,10,20,209,0.411483254,0.04784689,0.531100478,0,0.017448125
6162,18,21028,6,10,0,0,0,16,4,9,10,0,0,23,nowin,win,dlbust,bust,20,0,16,182,0.461538462,0.043956044,0.587912088,3,0.892649374
6163,115,21028,6,7,0,0,0,13,4,9,10,0,0,23,nowin,win,dlbust,bust,20,0,13,194,0.427835052,0.041237113,0.592783505,2,0.583863602
6164,142,21028,9,11,0,0,0,20,4,9,10,0,0,23,nowin,win,dlbust,bust,20,0,20,211,0.417061611,0.047393365,0.526066351,1,0.271531309
6165,108,21028,6,1,10,0,0,17,4,9,10,0,0,23,nowin,win,dlbust,bust,20,0,7,193,0.435233161,0.056994819,0.559585492,1,0.298824795
6166,107,21028,4,10,0,0,0,14,4,9,10,0,0,23,nowin,win,dlbust,bust,20,0,14,218,0.444954128,0.073394495,0.600917431,2,0.605210014
6167,96,21028,10,4,0,0,0,14,4,9,10,0,0,23,nowin,win,dlbust,bust,20,0,14,190,0.468421053,0.057894737,0.584210526,3,0.897263354
6168,125,21029,9,11,0,0,0,20,10,3,5,0,0,18,nowin,win,plwin,beat,20,0,20,219,0.438356164,0.050228311,0.575342466,1,0.308411257
6169,72,21029,10,10,0,0,0,20,10,3,5,0,0,18,nowin,win,plwin,beat,20,0,20,185,0.394594595,0.032432432,0.508108108,0,0.006763115
6170,15,21029,8,9,0,0,0,17,10,3,5,0,0,18,nowin,loss,beat,dlwin,0,10,17,212,0.410377358,0.051886792,0.561320755,0,0.024517408
6171,137,21029,10,6,0,8,0,24,10,3,5,0,0,18,nowin,loss,bust,plbust,0,10,16,194,0.417525773,0.046391753,0.536082474,1,0.276714602
6172,128,21029,8,10,0,0,0,18,10,3,5,0,0,18,nowin,push,push,push,10,0,18,227,0.356828194,0.052863436,0.577092511,0,0.012352564
6173,127,21029,5,7,0,8,0,20,10,3,5,0,0,18,nowin,win,plwin,beat,20,0,12,201,0.402985075,0.029850746,0.60199005,0,0.032263937
6174,1,21030,2,8,4,6,0,20,7,7,2,10,0,26,nowin,win,dlbust,bust,20,0,10,197,0.406091371,0.025380711,0.649746193,2,0.606186955
6175,72,21030,6,9,0,1,5,21,7,7,2,10,0,26,nowin,win,dlbust,bust,20,0,15,185,0.394594595,0.032432432,0.508108108,0,0.006763115
6176,75,21030,10,8,0,0,0,18,7,7,2,10,0,26,nowin,win,dlbust,bust,20,0,18,191,0.418848168,0.052356021,0.570680628,0,0.029344702
6177,128,21030,10,5,0,9,0,24,7,7,2,10,0,26,nowin,loss,bust,plbust,0,10,15,227,0.356828194,0.052863436,0.577092511,0,0.012352564
6178,101,21030,2,10,0,3,8,23,7,7,2,10,0,26,nowin,loss,bust,plbust,0,10,12,205,0.424390244,0.068292683,0.63902439,2,0.614740646
6179,62,21030,11,4,2,0,0,17,7,7,2,10,0,26,nowin,win,dlbust,bust,20,0,15,178,0.370786517,0.028089888,0.54494382,0,0.008657722
6180,113,21031,8,10,0,0,0,18,3,10,10,0,0,23,nowin,win,dlbust,bust,20,0,18,199,0.407035176,0.055276382,0.668341709,2,0.620695264
6181,26,21031,10,11,0,0,0,21,3,10,10,0,0,23,win,win,dlbust,bust,25,0,21,203,0.463054187,0.0591133,0.541871921,1,0.306802864
6182,52,21031,9,9,0,0,0,18,3,10,10,0,0,23,nowin,win,dlbust,bust,20,0,18,217,0.414746544,0.02764977,0.599078341,2,0.576736024
6183,117,21031,6,10,0,0,0,16,3,10,10,0,0,23,nowin,win,dlbust,bust,20,0,16,173,0.410404624,0.069364162,0.606936416,2,0.578610282
6184,27,21031,3,11,3,0,0,17,3,10,10,0,0,23,nowin,win,dlbust,bust,20,0,14,178,0.370786517,0.016853933,0.573033708,0,0.015536309
6185,33,21031,3,6,4,0,0,13,3,10,10,0,0,23,nowin,win,dlbust,bust,20,0,9,192,0.4375,0.057291667,0.625,2,0.616208916
6186,89,21032,3,7,2,10,0,22,8,4,9,0,0,21,nowin,loss,bust,plbust,0,10,10,212,0.537735849,0.047169811,0.594339623,3,0.990167191
6187,7,21032,10,5,0,7,0,22,8,4,9,0,0,21,nowin,loss,bust,plbust,0,10,15,183,0.442622951,0.06010929,0.62295082,2,0.619303341
6188,136,21032,6,7,0,8,0,21,8,4,9,0,0,21,nowin,push,push,push,10,0,13,194,0.396907216,0.025773196,0.597938144,0,0.029452644
6189,14,21032,4,9,0,10,0,23,8,4,9,0,0,21,nowin,loss,bust,plbust,0,10,13,202,0.391089109,0.01980198,0.628712871,2,0.577264877
6190,75,21032,3,10,0,3,5,21,8,4,9,0,0,21,nowin,push,push,push,10,0,13,191,0.418848168,0.052356021,0.570680628,0,0.029344702
6191,117,21032,6,1,8,9,0,24,8,4,9,0,0,21,nowin,loss,bust,plbust,0,10,7,173,0.410404624,0.069364162,0.606936416,2,0.578610282
6192,55,21033,4,11,6,0,0,21,8,5,10,0,0,23,nowin,win,dlbust,bust,20,0,15,191,0.371727749,0.057591623,0.54973822,0,0.01011347
6193,130,21033,2,9,2,7,0,20,8,5,10,0,0,23,nowin,win,dlbust,bust,20,0,11,219,0.410958904,0.03652968,0.566210046,0,0.025888739
6194,33,21033,10,11,0,0,0,21,8,5,10,0,0,23,win,win,dlbust,bust,25,0,21,192,0.4375,0.057291667,0.625,2,0.616208916
6195,146,21033,7,10,0,0,0,17,8,5,10,0,0,23,nowin,win,dlbust,bust,20,0,17,221,0.43438914,0.040723982,0.542986425,1,0.290190091
6196,148,21033,9,3,0,6,0,18,8,5,10,0,0,23,nowin,win,dlbust,bust,20,0,12,204,0.401960784,0.078431373,0.593137255,0,0.029789521
6197,85,21033,2,10,0,5,0,17,8,5,10,0,0,23,nowin,win,dlbust,bust,20,0,12,195,0.41025641,0.066666667,0.594871795,0,0.03269711
6198,29,21034,3,3,6,10,0,22,9,8,0,0,0,17,nowin,loss,bust,plbust,0,10,6,189,0.44973545,0.058201058,0.544973545,1,0.300349439
6199,91,21034,11,4,2,0,0,17,9,8,0,0,0,17,nowin,push,push,push,10,0,15,194,0.417525773,0.046391753,0.515463918,1,0.266616552
6200,16,21034,6,4,5,2,0,17,9,8,0,0,0,17,nowin,push,push,push,10,0,10,220,0.427272727,0.081818182,0.6,2,0.588660176
6201,42,21034,10,8,0,0,0,18,9,8,0,0,0,17,nowin,win,plwin,beat,20,0,18,212,0.443396226,0.051886792,0.570754717,1,0.309181312
6202,78,21034,7,5,0,10,0,22,9,8,0,0,0,17,nowin,loss,bust,plbust,0,10,12,201,0.517412935,0.034825871,0.587064677,3,0.95871112
6203,18,21034,2,8,5,8,0,23,9,8,0,0,0,17,nowin,loss,bust,plbust,0,10,10,182,0.461538462,0.043956044,0.587912088,3,0.892649374
6204,57,21035,10,4,0,0,0,14,3,7,10,0,0,20,nowin,loss,beat,dlwin,0,10,14,192,0.46875,0.052083333,0.59375,3,0.907001181
6205,61,21035,11,10,0,0,0,21,3,7,10,0,0,20,win,win,plwin,beat,25,0,21,194,0.427835052,0.077319588,0.603092784,2,0.591437139
6206,112,21035,6,8,0,0,0,14,3,7,10,0,0,20,nowin,loss,beat,dlwin,0,10,14,203,0.448275862,0.054187192,0.600985222,3,0.889576933
6207,116,21035,4,10,0,0,0,14,3,7,10,0,0,20,nowin,loss,beat,dlwin,0,10,14,195,0.425641026,0.056410256,0.538461538,1,0.28273747
6208,77,21035,10,10,0,0,0,20,3,7,10,0,0,20,nowin,push,push,push,10,0,20,200,0.455,0.04,0.62,3,0.916252116
6209,19,21035,5,1,10,0,0,16,3,7,10,0,0,20,nowin,loss,beat,dlwin,0,10,6,237,0.41350211,0.054852321,0.628691983,2,0.597373826
6210,76,21036,3,2,10,5,0,20,10,9,0,0,0,19,nowin,win,plwin,beat,20,0,5,189,0.534391534,0.079365079,0.608465608,3,1
6211,41,21036,6,10,0,1,0,17,10,9,0,0,0,19,nowin,loss,beat,dlwin,0,10,16,192,0.364583333,0.036458333,0.520833333,0,0.00089702
6212,106,21036,4,9,0,8,0,21,10,9,0,0,0,19,nowin,win,plwin,beat,20,0,13,192,0.411458333,0.026041667,0.557291667,0,0.023854304
6213,8,21036,4,11,2,0,0,17,10,9,0,0,0,19,nowin,loss,beat,dlwin,0,10,15,181,0.44198895,0.071823204,0.596685083,2,0.599438402
6214,38,21036,7,10,0,0,0,17,10,9,0,0,0,19,nowin,loss,beat,dlwin,0,10,17,202,0.361386139,0.03960396,0.564356436,0,0.010597953
6215,76,21036,10,4,0,5,0,19,10,9,0,0,0,19,nowin,push,push,push,10,0,14,189,0.534391534,0.079365079,0.608465608,3,1
6216,125,21037,9,10,0,0,0,19,6,11,0,0,0,17,nowin,win,plwin,beat,20,0,19,219,0.438356164,0.050228311,0.575342466,1,0.308411257
6217,97,21037,5,3,11,0,0,19,6,11,0,0,0,17,nowin,win,plwin,beat,20,0,8,182,0.450549451,0.06043956,0.692307692,2,0.677372279
6218,70,21037,9,10,0,0,0,19,6,11,0,0,0,17,nowin,win,plwin,beat,20,0,19,228,0.385964912,0.039473684,0.557017544,0,0.016157125
6219,66,21037,5,1,10,0,0,16,6,11,0,0,0,17,nowin,loss,beat,dlwin,0,10,6,217,0.456221198,0.064516129,0.626728111,3,0.924304367
6220,130,21037,4,8,0,0,0,12,6,11,0,0,0,17,nowin,loss,beat,dlwin,0,10,12,219,0.410958904,0.03652968,0.566210046,0,0.025888739
6221,90,21037,5,5,7,0,0,17,6,11,0,0,0,17,nowin,push,push,push,10,0,10,201,0.447761194,0.049751244,0.60199005,3,0.889945023
6222,113,21038,10,10,0,0,0,20,4,10,1,7,0,22,nowin,win,dlbust,bust,20,0,20,199,0.407035176,0.055276382,0.668341709,2,0.620695264
6223,58,21038,7,5,0,0,0,12,4,10,1,7,0,22,nowin,win,dlbust,bust,20,0,12,195,0.430769231,0.041025641,0.584615385,2,0.580497586
6224,102,21038,8,3,3,0,0,14,4,10,1,7,0,22,nowin,win,dlbust,bust,20,0,11,192,0.338541667,0.046875,0.5625,0,0.003306118
6225,101,21038,2,4,8,0,0,14,4,10,1,7,0,22,nowin,win,dlbust,bust,20,0,6,205,0.424390244,0.068292683,0.63902439,2,0.614740646
6226,58,21038,3,8,10,0,0,21,4,10,1,7,0,22,nowin,win,dlbust,bust,20,0,11,195,0.430769231,0.041025641,0.584615385,2,0.580497586
6227,55,21038,5,7,0,0,0,12,4,10,1,7,0,22,nowin,win,dlbust,bust,20,0,12,191,0.371727749,0.057591623,0.54973822,0,0.01011347
6228,104,21039,9,10,0,0,0,19,11,3,6,0,0,20,nowin,loss,beat,dlwin,0,10,19,209,0.363636364,0.052631579,0.593301435,0,0.018359419
6229,76,21039,7,11,0,0,0,18,11,3,6,0,0,20,nowin,loss,beat,dlwin,0,10,18,189,0.534391534,0.079365079,0.608465608,3,1
6230,6,21039,11,9,0,0,0,20,11,3,6,0,0,20,nowin,push,push,push,10,0,20,191,0.439790576,0.047120419,0.581151832,1,0.31211505
6231,47,21039,4,4,10,0,0,18,11,3,6,0,0,20,nowin,loss,beat,dlwin,0,10,8,210,0.438095238,0.057142857,0.623809524,2,0.615868808
6232,148,21039,10,8,0,0,0,18,11,3,6,0,0,20,nowin,loss,beat,dlwin,0,10,18,204,0.401960784,0.078431373,0.593137255,0,0.029789521
6233,145,21039,2,11,2,8,0,23,11,3,6,0,0,20,nowin,loss,bust,plbust,0,10,13,188,0.441489362,0.031914894,0.622340426,2,0.617837093
6234,50,21040,9,4,0,10,0,23,8,4,3,3,0,18,nowin,loss,bust,plbust,0,10,13,202,0.405940594,0.04950495,0.54950495,0,0.020296079
6235,92,21040,2,1,10,6,0,19,8,4,3,3,0,18,nowin,win,plwin,beat,20,0,3,186,0.446236559,0.059139785,0.564516129,1,0.307826125
6236,145,21040,10,6,0,10,0,26,8,4,3,3,0,18,nowin,loss,bust,plbust,0,10,16,188,0.441489362,0.031914894,0.622340426,2,0.617837093
6237,137,21040,7,7,0,8,0,22,8,4,3,3,0,18,nowin,loss,bust,plbust,0,10,14,194,0.417525773,0.046391753,0.536082474,1,0.276714602
6238,112,21040,5,6,5,9,0,25,8,4,3,3,0,18,nowin,loss,bust,plbust,0,10,11,203,0.448275862,0.054187192,0.600985222,3,0.889576933
6239,94,21040,2,5,11,0,0,18,8,4,3,3,0,18,nowin,push,push,push,10,0,7,183,0.43715847,0.043715847,0.540983607,1,0.290866892
6240,59,21041,9,3,0,6,0,18,9,2,2,7,0,20,nowin,loss,beat,dlwin,0,10,12,228,0.429824561,0.048245614,0.543859649,1,0.287885446
6241,76,21041,10,10,0,0,0,20,9,2,2,7,0,20,nowin,push,push,push,10,0,20,189,0.534391534,0.079365079,0.608465608,3,1
6242,97,21041,7,2,11,0,0,20,9,2,2,7,0,20,nowin,push,push,push,10,0,9,182,0.450549451,0.06043956,0.692307692,2,0.677372279
6243,98,21041,9,3,0,10,0,22,9,2,2,7,0,20,nowin,loss,bust,plbust,0,10,12,220,0.422727273,0.054545455,0.55,1,0.28664435
6244,90,21041,8,11,0,0,0,19,9,2,2,7,0,20,nowin,loss,beat,dlwin,0,10,19,201,0.447761194,0.049751244,0.60199005,3,0.889945023
6245,28,21041,10,10,0,0,0,20,9,2,2,7,0,20,nowin,push,push,push,10,0,20,199,0.422110553,0.045226131,0.542713568,1,0.282706618
6246,92,21042,3,7,10,0,0,20,3,10,7,0,0,20,nowin,push,push,push,10,0,10,186,0.446236559,0.059139785,0.564516129,1,0.307826125
6247,101,21042,10,8,0,0,0,18,3,10,7,0,0,20,nowin,loss,beat,dlwin,0,10,18,205,0.424390244,0.068292683,0.63902439,2,0.614740646
6248,93,21042,9,8,0,0,0,17,3,10,7,0,0,20,nowin,loss,beat,dlwin,0,10,17,175,0.485714286,0.051428571,0.548571429,1,0.323648091
6249,19,21042,10,4,0,0,0,14,3,10,7,0,0,20,nowin,loss,beat,dlwin,0,10,14,237,0.41350211,0.054852321,0.628691983,2,0.597373826
6250,140,21042,7,10,0,0,0,17,3,10,7,0,0,20,nowin,loss,beat,dlwin,0,10,17,210,0.466666667,0.023809524,0.604761905,3,0.915293335
6251,18,21042,10,11,0,0,0,21,3,10,7,0,0,20,win,win,plwin,beat,25,0,21,182,0.461538462,0.043956044,0.587912088,3,0.892649374
6252,48,21043,3,8,3,7,0,21,10,4,3,0,0,17,nowin,win,plwin,beat,20,0,11,203,0.413793103,0.019704433,0.600985222,2,0.577280801
6253,107,21043,10,11,0,0,0,21,10,4,3,0,0,17,win,win,plwin,beat,25,0,21,218,0.444954128,0.073394495,0.600917431,2,0.605210014
6254,102,21043,4,2,10,10,0,26,10,4,3,0,0,17,nowin,loss,bust,plbust,0,10,6,192,0.338541667,0.046875,0.5625,0,0.003306118
6255,74,21043,10,7,0,0,0,17,10,4,3,0,0,17,nowin,push,push,push,10,0,17,209,0.411483254,0.04784689,0.531100478,0,0.017448125
6256,101,21043,3,4,2,4,10,23,10,4,3,0,0,17,nowin,loss,bust,plbust,0,10,7,205,0.424390244,0.068292683,0.63902439,2,0.614740646
6257,27,21043,4,2,10,4,0,20,10,4,3,0,0,17,nowin,win,plwin,beat,20,0,6,178,0.370786517,0.016853933,0.573033708,0,0.015536309
6258,94,21044,6,10,0,0,0,16,2,7,4,3,10,26,nowin,win,dlbust,bust,20,0,16,183,0.43715847,0.043715847,0.540983607,1,0.290866892
6259,47,21044,10,10,0,0,0,20,2,7,4,3,10,26,nowin,win,dlbust,bust,20,0,20,210,0.438095238,0.057142857,0.623809524,2,0.615868808
6260,61,21044,4,10,0,0,0,14,2,7,4,3,10,26,nowin,win,dlbust,bust,20,0,14,194,0.427835052,0.077319588,0.603092784,2,0.591437139
6261,11,21044,10,10,0,0,0,20,2,7,4,3,10,26,nowin,win,dlbust,bust,20,0,20,236,0.457627119,0.016949153,0.588983051,3,0.889015813
6262,45,21044,5,10,0,0,0,15,2,7,4,3,10,26,nowin,win,dlbust,bust,20,0,15,196,0.428571429,0.051020408,0.612244898,2,0.598821767
6263,107,21044,10,10,0,0,0,20,2,7,4,3,10,26,nowin,win,dlbust,bust,20,0,20,218,0.444954128,0.073394495,0.600917431,2,0.605210014
6264,88,21045,10,4,0,1,5,20,11,6,0,0,0,17,nowin,win,plwin,beat,20,0,14,206,0.466019417,0.033980583,0.54368932,1,0.309467903
6265,96,21045,4,10,0,5,0,19,11,6,0,0,0,17,nowin,win,plwin,beat,20,0,14,190,0.468421053,0.057894737,0.584210526,3,0.897263354
6266,115,21045,8,10,0,0,0,18,11,6,0,0,0,17,nowin,win,plwin,beat,20,0,18,194,0.427835052,0.041237113,0.592783505,2,0.583863602
6267,82,21045,10,10,0,0,0,20,11,6,0,0,0,17,nowin,win,plwin,beat,20,0,20,225,0.408888889,0.075555556,0.577777778,0,0.028101874
6268,59,21045,10,10,0,0,0,20,11,6,0,0,0,17,nowin,win,plwin,beat,20,0,20,228,0.429824561,0.048245614,0.543859649,1,0.287885446
6269,28,21045,2,7,8,0,0,17,11,6,0,0,0,17,nowin,push,push,push,10,0,9,199,0.422110553,0.045226131,0.542713568,1,0.282706618
6270,132,21046,10,10,0,0,0,20,9,5,10,0,0,24,nowin,win,dlbust,bust,20,0,20,194,0.412371134,0.036082474,0.649484536,2,0.611633238
6271,22,21046,1,2,10,1,10,24,9,5,10,0,0,24,nowin,loss,bust,plbust,0,10,3,187,0.481283422,0.042780749,0.577540107,3,0.906128176
6272,43,21046,8,6,0,9,0,23,9,5,10,0,0,24,nowin,loss,bust,plbust,0,10,14,192,0.40625,0.041666667,0.609375,2,0.576671372
6273,45,21046,6,7,0,2,7,22,9,5,10,0,0,24,nowin,loss,bust,plbust,0,10,13,196,0.428571429,0.051020408,0.612244898,2,0.598821767
6274,149,21046,3,3,10,7,0,23,9,5,10,0,0,24,nowin,loss,bust,plbust,0,10,6,225,0.457777778,0.057777778,0.648888889,2,0.651965595
6275,141,21046,3,10,0,10,0,23,9,5,10,0,0,24,nowin,loss,bust,plbust,0,10,13,202,0.420792079,0.074257426,0.564356436,0,0.028377851
6276,95,21047,2,6,10,0,0,18,8,10,0,0,0,18,nowin,push,push,push,10,0,8,218,0.412844037,0.04587156,0.559633028,0,0.024842385
6277,134,21047,11,8,0,0,0,19,8,10,0,0,0,18,nowin,win,plwin,beat,20,0,19,185,0.443243243,0.021621622,0.545945946,1,0.296939509
6278,131,21047,7,5,0,2,10,24,8,10,0,0,0,18,nowin,loss,bust,plbust,0,10,12,217,0.410138249,0.069124424,0.543778802,0,0.02015021
6279,59,21047,6,3,3,1,10,23,8,10,0,0,0,18,nowin,loss,bust,plbust,0,10,9,228,0.429824561,0.048245614,0.543859649,1,0.287885446
6280,99,21047,3,7,11,0,0,21,8,10,0,0,0,18,nowin,win,plwin,beat,20,0,10,207,0.47826087,0.062801932,0.637681159,3,0.961418446
6281,124,21047,1,4,7,2,10,24,8,10,0,0,0,18,nowin,loss,bust,plbust,0,10,5,202,0.47029703,0.064356436,0.584158416,3,0.899458193
6282,12,21048,9,10,0,0,0,19,5,6,1,3,4,19,nowin,push,push,push,10,0,19,189,0.470899471,0.015873016,0.613756614,3,0.929171178
6283,148,21048,4,9,0,0,0,13,5,6,1,3,4,19,nowin,loss,beat,dlwin,0,10,13,204,0.401960784,0.078431373,0.593137255,0,0.029789521
6284,26,21048,11,10,0,0,0,21,5,6,1,3,4,19,win,win,plwin,beat,25,0,21,203,0.463054187,0.0591133,0.541871921,1,0.306802864
6285,112,21048,2,3,7,0,0,12,5,6,1,3,4,19,nowin,loss,beat,dlwin,0,10,5,203,0.448275862,0.054187192,0.600985222,3,0.889576933
6286,49,21048,8,11,0,0,0,19,5,6,1,3,4,19,nowin,push,push,push,10,0,19,207,0.396135266,0.053140097,0.594202899,0,0.028306925
6287,21,21048,8,7,0,0,0,15,5,6,1,3,4,19,nowin,loss,beat,dlwin,0,10,15,214,0.359813084,0.042056075,0.626168224,0,0.025263474
6288,17,21049,8,6,0,5,0,19,10,10,0,0,0,20,nowin,loss,beat,dlwin,0,10,14,171,0.444444444,0.070175439,0.555555556,1,0.302364894
6289,45,21049,6,7,0,5,0,18,10,10,0,0,0,20,nowin,loss,beat,dlwin,0,10,13,196,0.428571429,0.051020408,0.612244898,2,0.598821767
6290,134,21049,7,6,0,4,0,17,10,10,0,0,0,20,nowin,loss,beat,dlwin,0,10,13,185,0.443243243,0.021621622,0.545945946,1,0.296939509
6291,123,21049,2,8,8,0,0,18,10,10,0,0,0,20,nowin,loss,beat,dlwin,0,10,10,205,0.43902439,0.034146341,0.614634146,2,0.609962544
6292,75,21049,10,7,0,0,0,17,10,10,0,0,0,20,nowin,loss,beat,dlwin,0,10,17,191,0.418848168,0.052356021,0.570680628,0,0.029344702
6293,18,21049,4,2,3,3,3,15,10,10,0,0,0,20,nowin,loss,beat,dlwin,0,10,6,182,0.461538462,0.043956044,0.587912088,3,0.892649374
6294,12,21050,10,2,0,10,0,22,8,10,0,0,0,18,nowin,loss,bust,plbust,0,10,12,189,0.470899471,0.015873016,0.613756614,3,0.929171178
6295,136,21050,9,10,0,0,0,19,8,10,0,0,0,18,nowin,win,plwin,beat,20,0,19,194,0.396907216,0.025773196,0.597938144,0,0.029452644
6296,41,21050,11,8,0,0,0,19,8,10,0,0,0,18,nowin,win,plwin,beat,20,0,19,192,0.364583333,0.036458333,0.520833333,0,0.00089702
6297,15,21050,6,2,2,10,0,20,8,10,0,0,0,18,nowin,win,plwin,beat,20,0,8,212,0.410377358,0.051886792,0.561320755,0,0.024517408
6298,109,21050,10,10,0,0,0,20,8,10,0,0,0,18,nowin,win,plwin,beat,20,0,20,221,0.461538462,0.058823529,0.597285068,3,0.901830309
6299,75,21050,3,5,4,10,0,22,8,10,0,0,0,18,nowin,loss,bust,plbust,0,10,8,191,0.418848168,0.052356021,0.570680628,0,0.029344702
6300,43,21051,6,2,10,0,0,18,6,4,10,0,0,20,nowin,loss,beat,dlwin,0,10,8,192,0.40625,0.041666667,0.609375,2,0.576671372
6301,131,21051,11,10,0,0,0,21,6,4,10,0,0,20,win,win,plwin,beat,25,0,21,217,0.410138249,0.069124424,0.543778802,0,0.02015021
6302,102,21051,10,7,0,0,0,17,6,4,10,0,0,20,nowin,loss,beat,dlwin,0,10,17,192,0.338541667,0.046875,0.5625,0,0.003306118
6303,113,21051,9,3,0,0,0,12,6,4,10,0,0,20,nowin,loss,beat,dlwin,0,10,12,199,0.407035176,0.055276382,0.668341709,2,0.620695264
6304,93,21051,8,9,0,0,0,17,6,4,10,0,0,20,nowin,loss,beat,dlwin,0,10,17,175,0.485714286,0.051428571,0.548571429,1,0.323648091
6305,100,21051,11,10,0,0,0,21,6,4,10,0,0,20,win,win,plwin,beat,25,0,21,190,0.452631579,0.036842105,0.594736842,3,0.888671154
6306,21,21052,10,10,0,0,0,20,5,3,9,0,0,17,nowin,win,plwin,beat,20,0,20,214,0.359813084,0.042056075,0.626168224,0,0.025263474
6307,32,21052,3,4,9,0,0,16,5,3,9,0,0,17,nowin,loss,beat,dlwin,0,10,7,189,0.391534392,0.037037037,0.53968254,0,0.013579086
6308,48,21052,5,5,2,0,0,12,5,3,9,0,0,17,nowin,loss,beat,dlwin,0,10,10,203,0.413793103,0.019704433,0.600985222,2,0.577280801
6309,60,21052,10,10,0,0,0,20,5,3,9,0,0,17,nowin,win,plwin,beat,20,0,20,227,0.418502203,0.022026432,0.559471366,0,0.026496258
6310,147,21052,10,7,0,0,0,17,5,3,9,0,0,17,nowin,push,push,push,10,0,17,205,0.380487805,0.014634146,0.536585366,0,0.00951447
6311,149,21052,4,3,6,0,0,13,5,3,9,0,0,17,nowin,loss,beat,dlwin,0,10,7,225,0.457777778,0.057777778,0.648888889,2,0.651965595
6312,64,21053,3,2,3,9,0,17,10,10,0,0,0,20,nowin,loss,beat,dlwin,0,10,5,187,0.363636364,0.048128342,0.631016043,0,0.027594885
6313,121,21053,8,4,0,4,10,26,10,10,0,0,0,20,nowin,loss,bust,plbust,0,10,12,195,0.456410256,0.025641026,0.512820513,1,0.288597791
6314,78,21053,11,3,7,0,0,21,10,10,0,0,0,20,nowin,win,plwin,beat,20,0,14,201,0.517412935,0.034825871,0.587064677,3,0.95871112
6315,82,21053,10,11,0,0,0,21,10,10,0,0,0,20,win,win,plwin,beat,25,0,21,225,0.408888889,0.075555556,0.577777778,0,0.028101874
6316,148,21053,4,8,0,3,10,25,10,10,0,0,0,20,nowin,loss,bust,plbust,0,10,12,204,0.401960784,0.078431373,0.593137255,0,0.029789521
6317,93,21053,8,10,0,0,0,18,10,10,0,0,0,20,nowin,loss,beat,dlwin,0,10,18,175,0.485714286,0.051428571,0.548571429,1,0.323648091
6318,129,21054,10,10,0,0,0,20,4,3,5,10,0,22,nowin,win,dlbust,bust,20,0,20,201,0.422885572,0.064676617,0.55721393,0,0.027255383
6319,119,21054,4,10,0,0,0,14,4,3,5,10,0,22,nowin,win,dlbust,bust,20,0,14,190,0.405263158,0.068421053,0.515789474,0,0.011837158
6320,11,21054,8,10,0,0,0,18,4,3,5,10,0,22,nowin,win,dlbust,bust,20,0,18,236,0.457627119,0.016949153,0.588983051,3,0.889015813
6321,122,21054,10,8,0,0,0,18,4,3,5,10,0,22,nowin,win,dlbust,bust,20,0,18,210,0.347619048,0.052380952,0.59047619,0,0.012873677
6322,82,21054,3,4,4,1,0,12,4,3,5,10,0,22,nowin,win,dlbust,bust,20,0,7,225,0.408888889,0.075555556,0.577777778,0,0.028101874
6323,14,21054,9,11,0,0,0,20,4,3,5,10,0,22,nowin,win,dlbust,bust,20,0,20,202,0.391089109,0.01980198,0.628712871,2,0.577264877
6324,23,21055,7,7,0,9,0,23,11,8,0,0,0,19,nowin,loss,bust,plbust,0,10,14,208,0.427884615,0.0625,0.552884615,1,0.29114424
6325,40,21055,5,10,0,10,0,25,11,8,0,0,0,19,nowin,loss,bust,plbust,0,10,15,196,0.367346939,0.030612245,0.617346939,0,0.025358183
6326,42,21055,10,10,0,0,0,20,11,8,0,0,0,19,nowin,win,plwin,beat,20,0,20,212,0.443396226,0.051886792,0.570754717,1,0.309181312
6327,41,21055,2,2,4,3,6,17,11,8,0,0,0,19,nowin,loss,beat,dlwin,0,10,4,192,0.364583333,0.036458333,0.520833333,0,0.00089702
6328,145,21055,6,3,6,1,10,26,11,8,0,0,0,19,nowin,loss,bust,plbust,0,10,9,188,0.441489362,0.031914894,0.622340426,2,0.617837093
6329,91,21055,2,10,0,4,10,26,11,8,0,0,0,19,nowin,loss,bust,plbust,0,10,12,194,0.417525773,0.046391753,0.515463918,1,0.266616552
6330,139,21056,2,7,10,0,0,19,10,7,0,0,0,17,nowin,win,plwin,beat,20,0,9,192,0.380208333,0.036458333,0.59375,0,0.023429169
6331,77,21056,1,4,8,7,0,20,10,7,0,0,0,17,nowin,win,plwin,beat,20,0,5,200,0.455,0.04,0.62,3,0.916252116
6332,147,21056,8,10,0,0,0,18,10,7,0,0,0,17,nowin,win,plwin,beat,20,0,18,205,0.380487805,0.014634146,0.536585366,0,0.00951447
6333,93,21056,3,8,10,0,0,21,10,7,0,0,0,17,nowin,win,plwin,beat,20,0,11,175,0.485714286,0.051428571,0.548571429,1,0.323648091
6334,75,21056,2,3,10,5,0,20,10,7,0,0,0,17,nowin,win,plwin,beat,20,0,5,191,0.418848168,0.052356021,0.570680628,0,0.029344702
6335,6,21056,2,2,4,6,10,24,10,7,0,0,0,17,nowin,loss,bust,plbust,0,10,4,191,0.439790576,0.047120419,0.581151832,1,0.31211505
6336,20,21057,10,10,0,0,0,20,10,10,0,0,0,20,nowin,push,push,push,10,0,20,186,0.456989247,0.037634409,0.537634409,1,0.301097108
6337,70,21057,10,6,0,10,0,26,10,10,0,0,0,20,nowin,loss,bust,plbust,0,10,16,228,0.385964912,0.039473684,0.557017544,0,0.016157125
6338,51,21057,3,5,8,6,0,22,10,10,0,0,0,20,nowin,loss,bust,plbust,0,10,8,189,0.529100529,0.068783069,0.608465608,3,0.993665715
6339,140,21057,2,9,10,0,0,21,10,10,0,0,0,20,nowin,win,plwin,beat,20,0,11,210,0.466666667,0.023809524,0.604761905,3,0.915293335
6340,39,21057,4,10,0,10,0,24,10,10,0,0,0,20,nowin,loss,bust,plbust,0,10,14,191,0.429319372,0.062827225,0.57591623,0,0.033760763
6341,114,21057,9,10,0,0,0,19,10,10,0,0,0,20,nowin,loss,beat,dlwin,0,10,19,198,0.47979798,0.025252525,0.611111111,3,0.937232995
6342,115,21058,10,9,0,0,0,19,9,6,1,9,0,25,nowin,win,dlbust,bust,20,0,19,194,0.427835052,0.041237113,0.592783505,2,0.583863602
6343,72,21058,4,7,2,10,0,23,9,6,1,9,0,25,nowin,loss,bust,plbust,0,10,11,185,0.394594595,0.032432432,0.508108108,0,0.006763115
6344,86,21058,9,9,0,0,0,18,9,6,1,9,0,25,nowin,win,dlbust,bust,20,0,18,196,0.454081633,0.040816327,0.591836735,3,0.887566443
6345,81,21058,10,10,0,0,0,20,9,6,1,9,0,25,nowin,win,dlbust,bust,20,0,20,182,0.395604396,0.043956044,0.60989011,2,0.567491261
6346,137,21058,3,6,10,0,0,19,9,6,1,9,0,25,nowin,win,dlbust,bust,20,0,9,194,0.417525773,0.046391753,0.536082474,1,0.276714602
6347,87,21058,4,11,1,4,0,20,9,6,1,9,0,25,nowin,win,dlbust,bust,20,0,15,202,0.405940594,0.054455446,0.628712871,2,0.590599801
6348,92,21059,10,4,0,0,0,14,6,10,10,0,0,26,nowin,win,dlbust,bust,20,0,14,186,0.446236559,0.059139785,0.564516129,1,0.307826125
6349,95,21059,10,2,0,0,0,12,6,10,10,0,0,26,nowin,win,dlbust,bust,20,0,12,218,0.412844037,0.04587156,0.559633028,0,0.024842385
6350,129,21059,10,5,0,0,0,15,6,10,10,0,0,26,nowin,win,dlbust,bust,20,0,15,201,0.422885572,0.064676617,0.55721393,0,0.027255383
6351,31,21059,11,10,0,0,0,21,6,10,10,0,0,26,win,win,dlbust,bust,25,0,21,188,0.473404255,0.058510638,0.515957447,1,0.300306557
6352,19,21059,9,10,0,0,0,19,6,10,10,0,0,26,nowin,win,dlbust,bust,20,0,19,237,0.41350211,0.054852321,0.628691983,2,0.597373826
6353,87,21059,3,1,10,0,0,14,6,10,10,0,0,26,nowin,win,dlbust,bust,20,0,4,202,0.405940594,0.054455446,0.628712871,2,0.590599801
6354,26,21060,10,11,0,0,0,21,11,10,0,0,0,21,win,push,push,push,10,0,21,203,0.463054187,0.0591133,0.541871921,1,0.306802864
6355,86,21060,10,10,0,0,0,20,11,10,0,0,0,21,nowin,loss,beat,dlwin,0,10,20,196,0.454081633,0.040816327,0.591836735,3,0.887566443
6356,85,21060,6,9,0,2,0,17,11,10,0,0,0,21,nowin,loss,beat,dlwin,0,10,15,195,0.41025641,0.066666667,0.594871795,0,0.03269711
6357,42,21060,10,10,0,0,0,20,11,10,0,0,0,21,nowin,loss,beat,dlwin,0,10,20,212,0.443396226,0.051886792,0.570754717,1,0.309181312
6358,46,21060,8,10,0,0,0,18,11,10,0,0,0,21,nowin,loss,beat,dlwin,0,10,18,186,0.403225806,0.048387097,0.591397849,0,0.029742194
6359,69,21060,2,10,0,8,0,20,11,10,0,0,0,21,nowin,loss,beat,dlwin,0,10,12,194,0.365979381,0.030927835,0.515463918,0,0
6360,54,21061,4,10,0,6,0,20,9,11,0,0,0,20,nowin,push,push,push,10,0,14,185,0.437837838,0.032432432,0.556756757,1,0.29899854
6361,10,21061,8,4,0,4,5,21,9,11,0,0,0,20,nowin,win,plwin,beat,20,0,12,191,0.413612565,0.057591623,0.596858639,2,0.574087175
6362,83,21061,3,6,11,0,0,20,9,11,0,0,0,20,nowin,push,push,push,10,0,9,193,0.424870466,0.051813472,0.678756477,2,0.644360335
6363,121,21061,6,6,0,2,3,17,9,11,0,0,0,20,nowin,loss,beat,dlwin,0,10,12,195,0.456410256,0.025641026,0.512820513,1,0.288597791
6364,133,21061,10,10,0,0,0,20,9,11,0,0,0,20,nowin,push,push,push,10,0,20,201,0.47761194,0.064676617,0.611940299,3,0.935428111
6365,5,21061,3,11,7,0,0,21,9,11,0,0,0,20,nowin,win,plwin,beat,20,0,14,203,0.42364532,0.02955665,0.596059113,2,0.582508076
6366,129,21062,11,10,0,0,0,21,10,10,0,0,0,20,win,win,plwin,beat,25,0,21,201,0.422885572,0.064676617,0.55721393,0,0.027255383
6367,63,21062,6,5,1,7,0,19,10,10,0,0,0,20,nowin,loss,beat,dlwin,0,10,11,216,0.467592593,0.037037037,0.62037037,3,0.931690496
6368,149,21062,10,11,0,0,0,21,10,10,0,0,0,20,win,win,plwin,beat,25,0,21,225,0.457777778,0.057777778,0.648888889,2,0.651965595
6369,113,21062,8,10,0,0,0,18,10,10,0,0,0,20,nowin,loss,beat,dlwin,0,10,18,199,0.407035176,0.055276382,0.668341709,2,0.620695264
6370,87,21062,10,7,0,0,0,17,10,10,0,0,0,20,nowin,loss,beat,dlwin,0,10,17,202,0.405940594,0.054455446,0.628712871,2,0.590599801
6371,3,21062,9,10,0,0,0,19,10,10,0,0,0,20,nowin,loss,beat,dlwin,0,10,19,190,0.431578947,0.026315789,0.542105263,1,0.288076384
6372,147,21063,7,7,0,5,0,19,11,10,0,0,0,21,nowin,loss,beat,dlwin,0,10,14,205,0.380487805,0.014634146,0.536585366,0,0.00951447
6373,134,21063,9,10,0,0,0,19,11,10,0,0,0,21,nowin,loss,beat,dlwin,0,10,19,185,0.443243243,0.021621622,0.545945946,1,0.296939509
6374,93,21063,5,9,0,6,0,20,11,10,0,0,0,21,nowin,loss,beat,dlwin,0,10,14,175,0.485714286,0.051428571,0.548571429,1,0.323648091
6375,20,21063,10,6,0,3,0,19,11,10,0,0,0,21,nowin,loss,beat,dlwin,0,10,16,186,0.456989247,0.037634409,0.537634409,1,0.301097108
6376,48,21063,4,6,10,0,0,20,11,10,0,0,0,21,nowin,loss,beat,dlwin,0,10,10,203,0.413793103,0.019704433,0.600985222,2,0.577280801
6377,67,21063,6,10,0,5,0,21,11,10,0,0,0,21,nowin,push,push,push,10,0,16,195,0.369230769,0.041025641,0.569230769,0,0.014139427
6378,56,21064,9,4,0,1,9,23,10,2,1,9,0,22,nowin,loss,bust,plbust,0,10,13,175,0.4,0.057142857,0.582857143,0,0.026685297
6379,30,21064,3,10,0,5,0,18,10,2,1,9,0,22,nowin,win,dlbust,bust,20,0,13,206,0.393203883,0.033980583,0.601941748,0,0.029324648
6380,35,21064,5,10,0,5,0,20,10,2,1,9,0,22,nowin,win,dlbust,bust,20,0,15,202,0.410891089,0.044554455,0.633663366,2,0.598681573
6381,147,21064,10,11,0,0,0,21,10,2,1,9,0,22,win,win,dlbust,bust,25,0,21,205,0.380487805,0.014634146,0.536585366,0,0.00951447
6382,77,21064,6,2,9,0,0,17,10,2,1,9,0,22,nowin,win,dlbust,bust,20,0,8,200,0.455,0.04,0.62,3,0.916252116
6383,70,21064,2,9,9,0,0,20,10,2,1,9,0,22,nowin,win,dlbust,bust,20,0,11,228,0.385964912,0.039473684,0.557017544,0,0.016157125
6384,61,21065,1,4,10,10,0,25,7,9,10,0,0,26,nowin,loss,bust,plbust,0,10,5,194,0.427835052,0.077319588,0.603092784,2,0.591437139
6385,54,21065,4,10,0,4,0,18,7,9,10,0,0,26,nowin,win,dlbust,bust,20,0,14,185,0.437837838,0.032432432,0.556756757,1,0.29899854
6386,106,21065,10,10,0,0,0,20,7,9,10,0,0,26,nowin,win,dlbust,bust,20,0,20,192,0.411458333,0.026041667,0.557291667,0,0.023854304
6387,89,21065,6,10,0,7,0,23,7,9,10,0,0,26,nowin,loss,bust,plbust,0,10,16,212,0.537735849,0.047169811,0.594339623,3,0.990167191
6388,94,21065,2,10,0,8,0,20,7,9,10,0,0,26,nowin,win,dlbust,bust,20,0,12,183,0.43715847,0.043715847,0.540983607,1,0.290866892
6389,111,21065,9,10,0,0,0,19,7,9,10,0,0,26,nowin,win,dlbust,bust,20,0,19,180,0.433333333,0.055555556,0.611111111,2,0.602264492
6390,19,21066,3,5,9,0,0,17,10,8,0,0,0,18,nowin,loss,beat,dlwin,0,10,8,237,0.41350211,0.054852321,0.628691983,2,0.597373826
6391,97,21066,3,10,0,6,0,19,10,8,0,0,0,18,nowin,win,plwin,beat,20,0,13,182,0.450549451,0.06043956,0.692307692,2,0.677372279
6392,101,21066,5,5,11,0,0,21,10,8,0,0,0,18,nowin,win,plwin,beat,20,0,10,205,0.424390244,0.068292683,0.63902439,2,0.614740646
6393,107,21066,10,7,0,0,0,17,10,8,0,0,0,18,nowin,loss,beat,dlwin,0,10,17,218,0.444954128,0.073394495,0.600917431,2,0.605210014
6394,114,21066,4,2,10,8,0,24,10,8,0,0,0,18,nowin,loss,bust,plbust,0,10,6,198,0.47979798,0.025252525,0.611111111,3,0.937232995
6395,149,21066,10,3,0,3,2,18,10,8,0,0,0,18,nowin,push,push,push,10,0,13,225,0.457777778,0.057777778,0.648888889,2,0.651965595
6396,30,21067,4,10,0,6,0,20,9,10,0,0,0,19,nowin,win,plwin,beat,20,0,14,206,0.393203883,0.033980583,0.601941748,0,0.029324648
6397,147,21067,10,10,0,0,0,20,9,10,0,0,0,19,nowin,win,plwin,beat,20,0,20,205,0.380487805,0.014634146,0.536585366,0,0.00951447
6398,138,21067,8,9,0,0,0,17,9,10,0,0,0,19,nowin,loss,beat,dlwin,0,10,17,190,0.442105263,0.047368421,0.610526316,2,0.609711065
6399,121,21067,8,7,0,1,10,26,9,10,0,0,0,19,nowin,loss,bust,plbust,0,10,15,195,0.456410256,0.025641026,0.512820513,1,0.288597791
6400,135,21067,4,9,0,5,0,18,9,10,0,0,0,19,nowin,loss,beat,dlwin,0,10,13,179,0.391061453,0.067039106,0.586592179,0,0.024924662
6401,103,21067,11,10,0,0,0,21,9,10,0,0,0,19,win,win,plwin,beat,25,0,21,203,0.379310345,0.064039409,0.551724138,0,0.012869209
6402,110,21068,7,2,6,10,0,25,10,6,4,0,0,20,nowin,loss,bust,plbust,0,10,9,192,0.416666667,0.046875,0.557291667,0,0.025413132
6403,77,21068,5,5,2,10,0,22,10,6,4,0,0,20,nowin,loss,bust,plbust,0,10,10,200,0.455,0.04,0.62,3,0.916252116
6404,4,21068,3,4,2,2,5,16,10,6,4,0,0,20,nowin,loss,beat,dlwin,0,10,7,217,0.460829493,0.036866359,0.562211982,1,0.315432839
6405,142,21068,10,6,0,2,0,18,10,6,4,0,0,20,nowin,loss,beat,dlwin,0,10,16,211,0.417061611,0.047393365,0.526066351,1,0.271531309
6406,149,21068,7,4,5,9,0,25,10,6,4,0,0,20,nowin,loss,bust,plbust,0,10,11,225,0.457777778,0.057777778,0.648888889,2,0.651965595
6407,79,21068,10,5,0,7,0,22,10,6,4,0,0,20,nowin,loss,bust,plbust,0,10,15,211,0.436018957,0.028436019,0.672985782,2,0.650131054
6408,91,21069,9,7,0,0,0,16,6,6,7,0,0,19,nowin,loss,beat,dlwin,0,10,16,194,0.417525773,0.046391753,0.515463918,1,0.266616552
6409,24,21069,8,11,0,0,0,19,6,6,7,0,0,19,nowin,push,push,push,10,0,19,207,0.458937198,0.048309179,0.570048309,1,0.318138014
6410,14,21069,10,7,0,0,0,17,6,6,7,0,0,19,nowin,loss,beat,dlwin,0,10,17,202,0.391089109,0.01980198,0.628712871,2,0.577264877
6411,121,21069,10,9,0,0,0,19,6,6,7,0,0,19,nowin,push,push,push,10,0,19,195,0.456410256,0.025641026,0.512820513,1,0.288597791
6412,6,21069,10,10,0,0,0,20,6,6,7,0,0,19,nowin,win,plwin,beat,20,0,20,191,0.439790576,0.047120419,0.581151832,1,0.31211505
6413,49,21069,6,1,10,0,0,17,6,6,7,0,0,19,nowin,loss,beat,dlwin,0,10,7,207,0.396135266,0.053140097,0.594202899,0,0.028306925
6414,34,21070,9,2,1,0,0,12,6,6,3,6,0,21,nowin,loss,beat,dlwin,0,10,11,202,0.5,0.079207921,0.618811881,3,0.968961434
6415,149,21070,10,5,0,0,0,15,6,6,3,6,0,21,nowin,loss,beat,dlwin,0,10,15,225,0.457777778,0.057777778,0.648888889,2,0.651965595
6416,72,21070,9,8,0,0,0,17,6,6,3,6,0,21,nowin,loss,beat,dlwin,0,10,17,185,0.394594595,0.032432432,0.508108108,0,0.006763115
6417,102,21070,10,10,0,0,0,20,6,6,3,6,0,21,nowin,loss,beat,dlwin,0,10,20,192,0.338541667,0.046875,0.5625,0,0.003306118
6418,12,21070,10,10,0,0,0,20,6,6,3,6,0,21,nowin,loss,beat,dlwin,0,10,20,189,0.470899471,0.015873016,0.613756614,3,0.929171178
6419,44,21070,10,10,0,0,0,20,6,6,3,6,0,21,nowin,loss,beat,dlwin,0,10,20,219,0.433789954,0.050228311,0.534246575,1,0.285551035
6420,92,21071,1,5,7,2,10,25,10,7,0,0,0,17,nowin,loss,bust,plbust,0,10,6,186,0.446236559,0.059139785,0.564516129,1,0.307826125
6421,121,21071,10,10,0,0,0,20,10,7,0,0,0,17,nowin,win,plwin,beat,20,0,20,195,0.456410256,0.025641026,0.512820513,1,0.288597791
6422,63,21071,10,4,0,1,5,20,10,7,0,0,0,17,nowin,win,plwin,beat,20,0,14,216,0.467592593,0.037037037,0.62037037,3,0.931690496
6423,121,21071,5,10,0,5,0,20,10,7,0,0,0,17,nowin,win,plwin,beat,20,0,15,195,0.456410256,0.025641026,0.512820513,1,0.288597791
6424,37,21071,10,10,0,0,0,20,10,7,0,0,0,17,nowin,win,plwin,beat,20,0,20,208,0.394230769,0.038461538,0.581730769,0,0.024682772
6425,104,21071,2,7,10,0,0,19,10,7,0,0,0,17,nowin,win,plwin,beat,20,0,9,209,0.363636364,0.052631579,0.593301435,0,0.018359419
6426,67,21072,3,10,0,0,0,13,4,10,9,0,0,23,nowin,win,dlbust,bust,20,0,13,195,0.369230769,0.041025641,0.569230769,0,0.014139427
6427,123,21072,6,2,10,0,0,18,4,10,9,0,0,23,nowin,win,dlbust,bust,20,0,8,205,0.43902439,0.034146341,0.614634146,2,0.609962544
6428,113,21072,6,8,0,0,0,14,4,10,9,0,0,23,nowin,win,dlbust,bust,20,0,14,199,0.407035176,0.055276382,0.668341709,2,0.620695264
6429,35,21072,4,3,5,0,0,12,4,10,9,0,0,23,nowin,win,dlbust,bust,20,0,7,202,0.410891089,0.044554455,0.633663366,2,0.598681573
6430,125,21072,3,8,3,0,0,14,4,10,9,0,0,23,nowin,win,dlbust,bust,20,0,11,219,0.438356164,0.050228311,0.575342466,1,0.308411257
6431,91,21072,2,7,6,0,0,15,4,10,9,0,0,23,nowin,win,dlbust,bust,20,0,9,194,0.417525773,0.046391753,0.515463918,1,0.266616552
6432,107,21073,8,8,0,10,0,26,10,5,9,0,0,24,nowin,loss,bust,plbust,0,10,16,218,0.444954128,0.073394495,0.600917431,2,0.605210014
6433,66,21073,10,2,0,6,0,18,10,5,9,0,0,24,nowin,win,dlbust,bust,20,0,12,217,0.456221198,0.064516129,0.626728111,3,0.924304367
6434,88,21073,9,10,0,0,0,19,10,5,9,0,0,24,nowin,win,dlbust,bust,20,0,19,206,0.466019417,0.033980583,0.54368932,1,0.309467903
6435,118,21073,8,2,10,0,0,20,10,5,9,0,0,24,nowin,win,dlbust,bust,20,0,10,216,0.393518519,0.037037037,0.555555556,0,0.018059873
6436,1,21073,11,2,4,0,0,17,10,5,9,0,0,24,nowin,win,dlbust,bust,20,0,13,197,0.406091371,0.025380711,0.649746193,2,0.606186955
6437,114,21073,10,10,0,0,0,20,10,5,9,0,0,24,nowin,win,dlbust,bust,20,0,20,198,0.47979798,0.025252525,0.611111111,3,0.937232995
6438,9,21074,10,10,0,0,0,20,8,4,9,0,0,21,nowin,loss,beat,dlwin,0,10,20,194,0.37628866,0.015463918,0.541237113,0,0.009396796
6439,149,21074,6,2,5,1,7,21,8,4,9,0,0,21,nowin,push,push,push,10,0,8,225,0.457777778,0.057777778,0.648888889,2,0.651965595
6440,106,21074,3,4,7,4,0,18,8,4,9,0,0,21,nowin,loss,beat,dlwin,0,10,7,192,0.411458333,0.026041667,0.557291667,0,0.023854304
6441,148,21074,5,2,7,6,0,20,8,4,9,0,0,21,nowin,loss,beat,dlwin,0,10,7,204,0.401960784,0.078431373,0.593137255,0,0.029789521
6442,2,21074,9,8,0,0,0,17,8,4,9,0,0,21,nowin,loss,beat,dlwin,0,10,17,200,0.445,0.035,0.64,2,0.633962549
6443,81,21074,2,6,5,10,0,23,8,4,9,0,0,21,nowin,loss,bust,plbust,0,10,8,182,0.395604396,0.043956044,0.60989011,2,0.567491261
6444,13,21075,9,9,0,0,0,18,10,8,0,0,0,18,nowin,push,push,push,10,0,18,206,0.417475728,0.063106796,0.621359223,2,0.59555479
6445,99,21075,10,10,0,0,0,20,10,8,0,0,0,18,nowin,win,plwin,beat,20,0,20,207,0.47826087,0.062801932,0.637681159,3,0.961418446
6446,12,21075,9,9,0,0,0,18,10,8,0,0,0,18,nowin,push,push,push,10,0,18,189,0.470899471,0.015873016,0.613756614,3,0.929171178
6447,34,21075,3,7,7,0,0,17,10,8,0,0,0,18,nowin,loss,beat,dlwin,0,10,10,202,0.5,0.079207921,0.618811881,3,0.968961434
6448,61,21075,3,2,3,4,6,18,10,8,0,0,0,18,nowin,push,push,push,10,0,5,194,0.427835052,0.077319588,0.603092784,2,0.591437139
6449,125,21075,9,10,0,0,0,19,10,8,0,0,0,18,nowin,win,plwin,beat,20,0,19,219,0.438356164,0.050228311,0.575342466,1,0.308411257
6450,110,21076,9,9,0,0,0,18,3,9,10,0,0,22,nowin,win,dlbust,bust,20,0,18,192,0.416666667,0.046875,0.557291667,0,0.025413132
6451,100,21076,10,10,0,0,0,20,3,9,10,0,0,22,nowin,win,dlbust,bust,20,0,20,190,0.452631579,0.036842105,0.594736842,3,0.888671154
6452,32,21076,10,10,0,0,0,20,3,9,10,0,0,22,nowin,win,dlbust,bust,20,0,20,189,0.391534392,0.037037037,0.53968254,0,0.013579086
6453,80,21076,3,4,2,1,9,19,3,9,10,0,0,22,nowin,win,dlbust,bust,20,0,7,186,0.419354839,0.059139785,0.623655914,2,0.59892924
6454,10,21076,3,7,10,0,0,20,3,9,10,0,0,22,nowin,win,dlbust,bust,20,0,10,191,0.413612565,0.057591623,0.596858639,2,0.574087175
6455,42,21076,4,5,11,0,0,20,3,9,10,0,0,22,nowin,win,dlbust,bust,20,0,9,212,0.443396226,0.051886792,0.570754717,1,0.309181312
6456,16,21077,5,10,0,7,0,22,10,10,0,0,0,20,nowin,loss,bust,plbust,0,10,15,220,0.427272727,0.081818182,0.6,2,0.588660176
6457,130,21077,8,5,0,10,0,23,10,10,0,0,0,20,nowin,loss,bust,plbust,0,10,13,219,0.410958904,0.03652968,0.566210046,0,0.025888739
6458,59,21077,11,9,0,0,0,20,10,10,0,0,0,20,nowin,push,push,push,10,0,20,228,0.429824561,0.048245614,0.543859649,1,0.287885446
6459,16,21077,9,9,0,0,0,18,10,10,0,0,0,20,nowin,loss,beat,dlwin,0,10,18,220,0.427272727,0.081818182,0.6,2,0.588660176
6460,98,21077,6,10,0,9,0,25,10,10,0,0,0,20,nowin,loss,bust,plbust,0,10,16,220,0.422727273,0.054545455,0.55,1,0.28664435
6461,30,21077,7,10,0,0,0,17,10,10,0,0,0,20,nowin,loss,beat,dlwin,0,10,17,206,0.393203883,0.033980583,0.601941748,0,0.029324648
6462,24,21078,2,10,0,9,0,21,10,6,7,0,0,23,nowin,win,dlbust,bust,20,0,12,207,0.458937198,0.048309179,0.570048309,1,0.318138014
6463,147,21078,10,7,0,0,0,17,10,6,7,0,0,23,nowin,win,dlbust,bust,20,0,17,205,0.380487805,0.014634146,0.536585366,0,0.00951447
6464,117,21078,7,11,0,0,0,18,10,6,7,0,0,23,nowin,win,dlbust,bust,20,0,18,173,0.410404624,0.069364162,0.606936416,2,0.578610282
6465,83,21078,2,3,10,9,0,24,10,6,7,0,0,23,nowin,loss,bust,plbust,0,10,5,193,0.424870466,0.051813472,0.678756477,2,0.644360335
6466,56,21078,2,1,10,10,0,23,10,6,7,0,0,23,nowin,loss,bust,plbust,0,10,3,175,0.4,0.057142857,0.582857143,0,0.026685297
6467,49,21078,10,11,0,0,0,21,10,6,7,0,0,23,win,win,dlbust,bust,25,0,21,207,0.396135266,0.053140097,0.594202899,0,0.028306925
6468,123,21079,5,3,3,7,0,18,10,4,8,0,0,22,nowin,win,dlbust,bust,20,0,8,205,0.43902439,0.034146341,0.614634146,2,0.609962544
6469,139,21079,8,2,10,0,0,20,10,4,8,0,0,22,nowin,win,dlbust,bust,20,0,10,192,0.380208333,0.036458333,0.59375,0,0.023429169
6470,47,21079,6,5,10,0,0,21,10,4,8,0,0,22,nowin,win,dlbust,bust,20,0,11,210,0.438095238,0.057142857,0.623809524,2,0.615868808
6471,126,21079,2,4,10,9,0,25,10,4,8,0,0,22,nowin,loss,bust,plbust,0,10,6,188,0.457446809,0.074468085,0.60106383,3,0.900633203
6472,44,21079,7,3,3,1,10,24,10,4,8,0,0,22,nowin,loss,bust,plbust,0,10,10,219,0.433789954,0.050228311,0.534246575,1,0.285551035
6473,108,21079,10,8,0,0,0,18,10,4,8,0,0,22,nowin,win,dlbust,bust,20,0,18,193,0.435233161,0.056994819,0.559585492,1,0.298824795
6474,145,21080,10,7,0,0,0,17,10,3,10,0,0,23,nowin,win,dlbust,bust,20,0,17,188,0.441489362,0.031914894,0.622340426,2,0.617837093
6475,11,21080,10,4,0,10,0,24,10,3,10,0,0,23,nowin,loss,bust,plbust,0,10,14,236,0.457627119,0.016949153,0.588983051,3,0.889015813
6476,19,21080,10,10,0,0,0,20,10,3,10,0,0,23,nowin,win,dlbust,bust,20,0,20,237,0.41350211,0.054852321,0.628691983,2,0.597373826
6477,84,21080,3,8,10,0,0,21,10,3,10,0,0,23,nowin,win,dlbust,bust,20,0,11,195,0.379487179,0.056410256,0.569230769,0,0.017209119
6478,70,21080,6,10,0,4,0,20,10,3,10,0,0,23,nowin,win,dlbust,bust,20,0,16,228,0.385964912,0.039473684,0.557017544,0,0.016157125
6479,87,21080,10,2,0,10,0,22,10,3,10,0,0,23,nowin,loss,bust,plbust,0,10,12,202,0.405940594,0.054455446,0.628712871,2,0.590599801
6480,33,21081,10,3,0,0,0,13,4,3,8,7,0,22,nowin,win,dlbust,bust,20,0,13,192,0.4375,0.057291667,0.625,2,0.616208916
6481,89,21081,7,3,9,0,0,19,4,3,8,7,0,22,nowin,win,dlbust,bust,20,0,10,212,0.537735849,0.047169811,0.594339623,3,0.990167191
6482,123,21081,10,7,0,0,0,17,4,3,8,7,0,22,nowin,win,dlbust,bust,20,0,17,205,0.43902439,0.034146341,0.614634146,2,0.609962544
6483,58,21081,9,5,0,0,0,14,4,3,8,7,0,22,nowin,win,dlbust,bust,20,0,14,195,0.430769231,0.041025641,0.584615385,2,0.580497586
6484,27,21081,6,10,0,0,0,16,4,3,8,7,0,22,nowin,win,dlbust,bust,20,0,16,178,0.370786517,0.016853933,0.573033708,0,0.015536309
6485,109,21081,5,10,0,0,0,15,4,3,8,7,0,22,nowin,win,dlbust,bust,20,0,15,221,0.461538462,0.058823529,0.597285068,3,0.901830309
6486,90,21082,3,9,0,0,0,12,4,9,10,0,0,23,nowin,win,dlbust,bust,20,0,12,201,0.447761194,0.049751244,0.60199005,3,0.889945023
6487,43,21082,4,2,2,7,0,15,4,9,10,0,0,23,nowin,win,dlbust,bust,20,0,6,192,0.40625,0.041666667,0.609375,2,0.576671372
6488,68,21082,11,5,2,0,0,18,4,9,10,0,0,23,nowin,win,dlbust,bust,20,0,16,205,0.434146341,0.029268293,0.6,2,0.59483189
6489,44,21082,6,10,0,0,0,16,4,9,10,0,0,23,nowin,win,dlbust,bust,20,0,16,219,0.433789954,0.050228311,0.534246575,1,0.285551035
6490,88,21082,5,3,4,0,0,12,4,9,10,0,0,23,nowin,win,dlbust,bust,20,0,8,206,0.466019417,0.033980583,0.54368932,1,0.309467903
6491,52,21082,10,10,0,0,0,20,4,9,10,0,0,23,nowin,win,dlbust,bust,20,0,20,217,0.414746544,0.02764977,0.599078341,2,0.576736024
6492,106,21083,2,6,2,4,10,24,10,2,9,0,0,21,nowin,loss,bust,plbust,0,10,8,192,0.411458333,0.026041667,0.557291667,0,0.023854304
6493,137,21083,3,4,9,10,0,26,10,2,9,0,0,21,nowin,loss,bust,plbust,0,10,7,194,0.417525773,0.046391753,0.536082474,1,0.276714602
6494,63,21083,6,10,0,3,0,19,10,2,9,0,0,21,nowin,loss,beat,dlwin,0,10,16,216,0.467592593,0.037037037,0.62037037,3,0.931690496
6495,147,21083,8,9,0,0,0,17,10,2,9,0,0,21,nowin,loss,beat,dlwin,0,10,17,205,0.380487805,0.014634146,0.536585366,0,0.00951447
6496,146,21083,10,11,0,0,0,21,10,2,9,0,0,21,win,push,push,push,10,0,21,221,0.43438914,0.040723982,0.542986425,1,0.290190091
6497,128,21083,10,10,0,0,0,20,10,2,9,0,0,21,nowin,loss,beat,dlwin,0,10,20,227,0.356828194,0.052863436,0.577092511,0,0.012352564
6498,141,21084,11,10,0,0,0,21,7,2,6,2,0,17,win,win,plwin,beat,25,0,21,202,0.420792079,0.074257426,0.564356436,0,0.028377851
6499,26,21084,11,10,0,0,0,21,7,2,6,2,0,17,win,win,plwin,beat,25,0,21,203,0.463054187,0.0591133,0.541871921,1,0.306802864
6500,127,21084,10,10,0,0,0,20,7,2,6,2,0,17,nowin,win,plwin,beat,20,0,20,201,0.402985075,0.029850746,0.60199005,0,0.032263937
6501,77,21084,9,6,0,1,10,26,7,2,6,2,0,17,nowin,loss,bust,plbust,0,10,15,200,0.455,0.04,0.62,3,0.916252116
6502,42,21084,8,10,0,0,0,18,7,2,6,2,0,17,nowin,win,plwin,beat,20,0,18,212,0.443396226,0.051886792,0.570754717,1,0.309181312
6503,19,21084,6,4,3,1,1,15,7,2,6,2,0,17,nowin,loss,beat,dlwin,0,10,10,237,0.41350211,0.054852321,0.628691983,2,0.597373826
6504,57,21085,10,10,0,0,0,20,10,4,4,0,0,18,nowin,win,plwin,beat,20,0,20,192,0.46875,0.052083333,0.59375,3,0.907001181
6505,150,21085,10,11,0,0,0,21,10,4,4,0,0,18,win,win,plwin,beat,25,0,21,192,0.401041667,0.036458333,0.567708333,0,0.023287458
6506,95,21085,3,10,0,8,0,21,10,4,4,0,0,18,nowin,win,plwin,beat,20,0,13,218,0.412844037,0.04587156,0.559633028,0,0.024842385
6507,42,21085,7,2,10,0,0,19,10,4,4,0,0,18,nowin,win,plwin,beat,20,0,9,212,0.443396226,0.051886792,0.570754717,1,0.309181312
6508,57,21085,6,8,0,6,0,20,10,4,4,0,0,18,nowin,win,plwin,beat,20,0,14,192,0.46875,0.052083333,0.59375,3,0.907001181
6509,78,21085,11,10,0,0,0,21,10,4,4,0,0,18,win,win,plwin,beat,25,0,21,201,0.517412935,0.034825871,0.587064677,3,0.95871112
6510,50,21086,10,5,0,0,0,15,4,2,2,10,0,18,nowin,loss,beat,dlwin,0,10,15,202,0.405940594,0.04950495,0.54950495,0,0.020296079
6511,72,21086,7,5,0,0,0,12,4,2,2,10,0,18,nowin,loss,beat,dlwin,0,10,12,185,0.394594595,0.032432432,0.508108108,0,0.006763115
6512,126,21086,2,10,0,0,0,12,4,2,2,10,0,18,nowin,loss,beat,dlwin,0,10,12,188,0.457446809,0.074468085,0.60106383,3,0.900633203
6513,143,21086,8,3,4,0,0,15,4,2,2,10,0,18,nowin,loss,beat,dlwin,0,10,11,203,0.463054187,0.044334975,0.57635468,3,0.883143365
6514,60,21086,9,10,0,0,0,19,4,2,2,10,0,18,nowin,win,plwin,beat,20,0,19,227,0.418502203,0.022026432,0.559471366,0,0.026496258
6515,13,21086,6,5,8,0,0,19,4,2,2,10,0,18,nowin,win,plwin,beat,20,0,11,206,0.417475728,0.063106796,0.621359223,2,0.59555479
6516,37,21087,6,4,3,0,0,13,5,10,4,0,0,19,nowin,loss,beat,dlwin,0,10,10,208,0.394230769,0.038461538,0.581730769,0,0.024682772
6517,17,21087,10,10,0,0,0,20,5,10,4,0,0,19,nowin,win,plwin,beat,20,0,20,171,0.444444444,0.070175439,0.555555556,1,0.302364894
6518,137,21087,6,10,0,0,0,16,5,10,4,0,0,19,nowin,loss,beat,dlwin,0,10,16,194,0.417525773,0.046391753,0.536082474,1,0.276714602
6519,140,21087,7,11,0,0,0,18,5,10,4,0,0,19,nowin,loss,beat,dlwin,0,10,18,210,0.466666667,0.023809524,0.604761905,3,0.915293335
6520,47,21087,10,2,0,0,0,12,5,10,4,0,0,19,nowin,loss,beat,dlwin,0,10,12,210,0.438095238,0.057142857,0.623809524,2,0.615868808
6521,94,21087,3,3,11,0,0,17,5,10,4,0,0,19,nowin,loss,beat,dlwin,0,10,6,183,0.43715847,0.043715847,0.540983607,1,0.290866892
6522,133,21088,8,4,0,9,0,21,10,10,0,0,0,20,nowin,win,plwin,beat,20,0,12,201,0.47761194,0.064676617,0.611940299,3,0.935428111
6523,95,21088,5,10,0,6,0,21,10,10,0,0,0,20,nowin,win,plwin,beat,20,0,15,218,0.412844037,0.04587156,0.559633028,0,0.024842385
6524,130,21088,7,7,0,8,0,22,10,10,0,0,0,20,nowin,loss,bust,plbust,0,10,14,219,0.410958904,0.03652968,0.566210046,0,0.025888739
6525,144,21088,5,9,0,4,0,18,10,10,0,0,0,20,nowin,loss,beat,dlwin,0,10,14,202,0.386138614,0.054455446,0.564356436,0,0.018006244
6526,101,21088,1,2,10,3,3,19,10,10,0,0,0,20,nowin,loss,beat,dlwin,0,10,3,205,0.424390244,0.068292683,0.63902439,2,0.614740646
6527,84,21088,10,10,0,0,0,20,10,10,0,0,0,20,nowin,push,push,push,10,0,20,195,0.379487179,0.056410256,0.569230769,0,0.017209119
6528,45,21089,10,10,0,0,0,20,5,11,3,0,0,19,nowin,win,plwin,beat,20,0,20,196,0.428571429,0.051020408,0.612244898,2,0.598821767
6529,127,21089,6,10,0,0,0,16,5,11,3,0,0,19,nowin,loss,beat,dlwin,0,10,16,201,0.402985075,0.029850746,0.60199005,0,0.032263937
6530,41,21089,10,9,0,0,0,19,5,11,3,0,0,19,nowin,push,push,push,10,0,19,192,0.364583333,0.036458333,0.520833333,0,0.00089702
6531,118,21089,9,10,0,0,0,19,5,11,3,0,0,19,nowin,push,push,push,10,0,19,216,0.393518519,0.037037037,0.555555556,0,0.018059873
6532,145,21089,6,3,9,0,0,18,5,11,3,0,0,19,nowin,loss,beat,dlwin,0,10,9,188,0.441489362,0.031914894,0.622340426,2,0.617837093
6533,117,21089,10,8,0,0,0,18,5,11,3,0,0,19,nowin,loss,beat,dlwin,0,10,18,173,0.410404624,0.069364162,0.606936416,2,0.578610282
6534,146,21090,7,10,0,0,0,17,2,8,7,0,0,17,nowin,push,push,push,10,0,17,221,0.43438914,0.040723982,0.542986425,1,0.290190091
6535,135,21090,10,10,0,0,0,20,2,8,7,0,0,17,nowin,win,plwin,beat,20,0,20,179,0.391061453,0.067039106,0.586592179,0,0.024924662
6536,31,21090,4,10,0,0,0,14,2,8,7,0,0,17,nowin,loss,beat,dlwin,0,10,14,188,0.473404255,0.058510638,0.515957447,1,0.300306557
6537,121,21090,7,6,0,0,0,13,2,8,7,0,0,17,nowin,loss,beat,dlwin,0,10,13,195,0.456410256,0.025641026,0.512820513,1,0.288597791
6538,124,21090,11,9,0,0,0,20,2,8,7,0,0,17,nowin,win,plwin,beat,20,0,20,202,0.47029703,0.064356436,0.584158416,3,0.899458193
6539,126,21090,10,10,0,0,0,20,2,8,7,0,0,17,nowin,win,plwin,beat,20,0,20,188,0.457446809,0.074468085,0.60106383,3,0.900633203
6540,127,21091,5,9,0,0,0,14,4,10,10,0,0,24,nowin,win,dlbust,bust,20,0,14,201,0.402985075,0.029850746,0.60199005,0,0.032263937
6541,27,21091,7,6,0,0,0,13,4,10,10,0,0,24,nowin,win,dlbust,bust,20,0,13,178,0.370786517,0.016853933,0.573033708,0,0.015536309
6542,105,21091,11,10,0,0,0,21,4,10,10,0,0,24,win,win,dlbust,bust,25,0,21,198,0.414141414,0.070707071,0.590909091,0,0.032889494
6543,36,21091,3,7,10,0,0,20,4,10,10,0,0,24,nowin,win,dlbust,bust,20,0,10,229,0.445414847,0.056768559,0.655021834,2,0.645370571
6544,76,21091,4,4,10,0,0,18,4,10,10,0,0,24,nowin,win,dlbust,bust,20,0,8,189,0.534391534,0.079365079,0.608465608,3,1
6545,139,21091,6,3,3,0,0,12,4,10,10,0,0,24,nowin,win,dlbust,bust,20,0,9,192,0.380208333,0.036458333,0.59375,0,0.023429169
6546,140,21092,7,3,10,0,0,20,10,9,0,0,0,19,nowin,win,plwin,beat,20,0,10,210,0.466666667,0.023809524,0.604761905,3,0.915293335
6547,86,21092,5,6,10,0,0,21,10,9,0,0,0,19,nowin,win,plwin,beat,20,0,11,196,0.454081633,0.040816327,0.591836735,3,0.887566443
6548,8,21092,4,3,6,10,0,23,10,9,0,0,0,19,nowin,loss,bust,plbust,0,10,7,181,0.44198895,0.071823204,0.596685083,2,0.599438402
6549,92,21092,3,7,2,10,0,22,10,9,0,0,0,19,nowin,loss,bust,plbust,0,10,10,186,0.446236559,0.059139785,0.564516129,1,0.307826125
6550,50,21092,4,8,0,2,4,18,10,9,0,0,0,19,nowin,loss,beat,dlwin,0,10,12,202,0.405940594,0.04950495,0.54950495,0,0.020296079
6551,124,21092,9,10,0,0,0,19,10,9,0,0,0,19,nowin,push,push,push,10,0,19,202,0.47029703,0.064356436,0.584158416,3,0.899458193
6552,41,21093,8,9,0,0,0,17,10,10,0,0,0,20,nowin,loss,beat,dlwin,0,10,17,192,0.364583333,0.036458333,0.520833333,0,0.00089702
6553,91,21093,5,10,0,10,0,25,10,10,0,0,0,20,nowin,loss,bust,plbust,0,10,15,194,0.417525773,0.046391753,0.515463918,1,0.266616552
6554,45,21093,10,10,0,0,0,20,10,10,0,0,0,20,nowin,push,push,push,10,0,20,196,0.428571429,0.051020408,0.612244898,2,0.598821767
6555,91,21093,10,2,0,10,0,22,10,10,0,0,0,20,nowin,loss,bust,plbust,0,10,12,194,0.417525773,0.046391753,0.515463918,1,0.266616552
6556,85,21093,6,5,2,9,0,22,10,10,0,0,0,20,nowin,loss,bust,plbust,0,10,11,195,0.41025641,0.066666667,0.594871795,0,0.03269711
6557,116,21093,3,10,0,2,8,23,10,10,0,0,0,20,nowin,loss,bust,plbust,0,10,13,195,0.425641026,0.056410256,0.538461538,1,0.28273747
6558,105,21094,4,11,3,0,0,18,2,6,5,3,7,23,nowin,win,dlbust,bust,20,0,15,198,0.414141414,0.070707071,0.590909091,0,0.032889494
6559,108,21094,10,4,0,0,0,14,2,6,5,3,7,23,nowin,win,dlbust,bust,20,0,14,193,0.435233161,0.056994819,0.559585492,1,0.298824795
6560,82,21094,2,10,0,6,0,18,2,6,5,3,7,23,nowin,win,dlbust,bust,20,0,12,225,0.408888889,0.075555556,0.577777778,0,0.028101874
6561,53,21094,8,7,0,0,0,15,2,6,5,3,7,23,nowin,win,dlbust,bust,20,0,15,250,0.372,0.064,0.564,0,0.013687345
6562,46,21094,5,10,0,0,0,15,2,6,5,3,7,23,nowin,win,dlbust,bust,20,0,15,186,0.403225806,0.048387097,0.591397849,0,0.029742194
6563,108,21094,10,7,0,0,0,17,2,6,5,3,7,23,nowin,win,dlbust,bust,20,0,17,193,0.435233161,0.056994819,0.559585492,1,0.298824795
6564,94,21095,9,5,0,8,0,22,7,10,0,0,0,17,nowin,loss,bust,plbust,0,10,14,183,0.43715847,0.043715847,0.540983607,1,0.290866892
6565,75,21095,2,10,0,4,9,25,7,10,0,0,0,17,nowin,loss,bust,plbust,0,10,12,191,0.418848168,0.052356021,0.570680628,0,0.029344702
6566,146,21095,6,4,3,2,6,21,7,10,0,0,0,17,nowin,win,plwin,beat,20,0,10,221,0.43438914,0.040723982,0.542986425,1,0.290190091
6567,101,21095,2,4,8,9,0,23,7,10,0,0,0,17,nowin,loss,bust,plbust,0,10,6,205,0.424390244,0.068292683,0.63902439,2,0.614740646
6568,144,21095,7,4,10,0,0,21,7,10,0,0,0,17,nowin,win,plwin,beat,20,0,11,202,0.386138614,0.054455446,0.564356436,0,0.018006244
6569,44,21095,4,10,0,1,1,16,7,10,0,0,0,17,nowin,loss,beat,dlwin,0,10,14,219,0.433789954,0.050228311,0.534246575,1,0.285551035
6570,135,21096,9,8,0,0,0,17,7,2,10,0,0,19,nowin,loss,beat,dlwin,0,10,17,179,0.391061453,0.067039106,0.586592179,0,0.024924662
6571,61,21096,7,6,0,9,0,22,7,2,10,0,0,19,nowin,loss,bust,plbust,0,10,13,194,0.427835052,0.077319588,0.603092784,2,0.591437139
6572,94,21096,8,4,0,3,7,22,7,2,10,0,0,19,nowin,loss,bust,plbust,0,10,12,183,0.43715847,0.043715847,0.540983607,1,0.290866892
6573,136,21096,2,8,8,0,0,18,7,2,10,0,0,19,nowin,loss,beat,dlwin,0,10,10,194,0.396907216,0.025773196,0.597938144,0,0.029452644
6574,68,21096,10,10,0,0,0,20,7,2,10,0,0,19,nowin,win,plwin,beat,20,0,20,205,0.434146341,0.029268293,0.6,2,0.59483189
6575,4,21096,9,10,0,0,0,19,7,2,10,0,0,19,nowin,push,push,push,10,0,19,217,0.460829493,0.036866359,0.562211982,1,0.315432839
6576,39,21097,3,11,7,0,0,21,7,11,0,0,0,18,nowin,win,plwin,beat,20,0,14,191,0.429319372,0.062827225,0.57591623,0,0.033760763
6577,101,21097,10,7,0,0,0,17,7,11,0,0,0,18,nowin,loss,beat,dlwin,0,10,17,205,0.424390244,0.068292683,0.63902439,2,0.614740646
6578,81,21097,7,2,8,0,0,17,7,11,0,0,0,18,nowin,loss,beat,dlwin,0,10,9,182,0.395604396,0.043956044,0.60989011,2,0.567491261
6579,98,21097,10,2,0,10,0,22,7,11,0,0,0,18,nowin,loss,bust,plbust,0,10,12,220,0.422727273,0.054545455,0.55,1,0.28664435
6580,101,21097,5,10,0,10,0,25,7,11,0,0,0,18,nowin,loss,bust,plbust,0,10,15,205,0.424390244,0.068292683,0.63902439,2,0.614740646
6581,48,21097,10,5,0,10,0,25,7,11,0,0,0,18,nowin,loss,bust,plbust,0,10,15,203,0.413793103,0.019704433,0.600985222,2,0.577280801
6582,122,21098,9,10,0,0,0,19,5,7,9,0,0,21,nowin,loss,beat,dlwin,0,10,19,210,0.347619048,0.052380952,0.59047619,0,0.012873677
6583,120,21098,9,6,0,0,0,15,5,7,9,0,0,21,nowin,loss,beat,dlwin,0,10,15,202,0.440594059,0.034653465,0.618811881,2,0.614441029
6584,55,21098,7,2,10,0,0,19,5,7,9,0,0,21,nowin,loss,beat,dlwin,0,10,9,191,0.371727749,0.057591623,0.54973822,0,0.01011347
6585,37,21098,2,10,0,0,0,12,5,7,9,0,0,21,nowin,loss,beat,dlwin,0,10,12,208,0.394230769,0.038461538,0.581730769,0,0.024682772
6586,7,21098,9,10,0,0,0,19,5,7,9,0,0,21,nowin,loss,beat,dlwin,0,10,19,183,0.442622951,0.06010929,0.62295082,2,0.619303341
6587,95,21098,7,2,11,0,0,20,5,7,9,0,0,21,nowin,loss,beat,dlwin,0,10,9,218,0.412844037,0.04587156,0.559633028,0,0.024842385
6588,114,21099,10,7,0,0,0,17,4,1,10,10,0,25,nowin,win,dlbust,bust,20,0,17,198,0.47979798,0.025252525,0.611111111,3,0.937232995
6589,28,21099,10,5,0,0,0,15,4,1,10,10,0,25,nowin,win,dlbust,bust,20,0,15,199,0.422110553,0.045226131,0.542713568,1,0.282706618
6590,125,21099,9,7,0,0,0,16,4,1,10,10,0,25,nowin,win,dlbust,bust,20,0,16,219,0.438356164,0.050228311,0.575342466,1,0.308411257
6591,72,21099,10,3,0,0,0,13,4,1,10,10,0,25,nowin,win,dlbust,bust,20,0,13,185,0.394594595,0.032432432,0.508108108,0,0.006763115
6592,81,21099,9,6,0,0,0,15,4,1,10,10,0,25,nowin,win,dlbust,bust,20,0,15,182,0.395604396,0.043956044,0.60989011,2,0.567491261
6593,65,21099,7,10,0,0,0,17,4,1,10,10,0,25,nowin,win,dlbust,bust,20,0,17,203,0.492610837,0.054187192,0.571428571,3,0.913702814
6594,143,21100,7,8,0,0,0,15,6,4,10,0,0,20,nowin,loss,beat,dlwin,0,10,15,203,0.463054187,0.044334975,0.57635468,3,0.883143365
6595,113,21100,10,10,0,0,0,20,6,4,10,0,0,20,nowin,push,push,push,10,0,20,199,0.407035176,0.055276382,0.668341709,2,0.620695264
6596,2,21100,10,7,0,0,0,17,6,4,10,0,0,20,nowin,loss,beat,dlwin,0,10,17,200,0.445,0.035,0.64,2,0.633962549
6597,94,21100,10,4,0,0,0,14,6,4,10,0,0,20,nowin,loss,beat,dlwin,0,10,14,183,0.43715847,0.043715847,0.540983607,1,0.290866892
6598,51,21100,9,3,0,0,0,12,6,4,10,0,0,20,nowin,loss,beat,dlwin,0,10,12,189,0.529100529,0.068783069,0.608465608,3,0.993665715
6599,72,21100,8,4,0,0,0,12,6,4,10,0,0,20,nowin,loss,beat,dlwin,0,10,12,185,0.394594595,0.032432432,0.508108108,0,0.006763115
6600,24,21101,10,4,0,2,1,17,8,10,0,0,0,18,nowin,loss,beat,dlwin,0,10,14,207,0.458937198,0.048309179,0.570048309,1,0.318138014
6601,5,21101,2,7,5,10,0,24,8,10,0,0,0,18,nowin,loss,bust,plbust,0,10,9,203,0.42364532,0.02955665,0.596059113,2,0.582508076
6602,128,21101,9,7,0,10,0,26,8,10,0,0,0,18,nowin,loss,bust,plbust,0,10,16,227,0.356828194,0.052863436,0.577092511,0,0.012352564
6603,18,21101,9,5,0,3,0,17,8,10,0,0,0,18,nowin,loss,beat,dlwin,0,10,14,182,0.461538462,0.043956044,0.587912088,3,0.892649374
6604,137,21101,5,4,9,0,0,18,8,10,0,0,0,18,nowin,push,push,push,10,0,9,194,0.417525773,0.046391753,0.536082474,1,0.276714602
6605,139,21101,5,10,0,9,0,24,8,10,0,0,0,18,nowin,loss,bust,plbust,0,10,15,192,0.380208333,0.036458333,0.59375,0,0.023429169
6606,109,21102,10,9,0,0,0,19,11,2,8,0,0,21,nowin,loss,beat,dlwin,0,10,19,221,0.461538462,0.058823529,0.597285068,3,0.901830309
6607,104,21102,7,4,8,0,0,19,11,2,8,0,0,21,nowin,loss,beat,dlwin,0,10,11,209,0.363636364,0.052631579,0.593301435,0,0.018359419
6608,119,21102,3,5,9,0,0,17,11,2,8,0,0,21,nowin,loss,beat,dlwin,0,10,8,190,0.405263158,0.068421053,0.515789474,0,0.011837158
6609,17,21102,11,8,0,0,0,19,11,2,8,0,0,21,nowin,loss,beat,dlwin,0,10,19,171,0.444444444,0.070175439,0.555555556,1,0.302364894
6610,49,21102,4,8,0,10,0,22,11,2,8,0,0,21,nowin,loss,bust,plbust,0,10,12,207,0.396135266,0.053140097,0.594202899,0,0.028306925
6611,12,21102,10,9,0,0,0,19,11,2,8,0,0,21,nowin,loss,beat,dlwin,0,10,19,189,0.470899471,0.015873016,0.613756614,3,0.929171178
6612,9,21103,8,10,0,0,0,18,11,4,4,0,0,19,nowin,loss,beat,dlwin,0,10,18,194,0.37628866,0.015463918,0.541237113,0,0.009396796
6613,34,21103,11,4,4,0,0,19,11,4,4,0,0,19,nowin,push,push,push,10,0,15,202,0.5,0.079207921,0.618811881,3,0.968961434
6614,13,21103,9,10,0,0,0,19,11,4,4,0,0,19,nowin,push,push,push,10,0,19,206,0.417475728,0.063106796,0.621359223,2,0.59555479
6615,6,21103,6,10,0,10,0,26,11,4,4,0,0,19,nowin,loss,bust,plbust,0,10,16,191,0.439790576,0.047120419,0.581151832,1,0.31211505
6616,131,21103,10,5,0,10,0,25,11,4,4,0,0,19,nowin,loss,bust,plbust,0,10,15,217,0.410138249,0.069124424,0.543778802,0,0.02015021
6617,9,21103,10,9,0,0,0,19,11,4,4,0,0,19,nowin,push,push,push,10,0,19,194,0.37628866,0.015463918,0.541237113,0,0.009396796
6618,103,21104,8,11,0,0,0,19,10,10,0,0,0,20,nowin,loss,beat,dlwin,0,10,19,203,0.379310345,0.064039409,0.551724138,0,0.012869209
6619,18,21104,6,11,2,0,0,19,10,10,0,0,0,20,nowin,loss,beat,dlwin,0,10,17,182,0.461538462,0.043956044,0.587912088,3,0.892649374
6620,134,21104,10,8,0,0,0,18,10,10,0,0,0,20,nowin,loss,beat,dlwin,0,10,18,185,0.443243243,0.021621622,0.545945946,1,0.296939509
6621,147,21104,10,10,0,0,0,20,10,10,0,0,0,20,nowin,push,push,push,10,0,20,205,0.380487805,0.014634146,0.536585366,0,0.00951447
6622,132,21104,9,10,0,0,0,19,10,10,0,0,0,20,nowin,loss,beat,dlwin,0,10,19,194,0.412371134,0.036082474,0.649484536,2,0.611633238
6623,81,21104,9,11,0,0,0,20,10,10,0,0,0,20,nowin,push,push,push,10,0,20,182,0.395604396,0.043956044,0.60989011,2,0.567491261
6624,24,21105,10,10,0,0,0,20,3,10,3,9,0,25,nowin,win,dlbust,bust,20,0,20,207,0.458937198,0.048309179,0.570048309,1,0.318138014
6625,112,21105,10,8,0,0,0,18,3,10,3,9,0,25,nowin,win,dlbust,bust,20,0,18,203,0.448275862,0.054187192,0.600985222,3,0.889576933
6626,21,21105,9,10,0,0,0,19,3,10,3,9,0,25,nowin,win,dlbust,bust,20,0,19,214,0.359813084,0.042056075,0.626168224,0,0.025263474
6627,90,21105,10,3,0,0,0,13,3,10,3,9,0,25,nowin,win,dlbust,bust,20,0,13,201,0.447761194,0.049751244,0.60199005,3,0.889945023
6628,148,21105,10,7,0,0,0,17,3,10,3,9,0,25,nowin,win,dlbust,bust,20,0,17,204,0.401960784,0.078431373,0.593137255,0,0.029789521
6629,146,21105,10,6,0,0,0,16,3,10,3,9,0,25,nowin,win,dlbust,bust,20,0,16,221,0.43438914,0.040723982,0.542986425,1,0.290190091
6630,71,21106,8,7,0,5,0,20,7,2,3,2,6,20,nowin,push,push,push,10,0,15,193,0.352331606,0.046632124,0.585492228,0,0.013063661
6631,33,21106,4,8,0,8,0,20,7,2,3,2,6,20,nowin,push,push,push,10,0,12,192,0.4375,0.057291667,0.625,2,0.616208916
6632,111,21106,4,5,11,0,0,20,7,2,3,2,6,20,nowin,push,push,push,10,0,9,180,0.433333333,0.055555556,0.611111111,2,0.602264492
6633,16,21106,8,11,0,0,0,19,7,2,3,2,6,20,nowin,loss,beat,dlwin,0,10,19,220,0.427272727,0.081818182,0.6,2,0.588660176
6634,49,21106,3,1,8,7,0,19,7,2,3,2,6,20,nowin,loss,beat,dlwin,0,10,4,207,0.396135266,0.053140097,0.594202899,0,0.028306925
6635,10,21106,7,9,0,9,0,25,7,2,3,2,6,20,nowin,loss,bust,plbust,0,10,16,191,0.413612565,0.057591623,0.596858639,2,0.574087175
6636,111,21107,2,10,0,9,0,21,9,8,0,0,0,17,nowin,win,plwin,beat,20,0,12,180,0.433333333,0.055555556,0.611111111,2,0.602264492
6637,85,21107,1,5,10,7,0,23,9,8,0,0,0,17,nowin,loss,bust,plbust,0,10,6,195,0.41025641,0.066666667,0.594871795,0,0.03269711
6638,62,21107,10,10,0,0,0,20,9,8,0,0,0,17,nowin,win,plwin,beat,20,0,20,178,0.370786517,0.028089888,0.54494382,0,0.008657722
6639,24,21107,10,5,0,10,0,25,9,8,0,0,0,17,nowin,loss,bust,plbust,0,10,15,207,0.458937198,0.048309179,0.570048309,1,0.318138014
6640,69,21107,7,8,0,4,0,19,9,8,0,0,0,17,nowin,win,plwin,beat,20,0,15,194,0.365979381,0.030927835,0.515463918,0,0
6641,52,21107,5,10,0,10,0,25,9,8,0,0,0,17,nowin,loss,bust,plbust,0,10,15,217,0.414746544,0.02764977,0.599078341,2,0.576736024
6642,76,21108,9,3,0,10,0,22,10,5,6,0,0,21,nowin,loss,bust,plbust,0,10,12,189,0.534391534,0.079365079,0.608465608,3,1
6643,54,21108,8,10,0,0,0,18,10,5,6,0,0,21,nowin,loss,beat,dlwin,0,10,18,185,0.437837838,0.032432432,0.556756757,1,0.29899854
6644,10,21108,8,8,0,7,0,23,10,5,6,0,0,21,nowin,loss,bust,plbust,0,10,16,191,0.413612565,0.057591623,0.596858639,2,0.574087175
6645,12,21108,1,5,10,4,0,20,10,5,6,0,0,21,nowin,loss,beat,dlwin,0,10,6,189,0.470899471,0.015873016,0.613756614,3,0.929171178
6646,87,21108,1,5,6,10,0,22,10,5,6,0,0,21,nowin,loss,bust,plbust,0,10,6,202,0.405940594,0.054455446,0.628712871,2,0.590599801
6647,88,21108,4,3,6,2,10,25,10,5,6,0,0,21,nowin,loss,bust,plbust,0,10,7,206,0.466019417,0.033980583,0.54368932,1,0.309467903
6648,70,21109,4,2,3,4,5,18,11,10,0,0,0,21,nowin,loss,beat,dlwin,0,10,6,228,0.385964912,0.039473684,0.557017544,0,0.016157125
6649,144,21109,4,3,5,5,0,17,11,10,0,0,0,21,nowin,loss,beat,dlwin,0,10,7,202,0.386138614,0.054455446,0.564356436,0,0.018006244
6650,109,21109,4,3,7,10,0,24,11,10,0,0,0,21,nowin,loss,bust,plbust,0,10,7,221,0.461538462,0.058823529,0.597285068,3,0.901830309
6651,16,21109,6,8,0,6,0,20,11,10,0,0,0,21,nowin,loss,beat,dlwin,0,10,14,220,0.427272727,0.081818182,0.6,2,0.588660176
6652,149,21109,10,4,0,10,0,24,11,10,0,0,0,21,nowin,loss,bust,plbust,0,10,14,225,0.457777778,0.057777778,0.648888889,2,0.651965595
6653,49,21109,10,7,0,0,0,17,11,10,0,0,0,21,nowin,loss,beat,dlwin,0,10,17,207,0.396135266,0.053140097,0.594202899,0,0.028306925
6654,52,21110,10,9,0,0,0,19,10,7,0,0,0,17,nowin,win,plwin,beat,20,0,19,217,0.414746544,0.02764977,0.599078341,2,0.576736024
6655,5,21110,10,10,0,0,0,20,10,7,0,0,0,17,nowin,win,plwin,beat,20,0,20,203,0.42364532,0.02955665,0.596059113,2,0.582508076
6656,63,21110,6,2,7,9,0,24,10,7,0,0,0,17,nowin,loss,bust,plbust,0,10,8,216,0.467592593,0.037037037,0.62037037,3,0.931690496
6657,121,21110,10,9,0,0,0,19,10,7,0,0,0,17,nowin,win,plwin,beat,20,0,19,195,0.456410256,0.025641026,0.512820513,1,0.288597791
6658,67,21110,8,3,5,1,0,17,10,7,0,0,0,17,nowin,push,push,push,10,0,11,195,0.369230769,0.041025641,0.569230769,0,0.014139427
6659,122,21110,3,10,0,10,0,23,10,7,0,0,0,17,nowin,loss,bust,plbust,0,10,13,210,0.347619048,0.052380952,0.59047619,0,0.012873677
6660,88,21111,9,6,0,9,0,24,11,3,2,1,0,17,nowin,loss,bust,plbust,0,10,15,206,0.466019417,0.033980583,0.54368932,1,0.309467903
6661,54,21111,4,6,10,0,0,20,11,3,2,1,0,17,nowin,win,plwin,beat,20,0,10,185,0.437837838,0.032432432,0.556756757,1,0.29899854
6662,32,21111,6,2,9,0,0,17,11,3,2,1,0,17,nowin,push,push,push,10,0,8,189,0.391534392,0.037037037,0.53968254,0,0.013579086
6663,104,21111,6,2,10,0,0,18,11,3,2,1,0,17,nowin,win,plwin,beat,20,0,8,209,0.363636364,0.052631579,0.593301435,0,0.018359419
6664,63,21111,10,10,0,0,0,20,11,3,2,1,0,17,nowin,win,plwin,beat,20,0,20,216,0.467592593,0.037037037,0.62037037,3,0.931690496
6665,2,21111,10,5,0,5,0,20,11,3,2,1,0,17,nowin,win,plwin,beat,20,0,15,200,0.445,0.035,0.64,2,0.633962549
6666,8,21112,2,9,3,0,0,14,6,9,1,6,0,22,nowin,win,dlbust,bust,20,0,11,181,0.44198895,0.071823204,0.596685083,2,0.599438402
6667,58,21112,4,9,0,0,0,13,6,9,1,6,0,22,nowin,win,dlbust,bust,20,0,13,195,0.430769231,0.041025641,0.584615385,2,0.580497586
6668,47,21112,10,10,0,0,0,20,6,9,1,6,0,22,nowin,win,dlbust,bust,20,0,20,210,0.438095238,0.057142857,0.623809524,2,0.615868808
6669,79,21112,7,4,8,0,0,19,6,9,1,6,0,22,nowin,win,dlbust,bust,20,0,11,211,0.436018957,0.028436019,0.672985782,2,0.650131054
6670,5,21112,5,7,0,0,0,12,6,9,1,6,0,22,nowin,win,dlbust,bust,20,0,12,203,0.42364532,0.02955665,0.596059113,2,0.582508076
6671,105,21112,9,9,0,0,0,18,6,9,1,6,0,22,nowin,win,dlbust,bust,20,0,18,198,0.414141414,0.070707071,0.590909091,0,0.032889494
6672,132,21113,2,6,5,1,2,16,7,2,9,0,0,18,nowin,loss,beat,dlwin,0,10,8,194,0.412371134,0.036082474,0.649484536,2,0.611633238
6673,59,21113,3,9,0,10,0,22,7,2,9,0,0,18,nowin,loss,bust,plbust,0,10,12,228,0.429824561,0.048245614,0.543859649,1,0.287885446
6674,148,21113,8,6,0,5,0,19,7,2,9,0,0,18,nowin,win,plwin,beat,20,0,14,204,0.401960784,0.078431373,0.593137255,0,0.029789521
6675,149,21113,8,11,0,0,0,19,7,2,9,0,0,18,nowin,win,plwin,beat,20,0,19,225,0.457777778,0.057777778,0.648888889,2,0.651965595
6676,64,21113,10,8,0,0,0,18,7,2,9,0,0,18,nowin,push,push,push,10,0,18,187,0.363636364,0.048128342,0.631016043,0,0.027594885
6677,23,21113,9,10,0,0,0,19,7,2,9,0,0,18,nowin,win,plwin,beat,20,0,19,208,0.427884615,0.0625,0.552884615,1,0.29114424
6678,63,21114,9,10,0,0,0,19,8,9,0,0,0,17,nowin,win,plwin,beat,20,0,19,216,0.467592593,0.037037037,0.62037037,3,0.931690496
6679,85,21114,3,2,10,2,0,17,8,9,0,0,0,17,nowin,push,push,push,10,0,5,195,0.41025641,0.066666667,0.594871795,0,0.03269711
6680,113,21114,3,7,5,10,0,25,8,9,0,0,0,17,nowin,loss,bust,plbust,0,10,10,199,0.407035176,0.055276382,0.668341709,2,0.620695264
6681,24,21114,11,4,4,0,0,19,8,9,0,0,0,17,nowin,win,plwin,beat,20,0,15,207,0.458937198,0.048309179,0.570048309,1,0.318138014
6682,13,21114,11,2,4,0,0,17,8,9,0,0,0,17,nowin,push,push,push,10,0,13,206,0.417475728,0.063106796,0.621359223,2,0.59555479
6683,93,21114,10,10,0,0,0,20,8,9,0,0,0,17,nowin,win,plwin,beat,20,0,20,175,0.485714286,0.051428571,0.548571429,1,0.323648091
6684,119,21115,11,10,0,0,0,21,10,9,0,0,0,19,win,win,plwin,beat,25,0,21,190,0.405263158,0.068421053,0.515789474,0,0.011837158
6685,132,21115,8,4,0,1,1,14,10,9,0,0,0,19,nowin,loss,beat,dlwin,0,10,12,194,0.412371134,0.036082474,0.649484536,2,0.611633238
6686,61,21115,6,10,0,10,0,26,10,9,0,0,0,19,nowin,loss,bust,plbust,0,10,16,194,0.427835052,0.077319588,0.603092784,2,0.591437139
6687,16,21115,4,8,0,6,0,18,10,9,0,0,0,19,nowin,loss,beat,dlwin,0,10,12,220,0.427272727,0.081818182,0.6,2,0.588660176
6688,37,21115,6,10,0,3,0,19,10,9,0,0,0,19,nowin,push,push,push,10,0,16,208,0.394230769,0.038461538,0.581730769,0,0.024682772
6689,105,21115,10,10,0,0,0,20,10,9,0,0,0,19,nowin,win,plwin,beat,20,0,20,198,0.414141414,0.070707071,0.590909091,0,0.032889494
6690,104,21116,10,3,0,0,0,13,2,4,2,10,0,18,nowin,loss,beat,dlwin,0,10,13,209,0.363636364,0.052631579,0.593301435,0,0.018359419
6691,16,21116,2,10,0,1,0,13,2,4,2,10,0,18,nowin,loss,beat,dlwin,0,10,12,220,0.427272727,0.081818182,0.6,2,0.588660176
6692,106,21116,10,3,0,0,0,13,2,4,2,10,0,18,nowin,loss,beat,dlwin,0,10,13,192,0.411458333,0.026041667,0.557291667,0,0.023854304
6693,26,21116,5,6,10,0,0,21,2,4,2,10,0,18,nowin,win,plwin,beat,20,0,11,203,0.463054187,0.0591133,0.541871921,1,0.306802864
6694,54,21116,10,10,0,0,0,20,2,4,2,10,0,18,nowin,win,plwin,beat,20,0,20,185,0.437837838,0.032432432,0.556756757,1,0.29899854
6695,24,21116,3,3,10,0,0,16,2,4,2,10,0,18,nowin,loss,beat,dlwin,0,10,6,207,0.458937198,0.048309179,0.570048309,1,0.318138014
6696,102,21117,10,3,0,10,0,23,1,5,10,5,0,21,nowin,loss,bust,plbust,0,10,13,192,0.338541667,0.046875,0.5625,0,0.003306118
6697,72,21117,2,10,0,7,0,19,1,5,10,5,0,21,nowin,loss,beat,dlwin,0,10,12,185,0.394594595,0.032432432,0.508108108,0,0.006763115
6698,105,21117,10,10,0,0,0,20,1,5,10,5,0,21,nowin,loss,beat,dlwin,0,10,20,198,0.414141414,0.070707071,0.590909091,0,0.032889494
6699,32,21117,8,10,0,0,0,18,1,5,10,5,0,21,nowin,loss,beat,dlwin,0,10,18,189,0.391534392,0.037037037,0.53968254,0,0.013579086
6700,144,21117,1,3,8,9,0,21,1,5,10,5,0,21,nowin,push,push,push,10,0,4,202,0.386138614,0.054455446,0.564356436,0,0.018006244
6701,143,21117,10,10,0,0,0,20,1,5,10,5,0,21,nowin,loss,beat,dlwin,0,10,20,203,0.463054187,0.044334975,0.57635468,3,0.883143365
6702,133,21118,5,9,0,0,0,14,2,10,10,0,0,22,nowin,win,dlbust,bust,20,0,14,201,0.47761194,0.064676617,0.611940299,3,0.935428111
6703,96,21118,7,10,0,0,0,17,2,10,10,0,0,22,nowin,win,dlbust,bust,20,0,17,190,0.468421053,0.057894737,0.584210526,3,0.897263354
6704,134,21118,10,6,0,0,0,16,2,10,10,0,0,22,nowin,win,dlbust,bust,20,0,16,185,0.443243243,0.021621622,0.545945946,1,0.296939509
6705,120,21118,2,4,7,0,0,13,2,10,10,0,0,22,nowin,win,dlbust,bust,20,0,6,202,0.440594059,0.034653465,0.618811881,2,0.614441029
6706,150,21118,9,6,0,0,0,15,2,10,10,0,0,22,nowin,win,dlbust,bust,20,0,15,192,0.401041667,0.036458333,0.567708333,0,0.023287458
6707,50,21118,5,6,6,0,0,17,2,10,10,0,0,22,nowin,win,dlbust,bust,20,0,11,202,0.405940594,0.04950495,0.54950495,0,0.020296079
6708,140,21119,7,10,0,0,0,17,10,10,0,0,0,20,nowin,loss,beat,dlwin,0,10,17,210,0.466666667,0.023809524,0.604761905,3,0.915293335
6709,102,21119,3,10,0,10,0,23,10,10,0,0,0,20,nowin,loss,bust,plbust,0,10,13,192,0.338541667,0.046875,0.5625,0,0.003306118
6710,40,21119,10,10,0,0,0,20,10,10,0,0,0,20,nowin,push,push,push,10,0,20,196,0.367346939,0.030612245,0.617346939,0,0.025358183
6711,12,21119,2,5,11,0,0,18,10,10,0,0,0,20,nowin,loss,beat,dlwin,0,10,7,189,0.470899471,0.015873016,0.613756614,3,0.929171178
6712,102,21119,9,2,9,0,0,20,10,10,0,0,0,20,nowin,push,push,push,10,0,11,192,0.338541667,0.046875,0.5625,0,0.003306118
6713,125,21119,10,10,0,0,0,20,10,10,0,0,0,20,nowin,push,push,push,10,0,20,219,0.438356164,0.050228311,0.575342466,1,0.308411257
6714,87,21120,3,7,5,1,4,20,7,8,10,0,0,25,nowin,win,dlbust,bust,20,0,10,202,0.405940594,0.054455446,0.628712871,2,0.590599801
6715,143,21120,8,5,0,8,0,21,7,8,10,0,0,25,nowin,win,dlbust,bust,20,0,13,203,0.463054187,0.044334975,0.57635468,3,0.883143365
6716,12,21120,10,6,0,8,0,24,7,8,10,0,0,25,nowin,loss,bust,plbust,0,10,16,189,0.470899471,0.015873016,0.613756614,3,0.929171178
6717,128,21120,10,10,0,0,0,20,7,8,10,0,0,25,nowin,win,dlbust,bust,20,0,20,227,0.356828194,0.052863436,0.577092511,0,0.012352564
6718,85,21120,10,10,0,0,0,20,7,8,10,0,0,25,nowin,win,dlbust,bust,20,0,20,195,0.41025641,0.066666667,0.594871795,0,0.03269711
6719,141,21120,8,9,0,0,0,17,7,8,10,0,0,25,nowin,win,dlbust,bust,20,0,17,202,0.420792079,0.074257426,0.564356436,0,0.028377851
6720,95,21121,2,7,6,10,0,25,8,8,10,0,0,26,nowin,loss,bust,plbust,0,10,9,218,0.412844037,0.04587156,0.559633028,0,0.024842385
6721,23,21121,5,7,0,1,10,23,8,8,10,0,0,26,nowin,loss,bust,plbust,0,10,12,208,0.427884615,0.0625,0.552884615,1,0.29114424
6722,122,21121,4,9,0,1,10,24,8,8,10,0,0,26,nowin,loss,bust,plbust,0,10,13,210,0.347619048,0.052380952,0.59047619,0,0.012873677
6723,27,21121,8,10,0,0,0,18,8,8,10,0,0,26,nowin,win,dlbust,bust,20,0,18,178,0.370786517,0.016853933,0.573033708,0,0.015536309
6724,37,21121,4,9,0,10,0,23,8,8,10,0,0,26,nowin,loss,bust,plbust,0,10,13,208,0.394230769,0.038461538,0.581730769,0,0.024682772
6725,146,21121,10,10,0,0,0,20,8,8,10,0,0,26,nowin,win,dlbust,bust,20,0,20,221,0.43438914,0.040723982,0.542986425,1,0.290190091
6726,129,21122,6,1,10,0,0,17,7,5,7,0,0,19,nowin,loss,beat,dlwin,0,10,7,201,0.422885572,0.064676617,0.55721393,0,0.027255383
6727,33,21122,3,4,11,0,0,18,7,5,7,0,0,19,nowin,loss,beat,dlwin,0,10,7,192,0.4375,0.057291667,0.625,2,0.616208916
6728,17,21122,10,10,0,0,0,20,7,5,7,0,0,19,nowin,win,plwin,beat,20,0,20,171,0.444444444,0.070175439,0.555555556,1,0.302364894
6729,71,21122,8,10,0,0,0,18,7,5,7,0,0,19,nowin,loss,beat,dlwin,0,10,18,193,0.352331606,0.046632124,0.585492228,0,0.013063661
6730,87,21122,6,4,2,3,4,19,7,5,7,0,0,19,nowin,push,push,push,10,0,10,202,0.405940594,0.054455446,0.628712871,2,0.590599801
6731,85,21122,2,4,11,0,0,17,7,5,7,0,0,19,nowin,loss,beat,dlwin,0,10,6,195,0.41025641,0.066666667,0.594871795,0,0.03269711
6732,116,21123,3,10,0,10,0,23,10,11,0,0,0,21,nowin,loss,bust,plbust,0,10,13,195,0.425641026,0.056410256,0.538461538,1,0.28273747
6733,49,21123,11,9,0,0,0,20,10,11,0,0,0,21,nowin,loss,beat,dlwin,0,10,20,207,0.396135266,0.053140097,0.594202899,0,0.028306925
6734,99,21123,10,9,0,0,0,19,10,11,0,0,0,21,nowin,loss,beat,dlwin,0,10,19,207,0.47826087,0.062801932,0.637681159,3,0.961418446
6735,22,21123,7,10,0,0,0,17,10,11,0,0,0,21,nowin,loss,beat,dlwin,0,10,17,187,0.481283422,0.042780749,0.577540107,3,0.906128176
6736,120,21123,10,4,0,8,0,22,10,11,0,0,0,21,nowin,loss,bust,plbust,0,10,14,202,0.440594059,0.034653465,0.618811881,2,0.614441029
6737,10,21123,7,10,0,0,0,17,10,11,0,0,0,21,nowin,loss,beat,dlwin,0,10,17,191,0.413612565,0.057591623,0.596858639,2,0.574087175
6738,25,21124,6,3,10,0,0,19,4,10,4,0,0,18,nowin,win,plwin,beat,20,0,9,190,0.463157895,0.063157895,0.536842105,1,0.304401563
6739,31,21124,5,8,0,0,0,13,4,10,4,0,0,18,nowin,loss,beat,dlwin,0,10,13,188,0.473404255,0.058510638,0.515957447,1,0.300306557
6740,11,21124,4,10,0,0,0,14,4,10,4,0,0,18,nowin,loss,beat,dlwin,0,10,14,236,0.457627119,0.016949153,0.588983051,3,0.889015813
6741,148,21124,4,10,0,0,0,14,4,10,4,0,0,18,nowin,loss,beat,dlwin,0,10,14,204,0.401960784,0.078431373,0.593137255,0,0.029789521
6742,20,21124,3,5,8,0,0,16,4,10,4,0,0,18,nowin,loss,beat,dlwin,0,10,8,186,0.456989247,0.037634409,0.537634409,1,0.301097108
6743,143,21124,10,10,0,0,0,20,4,10,4,0,0,18,nowin,win,plwin,beat,20,0,20,203,0.463054187,0.044334975,0.57635468,3,0.883143365
6744,88,21125,6,2,2,9,0,19,4,11,4,0,0,19,nowin,push,push,push,10,0,8,206,0.466019417,0.033980583,0.54368932,1,0.309467903
6745,107,21125,4,6,10,0,0,20,4,11,4,0,0,19,nowin,win,plwin,beat,20,0,10,218,0.444954128,0.073394495,0.600917431,2,0.605210014
6746,39,21125,5,9,0,0,0,14,4,11,4,0,0,19,nowin,loss,beat,dlwin,0,10,14,191,0.429319372,0.062827225,0.57591623,0,0.033760763
6747,86,21125,1,1,10,0,0,12,4,11,4,0,0,19,nowin,loss,beat,dlwin,0,10,2,196,0.454081633,0.040816327,0.591836735,3,0.887566443
6748,51,21125,10,10,0,0,0,20,4,11,4,0,0,19,nowin,win,plwin,beat,20,0,20,189,0.529100529,0.068783069,0.608465608,3,0.993665715
6749,5,21125,6,5,1,0,0,12,4,11,4,0,0,19,nowin,loss,beat,dlwin,0,10,11,203,0.42364532,0.02955665,0.596059113,2,0.582508076
6750,141,21126,5,1,10,0,0,16,5,10,10,0,0,25,nowin,win,dlbust,bust,20,0,6,202,0.420792079,0.074257426,0.564356436,0,0.028377851
6751,90,21126,3,6,11,0,0,20,5,10,10,0,0,25,nowin,win,dlbust,bust,20,0,9,201,0.447761194,0.049751244,0.60199005,3,0.889945023
6752,76,21126,3,9,0,0,0,12,5,10,10,0,0,25,nowin,win,dlbust,bust,20,0,12,189,0.534391534,0.079365079,0.608465608,3,1
6753,20,21126,8,7,0,0,0,15,5,10,10,0,0,25,nowin,win,dlbust,bust,20,0,15,186,0.456989247,0.037634409,0.537634409,1,0.301097108
6754,68,21126,10,6,0,0,0,16,5,10,10,0,0,25,nowin,win,dlbust,bust,20,0,16,205,0.434146341,0.029268293,0.6,2,0.59483189
6755,93,21126,6,1,10,0,0,17,5,10,10,0,0,25,nowin,win,dlbust,bust,20,0,7,175,0.485714286,0.051428571,0.548571429,1,0.323648091
6756,94,21127,3,2,11,0,0,16,4,9,10,0,0,23,nowin,win,dlbust,bust,20,0,5,183,0.43715847,0.043715847,0.540983607,1,0.290866892
6757,110,21127,10,10,0,0,0,20,4,9,10,0,0,23,nowin,win,dlbust,bust,20,0,20,192,0.416666667,0.046875,0.557291667,0,0.025413132
6758,5,21127,6,4,10,0,0,20,4,9,10,0,0,23,nowin,win,dlbust,bust,20,0,10,203,0.42364532,0.02955665,0.596059113,2,0.582508076
6759,27,21127,11,10,0,0,0,21,4,9,10,0,0,23,win,win,dlbust,bust,25,0,21,178,0.370786517,0.016853933,0.573033708,0,0.015536309
6760,150,21127,7,11,0,0,0,18,4,9,10,0,0,23,nowin,win,dlbust,bust,20,0,18,192,0.401041667,0.036458333,0.567708333,0,0.023287458
6761,51,21127,10,6,0,0,0,16,4,9,10,0,0,23,nowin,win,dlbust,bust,20,0,16,189,0.529100529,0.068783069,0.608465608,3,0.993665715
6762,70,21128,10,6,0,10,0,26,10,6,6,0,0,22,nowin,loss,bust,plbust,0,10,16,228,0.385964912,0.039473684,0.557017544,0,0.016157125
6763,109,21128,10,4,0,10,0,24,10,6,6,0,0,22,nowin,loss,bust,plbust,0,10,14,221,0.461538462,0.058823529,0.597285068,3,0.901830309
6764,103,21128,9,2,6,0,0,17,10,6,6,0,0,22,nowin,win,dlbust,bust,20,0,11,203,0.379310345,0.064039409,0.551724138,0,0.012869209
6765,96,21128,8,10,0,0,0,18,10,6,6,0,0,22,nowin,win,dlbust,bust,20,0,18,190,0.468421053,0.057894737,0.584210526,3,0.897263354
6766,82,21128,5,8,0,10,0,23,10,6,6,0,0,22,nowin,loss,bust,plbust,0,10,13,225,0.408888889,0.075555556,0.577777778,0,0.028101874
6767,54,21128,3,3,2,10,0,18,10,6,6,0,0,22,nowin,win,dlbust,bust,20,0,6,185,0.437837838,0.032432432,0.556756757,1,0.29899854
6768,99,21129,10,10,0,0,0,20,11,2,4,0,0,17,nowin,win,plwin,beat,20,0,20,207,0.47826087,0.062801932,0.637681159,3,0.961418446
6769,12,21129,10,4,0,5,0,19,11,2,4,0,0,17,nowin,win,plwin,beat,20,0,14,189,0.470899471,0.015873016,0.613756614,3,0.929171178
6770,87,21129,10,3,0,2,6,21,11,2,4,0,0,17,nowin,win,plwin,beat,20,0,13,202,0.405940594,0.054455446,0.628712871,2,0.590599801
6771,21,21129,10,10,0,0,0,20,11,2,4,0,0,17,nowin,win,plwin,beat,20,0,20,214,0.359813084,0.042056075,0.626168224,0,0.025263474
6772,101,21129,10,9,0,0,0,19,11,2,4,0,0,17,nowin,win,plwin,beat,20,0,19,205,0.424390244,0.068292683,0.63902439,2,0.614740646
6773,54,21129,2,8,3,1,2,16,11,2,4,0,0,17,nowin,loss,beat,dlwin,0,10,10,185,0.437837838,0.032432432,0.556756757,1,0.29899854
6774,38,21130,10,11,0,0,0,21,9,3,7,0,0,19,win,win,plwin,beat,25,0,21,202,0.361386139,0.03960396,0.564356436,0,0.010597953
6775,76,21130,2,7,10,0,0,19,9,3,7,0,0,19,nowin,push,push,push,10,0,9,189,0.534391534,0.079365079,0.608465608,3,1
6776,23,21130,11,9,0,0,0,20,9,3,7,0,0,19,nowin,win,plwin,beat,20,0,20,208,0.427884615,0.0625,0.552884615,1,0.29114424
6777,51,21130,1,2,10,3,2,18,9,3,7,0,0,19,nowin,loss,beat,dlwin,0,10,3,189,0.529100529,0.068783069,0.608465608,3,0.993665715
6778,135,21130,8,4,0,10,0,22,9,3,7,0,0,19,nowin,loss,bust,plbust,0,10,12,179,0.391061453,0.067039106,0.586592179,0,0.024924662
6779,92,21130,5,10,0,10,0,25,9,3,7,0,0,19,nowin,loss,bust,plbust,0,10,15,186,0.446236559,0.059139785,0.564516129,1,0.307826125
6780,68,21131,3,10,0,10,0,23,11,10,0,0,0,21,nowin,loss,bust,plbust,0,10,13,205,0.434146341,0.029268293,0.6,2,0.59483189
6781,142,21131,4,10,0,2,4,20,11,10,0,0,0,21,nowin,loss,beat,dlwin,0,10,14,211,0.417061611,0.047393365,0.526066351,1,0.271531309
6782,147,21131,10,8,0,0,0,18,11,10,0,0,0,21,nowin,loss,beat,dlwin,0,10,18,205,0.380487805,0.014634146,0.536585366,0,0.00951447
6783,132,21131,3,11,7,0,0,21,11,10,0,0,0,21,nowin,push,push,push,10,0,14,194,0.412371134,0.036082474,0.649484536,2,0.611633238
6784,64,21131,6,1,10,0,0,17,11,10,0,0,0,21,nowin,loss,beat,dlwin,0,10,7,187,0.363636364,0.048128342,0.631016043,0,0.027594885
6785,93,21131,11,7,0,0,0,18,11,10,0,0,0,21,nowin,loss,beat,dlwin,0,10,18,175,0.485714286,0.051428571,0.548571429,1,0.323648091
6786,66,21132,10,7,0,0,0,17,5,9,4,0,0,18,nowin,loss,beat,dlwin,0,10,17,217,0.456221198,0.064516129,0.626728111,3,0.924304367
6787,43,21132,7,7,0,0,0,14,5,9,4,0,0,18,nowin,loss,beat,dlwin,0,10,14,192,0.40625,0.041666667,0.609375,2,0.576671372
6788,73,21132,10,5,0,0,0,15,5,9,4,0,0,18,nowin,loss,beat,dlwin,0,10,15,181,0.375690608,0.011049724,0.596685083,0,0.022795773
6789,1,21132,7,10,0,0,0,17,5,9,4,0,0,18,nowin,loss,beat,dlwin,0,10,17,197,0.406091371,0.025380711,0.649746193,2,0.606186955
6790,54,21132,3,2,10,0,0,15,5,9,4,0,0,18,nowin,loss,beat,dlwin,0,10,5,185,0.437837838,0.032432432,0.556756757,1,0.29899854
6791,7,21132,2,6,6,0,0,14,5,9,4,0,0,18,nowin,loss,beat,dlwin,0,10,8,183,0.442622951,0.06010929,0.62295082,2,0.619303341
6792,138,21133,3,1,8,8,0,20,3,8,7,0,0,18,nowin,win,plwin,beat,20,0,4,190,0.442105263,0.047368421,0.610526316,2,0.609711065
6793,51,21133,11,10,0,0,0,21,3,8,7,0,0,18,win,win,plwin,beat,25,0,21,189,0.529100529,0.068783069,0.608465608,3,0.993665715
6794,122,21133,1,4,10,0,0,15,3,8,7,0,0,18,nowin,loss,beat,dlwin,0,10,5,210,0.347619048,0.052380952,0.59047619,0,0.012873677
6795,83,21133,4,6,3,0,0,13,3,8,7,0,0,18,nowin,loss,beat,dlwin,0,10,10,193,0.424870466,0.051813472,0.678756477,2,0.644360335
6796,120,21133,10,10,0,0,0,20,3,8,7,0,0,18,nowin,win,plwin,beat,20,0,20,202,0.440594059,0.034653465,0.618811881,2,0.614441029
6797,14,21133,4,7,10,0,0,21,3,8,7,0,0,18,nowin,win,plwin,beat,20,0,11,202,0.391089109,0.01980198,0.628712871,2,0.577264877
6798,64,21134,10,10,0,0,0,20,4,5,10,0,0,19,nowin,win,plwin,beat,20,0,20,187,0.363636364,0.048128342,0.631016043,0,0.027594885
6799,134,21134,2,9,9,0,0,20,4,5,10,0,0,19,nowin,win,plwin,beat,20,0,11,185,0.443243243,0.021621622,0.545945946,1,0.296939509
6800,42,21134,10,9,0,0,0,19,4,5,10,0,0,19,nowin,push,push,push,10,0,19,212,0.443396226,0.051886792,0.570754717,1,0.309181312
6801,118,21134,10,5,0,0,0,15,4,5,10,0,0,19,nowin,loss,beat,dlwin,0,10,15,216,0.393518519,0.037037037,0.555555556,0,0.018059873
6802,103,21134,10,2,0,0,0,12,4,5,10,0,0,19,nowin,loss,beat,dlwin,0,10,12,203,0.379310345,0.064039409,0.551724138,0,0.012869209
6803,108,21134,9,10,0,0,0,19,4,5,10,0,0,19,nowin,push,push,push,10,0,19,193,0.435233161,0.056994819,0.559585492,1,0.298824795
6804,80,21135,6,9,0,3,0,18,9,8,0,0,0,17,nowin,win,plwin,beat,20,0,15,186,0.419354839,0.059139785,0.623655914,2,0.59892924
6805,37,21135,7,10,0,0,0,17,9,8,0,0,0,17,nowin,push,push,push,10,0,17,208,0.394230769,0.038461538,0.581730769,0,0.024682772
6806,12,21135,5,8,0,6,0,19,9,8,0,0,0,17,nowin,win,plwin,beat,20,0,13,189,0.470899471,0.015873016,0.613756614,3,0.929171178
6807,39,21135,10,2,0,7,0,19,9,8,0,0,0,17,nowin,win,plwin,beat,20,0,12,191,0.429319372,0.062827225,0.57591623,0,0.033760763
6808,76,21135,5,10,0,4,0,19,9,8,0,0,0,17,nowin,win,plwin,beat,20,0,15,189,0.534391534,0.079365079,0.608465608,3,1
6809,116,21135,10,10,0,0,0,20,9,8,0,0,0,17,nowin,win,plwin,beat,20,0,20,195,0.425641026,0.056410256,0.538461538,1,0.28273747
6810,79,21136,6,3,11,0,0,20,10,8,0,0,0,18,nowin,win,plwin,beat,20,0,9,211,0.436018957,0.028436019,0.672985782,2,0.650131054
6811,149,21136,11,10,0,0,0,21,10,8,0,0,0,18,win,win,plwin,beat,25,0,21,225,0.457777778,0.057777778,0.648888889,2,0.651965595
6812,38,21136,10,7,0,0,0,17,10,8,0,0,0,18,nowin,loss,beat,dlwin,0,10,17,202,0.361386139,0.03960396,0.564356436,0,0.010597953
6813,77,21136,5,8,0,9,0,22,10,8,0,0,0,18,nowin,loss,bust,plbust,0,10,13,200,0.455,0.04,0.62,3,0.916252116
6814,99,21136,1,4,10,10,0,25,10,8,0,0,0,18,nowin,loss,bust,plbust,0,10,5,207,0.47826087,0.062801932,0.637681159,3,0.961418446
6815,123,21136,3,9,0,7,0,19,10,8,0,0,0,18,nowin,win,plwin,beat,20,0,12,205,0.43902439,0.034146341,0.614634146,2,0.609962544
6816,23,21137,4,8,0,5,0,17,9,11,0,0,0,20,nowin,loss,beat,dlwin,0,10,12,208,0.427884615,0.0625,0.552884615,1,0.29114424
6817,76,21137,10,3,0,5,0,18,9,11,0,0,0,20,nowin,loss,beat,dlwin,0,10,13,189,0.534391534,0.079365079,0.608465608,3,1
6818,77,21137,5,10,0,10,0,25,9,11,0,0,0,20,nowin,loss,bust,plbust,0,10,15,200,0.455,0.04,0.62,3,0.916252116
6819,48,21137,5,9,0,1,2,17,9,11,0,0,0,20,nowin,loss,beat,dlwin,0,10,14,203,0.413793103,0.019704433,0.600985222,2,0.577280801
6820,129,21137,4,5,6,4,0,19,9,11,0,0,0,20,nowin,loss,beat,dlwin,0,10,9,201,0.422885572,0.064676617,0.55721393,0,0.027255383
6821,39,21137,6,10,0,2,0,18,9,11,0,0,0,20,nowin,loss,beat,dlwin,0,10,16,191,0.429319372,0.062827225,0.57591623,0,0.033760763
6822,15,21138,10,9,0,0,0,19,5,7,4,1,0,17,nowin,win,plwin,beat,20,0,19,212,0.410377358,0.051886792,0.561320755,0,0.024517408
6823,119,21138,4,4,10,0,0,18,5,7,4,1,0,17,nowin,win,plwin,beat,20,0,8,190,0.405263158,0.068421053,0.515789474,0,0.011837158
6824,90,21138,10,9,0,0,0,19,5,7,4,1,0,17,nowin,win,plwin,beat,20,0,19,201,0.447761194,0.049751244,0.60199005,3,0.889945023
6825,132,21138,5,10,0,0,0,15,5,7,4,1,0,17,nowin,loss,beat,dlwin,0,10,15,194,0.412371134,0.036082474,0.649484536,2,0.611633238
6826,63,21138,10,4,0,0,0,14,5,7,4,1,0,17,nowin,loss,beat,dlwin,0,10,14,216,0.467592593,0.037037037,0.62037037,3,0.931690496
6827,55,21138,10,3,0,0,0,13,5,7,4,1,0,17,nowin,loss,beat,dlwin,0,10,13,191,0.371727749,0.057591623,0.54973822,0,0.01011347
6828,56,21139,10,8,0,0,0,18,10,7,0,0,0,17,nowin,win,plwin,beat,20,0,18,175,0.4,0.057142857,0.582857143,0,0.026685297
6829,28,21139,10,10,0,0,0,20,10,7,0,0,0,17,nowin,win,plwin,beat,20,0,20,199,0.422110553,0.045226131,0.542713568,1,0.282706618
6830,54,21139,7,2,10,0,0,19,10,7,0,0,0,17,nowin,win,plwin,beat,20,0,9,185,0.437837838,0.032432432,0.556756757,1,0.29899854
6831,130,21139,4,7,5,1,0,17,10,7,0,0,0,17,nowin,push,push,push,10,0,11,219,0.410958904,0.03652968,0.566210046,0,0.025888739
6832,21,21139,6,9,0,7,0,22,10,7,0,0,0,17,nowin,loss,bust,plbust,0,10,15,214,0.359813084,0.042056075,0.626168224,0,0.025263474
6833,79,21139,10,10,0,0,0,20,10,7,0,0,0,17,nowin,win,plwin,beat,20,0,20,211,0.436018957,0.028436019,0.672985782,2,0.650131054
6834,92,21140,11,10,0,0,0,21,11,9,0,0,0,20,win,win,plwin,beat,25,0,21,186,0.446236559,0.059139785,0.564516129,1,0.307826125
6835,77,21140,10,10,0,0,0,20,11,9,0,0,0,20,nowin,push,push,push,10,0,20,200,0.455,0.04,0.62,3,0.916252116
6836,78,21140,6,9,0,8,0,23,11,9,0,0,0,20,nowin,loss,bust,plbust,0,10,15,201,0.517412935,0.034825871,0.587064677,3,0.95871112
6837,99,21140,7,9,0,9,0,25,11,9,0,0,0,20,nowin,loss,bust,plbust,0,10,16,207,0.47826087,0.062801932,0.637681159,3,0.961418446
6838,32,21140,10,11,0,0,0,21,11,9,0,0,0,20,win,win,plwin,beat,25,0,21,189,0.391534392,0.037037037,0.53968254,0,0.013579086
6839,102,21140,7,9,0,3,0,19,11,9,0,0,0,20,nowin,loss,beat,dlwin,0,10,16,192,0.338541667,0.046875,0.5625,0,0.003306118
6840,128,21141,10,10,0,0,0,20,10,3,8,0,0,21,nowin,loss,beat,dlwin,0,10,20,227,0.356828194,0.052863436,0.577092511,0,0.012352564
6841,140,21141,9,8,0,0,0,17,10,3,8,0,0,21,nowin,loss,beat,dlwin,0,10,17,210,0.466666667,0.023809524,0.604761905,3,0.915293335
6842,94,21141,3,10,0,2,10,25,10,3,8,0,0,21,nowin,loss,bust,plbust,0,10,13,183,0.43715847,0.043715847,0.540983607,1,0.290866892
6843,71,21141,6,7,0,5,0,18,10,3,8,0,0,21,nowin,loss,beat,dlwin,0,10,13,193,0.352331606,0.046632124,0.585492228,0,0.013063661
6844,144,21141,7,10,0,0,0,17,10,3,8,0,0,21,nowin,loss,beat,dlwin,0,10,17,202,0.386138614,0.054455446,0.564356436,0,0.018006244
6845,40,21141,10,10,0,0,0,20,10,3,8,0,0,21,nowin,loss,beat,dlwin,0,10,20,196,0.367346939,0.030612245,0.617346939,0,0.025358183
6846,120,21142,11,2,3,10,0,26,8,7,5,0,0,20,nowin,loss,bust,plbust,0,10,13,202,0.440594059,0.034653465,0.618811881,2,0.614441029
6847,59,21142,2,10,0,5,0,17,8,7,5,0,0,20,nowin,loss,beat,dlwin,0,10,12,228,0.429824561,0.048245614,0.543859649,1,0.287885446
6848,130,21142,10,10,0,0,0,20,8,7,5,0,0,20,nowin,push,push,push,10,0,20,219,0.410958904,0.03652968,0.566210046,0,0.025888739
6849,38,21142,10,10,0,0,0,20,8,7,5,0,0,20,nowin,push,push,push,10,0,20,202,0.361386139,0.03960396,0.564356436,0,0.010597953
6850,59,21142,10,10,0,0,0,20,8,7,5,0,0,20,nowin,push,push,push,10,0,20,228,0.429824561,0.048245614,0.543859649,1,0.287885446
6851,139,21142,7,10,0,0,0,17,8,7,5,0,0,20,nowin,loss,beat,dlwin,0,10,17,192,0.380208333,0.036458333,0.59375,0,0.023429169
6852,143,21143,4,10,0,2,10,26,10,6,10,0,0,26,nowin,loss,bust,plbust,0,10,14,203,0.463054187,0.044334975,0.57635468,3,0.883143365
6853,33,21143,10,10,0,0,0,20,10,6,10,0,0,26,nowin,win,dlbust,bust,20,0,20,192,0.4375,0.057291667,0.625,2,0.616208916
6854,133,21143,8,11,0,0,0,19,10,6,10,0,0,26,nowin,win,dlbust,bust,20,0,19,201,0.47761194,0.064676617,0.611940299,3,0.935428111
6855,20,21143,3,10,0,5,0,18,10,6,10,0,0,26,nowin,win,dlbust,bust,20,0,13,186,0.456989247,0.037634409,0.537634409,1,0.301097108
6856,6,21143,10,4,0,10,0,24,10,6,10,0,0,26,nowin,loss,bust,plbust,0,10,14,191,0.439790576,0.047120419,0.581151832,1,0.31211505
6857,64,21143,9,2,2,7,0,20,10,6,10,0,0,26,nowin,win,dlbust,bust,20,0,11,187,0.363636364,0.048128342,0.631016043,0,0.027594885
6858,104,21144,7,9,0,0,0,16,4,9,4,0,0,17,nowin,loss,beat,dlwin,0,10,16,209,0.363636364,0.052631579,0.593301435,0,0.018359419
6859,32,21144,7,10,0,0,0,17,4,9,4,0,0,17,nowin,push,push,push,10,0,17,189,0.391534392,0.037037037,0.53968254,0,0.013579086
6860,66,21144,8,10,0,0,0,18,4,9,4,0,0,17,nowin,win,plwin,beat,20,0,18,217,0.456221198,0.064516129,0.626728111,3,0.924304367
6861,145,21144,2,10,0,0,0,12,4,9,4,0,0,17,nowin,loss,beat,dlwin,0,10,12,188,0.441489362,0.031914894,0.622340426,2,0.617837093
6862,13,21144,10,10,0,0,0,20,4,9,4,0,0,17,nowin,win,plwin,beat,20,0,20,206,0.417475728,0.063106796,0.621359223,2,0.59555479
6863,150,21144,3,5,9,0,0,17,4,9,4,0,0,17,nowin,push,push,push,10,0,8,192,0.401041667,0.036458333,0.567708333,0,0.023287458
6864,134,21145,9,2,9,0,0,20,10,11,0,0,0,21,nowin,loss,beat,dlwin,0,10,11,185,0.443243243,0.021621622,0.545945946,1,0.296939509
6865,81,21145,2,5,3,10,0,20,10,11,0,0,0,21,nowin,loss,beat,dlwin,0,10,7,182,0.395604396,0.043956044,0.60989011,2,0.567491261
6866,67,21145,5,9,0,3,0,17,10,11,0,0,0,21,nowin,loss,beat,dlwin,0,10,14,195,0.369230769,0.041025641,0.569230769,0,0.014139427
6867,148,21145,1,6,10,0,0,17,10,11,0,0,0,21,nowin,loss,beat,dlwin,0,10,7,204,0.401960784,0.078431373,0.593137255,0,0.029789521
6868,95,21145,9,10,0,0,0,19,10,11,0,0,0,21,nowin,loss,beat,dlwin,0,10,19,218,0.412844037,0.04587156,0.559633028,0,0.024842385
6869,107,21145,9,10,0,0,0,19,10,11,0,0,0,21,nowin,loss,beat,dlwin,0,10,19,218,0.444954128,0.073394495,0.600917431,2,0.605210014
6870,125,21146,3,2,10,0,0,15,3,2,10,4,0,19,nowin,loss,beat,dlwin,0,10,5,219,0.438356164,0.050228311,0.575342466,1,0.308411257
6871,75,21146,3,8,7,0,0,18,3,2,10,4,0,19,nowin,loss,beat,dlwin,0,10,11,191,0.418848168,0.052356021,0.570680628,0,0.029344702
6872,23,21146,10,9,0,0,0,19,3,2,10,4,0,19,nowin,push,push,push,10,0,19,208,0.427884615,0.0625,0.552884615,1,0.29114424
6873,24,21146,4,8,0,8,0,20,3,2,10,4,0,19,nowin,win,plwin,beat,20,0,12,207,0.458937198,0.048309179,0.570048309,1,0.318138014
6874,95,21146,10,10,0,0,0,20,3,2,10,4,0,19,nowin,win,plwin,beat,20,0,20,218,0.412844037,0.04587156,0.559633028,0,0.024842385
6875,108,21146,2,5,6,0,0,13,3,2,10,4,0,19,nowin,loss,beat,dlwin,0,10,7,193,0.435233161,0.056994819,0.559585492,1,0.298824795
6876,117,21147,10,10,0,0,0,20,3,8,9,0,0,20,nowin,push,push,push,10,0,20,173,0.410404624,0.069364162,0.606936416,2,0.578610282
6877,43,21147,2,10,0,8,0,20,3,8,9,0,0,20,nowin,push,push,push,10,0,12,192,0.40625,0.041666667,0.609375,2,0.576671372
6878,127,21147,2,10,0,8,0,20,3,8,9,0,0,20,nowin,push,push,push,10,0,12,201,0.402985075,0.029850746,0.60199005,0,0.032263937
6879,29,21147,10,8,0,0,0,18,3,8,9,0,0,20,nowin,loss,beat,dlwin,0,10,18,189,0.44973545,0.058201058,0.544973545,1,0.300349439
6880,95,21147,11,10,0,0,0,21,3,8,9,0,0,20,win,win,plwin,beat,25,0,21,218,0.412844037,0.04587156,0.559633028,0,0.024842385
6881,108,21147,10,10,0,0,0,20,3,8,9,0,0,20,nowin,push,push,push,10,0,20,193,0.435233161,0.056994819,0.559585492,1,0.298824795
6882,1,21148,2,3,9,8,0,22,9,5,10,0,0,24,nowin,loss,bust,plbust,0,10,5,197,0.406091371,0.025380711,0.649746193,2,0.606186955
6883,67,21148,10,3,0,10,0,23,9,5,10,0,0,24,nowin,loss,bust,plbust,0,10,13,195,0.369230769,0.041025641,0.569230769,0,0.014139427
6884,6,21148,3,7,9,0,0,19,9,5,10,0,0,24,nowin,win,dlbust,bust,20,0,10,191,0.439790576,0.047120419,0.581151832,1,0.31211505
6885,129,21148,10,9,0,0,0,19,9,5,10,0,0,24,nowin,win,dlbust,bust,20,0,19,201,0.422885572,0.064676617,0.55721393,0,0.027255383
6886,35,21148,10,10,0,0,0,20,9,5,10,0,0,24,nowin,win,dlbust,bust,20,0,20,202,0.410891089,0.044554455,0.633663366,2,0.598681573
6887,23,21148,7,10,0,0,0,17,9,5,10,0,0,24,nowin,win,dlbust,bust,20,0,17,208,0.427884615,0.0625,0.552884615,1,0.29114424
6888,99,21149,6,10,0,0,0,16,5,4,4,10,0,23,nowin,win,dlbust,bust,20,0,16,207,0.47826087,0.062801932,0.637681159,3,0.961418446
6889,150,21149,10,4,0,0,0,14,5,4,4,10,0,23,nowin,win,dlbust,bust,20,0,14,192,0.401041667,0.036458333,0.567708333,0,0.023287458
6890,56,21149,10,11,0,0,0,21,5,4,4,10,0,23,win,win,dlbust,bust,25,0,21,175,0.4,0.057142857,0.582857143,0,0.026685297
6891,141,21149,9,3,0,0,0,12,5,4,4,10,0,23,nowin,win,dlbust,bust,20,0,12,202,0.420792079,0.074257426,0.564356436,0,0.028377851
6892,142,21149,10,10,0,0,0,20,5,4,4,10,0,23,nowin,win,dlbust,bust,20,0,20,211,0.417061611,0.047393365,0.526066351,1,0.271531309
6893,56,21149,10,10,0,0,0,20,5,4,4,10,0,23,nowin,win,dlbust,bust,20,0,20,175,0.4,0.057142857,0.582857143,0,0.026685297
6894,122,21150,10,10,0,0,0,20,10,10,0,0,0,20,nowin,push,push,push,10,0,20,210,0.347619048,0.052380952,0.59047619,0,0.012873677
6895,74,21150,4,11,3,0,0,18,10,10,0,0,0,20,nowin,loss,beat,dlwin,0,10,15,209,0.411483254,0.04784689,0.531100478,0,0.017448125
6896,7,21150,5,10,0,6,0,21,10,10,0,0,0,20,nowin,win,plwin,beat,20,0,15,183,0.442622951,0.06010929,0.62295082,2,0.619303341
6897,23,21150,10,10,0,0,0,20,10,10,0,0,0,20,nowin,push,push,push,10,0,20,208,0.427884615,0.0625,0.552884615,1,0.29114424
6898,16,21150,10,10,0,0,0,20,10,10,0,0,0,20,nowin,push,push,push,10,0,20,220,0.427272727,0.081818182,0.6,2,0.588660176
6899,38,21150,7,3,7,0,0,17,10,10,0,0,0,20,nowin,loss,beat,dlwin,0,10,10,202,0.361386139,0.03960396,0.564356436,0,0.010597953
6900,74,21151,6,7,0,0,0,13,6,4,10,0,0,20,nowin,loss,beat,dlwin,0,10,13,209,0.411483254,0.04784689,0.531100478,0,0.017448125
6901,67,21151,2,10,0,0,0,12,6,4,10,0,0,20,nowin,loss,beat,dlwin,0,10,12,195,0.369230769,0.041025641,0.569230769,0,0.014139427
6902,120,21151,10,10,0,0,0,20,6,4,10,0,0,20,nowin,push,push,push,10,0,20,202,0.440594059,0.034653465,0.618811881,2,0.614441029
6903,5,21151,3,10,0,0,0,13,6,4,10,0,0,20,nowin,loss,beat,dlwin,0,10,13,203,0.42364532,0.02955665,0.596059113,2,0.582508076
6904,37,21151,3,4,9,0,0,16,6,4,10,0,0,20,nowin,loss,beat,dlwin,0,10,7,208,0.394230769,0.038461538,0.581730769,0,0.024682772
6905,92,21151,10,3,0,0,0,13,6,4,10,0,0,20,nowin,loss,beat,dlwin,0,10,13,186,0.446236559,0.059139785,0.564516129,1,0.307826125
6906,58,21152,9,10,0,0,0,19,5,10,9,0,0,24,nowin,win,dlbust,bust,20,0,19,195,0.430769231,0.041025641,0.584615385,2,0.580497586
6907,149,21152,2,2,11,0,0,15,5,10,9,0,0,24,nowin,win,dlbust,bust,20,0,4,225,0.457777778,0.057777778,0.648888889,2,0.651965595
6908,53,21152,10,10,0,0,0,20,5,10,9,0,0,24,nowin,win,dlbust,bust,20,0,20,250,0.372,0.064,0.564,0,0.013687345
6909,78,21152,7,4,10,0,0,21,5,10,9,0,0,24,nowin,win,dlbust,bust,20,0,11,201,0.517412935,0.034825871,0.587064677,3,0.95871112
6910,53,21152,7,10,0,0,0,17,5,10,9,0,0,24,nowin,win,dlbust,bust,20,0,17,250,0.372,0.064,0.564,0,0.013687345
6911,113,21152,10,5,0,0,0,15,5,10,9,0,0,24,nowin,win,dlbust,bust,20,0,15,199,0.407035176,0.055276382,0.668341709,2,0.620695264
6912,126,21153,4,4,8,0,0,16,5,10,8,0,0,23,nowin,win,dlbust,bust,20,0,8,188,0.457446809,0.074468085,0.60106383,3,0.900633203
6913,18,21153,9,4,0,0,0,13,5,10,8,0,0,23,nowin,win,dlbust,bust,20,0,13,182,0.461538462,0.043956044,0.587912088,3,0.892649374
6914,86,21153,11,1,3,0,0,15,5,10,8,0,0,23,nowin,win,dlbust,bust,20,0,12,196,0.454081633,0.040816327,0.591836735,3,0.887566443
6915,78,21153,7,10,0,0,0,17,5,10,8,0,0,23,nowin,win,dlbust,bust,20,0,17,201,0.517412935,0.034825871,0.587064677,3,0.95871112
6916,71,21153,4,10,0,0,0,14,5,10,8,0,0,23,nowin,win,dlbust,bust,20,0,14,193,0.352331606,0.046632124,0.585492228,0,0.013063661
6917,122,21153,10,8,0,0,0,18,5,10,8,0,0,23,nowin,win,dlbust,bust,20,0,18,210,0.347619048,0.052380952,0.59047619,0,0.012873677
6918,100,21154,5,6,5,0,0,16,5,8,9,0,0,22,nowin,win,dlbust,bust,20,0,11,190,0.452631579,0.036842105,0.594736842,3,0.888671154
6919,134,21154,4,9,0,0,0,13,5,8,9,0,0,22,nowin,win,dlbust,bust,20,0,13,185,0.443243243,0.021621622,0.545945946,1,0.296939509
6920,32,21154,2,6,5,0,0,13,5,8,9,0,0,22,nowin,win,dlbust,bust,20,0,8,189,0.391534392,0.037037037,0.53968254,0,0.013579086
6921,117,21154,3,8,1,0,0,12,5,8,9,0,0,22,nowin,win,dlbust,bust,20,0,11,173,0.410404624,0.069364162,0.606936416,2,0.578610282
6922,117,21154,10,11,0,0,0,21,5,8,9,0,0,22,win,win,dlbust,bust,25,0,21,173,0.410404624,0.069364162,0.606936416,2,0.578610282
6923,13,21154,9,7,0,0,0,16,5,8,9,0,0,22,nowin,win,dlbust,bust,20,0,16,206,0.417475728,0.063106796,0.621359223,2,0.59555479
6924,82,21155,1,3,10,0,0,14,4,2,10,5,0,21,nowin,loss,beat,dlwin,0,10,4,225,0.408888889,0.075555556,0.577777778,0,0.028101874
6925,23,21155,11,10,0,0,0,21,4,2,10,5,0,21,win,push,push,push,10,0,21,208,0.427884615,0.0625,0.552884615,1,0.29114424
6926,29,21155,6,1,5,0,0,12,4,2,10,5,0,21,nowin,loss,beat,dlwin,0,10,7,189,0.44973545,0.058201058,0.544973545,1,0.300349439
6927,22,21155,10,8,0,0,0,18,4,2,10,5,0,21,nowin,loss,beat,dlwin,0,10,18,187,0.481283422,0.042780749,0.577540107,3,0.906128176
6928,70,21155,3,10,0,0,0,13,4,2,10,5,0,21,nowin,loss,beat,dlwin,0,10,13,228,0.385964912,0.039473684,0.557017544,0,0.016157125
6929,150,21155,3,10,0,0,0,13,4,2,10,5,0,21,nowin,loss,beat,dlwin,0,10,13,192,0.401041667,0.036458333,0.567708333,0,0.023287458
6930,77,21156,7,11,0,0,0,18,8,4,10,0,0,22,nowin,win,dlbust,bust,20,0,18,200,0.455,0.04,0.62,3,0.916252116
6931,41,21156,4,2,3,7,5,21,8,4,10,0,0,22,nowin,win,dlbust,bust,20,0,6,192,0.364583333,0.036458333,0.520833333,0,0.00089702
6932,90,21156,10,10,0,0,0,20,8,4,10,0,0,22,nowin,win,dlbust,bust,20,0,20,201,0.447761194,0.049751244,0.60199005,3,0.889945023
6933,24,21156,2,6,10,0,0,18,8,4,10,0,0,22,nowin,win,dlbust,bust,20,0,8,207,0.458937198,0.048309179,0.570048309,1,0.318138014
6934,76,21156,10,10,0,0,0,20,8,4,10,0,0,22,nowin,win,dlbust,bust,20,0,20,189,0.534391534,0.079365079,0.608465608,3,1
6935,91,21156,6,9,0,4,0,19,8,4,10,0,0,22,nowin,win,dlbust,bust,20,0,15,194,0.417525773,0.046391753,0.515463918,1,0.266616552
6936,1,21157,10,10,0,0,0,20,10,3,4,0,0,17,nowin,win,plwin,beat,20,0,20,197,0.406091371,0.025380711,0.649746193,2,0.606186955
6937,47,21157,10,2,0,10,0,22,10,3,4,0,0,17,nowin,loss,bust,plbust,0,10,12,210,0.438095238,0.057142857,0.623809524,2,0.615868808
6938,99,21157,8,5,0,8,0,21,10,3,4,0,0,17,nowin,win,plwin,beat,20,0,13,207,0.47826087,0.062801932,0.637681159,3,0.961418446
6939,134,21157,11,6,3,0,0,20,10,3,4,0,0,17,nowin,win,plwin,beat,20,0,17,185,0.443243243,0.021621622,0.545945946,1,0.296939509
6940,2,21157,7,3,10,0,0,20,10,3,4,0,0,17,nowin,win,plwin,beat,20,0,10,200,0.445,0.035,0.64,2,0.633962549
6941,105,21157,1,6,10,0,0,17,10,3,4,0,0,17,nowin,push,push,push,10,0,7,198,0.414141414,0.070707071,0.590909091,0,0.032889494
6942,97,21158,9,8,0,0,0,17,5,6,1,10,0,22,nowin,win,dlbust,bust,20,0,17,182,0.450549451,0.06043956,0.692307692,2,0.677372279
6943,45,21158,9,4,0,0,0,13,5,6,1,10,0,22,nowin,win,dlbust,bust,20,0,13,196,0.428571429,0.051020408,0.612244898,2,0.598821767
6944,107,21158,10,7,0,0,0,17,5,6,1,10,0,22,nowin,win,dlbust,bust,20,0,17,218,0.444954128,0.073394495,0.600917431,2,0.605210014
6945,99,21158,7,10,0,0,0,17,5,6,1,10,0,22,nowin,win,dlbust,bust,20,0,17,207,0.47826087,0.062801932,0.637681159,3,0.961418446
6946,38,21158,4,10,0,0,0,14,5,6,1,10,0,22,nowin,win,dlbust,bust,20,0,14,202,0.361386139,0.03960396,0.564356436,0,0.010597953
6947,125,21158,10,3,0,0,0,13,5,6,1,10,0,22,nowin,win,dlbust,bust,20,0,13,219,0.438356164,0.050228311,0.575342466,1,0.308411257
6948,141,21159,10,5,0,10,0,25,9,10,0,0,0,19,nowin,loss,bust,plbust,0,10,15,202,0.420792079,0.074257426,0.564356436,0,0.028377851
6949,90,21159,10,10,0,0,0,20,9,10,0,0,0,19,nowin,win,plwin,beat,20,0,20,201,0.447761194,0.049751244,0.60199005,3,0.889945023
6950,53,21159,5,10,0,5,0,20,9,10,0,0,0,19,nowin,win,plwin,beat,20,0,15,250,0.372,0.064,0.564,0,0.013687345
6951,90,21159,8,10,0,0,0,18,9,10,0,0,0,19,nowin,loss,beat,dlwin,0,10,18,201,0.447761194,0.049751244,0.60199005,3,0.889945023
6952,88,21159,6,2,10,0,0,18,9,10,0,0,0,19,nowin,loss,beat,dlwin,0,10,8,206,0.466019417,0.033980583,0.54368932,1,0.309467903
6953,123,21159,10,10,0,0,0,20,9,10,0,0,0,19,nowin,win,plwin,beat,20,0,20,205,0.43902439,0.034146341,0.614634146,2,0.609962544
6954,131,21160,10,6,0,2,0,18,10,9,0,0,0,19,nowin,loss,beat,dlwin,0,10,16,217,0.410138249,0.069124424,0.543778802,0,0.02015021
6955,143,21160,10,10,0,0,0,20,10,9,0,0,0,19,nowin,win,plwin,beat,20,0,20,203,0.463054187,0.044334975,0.57635468,3,0.883143365
6956,108,21160,4,6,6,1,0,17,10,9,0,0,0,19,nowin,loss,beat,dlwin,0,10,10,193,0.435233161,0.056994819,0.559585492,1,0.298824795
6957,38,21160,10,5,0,10,0,25,10,9,0,0,0,19,nowin,loss,bust,plbust,0,10,15,202,0.361386139,0.03960396,0.564356436,0,0.010597953
6958,55,21160,11,10,0,0,0,21,10,9,0,0,0,19,win,win,plwin,beat,25,0,21,191,0.371727749,0.057591623,0.54973822,0,0.01011347
6959,83,21160,2,5,11,0,0,18,10,9,0,0,0,19,nowin,loss,beat,dlwin,0,10,7,193,0.424870466,0.051813472,0.678756477,2,0.644360335
6960,122,21161,8,8,0,10,0,26,7,6,6,0,0,19,nowin,loss,bust,plbust,0,10,16,210,0.347619048,0.052380952,0.59047619,0,0.012873677
6961,15,21161,7,9,0,1,0,17,7,6,6,0,0,19,nowin,loss,beat,dlwin,0,10,16,212,0.410377358,0.051886792,0.561320755,0,0.024517408
6962,20,21161,5,3,5,6,0,19,7,6,6,0,0,19,nowin,push,push,push,10,0,8,186,0.456989247,0.037634409,0.537634409,1,0.301097108
6963,115,21161,4,10,0,5,0,19,7,6,6,0,0,19,nowin,push,push,push,10,0,14,194,0.427835052,0.041237113,0.592783505,2,0.583863602
6964,12,21161,10,9,0,0,0,19,7,6,6,0,0,19,nowin,push,push,push,10,0,19,189,0.470899471,0.015873016,0.613756614,3,0.929171178
6965,59,21161,7,7,0,1,3,18,7,6,6,0,0,19,nowin,loss,beat,dlwin,0,10,14,228,0.429824561,0.048245614,0.543859649,1,0.287885446
6966,42,21162,8,8,0,0,0,16,6,2,2,6,7,23,nowin,win,dlbust,bust,20,0,16,212,0.443396226,0.051886792,0.570754717,1,0.309181312
6967,107,21162,8,10,0,0,0,18,6,2,2,6,7,23,nowin,win,dlbust,bust,20,0,18,218,0.444954128,0.073394495,0.600917431,2,0.605210014
6968,30,21162,6,8,0,0,0,14,6,2,2,6,7,23,nowin,win,dlbust,bust,20,0,14,206,0.393203883,0.033980583,0.601941748,0,0.029324648
6969,130,21162,10,4,0,0,0,14,6,2,2,6,7,23,nowin,win,dlbust,bust,20,0,14,219,0.410958904,0.03652968,0.566210046,0,0.025888739
6970,150,21162,10,4,0,0,0,14,6,2,2,6,7,23,nowin,win,dlbust,bust,20,0,14,192,0.401041667,0.036458333,0.567708333,0,0.023287458
6971,2,21162,4,4,5,0,0,13,6,2,2,6,7,23,nowin,win,dlbust,bust,20,0,8,200,0.445,0.035,0.64,2,0.633962549
6972,76,21163,2,10,0,10,0,22,7,10,0,0,0,17,nowin,loss,bust,plbust,0,10,12,189,0.534391534,0.079365079,0.608465608,3,1
6973,106,21163,11,10,0,0,0,21,7,10,0,0,0,17,win,win,plwin,beat,25,0,21,192,0.411458333,0.026041667,0.557291667,0,0.023854304
6974,3,21163,3,10,0,3,7,23,7,10,0,0,0,17,nowin,loss,bust,plbust,0,10,13,190,0.431578947,0.026315789,0.542105263,1,0.288076384
6975,15,21163,10,3,0,9,0,22,7,10,0,0,0,17,nowin,loss,bust,plbust,0,10,13,212,0.410377358,0.051886792,0.561320755,0,0.024517408
6976,96,21163,4,9,0,10,0,23,7,10,0,0,0,17,nowin,loss,bust,plbust,0,10,13,190,0.468421053,0.057894737,0.584210526,3,0.897263354
6977,123,21163,9,7,0,10,0,26,7,10,0,0,0,17,nowin,loss,bust,plbust,0,10,16,205,0.43902439,0.034146341,0.614634146,2,0.609962544
6978,69,21164,4,11,4,0,0,19,9,6,9,0,0,24,nowin,win,dlbust,bust,20,0,15,194,0.365979381,0.030927835,0.515463918,0,0
6979,142,21164,10,10,0,0,0,20,9,6,9,0,0,24,nowin,win,dlbust,bust,20,0,20,211,0.417061611,0.047393365,0.526066351,1,0.271531309
6980,132,21164,10,10,0,0,0,20,9,6,9,0,0,24,nowin,win,dlbust,bust,20,0,20,194,0.412371134,0.036082474,0.649484536,2,0.611633238
6981,145,21164,2,8,10,0,0,20,9,6,9,0,0,24,nowin,win,dlbust,bust,20,0,10,188,0.441489362,0.031914894,0.622340426,2,0.617837093
6982,55,21164,8,4,0,8,0,20,9,6,9,0,0,24,nowin,win,dlbust,bust,20,0,12,191,0.371727749,0.057591623,0.54973822,0,0.01011347
6983,81,21164,2,9,3,10,0,24,9,6,9,0,0,24,nowin,loss,bust,plbust,0,10,11,182,0.395604396,0.043956044,0.60989011,2,0.567491261
6984,147,21165,4,2,7,10,0,23,10,2,6,0,0,18,nowin,loss,bust,plbust,0,10,6,205,0.380487805,0.014634146,0.536585366,0,0.00951447
6985,13,21165,10,10,0,0,0,20,10,2,6,0,0,18,nowin,win,plwin,beat,20,0,20,206,0.417475728,0.063106796,0.621359223,2,0.59555479
6986,3,21165,2,5,3,4,3,17,10,2,6,0,0,18,nowin,loss,beat,dlwin,0,10,7,190,0.431578947,0.026315789,0.542105263,1,0.288076384
6987,95,21165,2,2,8,2,10,24,10,2,6,0,0,18,nowin,loss,bust,plbust,0,10,4,218,0.412844037,0.04587156,0.559633028,0,0.024842385
6988,112,21165,10,11,0,0,0,21,10,2,6,0,0,18,win,win,plwin,beat,25,0,21,203,0.448275862,0.054187192,0.600985222,3,0.889576933
6989,9,21165,7,2,10,0,0,19,10,2,6,0,0,18,nowin,win,plwin,beat,20,0,9,194,0.37628866,0.015463918,0.541237113,0,0.009396796
6990,125,21166,9,4,0,0,0,13,5,6,4,6,0,21,nowin,loss,beat,dlwin,0,10,13,219,0.438356164,0.050228311,0.575342466,1,0.308411257
6991,87,21166,10,8,0,0,0,18,5,6,4,6,0,21,nowin,loss,beat,dlwin,0,10,18,202,0.405940594,0.054455446,0.628712871,2,0.590599801
6992,18,21166,10,6,0,0,0,16,5,6,4,6,0,21,nowin,loss,beat,dlwin,0,10,16,182,0.461538462,0.043956044,0.587912088,3,0.892649374
6993,80,21166,10,9,0,0,0,19,5,6,4,6,0,21,nowin,loss,beat,dlwin,0,10,19,186,0.419354839,0.059139785,0.623655914,2,0.59892924
6994,90,21166,7,3,11,0,0,21,5,6,4,6,0,21,nowin,push,push,push,10,0,10,201,0.447761194,0.049751244,0.60199005,3,0.889945023
6995,141,21166,5,9,0,0,0,14,5,6,4,6,0,21,nowin,loss,beat,dlwin,0,10,14,202,0.420792079,0.074257426,0.564356436,0,0.028377851
6996,94,21167,7,4,10,0,0,21,10,10,0,0,0,20,nowin,win,plwin,beat,20,0,11,183,0.43715847,0.043715847,0.540983607,1,0.290866892
6997,144,21167,3,10,0,9,0,22,10,10,0,0,0,20,nowin,loss,bust,plbust,0,10,13,202,0.386138614,0.054455446,0.564356436,0,0.018006244
6998,118,21167,11,8,0,0,0,19,10,10,0,0,0,20,nowin,loss,beat,dlwin,0,10,19,216,0.393518519,0.037037037,0.555555556,0,0.018059873
6999,33,21167,2,11,5,0,0,18,10,10,0,0,0,20,nowin,loss,beat,dlwin,0,10,13,192,0.4375,0.057291667,0.625,2,0.616208916
7000,65,21167,6,10,0,10,0,26,10,10,0,0,0,20,nowin,loss,bust,plbust,0,10,16,203,0.492610837,0.054187192,0.571428571,3,0.913702814
7001,142,21167,4,8,0,2,6,20,10,10,0,0,0,20,nowin,push,push,push,10,0,12,211,0.417061611,0.047393365,0.526066351,1,0.271531309
7002,136,21168,4,10,0,0,0,14,5,8,7,0,0,20,nowin,loss,beat,dlwin,0,10,14,194,0.396907216,0.025773196,0.597938144,0,0.029452644
7003,99,21168,10,10,0,0,0,20,5,8,7,0,0,20,nowin,push,push,push,10,0,20,207,0.47826087,0.062801932,0.637681159,3,0.961418446
7004,26,21168,11,3,1,0,0,15,5,8,7,0,0,20,nowin,loss,beat,dlwin,0,10,14,203,0.463054187,0.0591133,0.541871921,1,0.306802864
7005,31,21168,4,10,0,0,0,14,5,8,7,0,0,20,nowin,loss,beat,dlwin,0,10,14,188,0.473404255,0.058510638,0.515957447,1,0.300306557
7006,27,21168,9,3,0,0,0,12,5,8,7,0,0,20,nowin,loss,beat,dlwin,0,10,12,178,0.370786517,0.016853933,0.573033708,0,0.015536309
7007,18,21168,4,5,10,0,0,19,5,8,7,0,0,20,nowin,loss,beat,dlwin,0,10,9,182,0.461538462,0.043956044,0.587912088,3,0.892649374
7008,74,21169,1,5,10,7,0,23,11,1,4,8,0,24,nowin,loss,bust,plbust,0,10,6,209,0.411483254,0.04784689,0.531100478,0,0.017448125
7009,59,21169,9,2,3,10,0,24,11,1,4,8,0,24,nowin,loss,bust,plbust,0,10,11,228,0.429824561,0.048245614,0.543859649,1,0.287885446
7010,143,21169,9,8,0,0,0,17,11,1,4,8,0,24,nowin,win,dlbust,bust,20,0,17,203,0.463054187,0.044334975,0.57635468,3,0.883143365
7011,148,21169,5,1,10,6,0,22,11,1,4,8,0,24,nowin,loss,bust,plbust,0,10,6,204,0.401960784,0.078431373,0.593137255,0,0.029789521
7012,79,21169,10,8,0,0,0,18,11,1,4,8,0,24,nowin,win,dlbust,bust,20,0,18,211,0.436018957,0.028436019,0.672985782,2,0.650131054
7013,102,21169,6,2,3,7,0,18,11,1,4,8,0,24,nowin,win,dlbust,bust,20,0,8,192,0.338541667,0.046875,0.5625,0,0.003306118
7014,145,21170,11,5,5,0,0,21,2,2,10,2,10,26,nowin,win,dlbust,bust,20,0,16,188,0.441489362,0.031914894,0.622340426,2,0.617837093
7015,16,21170,9,5,0,0,0,14,2,2,10,2,10,26,nowin,win,dlbust,bust,20,0,14,220,0.427272727,0.081818182,0.6,2,0.588660176
7016,9,21170,4,8,0,6,0,18,2,2,10,2,10,26,nowin,win,dlbust,bust,20,0,12,194,0.37628866,0.015463918,0.541237113,0,0.009396796
7017,78,21170,8,10,0,0,0,18,2,2,10,2,10,26,nowin,win,dlbust,bust,20,0,18,201,0.517412935,0.034825871,0.587064677,3,0.95871112
7018,97,21170,10,3,0,0,0,13,2,2,10,2,10,26,nowin,win,dlbust,bust,20,0,13,182,0.450549451,0.06043956,0.692307692,2,0.677372279
7019,116,21170,5,10,0,0,0,15,2,2,10,2,10,26,nowin,win,dlbust,bust,20,0,15,195,0.425641026,0.056410256,0.538461538,1,0.28273747
7020,44,21171,6,10,0,8,0,24,8,10,0,0,0,18,nowin,loss,bust,plbust,0,10,16,219,0.433789954,0.050228311,0.534246575,1,0.285551035
7021,121,21171,6,6,0,7,0,19,8,10,0,0,0,18,nowin,win,plwin,beat,20,0,12,195,0.456410256,0.025641026,0.512820513,1,0.288597791
7022,42,21171,6,6,0,8,0,20,8,10,0,0,0,18,nowin,win,plwin,beat,20,0,12,212,0.443396226,0.051886792,0.570754717,1,0.309181312
7023,108,21171,2,10,0,10,0,22,8,10,0,0,0,18,nowin,loss,bust,plbust,0,10,12,193,0.435233161,0.056994819,0.559585492,1,0.298824795
7024,111,21171,9,10,0,0,0,19,8,10,0,0,0,18,nowin,win,plwin,beat,20,0,19,180,0.433333333,0.055555556,0.611111111,2,0.602264492
7025,88,21171,11,8,0,0,0,19,8,10,0,0,0,18,nowin,win,plwin,beat,20,0,19,206,0.466019417,0.033980583,0.54368932,1,0.309467903
7026,28,21172,2,10,0,0,0,12,5,10,10,0,0,25,nowin,win,dlbust,bust,20,0,12,199,0.422110553,0.045226131,0.542713568,1,0.282706618
7027,129,21172,10,4,0,0,0,14,5,10,10,0,0,25,nowin,win,dlbust,bust,20,0,14,201,0.422885572,0.064676617,0.55721393,0,0.027255383
7028,89,21172,10,10,0,0,0,20,5,10,10,0,0,25,nowin,win,dlbust,bust,20,0,20,212,0.537735849,0.047169811,0.594339623,3,0.990167191
7029,97,21172,10,11,0,0,0,21,5,10,10,0,0,25,win,win,dlbust,bust,25,0,21,182,0.450549451,0.06043956,0.692307692,2,0.677372279
7030,115,21172,9,4,0,0,0,13,5,10,10,0,0,25,nowin,win,dlbust,bust,20,0,13,194,0.427835052,0.041237113,0.592783505,2,0.583863602
7031,137,21172,10,11,0,0,0,21,5,10,10,0,0,25,win,win,dlbust,bust,25,0,21,194,0.417525773,0.046391753,0.536082474,1,0.276714602
7032,95,21173,6,10,0,6,0,22,10,3,9,0,0,22,nowin,loss,bust,plbust,0,10,16,218,0.412844037,0.04587156,0.559633028,0,0.024842385
7033,2,21173,7,6,0,1,5,19,10,3,9,0,0,22,nowin,win,dlbust,bust,20,0,13,200,0.445,0.035,0.64,2,0.633962549
7034,51,21173,7,5,0,10,0,22,10,3,9,0,0,22,nowin,loss,bust,plbust,0,10,12,189,0.529100529,0.068783069,0.608465608,3,0.993665715
7035,118,21173,9,10,0,0,0,19,10,3,9,0,0,22,nowin,win,dlbust,bust,20,0,19,216,0.393518519,0.037037037,0.555555556,0,0.018059873
7036,120,21173,9,10,0,0,0,19,10,3,9,0,0,22,nowin,win,dlbust,bust,20,0,19,202,0.440594059,0.034653465,0.618811881,2,0.614441029
7037,48,21173,10,10,0,0,0,20,10,3,9,0,0,22,nowin,win,dlbust,bust,20,0,20,203,0.413793103,0.019704433,0.600985222,2,0.577280801
7038,12,21174,10,9,0,0,0,19,2,10,10,0,0,22,nowin,win,dlbust,bust,20,0,19,189,0.470899471,0.015873016,0.613756614,3,0.929171178
7039,113,21174,11,10,0,0,0,21,2,10,10,0,0,22,win,win,dlbust,bust,25,0,21,199,0.407035176,0.055276382,0.668341709,2,0.620695264
7040,44,21174,5,3,11,0,0,19,2,10,10,0,0,22,nowin,win,dlbust,bust,20,0,8,219,0.433789954,0.050228311,0.534246575,1,0.285551035
7041,8,21174,7,8,0,0,0,15,2,10,10,0,0,22,nowin,win,dlbust,bust,20,0,15,181,0.44198895,0.071823204,0.596685083,2,0.599438402
7042,55,21174,6,5,2,0,0,13,2,10,10,0,0,22,nowin,win,dlbust,bust,20,0,11,191,0.371727749,0.057591623,0.54973822,0,0.01011347
7043,58,21174,5,10,0,0,0,15,2,10,10,0,0,22,nowin,win,dlbust,bust,20,0,15,195,0.430769231,0.041025641,0.584615385,2,0.580497586
7044,53,21175,10,10,0,0,0,20,5,1,8,10,0,24,nowin,win,dlbust,bust,20,0,20,250,0.372,0.064,0.564,0,0.013687345
7045,84,21175,2,10,0,0,0,12,5,1,8,10,0,24,nowin,win,dlbust,bust,20,0,12,195,0.379487179,0.056410256,0.569230769,0,0.017209119
7046,83,21175,10,10,0,0,0,20,5,1,8,10,0,24,nowin,win,dlbust,bust,20,0,20,193,0.424870466,0.051813472,0.678756477,2,0.644360335
7047,108,21175,10,3,0,0,0,13,5,1,8,10,0,24,nowin,win,dlbust,bust,20,0,13,193,0.435233161,0.056994819,0.559585492,1,0.298824795
7048,112,21175,10,4,0,0,0,14,5,1,8,10,0,24,nowin,win,dlbust,bust,20,0,14,203,0.448275862,0.054187192,0.600985222,3,0.889576933
7049,79,21175,2,10,0,0,0,12,5,1,8,10,0,24,nowin,win,dlbust,bust,20,0,12,211,0.436018957,0.028436019,0.672985782,2,0.650131054
7050,86,21176,3,5,10,0,0,18,9,5,10,0,0,24,nowin,win,dlbust,bust,20,0,8,196,0.454081633,0.040816327,0.591836735,3,0.887566443
7051,92,21176,6,10,0,10,0,26,9,5,10,0,0,24,nowin,loss,bust,plbust,0,10,16,186,0.446236559,0.059139785,0.564516129,1,0.307826125
7052,40,21176,5,10,0,10,0,25,9,5,10,0,0,24,nowin,loss,bust,plbust,0,10,15,196,0.367346939,0.030612245,0.617346939,0,0.025358183
7053,141,21176,10,11,0,0,0,21,9,5,10,0,0,24,win,win,dlbust,bust,25,0,21,202,0.420792079,0.074257426,0.564356436,0,0.028377851
7054,49,21176,1,6,5,7,0,19,9,5,10,0,0,24,nowin,win,dlbust,bust,20,0,7,207,0.396135266,0.053140097,0.594202899,0,0.028306925
7055,94,21176,10,10,0,0,0,20,9,5,10,0,0,24,nowin,win,dlbust,bust,20,0,20,183,0.43715847,0.043715847,0.540983607,1,0.290866892
7056,65,21177,5,7,0,0,0,12,6,10,5,0,0,21,nowin,loss,beat,dlwin,0,10,12,203,0.492610837,0.054187192,0.571428571,3,0.913702814
7057,29,21177,9,10,0,0,0,19,6,10,5,0,0,21,nowin,loss,beat,dlwin,0,10,19,189,0.44973545,0.058201058,0.544973545,1,0.300349439
7058,105,21177,6,2,5,0,0,13,6,10,5,0,0,21,nowin,loss,beat,dlwin,0,10,8,198,0.414141414,0.070707071,0.590909091,0,0.032889494
7059,50,21177,4,9,0,0,0,13,6,10,5,0,0,21,nowin,loss,beat,dlwin,0,10,13,202,0.405940594,0.04950495,0.54950495,0,0.020296079
7060,32,21177,2,10,0,0,0,12,6,10,5,0,0,21,nowin,loss,beat,dlwin,0,10,12,189,0.391534392,0.037037037,0.53968254,0,0.013579086
7061,43,21177,10,9,0,0,0,19,6,10,5,0,0,21,nowin,loss,beat,dlwin,0,10,19,192,0.40625,0.041666667,0.609375,2,0.576671372
7062,53,21178,10,8,0,0,0,18,11,4,5,0,0,20,nowin,loss,beat,dlwin,0,10,18,250,0.372,0.064,0.564,0,0.013687345
7063,139,21178,9,5,0,1,7,22,11,4,5,0,0,20,nowin,loss,bust,plbust,0,10,14,192,0.380208333,0.036458333,0.59375,0,0.023429169
7064,134,21178,6,1,8,9,0,24,11,4,5,0,0,20,nowin,loss,bust,plbust,0,10,7,185,0.443243243,0.021621622,0.545945946,1,0.296939509
7065,7,21178,7,9,0,2,0,18,11,4,5,0,0,20,nowin,loss,beat,dlwin,0,10,16,183,0.442622951,0.06010929,0.62295082,2,0.619303341
7066,3,21178,9,4,0,10,0,23,11,4,5,0,0,20,nowin,loss,bust,plbust,0,10,13,190,0.431578947,0.026315789,0.542105263,1,0.288076384
7067,118,21178,10,4,0,10,0,24,11,4,5,0,0,20,nowin,loss,bust,plbust,0,10,14,216,0.393518519,0.037037037,0.555555556,0,0.018059873
7068,7,21179,5,10,0,0,0,15,5,5,8,0,0,18,nowin,loss,beat,dlwin,0,10,15,183,0.442622951,0.06010929,0.62295082,2,0.619303341
7069,53,21179,10,7,0,0,0,17,5,5,8,0,0,18,nowin,loss,beat,dlwin,0,10,17,250,0.372,0.064,0.564,0,0.013687345
7070,18,21179,10,6,0,0,0,16,5,5,8,0,0,18,nowin,loss,beat,dlwin,0,10,16,182,0.461538462,0.043956044,0.587912088,3,0.892649374
7071,120,21179,6,10,0,0,0,16,5,5,8,0,0,18,nowin,loss,beat,dlwin,0,10,16,202,0.440594059,0.034653465,0.618811881,2,0.614441029
7072,19,21179,10,10,0,0,0,20,5,5,8,0,0,18,nowin,win,plwin,beat,20,0,20,237,0.41350211,0.054852321,0.628691983,2,0.597373826
7073,77,21179,4,7,4,0,0,15,5,5,8,0,0,18,nowin,loss,beat,dlwin,0,10,11,200,0.455,0.04,0.62,3,0.916252116
7074,96,21180,10,11,0,0,0,21,10,9,0,0,0,19,win,win,plwin,beat,25,0,21,190,0.468421053,0.057894737,0.584210526,3,0.897263354
7075,80,21180,2,2,11,4,0,19,10,9,0,0,0,19,nowin,push,push,push,10,0,4,186,0.419354839,0.059139785,0.623655914,2,0.59892924
7076,9,21180,10,4,0,10,0,24,10,9,0,0,0,19,nowin,loss,bust,plbust,0,10,14,194,0.37628866,0.015463918,0.541237113,0,0.009396796
7077,4,21180,6,10,0,10,0,26,10,9,0,0,0,19,nowin,loss,bust,plbust,0,10,16,217,0.460829493,0.036866359,0.562211982,1,0.315432839
7078,28,21180,3,5,11,0,0,19,10,9,0,0,0,19,nowin,push,push,push,10,0,8,199,0.422110553,0.045226131,0.542713568,1,0.282706618
7079,138,21180,10,10,0,0,0,20,10,9,0,0,0,19,nowin,win,plwin,beat,20,0,20,190,0.442105263,0.047368421,0.610526316,2,0.609711065
7080,142,21181,11,10,0,0,0,21,5,11,5,0,0,21,win,push,push,push,10,0,21,211,0.417061611,0.047393365,0.526066351,1,0.271531309
7081,56,21181,11,3,7,0,0,21,5,11,5,0,0,21,nowin,push,push,push,10,0,14,175,0.4,0.057142857,0.582857143,0,0.026685297
7082,79,21181,9,4,0,0,0,13,5,11,5,0,0,21,nowin,loss,beat,dlwin,0,10,13,211,0.436018957,0.028436019,0.672985782,2,0.650131054
7083,144,21181,10,3,0,0,0,13,5,11,5,0,0,21,nowin,loss,beat,dlwin,0,10,13,202,0.386138614,0.054455446,0.564356436,0,0.018006244
7084,82,21181,11,7,0,0,0,18,5,11,5,0,0,21,nowin,loss,beat,dlwin,0,10,18,225,0.408888889,0.075555556,0.577777778,0,0.028101874
7085,63,21181,6,7,0,0,0,13,5,11,5,0,0,21,nowin,loss,beat,dlwin,0,10,13,216,0.467592593,0.037037037,0.62037037,3,0.931690496
7086,118,21182,10,8,0,0,0,18,8,4,6,0,0,18,nowin,push,push,push,10,0,18,216,0.393518519,0.037037037,0.555555556,0,0.018059873
7087,97,21182,5,3,4,7,0,19,8,4,6,0,0,18,nowin,win,plwin,beat,20,0,8,182,0.450549451,0.06043956,0.692307692,2,0.677372279
7088,2,21182,11,10,0,0,0,21,8,4,6,0,0,18,win,win,plwin,beat,25,0,21,200,0.445,0.035,0.64,2,0.633962549
7089,96,21182,3,9,0,3,8,23,8,4,6,0,0,18,nowin,loss,bust,plbust,0,10,12,190,0.468421053,0.057894737,0.584210526,3,0.897263354
7090,78,21182,10,10,0,0,0,20,8,4,6,0,0,18,nowin,win,plwin,beat,20,0,20,201,0.517412935,0.034825871,0.587064677,3,0.95871112
7091,38,21182,10,7,0,0,0,17,8,4,6,0,0,18,nowin,loss,beat,dlwin,0,10,17,202,0.361386139,0.03960396,0.564356436,0,0.010597953
7092,130,21183,9,10,0,0,0,19,10,10,0,0,0,20,nowin,loss,beat,dlwin,0,10,19,219,0.410958904,0.03652968,0.566210046,0,0.025888739
7093,86,21183,11,6,3,0,0,20,10,10,0,0,0,20,nowin,push,push,push,10,0,17,196,0.454081633,0.040816327,0.591836735,3,0.887566443
7094,92,21183,8,4,0,2,10,24,10,10,0,0,0,20,nowin,loss,bust,plbust,0,10,12,186,0.446236559,0.059139785,0.564516129,1,0.307826125
7095,106,21183,10,10,0,0,0,20,10,10,0,0,0,20,nowin,push,push,push,10,0,20,192,0.411458333,0.026041667,0.557291667,0,0.023854304
7096,39,21183,4,10,0,10,0,24,10,10,0,0,0,20,nowin,loss,bust,plbust,0,10,14,191,0.429319372,0.062827225,0.57591623,0,0.033760763
7097,104,21183,4,7,1,5,0,17,10,10,0,0,0,20,nowin,loss,beat,dlwin,0,10,11,209,0.363636364,0.052631579,0.593301435,0,0.018359419
7098,2,21184,5,10,0,10,0,25,10,4,5,0,0,19,nowin,loss,bust,plbust,0,10,15,200,0.445,0.035,0.64,2,0.633962549
7099,57,21184,10,11,0,0,0,21,10,4,5,0,0,19,win,win,plwin,beat,25,0,21,192,0.46875,0.052083333,0.59375,3,0.907001181
7100,33,21184,3,5,8,1,0,17,10,4,5,0,0,19,nowin,loss,beat,dlwin,0,10,8,192,0.4375,0.057291667,0.625,2,0.616208916
7101,150,21184,8,9,0,0,0,17,10,4,5,0,0,19,nowin,loss,beat,dlwin,0,10,17,192,0.401041667,0.036458333,0.567708333,0,0.023287458
7102,30,21184,8,3,2,2,8,23,10,4,5,0,0,19,nowin,loss,bust,plbust,0,10,11,206,0.393203883,0.033980583,0.601941748,0,0.029324648
7103,112,21184,3,6,10,0,0,19,10,4,5,0,0,19,nowin,push,push,push,10,0,9,203,0.448275862,0.054187192,0.600985222,3,0.889576933
7104,128,21185,3,2,10,0,0,15,2,10,4,10,0,26,nowin,win,dlbust,bust,20,0,5,227,0.356828194,0.052863436,0.577092511,0,0.012352564
7105,21,21185,3,11,4,0,0,18,2,10,4,10,0,26,nowin,win,dlbust,bust,20,0,14,214,0.359813084,0.042056075,0.626168224,0,0.025263474
7106,43,21185,10,2,0,10,0,22,2,10,4,10,0,26,nowin,loss,bust,plbust,0,10,12,192,0.40625,0.041666667,0.609375,2,0.576671372
7107,79,21185,2,6,2,4,0,14,2,10,4,10,0,26,nowin,win,dlbust,bust,20,0,8,211,0.436018957,0.028436019,0.672985782,2,0.650131054
7108,96,21185,5,10,0,0,0,15,2,10,4,10,0,26,nowin,win,dlbust,bust,20,0,15,190,0.468421053,0.057894737,0.584210526,3,0.897263354
7109,120,21185,5,7,0,10,0,22,2,10,4,10,0,26,nowin,loss,bust,plbust,0,10,12,202,0.440594059,0.034653465,0.618811881,2,0.614441029
7110,110,21186,10,9,0,0,0,19,3,10,10,0,0,23,nowin,win,dlbust,bust,20,0,19,192,0.416666667,0.046875,0.557291667,0,0.025413132
7111,20,21186,10,4,0,0,0,14,3,10,10,0,0,23,nowin,win,dlbust,bust,20,0,14,186,0.456989247,0.037634409,0.537634409,1,0.301097108
7112,82,21186,3,2,10,0,0,15,3,10,10,0,0,23,nowin,win,dlbust,bust,20,0,5,225,0.408888889,0.075555556,0.577777778,0,0.028101874
7113,91,21186,5,3,9,0,0,17,3,10,10,0,0,23,nowin,win,dlbust,bust,20,0,8,194,0.417525773,0.046391753,0.515463918,1,0.266616552
7114,9,21186,2,7,10,0,0,19,3,10,10,0,0,23,nowin,win,dlbust,bust,20,0,9,194,0.37628866,0.015463918,0.541237113,0,0.009396796
7115,112,21186,10,6,0,0,0,16,3,10,10,0,0,23,nowin,win,dlbust,bust,20,0,16,203,0.448275862,0.054187192,0.600985222,3,0.889576933
7116,2,21187,3,2,5,10,0,20,10,2,7,0,0,19,nowin,win,plwin,beat,20,0,5,200,0.445,0.035,0.64,2,0.633962549
7117,48,21187,7,10,0,0,0,17,10,2,7,0,0,19,nowin,loss,beat,dlwin,0,10,17,203,0.413793103,0.019704433,0.600985222,2,0.577280801
7118,107,21187,10,10,0,0,0,20,10,2,7,0,0,19,nowin,win,plwin,beat,20,0,20,218,0.444954128,0.073394495,0.600917431,2,0.605210014
7119,120,21187,9,2,4,10,0,25,10,2,7,0,0,19,nowin,loss,bust,plbust,0,10,11,202,0.440594059,0.034653465,0.618811881,2,0.614441029
7120,14,21187,7,11,0,0,0,18,10,2,7,0,0,19,nowin,loss,beat,dlwin,0,10,18,202,0.391089109,0.01980198,0.628712871,2,0.577264877
7121,52,21187,4,10,0,1,8,23,10,2,7,0,0,19,nowin,loss,bust,plbust,0,10,14,217,0.414746544,0.02764977,0.599078341,2,0.576736024
7122,111,21188,10,11,0,0,0,21,10,10,0,0,0,20,win,win,plwin,beat,25,0,21,180,0.433333333,0.055555556,0.611111111,2,0.602264492
7123,129,21188,5,2,10,0,0,17,10,10,0,0,0,20,nowin,loss,beat,dlwin,0,10,7,201,0.422885572,0.064676617,0.55721393,0,0.027255383
7124,133,21188,10,10,0,0,0,20,10,10,0,0,0,20,nowin,push,push,push,10,0,20,201,0.47761194,0.064676617,0.611940299,3,0.935428111
7125,46,21188,3,2,10,9,0,24,10,10,0,0,0,20,nowin,loss,bust,plbust,0,10,5,186,0.403225806,0.048387097,0.591397849,0,0.029742194
7126,50,21188,11,10,0,0,0,21,10,10,0,0,0,20,win,win,plwin,beat,25,0,21,202,0.405940594,0.04950495,0.54950495,0,0.020296079
7127,81,21188,3,1,10,5,0,19,10,10,0,0,0,20,nowin,loss,beat,dlwin,0,10,4,182,0.395604396,0.043956044,0.60989011,2,0.567491261
7128,16,21189,11,10,0,0,0,21,10,4,7,0,0,21,win,push,push,push,10,0,21,220,0.427272727,0.081818182,0.6,2,0.588660176
7129,63,21189,11,10,0,0,0,21,10,4,7,0,0,21,win,push,push,push,10,0,21,216,0.467592593,0.037037037,0.62037037,3,0.931690496
7130,89,21189,5,9,0,8,0,22,10,4,7,0,0,21,nowin,loss,bust,plbust,0,10,14,212,0.537735849,0.047169811,0.594339623,3,0.990167191
7131,107,21189,10,2,0,10,0,22,10,4,7,0,0,21,nowin,loss,bust,plbust,0,10,12,218,0.444954128,0.073394495,0.600917431,2,0.605210014
7132,46,21189,11,10,0,0,0,21,10,4,7,0,0,21,win,push,push,push,10,0,21,186,0.403225806,0.048387097,0.591397849,0,0.029742194
7133,29,21189,2,7,6,1,3,19,10,4,7,0,0,21,nowin,loss,beat,dlwin,0,10,9,189,0.44973545,0.058201058,0.544973545,1,0.300349439
7134,121,21190,10,3,0,4,0,17,9,3,1,7,0,20,nowin,loss,beat,dlwin,0,10,13,195,0.456410256,0.025641026,0.512820513,1,0.288597791
7135,30,21190,5,4,11,0,0,20,9,3,1,7,0,20,nowin,push,push,push,10,0,9,206,0.393203883,0.033980583,0.601941748,0,0.029324648
7136,145,21190,10,10,0,0,0,20,9,3,1,7,0,20,nowin,push,push,push,10,0,20,188,0.441489362,0.031914894,0.622340426,2,0.617837093
7137,118,21190,9,10,0,0,0,19,9,3,1,7,0,20,nowin,loss,beat,dlwin,0,10,19,216,0.393518519,0.037037037,0.555555556,0,0.018059873
7138,97,21190,10,10,0,0,0,20,9,3,1,7,0,20,nowin,push,push,push,10,0,20,182,0.450549451,0.06043956,0.692307692,2,0.677372279
7139,129,21190,4,7,10,0,0,21,9,3,1,7,0,20,nowin,win,plwin,beat,20,0,11,201,0.422885572,0.064676617,0.55721393,0,0.027255383
7140,108,21191,10,10,0,0,0,20,10,4,5,0,0,19,nowin,win,plwin,beat,20,0,20,193,0.435233161,0.056994819,0.559585492,1,0.298824795
7141,16,21191,10,8,0,0,0,18,10,4,5,0,0,19,nowin,loss,beat,dlwin,0,10,18,220,0.427272727,0.081818182,0.6,2,0.588660176
7142,36,21191,2,6,8,1,0,17,10,4,5,0,0,19,nowin,loss,beat,dlwin,0,10,8,229,0.445414847,0.056768559,0.655021834,2,0.645370571
7143,99,21191,10,10,0,0,0,20,10,4,5,0,0,19,nowin,win,plwin,beat,20,0,20,207,0.47826087,0.062801932,0.637681159,3,0.961418446
7144,80,21191,5,9,0,6,0,20,10,4,5,0,0,19,nowin,win,plwin,beat,20,0,14,186,0.419354839,0.059139785,0.623655914,2,0.59892924
7145,29,21191,10,6,0,10,0,26,10,4,5,0,0,19,nowin,loss,bust,plbust,0,10,16,189,0.44973545,0.058201058,0.544973545,1,0.300349439
7146,58,21192,10,3,0,8,0,21,10,5,9,0,0,24,nowin,win,dlbust,bust,20,0,13,195,0.430769231,0.041025641,0.584615385,2,0.580497586
7147,54,21192,10,11,0,0,0,21,10,5,9,0,0,24,win,win,dlbust,bust,25,0,21,185,0.437837838,0.032432432,0.556756757,1,0.29899854
7148,109,21192,9,10,0,0,0,19,10,5,9,0,0,24,nowin,win,dlbust,bust,20,0,19,221,0.461538462,0.058823529,0.597285068,3,0.901830309
7149,16,21192,10,4,0,10,0,24,10,5,9,0,0,24,nowin,loss,bust,plbust,0,10,14,220,0.427272727,0.081818182,0.6,2,0.588660176
7150,133,21192,5,10,0,10,0,25,10,5,9,0,0,24,nowin,loss,bust,plbust,0,10,15,201,0.47761194,0.064676617,0.611940299,3,0.935428111
7151,118,21192,2,10,0,1,5,18,10,5,9,0,0,24,nowin,win,dlbust,bust,20,0,12,216,0.393518519,0.037037037,0.555555556,0,0.018059873
7152,119,21193,3,9,0,0,0,12,4,2,9,1,2,18,nowin,loss,beat,dlwin,0,10,12,190,0.405263158,0.068421053,0.515789474,0,0.011837158
7153,118,21193,10,9,0,0,0,19,4,2,9,1,2,18,nowin,win,plwin,beat,20,0,19,216,0.393518519,0.037037037,0.555555556,0,0.018059873
7154,72,21193,9,10,0,0,0,19,4,2,9,1,2,18,nowin,win,plwin,beat,20,0,19,185,0.394594595,0.032432432,0.508108108,0,0.006763115
7155,119,21193,7,3,2,0,0,12,4,2,9,1,2,18,nowin,loss,beat,dlwin,0,10,10,190,0.405263158,0.068421053,0.515789474,0,0.011837158
7156,119,21193,9,5,0,0,0,14,4,2,9,1,2,18,nowin,loss,beat,dlwin,0,10,14,190,0.405263158,0.068421053,0.515789474,0,0.011837158
7157,38,21193,10,10,0,0,0,20,4,2,9,1,2,18,nowin,win,plwin,beat,20,0,20,202,0.361386139,0.03960396,0.564356436,0,0.010597953
7158,99,21194,10,10,0,0,0,20,4,6,2,3,4,19,nowin,win,plwin,beat,20,0,20,207,0.47826087,0.062801932,0.637681159,3,0.961418446
7159,113,21194,2,10,0,0,0,12,4,6,2,3,4,19,nowin,loss,beat,dlwin,0,10,12,199,0.407035176,0.055276382,0.668341709,2,0.620695264
7160,134,21194,9,3,0,0,0,12,4,6,2,3,4,19,nowin,loss,beat,dlwin,0,10,12,185,0.443243243,0.021621622,0.545945946,1,0.296939509
7161,111,21194,11,10,0,0,0,21,4,6,2,3,4,19,win,win,plwin,beat,25,0,21,180,0.433333333,0.055555556,0.611111111,2,0.602264492
7162,86,21194,6,6,0,0,0,12,4,6,2,3,4,19,nowin,loss,beat,dlwin,0,10,12,196,0.454081633,0.040816327,0.591836735,3,0.887566443
7163,2,21194,3,10,0,0,0,13,4,6,2,3,4,19,nowin,loss,beat,dlwin,0,10,13,200,0.445,0.035,0.64,2,0.633962549
7164,128,21195,11,3,2,8,0,24,8,2,10,0,0,20,nowin,loss,bust,plbust,0,10,14,227,0.356828194,0.052863436,0.577092511,0,0.012352564
7165,99,21195,5,6,10,0,0,21,8,2,10,0,0,20,nowin,win,plwin,beat,20,0,11,207,0.47826087,0.062801932,0.637681159,3,0.961418446
7166,84,21195,10,10,0,0,0,20,8,2,10,0,0,20,nowin,push,push,push,10,0,20,195,0.379487179,0.056410256,0.569230769,0,0.017209119
7167,42,21195,5,10,0,10,0,25,8,2,10,0,0,20,nowin,loss,bust,plbust,0,10,15,212,0.443396226,0.051886792,0.570754717,1,0.309181312
7168,58,21195,10,2,0,6,0,18,8,2,10,0,0,20,nowin,loss,beat,dlwin,0,10,12,195,0.430769231,0.041025641,0.584615385,2,0.580497586
7169,142,21195,10,5,0,10,0,25,8,2,10,0,0,20,nowin,loss,bust,plbust,0,10,15,211,0.417061611,0.047393365,0.526066351,1,0.271531309
7170,119,21196,4,11,1,0,0,16,4,10,1,10,0,25,nowin,win,dlbust,bust,20,0,15,190,0.405263158,0.068421053,0.515789474,0,0.011837158
7171,125,21196,1,3,8,0,0,12,4,10,1,10,0,25,nowin,win,dlbust,bust,20,0,4,219,0.438356164,0.050228311,0.575342466,1,0.308411257
7172,133,21196,10,3,0,0,0,13,4,10,1,10,0,25,nowin,win,dlbust,bust,20,0,13,201,0.47761194,0.064676617,0.611940299,3,0.935428111
7173,98,21196,7,4,6,0,0,17,4,10,1,10,0,25,nowin,win,dlbust,bust,20,0,11,220,0.422727273,0.054545455,0.55,1,0.28664435
7174,149,21196,10,10,0,0,0,20,4,10,1,10,0,25,nowin,win,dlbust,bust,20,0,20,225,0.457777778,0.057777778,0.648888889,2,0.651965595
7175,121,21196,10,10,0,0,0,20,4,10,1,10,0,25,nowin,win,dlbust,bust,20,0,20,195,0.456410256,0.025641026,0.512820513,1,0.288597791
7176,120,21197,10,11,0,0,0,21,10,10,0,0,0,20,win,win,plwin,beat,25,0,21,202,0.440594059,0.034653465,0.618811881,2,0.614441029
7177,64,21197,10,2,0,10,0,22,10,10,0,0,0,20,nowin,loss,bust,plbust,0,10,12,187,0.363636364,0.048128342,0.631016043,0,0.027594885
7178,41,21197,8,2,10,0,0,20,10,10,0,0,0,20,nowin,push,push,push,10,0,10,192,0.364583333,0.036458333,0.520833333,0,0.00089702
7179,83,21197,6,4,10,0,0,20,10,10,0,0,0,20,nowin,push,push,push,10,0,10,193,0.424870466,0.051813472,0.678756477,2,0.644360335
7180,94,21197,6,5,9,0,0,20,10,10,0,0,0,20,nowin,push,push,push,10,0,11,183,0.43715847,0.043715847,0.540983607,1,0.290866892
7181,3,21197,4,10,0,7,0,21,10,10,0,0,0,20,nowin,win,plwin,beat,20,0,14,190,0.431578947,0.026315789,0.542105263,1,0.288076384
7182,36,21198,10,5,0,10,0,25,10,3,3,10,0,26,nowin,loss,bust,plbust,0,10,15,229,0.445414847,0.056768559,0.655021834,2,0.645370571
7183,136,21198,4,10,0,10,0,24,10,3,3,10,0,26,nowin,loss,bust,plbust,0,10,14,194,0.396907216,0.025773196,0.597938144,0,0.029452644
7184,138,21198,10,10,0,0,0,20,10,3,3,10,0,26,nowin,win,dlbust,bust,20,0,20,190,0.442105263,0.047368421,0.610526316,2,0.609711065
7185,103,21198,2,10,0,2,10,24,10,3,3,10,0,26,nowin,loss,bust,plbust,0,10,12,203,0.379310345,0.064039409,0.551724138,0,0.012869209
7186,7,21198,10,11,0,0,0,21,10,3,3,10,0,26,win,win,dlbust,bust,25,0,21,183,0.442622951,0.06010929,0.62295082,2,0.619303341
7187,14,21198,11,7,0,0,0,18,10,3,3,10,0,26,nowin,win,dlbust,bust,20,0,18,202,0.391089109,0.01980198,0.628712871,2,0.577264877
7188,102,21199,10,2,0,7,0,19,10,10,0,0,0,20,nowin,loss,beat,dlwin,0,10,12,192,0.338541667,0.046875,0.5625,0,0.003306118
7189,128,21199,5,7,0,3,10,25,10,10,0,0,0,20,nowin,loss,bust,plbust,0,10,12,227,0.356828194,0.052863436,0.577092511,0,0.012352564
7190,127,21199,10,11,0,0,0,21,10,10,0,0,0,20,win,win,plwin,beat,25,0,21,201,0.402985075,0.029850746,0.60199005,0,0.032263937
7191,62,21199,3,11,7,0,0,21,10,10,0,0,0,20,nowin,win,plwin,beat,20,0,14,178,0.370786517,0.028089888,0.54494382,0,0.008657722
7192,109,21199,5,9,0,9,0,23,10,10,0,0,0,20,nowin,loss,bust,plbust,0,10,14,221,0.461538462,0.058823529,0.597285068,3,0.901830309
7193,105,21199,7,10,0,0,0,17,10,10,0,0,0,20,nowin,loss,beat,dlwin,0,10,17,198,0.414141414,0.070707071,0.590909091,0,0.032889494
7194,118,21200,5,6,10,0,0,21,10,10,0,0,0,20,nowin,win,plwin,beat,20,0,11,216,0.393518519,0.037037037,0.555555556,0,0.018059873
7195,133,21200,10,10,0,0,0,20,10,10,0,0,0,20,nowin,push,push,push,10,0,20,201,0.47761194,0.064676617,0.611940299,3,0.935428111
7196,51,21200,10,3,0,1,8,22,10,10,0,0,0,20,nowin,loss,bust,plbust,0,10,13,189,0.529100529,0.068783069,0.608465608,3,0.993665715
7197,139,21200,10,3,0,4,0,17,10,10,0,0,0,20,nowin,loss,beat,dlwin,0,10,13,192,0.380208333,0.036458333,0.59375,0,0.023429169
7198,128,21200,4,10,0,4,0,18,10,10,0,0,0,20,nowin,loss,beat,dlwin,0,10,14,227,0.356828194,0.052863436,0.577092511,0,0.012352564
7199,38,21200,6,2,5,3,10,26,10,10,0,0,0,20,nowin,loss,bust,plbust,0,10,8,202,0.361386139,0.03960396,0.564356436,0,0.010597953
7200,39,21201,3,10,0,2,4,19,8,10,0,0,0,18,nowin,win,plwin,beat,20,0,13,191,0.429319372,0.062827225,0.57591623,0,0.033760763
7201,106,21201,9,4,0,7,0,20,8,10,0,0,0,18,nowin,win,plwin,beat,20,0,13,192,0.411458333,0.026041667,0.557291667,0,0.023854304
7202,111,21201,11,9,0,0,0,20,8,10,0,0,0,18,nowin,win,plwin,beat,20,0,20,180,0.433333333,0.055555556,0.611111111,2,0.602264492
7203,17,21201,3,8,10,0,0,21,8,10,0,0,0,18,nowin,win,plwin,beat,20,0,11,171,0.444444444,0.070175439,0.555555556,1,0.302364894
7204,56,21201,10,10,0,0,0,20,8,10,0,0,0,18,nowin,win,plwin,beat,20,0,20,175,0.4,0.057142857,0.582857143,0,0.026685297
7205,122,21201,10,11,0,0,0,21,8,10,0,0,0,18,win,win,plwin,beat,25,0,21,210,0.347619048,0.052380952,0.59047619,0,0.012873677
7206,88,21202,4,3,10,0,0,17,11,10,0,0,0,21,nowin,loss,beat,dlwin,0,10,7,206,0.466019417,0.033980583,0.54368932,1,0.309467903
7207,68,21202,8,9,0,0,0,17,11,10,0,0,0,21,nowin,loss,beat,dlwin,0,10,17,205,0.434146341,0.029268293,0.6,2,0.59483189
7208,34,21202,5,6,10,0,0,21,11,10,0,0,0,21,nowin,push,push,push,10,0,11,202,0.5,0.079207921,0.618811881,3,0.968961434
7209,109,21202,10,3,0,10,0,23,11,10,0,0,0,21,nowin,loss,bust,plbust,0,10,13,221,0.461538462,0.058823529,0.597285068,3,0.901830309
7210,102,21202,4,2,7,10,0,23,11,10,0,0,0,21,nowin,loss,bust,plbust,0,10,6,192,0.338541667,0.046875,0.5625,0,0.003306118
7211,102,21202,3,10,0,9,0,22,11,10,0,0,0,21,nowin,loss,bust,plbust,0,10,13,192,0.338541667,0.046875,0.5625,0,0.003306118
7212,47,21203,10,7,0,0,0,17,4,10,5,0,0,19,nowin,loss,beat,dlwin,0,10,17,210,0.438095238,0.057142857,0.623809524,2,0.615868808
7213,137,21203,5,9,0,0,0,14,4,10,5,0,0,19,nowin,loss,beat,dlwin,0,10,14,194,0.417525773,0.046391753,0.536082474,1,0.276714602
7214,70,21203,8,5,0,0,0,13,4,10,5,0,0,19,nowin,loss,beat,dlwin,0,10,13,228,0.385964912,0.039473684,0.557017544,0,0.016157125
7215,140,21203,4,3,10,0,0,17,4,10,5,0,0,19,nowin,loss,beat,dlwin,0,10,7,210,0.466666667,0.023809524,0.604761905,3,0.915293335
7216,97,21203,10,7,0,0,0,17,4,10,5,0,0,19,nowin,loss,beat,dlwin,0,10,17,182,0.450549451,0.06043956,0.692307692,2,0.677372279
7217,98,21203,1,3,10,0,0,14,4,10,5,0,0,19,nowin,loss,beat,dlwin,0,10,4,220,0.422727273,0.054545455,0.55,1,0.28664435
7218,141,21204,7,6,0,0,0,13,4,10,10,0,0,24,nowin,win,dlbust,bust,20,0,13,202,0.420792079,0.074257426,0.564356436,0,0.028377851
7219,82,21204,11,10,0,0,0,21,4,10,10,0,0,24,win,win,dlbust,bust,25,0,21,225,0.408888889,0.075555556,0.577777778,0,0.028101874
7220,24,21204,7,8,0,0,0,15,4,10,10,0,0,24,nowin,win,dlbust,bust,20,0,15,207,0.458937198,0.048309179,0.570048309,1,0.318138014
7221,43,21204,10,6,0,0,0,16,4,10,10,0,0,24,nowin,win,dlbust,bust,20,0,16,192,0.40625,0.041666667,0.609375,2,0.576671372
7222,55,21204,11,6,1,0,0,18,4,10,10,0,0,24,nowin,win,dlbust,bust,20,0,17,191,0.371727749,0.057591623,0.54973822,0,0.01011347
7223,59,21204,3,10,0,0,0,13,4,10,10,0,0,24,nowin,win,dlbust,bust,20,0,13,228,0.429824561,0.048245614,0.543859649,1,0.287885446
7224,52,21205,6,10,0,0,0,16,2,10,8,0,0,20,nowin,loss,beat,dlwin,0,10,16,217,0.414746544,0.02764977,0.599078341,2,0.576736024
7225,112,21205,3,9,0,10,0,22,2,10,8,0,0,20,nowin,loss,bust,plbust,0,10,12,203,0.448275862,0.054187192,0.600985222,3,0.889576933
7226,112,21205,10,2,0,5,0,17,2,10,8,0,0,20,nowin,loss,beat,dlwin,0,10,12,203,0.448275862,0.054187192,0.600985222,3,0.889576933
7227,106,21205,8,6,0,0,0,14,2,10,8,0,0,20,nowin,loss,beat,dlwin,0,10,14,192,0.411458333,0.026041667,0.557291667,0,0.023854304
7228,141,21205,10,4,0,0,0,14,2,10,8,0,0,20,nowin,loss,beat,dlwin,0,10,14,202,0.420792079,0.074257426,0.564356436,0,0.028377851
7229,93,21205,3,7,4,0,0,14,2,10,8,0,0,20,nowin,loss,beat,dlwin,0,10,10,175,0.485714286,0.051428571,0.548571429,1,0.323648091
7230,147,21206,4,10,0,0,0,14,2,11,4,0,0,17,nowin,loss,beat,dlwin,0,10,14,205,0.380487805,0.014634146,0.536585366,0,0.00951447
7231,63,21206,10,10,0,0,0,20,2,11,4,0,0,17,nowin,win,plwin,beat,20,0,20,216,0.467592593,0.037037037,0.62037037,3,0.931690496
7232,139,21206,9,7,0,0,0,16,2,11,4,0,0,17,nowin,loss,beat,dlwin,0,10,16,192,0.380208333,0.036458333,0.59375,0,0.023429169
7233,47,21206,7,10,0,0,0,17,2,11,4,0,0,17,nowin,push,push,push,10,0,17,210,0.438095238,0.057142857,0.623809524,2,0.615868808
7234,19,21206,3,3,6,10,0,22,2,11,4,0,0,17,nowin,loss,bust,plbust,0,10,6,237,0.41350211,0.054852321,0.628691983,2,0.597373826
7235,12,21206,9,10,0,0,0,19,2,11,4,0,0,17,nowin,win,plwin,beat,20,0,19,189,0.470899471,0.015873016,0.613756614,3,0.929171178
7236,21,21207,4,10,0,10,0,24,9,10,0,0,0,19,nowin,loss,bust,plbust,0,10,14,214,0.359813084,0.042056075,0.626168224,0,0.025263474
7237,141,21207,7,4,10,0,0,21,9,10,0,0,0,19,nowin,win,plwin,beat,20,0,11,202,0.420792079,0.074257426,0.564356436,0,0.028377851
7238,67,21207,10,7,0,0,0,17,9,10,0,0,0,19,nowin,loss,beat,dlwin,0,10,17,195,0.369230769,0.041025641,0.569230769,0,0.014139427
7239,11,21207,2,5,5,4,9,25,9,10,0,0,0,19,nowin,loss,bust,plbust,0,10,7,236,0.457627119,0.016949153,0.588983051,3,0.889015813
7240,44,21207,2,9,10,0,0,21,9,10,0,0,0,19,nowin,win,plwin,beat,20,0,11,219,0.433789954,0.050228311,0.534246575,1,0.285551035
7241,138,21207,5,10,0,2,0,17,9,10,0,0,0,19,nowin,loss,beat,dlwin,0,10,15,190,0.442105263,0.047368421,0.610526316,2,0.609711065
7242,147,21208,10,11,0,0,0,21,7,11,0,0,0,18,win,win,plwin,beat,25,0,21,205,0.380487805,0.014634146,0.536585366,0,0.00951447
7243,7,21208,10,9,0,0,0,19,7,11,0,0,0,18,nowin,win,plwin,beat,20,0,19,183,0.442622951,0.06010929,0.62295082,2,0.619303341
7244,41,21208,4,10,0,4,0,18,7,11,0,0,0,18,nowin,push,push,push,10,0,14,192,0.364583333,0.036458333,0.520833333,0,0.00089702
7245,78,21208,3,10,0,6,0,19,7,11,0,0,0,18,nowin,win,plwin,beat,20,0,13,201,0.517412935,0.034825871,0.587064677,3,0.95871112
7246,146,21208,10,5,0,1,9,25,7,11,0,0,0,18,nowin,loss,bust,plbust,0,10,15,221,0.43438914,0.040723982,0.542986425,1,0.290190091
7247,91,21208,9,4,0,5,0,18,7,11,0,0,0,18,nowin,push,push,push,10,0,13,194,0.417525773,0.046391753,0.515463918,1,0.266616552
7248,146,21209,10,10,0,0,0,20,10,10,0,0,0,20,nowin,push,push,push,10,0,20,221,0.43438914,0.040723982,0.542986425,1,0.290190091
7249,132,21209,2,7,8,0,0,17,10,10,0,0,0,20,nowin,loss,beat,dlwin,0,10,9,194,0.412371134,0.036082474,0.649484536,2,0.611633238
7250,123,21209,5,6,10,0,0,21,10,10,0,0,0,20,nowin,win,plwin,beat,20,0,11,205,0.43902439,0.034146341,0.614634146,2,0.609962544
7251,28,21209,1,6,8,8,0,23,10,10,0,0,0,20,nowin,loss,bust,plbust,0,10,7,199,0.422110553,0.045226131,0.542713568,1,0.282706618
7252,106,21209,10,9,0,0,0,19,10,10,0,0,0,20,nowin,loss,beat,dlwin,0,10,19,192,0.411458333,0.026041667,0.557291667,0,0.023854304
7253,133,21209,7,10,0,0,0,17,10,10,0,0,0,20,nowin,loss,beat,dlwin,0,10,17,201,0.47761194,0.064676617,0.611940299,3,0.935428111
7254,65,21210,5,10,0,7,0,22,7,3,10,0,0,20,nowin,loss,bust,plbust,0,10,15,203,0.492610837,0.054187192,0.571428571,3,0.913702814
7255,21,21210,6,6,0,10,0,22,7,3,10,0,0,20,nowin,loss,bust,plbust,0,10,12,214,0.359813084,0.042056075,0.626168224,0,0.025263474
7256,49,21210,9,2,1,2,2,16,7,3,10,0,0,20,nowin,loss,beat,dlwin,0,10,11,207,0.396135266,0.053140097,0.594202899,0,0.028306925
7257,105,21210,9,10,0,0,0,19,7,3,10,0,0,20,nowin,loss,beat,dlwin,0,10,19,198,0.414141414,0.070707071,0.590909091,0,0.032889494
7258,101,21210,11,10,0,0,0,21,7,3,10,0,0,20,win,win,plwin,beat,25,0,21,205,0.424390244,0.068292683,0.63902439,2,0.614740646
7259,97,21210,1,5,6,7,0,19,7,3,10,0,0,20,nowin,loss,beat,dlwin,0,10,6,182,0.450549451,0.06043956,0.692307692,2,0.677372279
7260,25,21211,8,5,0,10,0,23,9,10,0,0,0,19,nowin,loss,bust,plbust,0,10,13,190,0.463157895,0.063157895,0.536842105,1,0.304401563
7261,90,21211,10,10,0,0,0,20,9,10,0,0,0,19,nowin,win,plwin,beat,20,0,20,201,0.447761194,0.049751244,0.60199005,3,0.889945023
7262,10,21211,10,11,0,0,0,21,9,10,0,0,0,19,win,win,plwin,beat,25,0,21,191,0.413612565,0.057591623,0.596858639,2,0.574087175
7263,82,21211,5,9,0,10,0,24,9,10,0,0,0,19,nowin,loss,bust,plbust,0,10,14,225,0.408888889,0.075555556,0.577777778,0,0.028101874
7264,47,21211,8,7,0,5,0,20,9,10,0,0,0,19,nowin,win,plwin,beat,20,0,15,210,0.438095238,0.057142857,0.623809524,2,0.615868808
7265,102,21211,4,4,9,0,0,17,9,10,0,0,0,19,nowin,loss,beat,dlwin,0,10,8,192,0.338541667,0.046875,0.5625,0,0.003306118
7266,73,21212,7,4,9,0,0,20,10,6,9,0,0,25,nowin,win,dlbust,bust,20,0,11,181,0.375690608,0.011049724,0.596685083,0,0.022795773
7267,118,21212,10,10,0,0,0,20,10,6,9,0,0,25,nowin,win,dlbust,bust,20,0,20,216,0.393518519,0.037037037,0.555555556,0,0.018059873
7268,53,21212,4,10,0,10,0,24,10,6,9,0,0,25,nowin,loss,bust,plbust,0,10,14,250,0.372,0.064,0.564,0,0.013687345
7269,68,21212,5,3,8,10,0,26,10,6,9,0,0,25,nowin,loss,bust,plbust,0,10,8,205,0.434146341,0.029268293,0.6,2,0.59483189
7270,32,21212,8,10,0,0,0,18,10,6,9,0,0,25,nowin,win,dlbust,bust,20,0,18,189,0.391534392,0.037037037,0.53968254,0,0.013579086
7271,106,21212,11,7,0,0,0,18,10,6,9,0,0,25,nowin,win,dlbust,bust,20,0,18,192,0.411458333,0.026041667,0.557291667,0,0.023854304
7272,12,21213,10,10,0,0,0,20,4,5,10,0,0,19,nowin,win,plwin,beat,20,0,20,189,0.470899471,0.015873016,0.613756614,3,0.929171178
7273,39,21213,11,10,0,0,0,21,4,5,10,0,0,19,win,win,plwin,beat,25,0,21,191,0.429319372,0.062827225,0.57591623,0,0.033760763
7274,60,21213,9,3,0,0,0,12,4,5,10,0,0,19,nowin,loss,beat,dlwin,0,10,12,227,0.418502203,0.022026432,0.559471366,0,0.026496258
7275,104,21213,4,10,0,0,0,14,4,5,10,0,0,19,nowin,loss,beat,dlwin,0,10,14,209,0.363636364,0.052631579,0.593301435,0,0.018359419
7276,69,21213,4,8,0,0,0,12,4,5,10,0,0,19,nowin,loss,beat,dlwin,0,10,12,194,0.365979381,0.030927835,0.515463918,0,0
7277,91,21213,3,10,0,0,0,13,4,5,10,0,0,19,nowin,loss,beat,dlwin,0,10,13,194,0.417525773,0.046391753,0.515463918,1,0.266616552
7278,21,21214,10,10,0,0,0,20,8,5,2,6,0,21,nowin,loss,beat,dlwin,0,10,20,214,0.359813084,0.042056075,0.626168224,0,0.025263474
7279,25,21214,1,1,10,1,10,23,8,5,2,6,0,21,nowin,loss,bust,plbust,0,10,2,190,0.463157895,0.063157895,0.536842105,1,0.304401563
7280,71,21214,7,10,0,0,0,17,8,5,2,6,0,21,nowin,loss,beat,dlwin,0,10,17,193,0.352331606,0.046632124,0.585492228,0,0.013063661
7281,136,21214,8,8,0,4,0,20,8,5,2,6,0,21,nowin,loss,beat,dlwin,0,10,16,194,0.396907216,0.025773196,0.597938144,0,0.029452644
7282,40,21214,1,2,10,10,0,23,8,5,2,6,0,21,nowin,loss,bust,plbust,0,10,3,196,0.367346939,0.030612245,0.617346939,0,0.025358183
7283,2,21214,10,9,0,0,0,19,8,5,2,6,0,21,nowin,loss,beat,dlwin,0,10,19,200,0.445,0.035,0.64,2,0.633962549
7284,56,21215,6,9,0,1,8,24,8,10,0,0,0,18,nowin,loss,bust,plbust,0,10,15,175,0.4,0.057142857,0.582857143,0,0.026685297
7285,119,21215,10,3,0,10,0,23,8,10,0,0,0,18,nowin,loss,bust,plbust,0,10,13,190,0.405263158,0.068421053,0.515789474,0,0.011837158
7286,97,21215,7,10,0,0,0,17,8,10,0,0,0,18,nowin,loss,beat,dlwin,0,10,17,182,0.450549451,0.06043956,0.692307692,2,0.677372279
7287,83,21215,6,10,0,7,0,23,8,10,0,0,0,18,nowin,loss,bust,plbust,0,10,16,193,0.424870466,0.051813472,0.678756477,2,0.644360335
7288,80,21215,10,2,0,4,4,20,8,10,0,0,0,18,nowin,win,plwin,beat,20,0,12,186,0.419354839,0.059139785,0.623655914,2,0.59892924
7289,134,21215,5,6,2,5,0,18,8,10,0,0,0,18,nowin,push,push,push,10,0,11,185,0.443243243,0.021621622,0.545945946,1,0.296939509
7290,110,21216,10,8,0,0,0,18,4,3,5,4,2,18,nowin,push,push,push,10,0,18,192,0.416666667,0.046875,0.557291667,0,0.025413132
7291,27,21216,1,4,10,0,0,15,4,3,5,4,2,18,nowin,loss,beat,dlwin,0,10,5,178,0.370786517,0.016853933,0.573033708,0,0.015536309
7292,13,21216,3,6,10,0,0,19,4,3,5,4,2,18,nowin,win,plwin,beat,20,0,9,206,0.417475728,0.063106796,0.621359223,2,0.59555479
7293,39,21216,2,5,2,10,0,19,4,3,5,4,2,18,nowin,win,plwin,beat,20,0,7,191,0.429319372,0.062827225,0.57591623,0,0.033760763
7294,22,21216,10,11,0,0,0,21,4,3,5,4,2,18,win,win,plwin,beat,25,0,21,187,0.481283422,0.042780749,0.577540107,3,0.906128176
7295,1,21216,5,11,2,0,0,18,4,3,5,4,2,18,nowin,push,push,push,10,0,16,197,0.406091371,0.025380711,0.649746193,2,0.606186955
7296,58,21217,11,6,1,0,0,18,6,7,4,0,0,17,nowin,win,plwin,beat,20,0,17,195,0.430769231,0.041025641,0.584615385,2,0.580497586
7297,106,21217,10,5,0,0,0,15,6,7,4,0,0,17,nowin,loss,beat,dlwin,0,10,15,192,0.411458333,0.026041667,0.557291667,0,0.023854304
7298,61,21217,4,5,10,0,0,19,6,7,4,0,0,17,nowin,win,plwin,beat,20,0,9,194,0.427835052,0.077319588,0.603092784,2,0.591437139
7299,49,21217,8,4,0,0,0,12,6,7,4,0,0,17,nowin,loss,beat,dlwin,0,10,12,207,0.396135266,0.053140097,0.594202899,0,0.028306925
7300,125,21217,8,10,0,0,0,18,6,7,4,0,0,17,nowin,win,plwin,beat,20,0,18,219,0.438356164,0.050228311,0.575342466,1,0.308411257
7301,45,21217,9,2,9,0,0,20,6,7,4,0,0,17,nowin,win,plwin,beat,20,0,11,196,0.428571429,0.051020408,0.612244898,2,0.598821767
7302,7,21218,3,10,0,8,0,21,10,10,0,0,0,20,nowin,win,plwin,beat,20,0,13,183,0.442622951,0.06010929,0.62295082,2,0.619303341
7303,32,21218,6,10,0,6,0,22,10,10,0,0,0,20,nowin,loss,bust,plbust,0,10,16,189,0.391534392,0.037037037,0.53968254,0,0.013579086
7304,100,21218,10,2,0,9,0,21,10,10,0,0,0,20,nowin,win,plwin,beat,20,0,12,190,0.452631579,0.036842105,0.594736842,3,0.888671154
7305,143,21218,10,10,0,0,0,20,10,10,0,0,0,20,nowin,push,push,push,10,0,20,203,0.463054187,0.044334975,0.57635468,3,0.883143365
7306,69,21218,8,9,0,0,0,17,10,10,0,0,0,20,nowin,loss,beat,dlwin,0,10,17,194,0.365979381,0.030927835,0.515463918,0,0
7307,4,21218,11,1,5,0,0,17,10,10,0,0,0,20,nowin,loss,beat,dlwin,0,10,12,217,0.460829493,0.036866359,0.562211982,1,0.315432839
7308,47,21219,10,5,0,10,0,25,7,8,2,0,0,17,nowin,loss,bust,plbust,0,10,15,210,0.438095238,0.057142857,0.623809524,2,0.615868808
7309,150,21219,10,2,0,10,0,22,7,8,2,0,0,17,nowin,loss,bust,plbust,0,10,12,192,0.401041667,0.036458333,0.567708333,0,0.023287458
7310,7,21219,10,10,0,0,0,20,7,8,2,0,0,17,nowin,win,plwin,beat,20,0,20,183,0.442622951,0.06010929,0.62295082,2,0.619303341
7311,12,21219,10,10,0,0,0,20,7,8,2,0,0,17,nowin,win,plwin,beat,20,0,20,189,0.470899471,0.015873016,0.613756614,3,0.929171178
7312,32,21219,6,8,0,3,0,17,7,8,2,0,0,17,nowin,push,push,push,10,0,14,189,0.391534392,0.037037037,0.53968254,0,0.013579086
7313,56,21219,9,10,0,0,0,19,7,8,2,0,0,17,nowin,win,plwin,beat,20,0,19,175,0.4,0.057142857,0.582857143,0,0.026685297
7314,130,21220,11,3,4,0,0,18,5,9,1,7,0,22,nowin,win,dlbust,bust,20,0,14,219,0.410958904,0.03652968,0.566210046,0,0.025888739
7315,72,21220,10,10,0,0,0,20,5,9,1,7,0,22,nowin,win,dlbust,bust,20,0,20,185,0.394594595,0.032432432,0.508108108,0,0.006763115
7316,115,21220,3,8,10,0,0,21,5,9,1,7,0,22,nowin,win,dlbust,bust,20,0,11,194,0.427835052,0.041237113,0.592783505,2,0.583863602
7317,32,21220,4,10,0,0,0,14,5,9,1,7,0,22,nowin,win,dlbust,bust,20,0,14,189,0.391534392,0.037037037,0.53968254,0,0.013579086
7318,11,21220,10,2,0,0,0,12,5,9,1,7,0,22,nowin,win,dlbust,bust,20,0,12,236,0.457627119,0.016949153,0.588983051,3,0.889015813
7319,67,21220,6,4,7,0,0,17,5,9,1,7,0,22,nowin,win,dlbust,bust,20,0,10,195,0.369230769,0.041025641,0.569230769,0,0.014139427
7320,46,21221,8,7,0,2,0,17,11,9,0,0,0,20,nowin,loss,beat,dlwin,0,10,15,186,0.403225806,0.048387097,0.591397849,0,0.029742194
7321,148,21221,10,10,0,0,0,20,11,9,0,0,0,20,nowin,push,push,push,10,0,20,204,0.401960784,0.078431373,0.593137255,0,0.029789521
7322,18,21221,10,10,0,0,0,20,11,9,0,0,0,20,nowin,push,push,push,10,0,20,182,0.461538462,0.043956044,0.587912088,3,0.892649374
7323,104,21221,3,10,0,10,0,23,11,9,0,0,0,20,nowin,loss,bust,plbust,0,10,13,209,0.363636364,0.052631579,0.593301435,0,0.018359419
7324,16,21221,8,2,10,0,0,20,11,9,0,0,0,20,nowin,push,push,push,10,0,10,220,0.427272727,0.081818182,0.6,2,0.588660176
7325,120,21221,9,10,0,0,0,19,11,9,0,0,0,20,nowin,loss,beat,dlwin,0,10,19,202,0.440594059,0.034653465,0.618811881,2,0.614441029
7326,91,21222,8,11,0,0,0,19,5,10,10,0,0,25,nowin,win,dlbust,bust,20,0,19,194,0.417525773,0.046391753,0.515463918,1,0.266616552
7327,145,21222,9,11,0,0,0,20,5,10,10,0,0,25,nowin,win,dlbust,bust,20,0,20,188,0.441489362,0.031914894,0.622340426,2,0.617837093
7328,149,21222,10,6,0,0,0,16,5,10,10,0,0,25,nowin,win,dlbust,bust,20,0,16,225,0.457777778,0.057777778,0.648888889,2,0.651965595
7329,110,21222,2,11,6,0,0,19,5,10,10,0,0,25,nowin,win,dlbust,bust,20,0,13,192,0.416666667,0.046875,0.557291667,0,0.025413132
7330,93,21222,2,3,8,0,0,13,5,10,10,0,0,25,nowin,win,dlbust,bust,20,0,5,175,0.485714286,0.051428571,0.548571429,1,0.323648091
7331,89,21222,4,10,0,0,0,14,5,10,10,0,0,25,nowin,win,dlbust,bust,20,0,14,212,0.537735849,0.047169811,0.594339623,3,0.990167191
7332,149,21223,2,11,8,0,0,21,9,8,0,0,0,17,nowin,win,plwin,beat,20,0,13,225,0.457777778,0.057777778,0.648888889,2,0.651965595
7333,22,21223,10,10,0,0,0,20,9,8,0,0,0,17,nowin,win,plwin,beat,20,0,20,187,0.481283422,0.042780749,0.577540107,3,0.906128176
7334,24,21223,5,6,1,10,0,22,9,8,0,0,0,17,nowin,loss,bust,plbust,0,10,11,207,0.458937198,0.048309179,0.570048309,1,0.318138014
7335,11,21223,10,10,0,0,0,20,9,8,0,0,0,17,nowin,win,plwin,beat,20,0,20,236,0.457627119,0.016949153,0.588983051,3,0.889015813
7336,10,21223,10,10,0,0,0,20,9,8,0,0,0,17,nowin,win,plwin,beat,20,0,20,191,0.413612565,0.057591623,0.596858639,2,0.574087175
7337,102,21223,1,4,10,8,0,23,9,8,0,0,0,17,nowin,loss,bust,plbust,0,10,5,192,0.338541667,0.046875,0.5625,0,0.003306118
7338,129,21224,11,1,2,7,0,21,10,9,0,0,0,19,nowin,win,plwin,beat,20,0,12,201,0.422885572,0.064676617,0.55721393,0,0.027255383
7339,99,21224,3,10,0,10,0,23,10,9,0,0,0,19,nowin,loss,bust,plbust,0,10,13,207,0.47826087,0.062801932,0.637681159,3,0.961418446
7340,20,21224,8,3,2,10,0,23,10,9,0,0,0,19,nowin,loss,bust,plbust,0,10,11,186,0.456989247,0.037634409,0.537634409,1,0.301097108
7341,110,21224,6,8,0,5,0,19,10,9,0,0,0,19,nowin,push,push,push,10,0,14,192,0.416666667,0.046875,0.557291667,0,0.025413132
7342,96,21224,7,9,0,10,0,26,10,9,0,0,0,19,nowin,loss,bust,plbust,0,10,16,190,0.468421053,0.057894737,0.584210526,3,0.897263354
7343,51,21224,5,3,6,10,0,24,10,9,0,0,0,19,nowin,loss,bust,plbust,0,10,8,189,0.529100529,0.068783069,0.608465608,3,0.993665715
7344,89,21225,10,5,0,5,0,20,7,6,5,0,0,18,nowin,win,plwin,beat,20,0,15,212,0.537735849,0.047169811,0.594339623,3,0.990167191
7345,48,21225,10,11,0,0,0,21,7,6,5,0,0,18,win,win,plwin,beat,25,0,21,203,0.413793103,0.019704433,0.600985222,2,0.577280801
7346,146,21225,10,10,0,0,0,20,7,6,5,0,0,18,nowin,win,plwin,beat,20,0,20,221,0.43438914,0.040723982,0.542986425,1,0.290190091
7347,119,21225,10,11,0,0,0,21,7,6,5,0,0,18,win,win,plwin,beat,25,0,21,190,0.405263158,0.068421053,0.515789474,0,0.011837158
7348,30,21225,10,7,0,0,0,17,7,6,5,0,0,18,nowin,loss,beat,dlwin,0,10,17,206,0.393203883,0.033980583,0.601941748,0,0.029324648
7349,65,21225,10,10,0,0,0,20,7,6,5,0,0,18,nowin,win,plwin,beat,20,0,20,203,0.492610837,0.054187192,0.571428571,3,0.913702814
7350,2,21226,3,10,0,10,0,23,10,10,0,0,0,20,nowin,loss,bust,plbust,0,10,13,200,0.445,0.035,0.64,2,0.633962549
7351,33,21226,4,11,2,0,0,17,10,10,0,0,0,20,nowin,loss,beat,dlwin,0,10,15,192,0.4375,0.057291667,0.625,2,0.616208916
7352,82,21226,3,1,8,10,0,22,10,10,0,0,0,20,nowin,loss,bust,plbust,0,10,4,225,0.408888889,0.075555556,0.577777778,0,0.028101874
7353,8,21226,11,7,0,0,0,18,10,10,0,0,0,20,nowin,loss,beat,dlwin,0,10,18,181,0.44198895,0.071823204,0.596685083,2,0.599438402
7354,35,21226,10,10,0,0,0,20,10,10,0,0,0,20,nowin,push,push,push,10,0,20,202,0.410891089,0.044554455,0.633663366,2,0.598681573
7355,64,21226,3,10,0,5,0,18,10,10,0,0,0,20,nowin,loss,beat,dlwin,0,10,13,187,0.363636364,0.048128342,0.631016043,0,0.027594885
7356,145,21227,8,10,0,0,0,18,5,10,7,0,0,22,nowin,win,dlbust,bust,20,0,18,188,0.441489362,0.031914894,0.622340426,2,0.617837093
7357,72,21227,9,8,0,0,0,17,5,10,7,0,0,22,nowin,win,dlbust,bust,20,0,17,185,0.394594595,0.032432432,0.508108108,0,0.006763115
7358,29,21227,10,4,0,0,0,14,5,10,7,0,0,22,nowin,win,dlbust,bust,20,0,14,189,0.44973545,0.058201058,0.544973545,1,0.300349439
7359,90,21227,4,11,3,0,0,18,5,10,7,0,0,22,nowin,win,dlbust,bust,20,0,15,201,0.447761194,0.049751244,0.60199005,3,0.889945023
7360,23,21227,11,10,0,0,0,21,5,10,7,0,0,22,win,win,dlbust,bust,25,0,21,208,0.427884615,0.0625,0.552884615,1,0.29114424
7361,13,21227,10,10,0,0,0,20,5,10,7,0,0,22,nowin,win,dlbust,bust,20,0,20,206,0.417475728,0.063106796,0.621359223,2,0.59555479
7362,145,21228,7,2,8,0,0,17,9,5,7,0,0,21,nowin,loss,beat,dlwin,0,10,9,188,0.441489362,0.031914894,0.622340426,2,0.617837093
7363,104,21228,4,4,10,0,0,18,9,5,7,0,0,21,nowin,loss,beat,dlwin,0,10,8,209,0.363636364,0.052631579,0.593301435,0,0.018359419
7364,77,21228,1,1,10,4,9,25,9,5,7,0,0,21,nowin,loss,bust,plbust,0,10,2,200,0.455,0.04,0.62,3,0.916252116
7365,29,21228,4,2,2,10,0,18,9,5,7,0,0,21,nowin,loss,beat,dlwin,0,10,6,189,0.44973545,0.058201058,0.544973545,1,0.300349439
7366,107,21228,10,11,0,0,0,21,9,5,7,0,0,21,win,push,push,push,10,0,21,218,0.444954128,0.073394495,0.600917431,2,0.605210014
7367,23,21228,10,10,0,0,0,20,9,5,7,0,0,21,nowin,loss,beat,dlwin,0,10,20,208,0.427884615,0.0625,0.552884615,1,0.29114424
7368,70,21229,5,2,10,0,0,17,6,10,5,0,0,21,nowin,loss,beat,dlwin,0,10,7,228,0.385964912,0.039473684,0.557017544,0,0.016157125
7369,113,21229,10,11,0,0,0,21,6,10,5,0,0,21,win,push,push,push,10,0,21,199,0.407035176,0.055276382,0.668341709,2,0.620695264
7370,103,21229,4,10,0,0,0,14,6,10,5,0,0,21,nowin,loss,beat,dlwin,0,10,14,203,0.379310345,0.064039409,0.551724138,0,0.012869209
7371,98,21229,7,7,0,0,0,14,6,10,5,0,0,21,nowin,loss,beat,dlwin,0,10,14,220,0.422727273,0.054545455,0.55,1,0.28664435
7372,51,21229,7,10,0,0,0,17,6,10,5,0,0,21,nowin,loss,beat,dlwin,0,10,17,189,0.529100529,0.068783069,0.608465608,3,0.993665715
7373,7,21229,10,2,0,0,0,12,6,10,5,0,0,21,nowin,loss,beat,dlwin,0,10,12,183,0.442622951,0.06010929,0.62295082,2,0.619303341
7374,107,21230,3,10,0,0,0,13,3,3,6,8,0,20,nowin,loss,beat,dlwin,0,10,13,218,0.444954128,0.073394495,0.600917431,2,0.605210014
7375,70,21230,5,10,0,0,0,15,3,3,6,8,0,20,nowin,loss,beat,dlwin,0,10,15,228,0.385964912,0.039473684,0.557017544,0,0.016157125
7376,4,21230,11,10,0,0,0,21,3,3,6,8,0,20,win,win,plwin,beat,25,0,21,217,0.460829493,0.036866359,0.562211982,1,0.315432839
7377,62,21230,8,11,0,0,0,19,3,3,6,8,0,20,nowin,loss,beat,dlwin,0,10,19,178,0.370786517,0.028089888,0.54494382,0,0.008657722
7378,116,21230,8,6,0,0,0,14,3,3,6,8,0,20,nowin,loss,beat,dlwin,0,10,14,195,0.425641026,0.056410256,0.538461538,1,0.28273747
7379,92,21230,10,10,0,0,0,20,3,3,6,8,0,20,nowin,push,push,push,10,0,20,186,0.446236559,0.059139785,0.564516129,1,0.307826125
7380,55,21231,8,10,0,0,0,18,10,10,0,0,0,20,nowin,loss,beat,dlwin,0,10,18,191,0.371727749,0.057591623,0.54973822,0,0.01011347
7381,19,21231,8,10,0,0,0,18,10,10,0,0,0,20,nowin,loss,beat,dlwin,0,10,18,237,0.41350211,0.054852321,0.628691983,2,0.597373826
7382,95,21231,10,4,0,10,0,24,10,10,0,0,0,20,nowin,loss,bust,plbust,0,10,14,218,0.412844037,0.04587156,0.559633028,0,0.024842385
7383,118,21231,9,10,0,0,0,19,10,10,0,0,0,20,nowin,loss,beat,dlwin,0,10,19,216,0.393518519,0.037037037,0.555555556,0,0.018059873
7384,110,21231,11,1,2,5,0,19,10,10,0,0,0,20,nowin,loss,beat,dlwin,0,10,12,192,0.416666667,0.046875,0.557291667,0,0.025413132
7385,39,21231,11,1,2,7,0,21,10,10,0,0,0,20,nowin,win,plwin,beat,20,0,12,191,0.429319372,0.062827225,0.57591623,0,0.033760763
7386,7,21232,10,7,0,0,0,17,2,7,3,1,7,20,nowin,loss,beat,dlwin,0,10,17,183,0.442622951,0.06010929,0.62295082,2,0.619303341
7387,18,21232,11,7,0,0,0,18,2,7,3,1,7,20,nowin,loss,beat,dlwin,0,10,18,182,0.461538462,0.043956044,0.587912088,3,0.892649374
7388,33,21232,10,8,0,0,0,18,2,7,3,1,7,20,nowin,loss,beat,dlwin,0,10,18,192,0.4375,0.057291667,0.625,2,0.616208916
7389,131,21232,11,10,0,0,0,21,2,7,3,1,7,20,win,win,plwin,beat,25,0,21,217,0.410138249,0.069124424,0.543778802,0,0.02015021
7390,121,21232,3,1,9,0,0,13,2,7,3,1,7,20,nowin,loss,beat,dlwin,0,10,4,195,0.456410256,0.025641026,0.512820513,1,0.288597791
7391,119,21232,4,4,5,0,0,13,2,7,3,1,7,20,nowin,loss,beat,dlwin,0,10,8,190,0.405263158,0.068421053,0.515789474,0,0.011837158
7392,31,21233,9,2,5,5,0,21,10,8,0,0,0,18,nowin,win,plwin,beat,20,0,11,188,0.473404255,0.058510638,0.515957447,1,0.300306557
7393,107,21233,6,10,0,3,0,19,10,8,0,0,0,18,nowin,win,plwin,beat,20,0,16,218,0.444954128,0.073394495,0.600917431,2,0.605210014
7394,119,21233,6,1,10,0,0,17,10,8,0,0,0,18,nowin,loss,beat,dlwin,0,10,7,190,0.405263158,0.068421053,0.515789474,0,0.011837158
7395,85,21233,4,6,5,3,0,18,10,8,0,0,0,18,nowin,push,push,push,10,0,10,195,0.41025641,0.066666667,0.594871795,0,0.03269711
7396,85,21233,5,7,0,5,0,17,10,8,0,0,0,18,nowin,loss,beat,dlwin,0,10,12,195,0.41025641,0.066666667,0.594871795,0,0.03269711
7397,61,21233,3,10,0,9,0,22,10,8,0,0,0,18,nowin,loss,bust,plbust,0,10,13,194,0.427835052,0.077319588,0.603092784,2,0.591437139
7398,33,21234,2,10,0,4,10,26,10,10,0,0,0,20,nowin,loss,bust,plbust,0,10,12,192,0.4375,0.057291667,0.625,2,0.616208916
7399,117,21234,8,10,0,0,0,18,10,10,0,0,0,20,nowin,loss,beat,dlwin,0,10,18,173,0.410404624,0.069364162,0.606936416,2,0.578610282
7400,138,21234,10,3,0,10,0,23,10,10,0,0,0,20,nowin,loss,bust,plbust,0,10,13,190,0.442105263,0.047368421,0.610526316,2,0.609711065
7401,20,21234,10,9,0,0,0,19,10,10,0,0,0,20,nowin,loss,beat,dlwin,0,10,19,186,0.456989247,0.037634409,0.537634409,1,0.301097108
7402,83,21234,10,5,0,5,0,20,10,10,0,0,0,20,nowin,push,push,push,10,0,15,193,0.424870466,0.051813472,0.678756477,2,0.644360335
7403,16,21234,10,10,0,0,0,20,10,10,0,0,0,20,nowin,push,push,push,10,0,20,220,0.427272727,0.081818182,0.6,2,0.588660176
7404,27,21235,9,10,0,0,0,19,5,10,2,0,0,17,nowin,win,plwin,beat,20,0,19,178,0.370786517,0.016853933,0.573033708,0,0.015536309
7405,135,21235,10,4,0,0,0,14,5,10,2,0,0,17,nowin,loss,beat,dlwin,0,10,14,179,0.391061453,0.067039106,0.586592179,0,0.024924662
7406,1,21235,10,10,0,0,0,20,5,10,2,0,0,17,nowin,win,plwin,beat,20,0,20,197,0.406091371,0.025380711,0.649746193,2,0.606186955
7407,21,21235,8,5,0,0,0,13,5,10,2,0,0,17,nowin,loss,beat,dlwin,0,10,13,214,0.359813084,0.042056075,0.626168224,0,0.025263474
7408,42,21235,2,8,7,0,0,17,5,10,2,0,0,17,nowin,push,push,push,10,0,10,212,0.443396226,0.051886792,0.570754717,1,0.309181312
7409,77,21235,7,11,0,0,0,18,5,10,2,0,0,17,nowin,win,plwin,beat,20,0,18,200,0.455,0.04,0.62,3,0.916252116
7410,125,21236,8,10,0,0,0,18,3,8,5,10,0,26,nowin,win,dlbust,bust,20,0,18,219,0.438356164,0.050228311,0.575342466,1,0.308411257
7411,42,21236,10,4,0,0,0,14,3,8,5,10,0,26,nowin,win,dlbust,bust,20,0,14,212,0.443396226,0.051886792,0.570754717,1,0.309181312
7412,101,21236,10,6,0,0,0,16,3,8,5,10,0,26,nowin,win,dlbust,bust,20,0,16,205,0.424390244,0.068292683,0.63902439,2,0.614740646
7413,142,21236,7,10,0,0,0,17,3,8,5,10,0,26,nowin,win,dlbust,bust,20,0,17,211,0.417061611,0.047393365,0.526066351,1,0.271531309
7414,50,21236,10,11,0,0,0,21,3,8,5,10,0,26,win,win,dlbust,bust,25,0,21,202,0.405940594,0.04950495,0.54950495,0,0.020296079
7415,60,21236,10,10,0,0,0,20,3,8,5,10,0,26,nowin,win,dlbust,bust,20,0,20,227,0.418502203,0.022026432,0.559471366,0,0.026496258
7416,68,21237,3,4,9,10,0,26,10,4,9,0,0,23,nowin,loss,bust,plbust,0,10,7,205,0.434146341,0.029268293,0.6,2,0.59483189
7417,57,21237,11,3,3,0,0,17,10,4,9,0,0,23,nowin,win,dlbust,bust,20,0,14,192,0.46875,0.052083333,0.59375,3,0.907001181
7418,146,21237,11,2,7,0,0,20,10,4,9,0,0,23,nowin,win,dlbust,bust,20,0,13,221,0.43438914,0.040723982,0.542986425,1,0.290190091
7419,1,21237,10,9,0,0,0,19,10,4,9,0,0,23,nowin,win,dlbust,bust,20,0,19,197,0.406091371,0.025380711,0.649746193,2,0.606186955
7420,56,21237,10,7,0,0,0,17,10,4,9,0,0,23,nowin,win,dlbust,bust,20,0,17,175,0.4,0.057142857,0.582857143,0,0.026685297
7421,43,21237,10,9,0,0,0,19,10,4,9,0,0,23,nowin,win,dlbust,bust,20,0,19,192,0.40625,0.041666667,0.609375,2,0.576671372
7422,82,21238,10,5,0,10,0,25,10,7,0,0,0,17,nowin,loss,bust,plbust,0,10,15,225,0.408888889,0.075555556,0.577777778,0,0.028101874
7423,83,21238,9,6,0,10,0,25,10,7,0,0,0,17,nowin,loss,bust,plbust,0,10,15,193,0.424870466,0.051813472,0.678756477,2,0.644360335
7424,75,21238,8,5,0,9,0,22,10,7,0,0,0,17,nowin,loss,bust,plbust,0,10,13,191,0.418848168,0.052356021,0.570680628,0,0.029344702
7425,63,21238,8,3,1,4,9,25,10,7,0,0,0,17,nowin,loss,bust,plbust,0,10,11,216,0.467592593,0.037037037,0.62037037,3,0.931690496
7426,98,21238,10,2,0,2,1,15,10,7,0,0,0,17,nowin,loss,beat,dlwin,0,10,12,220,0.422727273,0.054545455,0.55,1,0.28664435
7427,76,21238,7,5,0,8,0,20,10,7,0,0,0,17,nowin,win,plwin,beat,20,0,12,189,0.534391534,0.079365079,0.608465608,3,1
7428,22,21239,10,6,0,0,0,16,4,3,10,0,0,17,nowin,loss,beat,dlwin,0,10,16,187,0.481283422,0.042780749,0.577540107,3,0.906128176
7429,55,21239,10,4,0,0,0,14,4,3,10,0,0,17,nowin,loss,beat,dlwin,0,10,14,191,0.371727749,0.057591623,0.54973822,0,0.01011347
7430,8,21239,4,10,0,0,0,14,4,3,10,0,0,17,nowin,loss,beat,dlwin,0,10,14,181,0.44198895,0.071823204,0.596685083,2,0.599438402
7431,71,21239,8,2,10,0,0,20,4,3,10,0,0,17,nowin,win,plwin,beat,20,0,10,193,0.352331606,0.046632124,0.585492228,0,0.013063661
7432,109,21239,10,5,0,0,0,15,4,3,10,0,0,17,nowin,loss,beat,dlwin,0,10,15,221,0.461538462,0.058823529,0.597285068,3,0.901830309
7433,112,21239,7,3,4,0,0,14,4,3,10,0,0,17,nowin,loss,beat,dlwin,0,10,10,203,0.448275862,0.054187192,0.600985222,3,0.889576933
7434,94,21240,10,10,0,0,0,20,10,6,10,0,0,26,nowin,win,dlbust,bust,20,0,20,183,0.43715847,0.043715847,0.540983607,1,0.290866892
7435,86,21240,10,10,0,0,0,20,10,6,10,0,0,26,nowin,win,dlbust,bust,20,0,20,196,0.454081633,0.040816327,0.591836735,3,0.887566443
7436,60,21240,5,5,10,0,0,20,10,6,10,0,0,26,nowin,win,dlbust,bust,20,0,10,227,0.418502203,0.022026432,0.559471366,0,0.026496258
7437,71,21240,6,10,0,2,0,18,10,6,10,0,0,26,nowin,win,dlbust,bust,20,0,16,193,0.352331606,0.046632124,0.585492228,0,0.013063661
7438,57,21240,1,4,10,1,3,19,10,6,10,0,0,26,nowin,win,dlbust,bust,20,0,5,192,0.46875,0.052083333,0.59375,3,0.907001181
7439,4,21240,7,5,0,9,0,21,10,6,10,0,0,26,nowin,win,dlbust,bust,20,0,12,217,0.460829493,0.036866359,0.562211982,1,0.315432839
7440,81,21241,10,8,0,0,0,18,4,4,4,4,4,20,nowin,loss,beat,dlwin,0,10,18,182,0.395604396,0.043956044,0.60989011,2,0.567491261
7441,63,21241,6,5,1,0,0,12,4,4,4,4,4,20,nowin,loss,beat,dlwin,0,10,11,216,0.467592593,0.037037037,0.62037037,3,0.931690496
7442,146,21241,10,2,0,0,0,12,4,4,4,4,4,20,nowin,loss,beat,dlwin,0,10,12,221,0.43438914,0.040723982,0.542986425,1,0.290190091
7443,75,21241,6,7,0,0,0,13,4,4,4,4,4,20,nowin,loss,beat,dlwin,0,10,13,191,0.418848168,0.052356021,0.570680628,0,0.029344702
7444,121,21241,7,6,0,0,0,13,4,4,4,4,4,20,nowin,loss,beat,dlwin,0,10,13,195,0.456410256,0.025641026,0.512820513,1,0.288597791
7445,30,21241,11,10,0,0,0,21,4,4,4,4,4,20,win,win,plwin,beat,25,0,21,206,0.393203883,0.033980583,0.601941748,0,0.029324648
7446,31,21242,4,11,3,0,0,18,6,10,10,0,0,26,nowin,win,dlbust,bust,20,0,15,188,0.473404255,0.058510638,0.515957447,1,0.300306557
7447,108,21242,11,10,0,0,0,21,6,10,10,0,0,26,win,win,dlbust,bust,25,0,21,193,0.435233161,0.056994819,0.559585492,1,0.298824795
7448,40,21242,11,10,0,0,0,21,6,10,10,0,0,26,win,win,dlbust,bust,25,0,21,196,0.367346939,0.030612245,0.617346939,0,0.025358183
7449,126,21242,10,9,0,0,0,19,6,10,10,0,0,26,nowin,win,dlbust,bust,20,0,19,188,0.457446809,0.074468085,0.60106383,3,0.900633203
7450,134,21242,5,1,8,0,0,14,6,10,10,0,0,26,nowin,win,dlbust,bust,20,0,6,185,0.443243243,0.021621622,0.545945946,1,0.296939509
7451,47,21242,10,4,0,0,0,14,6,10,10,0,0,26,nowin,win,dlbust,bust,20,0,14,210,0.438095238,0.057142857,0.623809524,2,0.615868808
7452,17,21243,2,9,9,0,0,20,4,8,3,10,0,25,nowin,win,dlbust,bust,20,0,11,171,0.444444444,0.070175439,0.555555556,1,0.302364894
7453,5,21243,6,10,0,0,0,16,4,8,3,10,0,25,nowin,win,dlbust,bust,20,0,16,203,0.42364532,0.02955665,0.596059113,2,0.582508076
7454,147,21243,4,7,9,0,0,20,4,8,3,10,0,25,nowin,win,dlbust,bust,20,0,11,205,0.380487805,0.014634146,0.536585366,0,0.00951447
7455,19,21243,10,9,0,0,0,19,4,8,3,10,0,25,nowin,win,dlbust,bust,20,0,19,237,0.41350211,0.054852321,0.628691983,2,0.597373826
7456,22,21243,8,10,0,0,0,18,4,8,3,10,0,25,nowin,win,dlbust,bust,20,0,18,187,0.481283422,0.042780749,0.577540107,3,0.906128176
7457,147,21243,11,1,8,0,0,20,4,8,3,10,0,25,nowin,win,dlbust,bust,20,0,12,205,0.380487805,0.014634146,0.536585366,0,0.00951447
7458,149,21244,10,10,0,0,0,20,2,10,4,4,0,20,nowin,push,push,push,10,0,20,225,0.457777778,0.057777778,0.648888889,2,0.651965595
7459,57,21244,7,2,10,0,0,19,2,10,4,4,0,20,nowin,loss,beat,dlwin,0,10,9,192,0.46875,0.052083333,0.59375,3,0.907001181
7460,6,21244,10,10,0,0,0,20,2,10,4,4,0,20,nowin,push,push,push,10,0,20,191,0.439790576,0.047120419,0.581151832,1,0.31211505
7461,58,21244,10,3,0,0,0,13,2,10,4,4,0,20,nowin,loss,beat,dlwin,0,10,13,195,0.430769231,0.041025641,0.584615385,2,0.580497586
7462,14,21244,8,7,0,0,0,15,2,10,4,4,0,20,nowin,loss,beat,dlwin,0,10,15,202,0.391089109,0.01980198,0.628712871,2,0.577264877
7463,9,21244,8,10,0,0,0,18,2,10,4,4,0,20,nowin,loss,beat,dlwin,0,10,18,194,0.37628866,0.015463918,0.541237113,0,0.009396796
7464,114,21245,1,5,6,0,0,12,5,10,10,0,0,25,nowin,win,dlbust,bust,20,0,6,198,0.47979798,0.025252525,0.611111111,3,0.937232995
7465,125,21245,3,2,2,10,0,17,5,10,10,0,0,25,nowin,win,dlbust,bust,20,0,5,219,0.438356164,0.050228311,0.575342466,1,0.308411257
7466,44,21245,6,1,7,0,0,14,5,10,10,0,0,25,nowin,win,dlbust,bust,20,0,7,219,0.433789954,0.050228311,0.534246575,1,0.285551035
7467,135,21245,9,2,10,0,0,21,5,10,10,0,0,25,nowin,win,dlbust,bust,20,0,11,179,0.391061453,0.067039106,0.586592179,0,0.024924662
7468,73,21245,10,2,0,0,0,12,5,10,10,0,0,25,nowin,win,dlbust,bust,20,0,12,181,0.375690608,0.011049724,0.596685083,0,0.022795773
7469,118,21245,5,8,0,0,0,13,5,10,10,0,0,25,nowin,win,dlbust,bust,20,0,13,216,0.393518519,0.037037037,0.555555556,0,0.018059873
7470,102,21246,4,9,0,0,0,13,2,5,10,0,0,17,nowin,loss,beat,dlwin,0,10,13,192,0.338541667,0.046875,0.5625,0,0.003306118
7471,35,21246,5,8,0,0,0,13,2,5,10,0,0,17,nowin,loss,beat,dlwin,0,10,13,202,0.410891089,0.044554455,0.633663366,2,0.598681573
7472,97,21246,10,8,0,0,0,18,2,5,10,0,0,17,nowin,win,plwin,beat,20,0,18,182,0.450549451,0.06043956,0.692307692,2,0.677372279
7473,84,21246,10,11,0,0,0,21,2,5,10,0,0,17,win,win,plwin,beat,25,0,21,195,0.379487179,0.056410256,0.569230769,0,0.017209119
7474,44,21246,5,10,0,0,0,15,2,5,10,0,0,17,nowin,loss,beat,dlwin,0,10,15,219,0.433789954,0.050228311,0.534246575,1,0.285551035
7475,94,21246,10,3,0,0,0,13,2,5,10,0,0,17,nowin,loss,beat,dlwin,0,10,13,183,0.43715847,0.043715847,0.540983607,1,0.290866892
7476,91,21247,7,6,0,3,9,25,7,6,3,7,0,23,nowin,loss,bust,plbust,0,10,13,194,0.417525773,0.046391753,0.515463918,1,0.266616552
7477,115,21247,3,2,10,5,0,20,7,6,3,7,0,23,nowin,win,dlbust,bust,20,0,5,194,0.427835052,0.041237113,0.592783505,2,0.583863602
7478,29,21247,10,4,0,9,0,23,7,6,3,7,0,23,nowin,loss,bust,plbust,0,10,14,189,0.44973545,0.058201058,0.544973545,1,0.300349439
7479,60,21247,10,3,0,2,8,23,7,6,3,7,0,23,nowin,loss,bust,plbust,0,10,13,227,0.418502203,0.022026432,0.559471366,0,0.026496258
7480,44,21247,10,4,0,4,0,18,7,6,3,7,0,23,nowin,win,dlbust,bust,20,0,14,219,0.433789954,0.050228311,0.534246575,1,0.285551035
7481,86,21247,2,4,7,3,5,21,7,6,3,7,0,23,nowin,win,dlbust,bust,20,0,6,196,0.454081633,0.040816327,0.591836735,3,0.887566443
7482,7,21248,3,10,0,6,0,19,8,5,8,0,0,21,nowin,loss,beat,dlwin,0,10,13,183,0.442622951,0.06010929,0.62295082,2,0.619303341
7483,118,21248,6,10,0,3,0,19,8,5,8,0,0,21,nowin,loss,beat,dlwin,0,10,16,216,0.393518519,0.037037037,0.555555556,0,0.018059873
7484,3,21248,5,3,9,0,0,17,8,5,8,0,0,21,nowin,loss,beat,dlwin,0,10,8,190,0.431578947,0.026315789,0.542105263,1,0.288076384
7485,43,21248,10,10,0,0,0,20,8,5,8,0,0,21,nowin,loss,beat,dlwin,0,10,20,192,0.40625,0.041666667,0.609375,2,0.576671372
7486,19,21248,9,7,0,6,0,22,8,5,8,0,0,21,nowin,loss,bust,plbust,0,10,16,237,0.41350211,0.054852321,0.628691983,2,0.597373826
7487,137,21248,10,11,0,0,0,21,8,5,8,0,0,21,win,push,push,push,10,0,21,194,0.417525773,0.046391753,0.536082474,1,0.276714602
7488,138,21249,8,3,2,0,0,13,4,4,4,6,0,18,nowin,loss,beat,dlwin,0,10,11,190,0.442105263,0.047368421,0.610526316,2,0.609711065
7489,3,21249,10,6,0,0,0,16,4,4,4,6,0,18,nowin,loss,beat,dlwin,0,10,16,190,0.431578947,0.026315789,0.542105263,1,0.288076384
7490,24,21249,10,10,0,0,0,20,4,4,4,6,0,18,nowin,win,plwin,beat,20,0,20,207,0.458937198,0.048309179,0.570048309,1,0.318138014
7491,17,21249,9,11,0,0,0,20,4,4,4,6,0,18,nowin,win,plwin,beat,20,0,20,171,0.444444444,0.070175439,0.555555556,1,0.302364894
7492,63,21249,6,10,0,0,0,16,4,4,4,6,0,18,nowin,loss,beat,dlwin,0,10,16,216,0.467592593,0.037037037,0.62037037,3,0.931690496
7493,126,21249,9,3,0,0,0,12,4,4,4,6,0,18,nowin,loss,beat,dlwin,0,10,12,188,0.457446809,0.074468085,0.60106383,3,0.900633203
7494,113,21250,10,11,0,0,0,21,7,6,6,0,0,19,win,win,plwin,beat,25,0,21,199,0.407035176,0.055276382,0.668341709,2,0.620695264
7495,125,21250,5,3,10,0,0,18,7,6,6,0,0,19,nowin,loss,beat,dlwin,0,10,8,219,0.438356164,0.050228311,0.575342466,1,0.308411257
7496,54,21250,10,10,0,0,0,20,7,6,6,0,0,19,nowin,win,plwin,beat,20,0,20,185,0.437837838,0.032432432,0.556756757,1,0.29899854
7497,77,21250,8,11,0,0,0,19,7,6,6,0,0,19,nowin,push,push,push,10,0,19,200,0.455,0.04,0.62,3,0.916252116
7498,43,21250,10,2,0,10,0,22,7,6,6,0,0,19,nowin,loss,bust,plbust,0,10,12,192,0.40625,0.041666667,0.609375,2,0.576671372
7499,113,21250,5,2,11,0,0,18,7,6,6,0,0,19,nowin,loss,beat,dlwin,0,10,7,199,0.407035176,0.055276382,0.668341709,2,0.620695264
7500,77,21251,9,10,0,0,0,19,6,2,10,0,0,18,nowin,win,plwin,beat,20,0,19,200,0.455,0.04,0.62,3,0.916252116
7501,59,21251,10,10,0,0,0,20,6,2,10,0,0,18,nowin,win,plwin,beat,20,0,20,228,0.429824561,0.048245614,0.543859649,1,0.287885446
7502,36,21251,3,4,3,10,0,20,6,2,10,0,0,18,nowin,win,plwin,beat,20,0,7,229,0.445414847,0.056768559,0.655021834,2,0.645370571
7503,139,21251,4,10,0,0,0,14,6,2,10,0,0,18,nowin,loss,beat,dlwin,0,10,14,192,0.380208333,0.036458333,0.59375,0,0.023429169
7504,144,21251,10,5,0,0,0,15,6,2,10,0,0,18,nowin,loss,beat,dlwin,0,10,15,202,0.386138614,0.054455446,0.564356436,0,0.018006244
7505,31,21251,8,10,0,0,0,18,6,2,10,0,0,18,nowin,push,push,push,10,0,18,188,0.473404255,0.058510638,0.515957447,1,0.300306557
7506,110,21252,8,10,0,0,0,18,7,4,3,1,2,17,nowin,win,plwin,beat,20,0,18,192,0.416666667,0.046875,0.557291667,0,0.025413132
7507,28,21252,11,4,4,0,0,19,7,4,3,1,2,17,nowin,win,plwin,beat,20,0,15,199,0.422110553,0.045226131,0.542713568,1,0.282706618
7508,37,21252,11,3,6,0,0,20,7,4,3,1,2,17,nowin,win,plwin,beat,20,0,14,208,0.394230769,0.038461538,0.581730769,0,0.024682772
7509,110,21252,4,7,6,0,0,17,7,4,3,1,2,17,nowin,push,push,push,10,0,11,192,0.416666667,0.046875,0.557291667,0,0.025413132
7510,72,21252,4,10,0,10,0,24,7,4,3,1,2,17,nowin,loss,bust,plbust,0,10,14,185,0.394594595,0.032432432,0.508108108,0,0.006763115
7511,116,21252,10,2,0,8,0,20,7,4,3,1,2,17,nowin,win,plwin,beat,20,0,12,195,0.425641026,0.056410256,0.538461538,1,0.28273747
7512,89,21253,11,2,3,5,0,21,9,6,8,0,0,23,nowin,win,dlbust,bust,20,0,13,212,0.537735849,0.047169811,0.594339623,3,0.990167191
7513,49,21253,2,10,0,8,0,20,9,6,8,0,0,23,nowin,win,dlbust,bust,20,0,12,207,0.396135266,0.053140097,0.594202899,0,0.028306925
7514,80,21253,11,8,0,0,0,19,9,6,8,0,0,23,nowin,win,dlbust,bust,20,0,19,186,0.419354839,0.059139785,0.623655914,2,0.59892924
7515,53,21253,7,5,0,10,0,22,9,6,8,0,0,23,nowin,loss,bust,plbust,0,10,12,250,0.372,0.064,0.564,0,0.013687345
7516,45,21253,11,2,3,7,0,23,9,6,8,0,0,23,nowin,loss,bust,plbust,0,10,13,196,0.428571429,0.051020408,0.612244898,2,0.598821767
7517,90,21253,10,3,0,10,0,23,9,6,8,0,0,23,nowin,loss,bust,plbust,0,10,13,201,0.447761194,0.049751244,0.60199005,3,0.889945023
7518,127,21254,4,10,0,10,0,24,10,11,0,0,0,21,nowin,loss,bust,plbust,0,10,14,201,0.402985075,0.029850746,0.60199005,0,0.032263937
7519,104,21254,5,6,5,7,0,23,10,11,0,0,0,21,nowin,loss,bust,plbust,0,10,11,209,0.363636364,0.052631579,0.593301435,0,0.018359419
7520,48,21254,2,7,2,10,0,21,10,11,0,0,0,21,nowin,push,push,push,10,0,9,203,0.413793103,0.019704433,0.600985222,2,0.577280801
7521,117,21254,2,10,0,5,0,17,10,11,0,0,0,21,nowin,loss,beat,dlwin,0,10,12,173,0.410404624,0.069364162,0.606936416,2,0.578610282
7522,78,21254,2,11,4,0,0,17,10,11,0,0,0,21,nowin,loss,beat,dlwin,0,10,13,201,0.517412935,0.034825871,0.587064677,3,0.95871112
7523,125,21254,10,2,0,10,0,22,10,11,0,0,0,21,nowin,loss,bust,plbust,0,10,12,219,0.438356164,0.050228311,0.575342466,1,0.308411257
7524,101,21255,5,4,6,10,0,25,10,10,0,0,0,20,nowin,loss,bust,plbust,0,10,9,205,0.424390244,0.068292683,0.63902439,2,0.614740646
7525,85,21255,4,6,10,0,0,20,10,10,0,0,0,20,nowin,push,push,push,10,0,10,195,0.41025641,0.066666667,0.594871795,0,0.03269711
7526,35,21255,10,5,0,10,0,25,10,10,0,0,0,20,nowin,loss,bust,plbust,0,10,15,202,0.410891089,0.044554455,0.633663366,2,0.598681573
7527,20,21255,2,7,10,0,0,19,10,10,0,0,0,20,nowin,loss,beat,dlwin,0,10,9,186,0.456989247,0.037634409,0.537634409,1,0.301097108
7528,52,21255,6,10,0,10,0,26,10,10,0,0,0,20,nowin,loss,bust,plbust,0,10,16,217,0.414746544,0.02764977,0.599078341,2,0.576736024
7529,37,21255,9,7,0,7,0,23,10,10,0,0,0,20,nowin,loss,bust,plbust,0,10,16,208,0.394230769,0.038461538,0.581730769,0,0.024682772
7530,3,21256,10,8,0,0,0,18,3,2,10,8,0,23,nowin,win,dlbust,bust,20,0,18,190,0.431578947,0.026315789,0.542105263,1,0.288076384
7531,128,21256,4,1,10,0,0,15,3,2,10,8,0,23,nowin,win,dlbust,bust,20,0,5,227,0.356828194,0.052863436,0.577092511,0,0.012352564
7532,118,21256,5,10,0,0,0,15,3,2,10,8,0,23,nowin,win,dlbust,bust,20,0,15,216,0.393518519,0.037037037,0.555555556,0,0.018059873
7533,3,21256,4,8,0,9,0,21,3,2,10,8,0,23,nowin,win,dlbust,bust,20,0,12,190,0.431578947,0.026315789,0.542105263,1,0.288076384
7534,17,21256,11,1,8,0,0,20,3,2,10,8,0,23,nowin,win,dlbust,bust,20,0,12,171,0.444444444,0.070175439,0.555555556,1,0.302364894
7535,80,21256,3,7,10,0,0,20,3,2,10,8,0,23,nowin,win,dlbust,bust,20,0,10,186,0.419354839,0.059139785,0.623655914,2,0.59892924
7536,89,21257,10,3,0,4,0,17,10,10,0,0,0,20,nowin,loss,beat,dlwin,0,10,13,212,0.537735849,0.047169811,0.594339623,3,0.990167191
7537,19,21257,4,9,0,4,0,17,10,10,0,0,0,20,nowin,loss,beat,dlwin,0,10,13,237,0.41350211,0.054852321,0.628691983,2,0.597373826
7538,73,21257,10,9,0,0,0,19,10,10,0,0,0,20,nowin,loss,beat,dlwin,0,10,19,181,0.375690608,0.011049724,0.596685083,0,0.022795773
7539,115,21257,3,2,11,4,0,20,10,10,0,0,0,20,nowin,push,push,push,10,0,5,194,0.427835052,0.041237113,0.592783505,2,0.583863602
7540,71,21257,10,5,0,5,0,20,10,10,0,0,0,20,nowin,push,push,push,10,0,15,193,0.352331606,0.046632124,0.585492228,0,0.013063661
7541,133,21257,9,10,0,0,0,19,10,10,0,0,0,20,nowin,loss,beat,dlwin,0,10,19,201,0.47761194,0.064676617,0.611940299,3,0.935428111
7542,66,21258,11,10,0,0,0,21,8,7,10,0,0,25,win,win,dlbust,bust,25,0,21,217,0.456221198,0.064516129,0.626728111,3,0.924304367
7543,124,21258,10,11,0,0,0,21,8,7,10,0,0,25,win,win,dlbust,bust,25,0,21,202,0.47029703,0.064356436,0.584158416,3,0.899458193
7544,78,21258,10,10,0,0,0,20,8,7,10,0,0,25,nowin,win,dlbust,bust,20,0,20,201,0.517412935,0.034825871,0.587064677,3,0.95871112
7545,10,21258,4,6,10,0,0,20,8,7,10,0,0,25,nowin,win,dlbust,bust,20,0,10,191,0.413612565,0.057591623,0.596858639,2,0.574087175
7546,63,21258,2,2,5,4,6,19,8,7,10,0,0,25,nowin,win,dlbust,bust,20,0,4,216,0.467592593,0.037037037,0.62037037,3,0.931690496
7547,96,21258,2,10,0,5,0,17,8,7,10,0,0,25,nowin,win,dlbust,bust,20,0,12,190,0.468421053,0.057894737,0.584210526,3,0.897263354
7548,80,21259,10,8,0,0,0,18,6,10,8,0,0,24,nowin,win,dlbust,bust,20,0,18,186,0.419354839,0.059139785,0.623655914,2,0.59892924
7549,61,21259,4,11,3,0,0,18,6,10,8,0,0,24,nowin,win,dlbust,bust,20,0,15,194,0.427835052,0.077319588,0.603092784,2,0.591437139
7550,126,21259,11,8,0,0,0,19,6,10,8,0,0,24,nowin,win,dlbust,bust,20,0,19,188,0.457446809,0.074468085,0.60106383,3,0.900633203
7551,31,21259,2,6,10,0,0,18,6,10,8,0,0,24,nowin,win,dlbust,bust,20,0,8,188,0.473404255,0.058510638,0.515957447,1,0.300306557
7552,101,21259,10,2,0,0,0,12,6,10,8,0,0,24,nowin,win,dlbust,bust,20,0,12,205,0.424390244,0.068292683,0.63902439,2,0.614740646
7553,72,21259,5,5,10,0,0,20,6,10,8,0,0,24,nowin,win,dlbust,bust,20,0,10,185,0.394594595,0.032432432,0.508108108,0,0.006763115
7554,121,21260,10,5,0,0,0,15,5,7,9,0,0,21,nowin,loss,beat,dlwin,0,10,15,195,0.456410256,0.025641026,0.512820513,1,0.288597791
7555,90,21260,3,4,11,0,0,18,5,7,9,0,0,21,nowin,loss,beat,dlwin,0,10,7,201,0.447761194,0.049751244,0.60199005,3,0.889945023
7556,101,21260,10,10,0,0,0,20,5,7,9,0,0,21,nowin,loss,beat,dlwin,0,10,20,205,0.424390244,0.068292683,0.63902439,2,0.614740646
7557,37,21260,2,7,6,0,0,15,5,7,9,0,0,21,nowin,loss,beat,dlwin,0,10,9,208,0.394230769,0.038461538,0.581730769,0,0.024682772
7558,143,21260,10,5,0,0,0,15,5,7,9,0,0,21,nowin,loss,beat,dlwin,0,10,15,203,0.463054187,0.044334975,0.57635468,3,0.883143365
7559,78,21260,5,10,0,0,0,15,5,7,9,0,0,21,nowin,loss,beat,dlwin,0,10,15,201,0.517412935,0.034825871,0.587064677,3,0.95871112
7560,137,21261,11,9,0,0,0,20,7,4,10,0,0,21,nowin,loss,beat,dlwin,0,10,20,194,0.417525773,0.046391753,0.536082474,1,0.276714602
7561,92,21261,4,7,10,0,0,21,7,4,10,0,0,21,nowin,push,push,push,10,0,11,186,0.446236559,0.059139785,0.564516129,1,0.307826125
7562,10,21261,11,5,5,0,0,21,7,4,10,0,0,21,nowin,push,push,push,10,0,16,191,0.413612565,0.057591623,0.596858639,2,0.574087175
7563,48,21261,7,6,0,5,0,18,7,4,10,0,0,21,nowin,loss,beat,dlwin,0,10,13,203,0.413793103,0.019704433,0.600985222,2,0.577280801
7564,116,21261,3,11,4,0,0,18,7,4,10,0,0,21,nowin,loss,beat,dlwin,0,10,14,195,0.425641026,0.056410256,0.538461538,1,0.28273747
7565,139,21261,10,6,0,3,0,19,7,4,10,0,0,21,nowin,loss,beat,dlwin,0,10,16,192,0.380208333,0.036458333,0.59375,0,0.023429169
7566,31,21262,4,5,7,10,0,26,10,5,10,0,0,25,nowin,loss,bust,plbust,0,10,9,188,0.473404255,0.058510638,0.515957447,1,0.300306557
7567,122,21262,2,4,9,3,0,18,10,5,10,0,0,25,nowin,win,dlbust,bust,20,0,6,210,0.347619048,0.052380952,0.59047619,0,0.012873677
7568,75,21262,10,2,0,7,0,19,10,5,10,0,0,25,nowin,win,dlbust,bust,20,0,12,191,0.418848168,0.052356021,0.570680628,0,0.029344702
7569,83,21262,2,5,10,0,0,17,10,5,10,0,0,25,nowin,win,dlbust,bust,20,0,7,193,0.424870466,0.051813472,0.678756477,2,0.644360335
7570,77,21262,10,10,0,0,0,20,10,5,10,0,0,25,nowin,win,dlbust,bust,20,0,20,200,0.455,0.04,0.62,3,0.916252116
7571,84,21262,10,4,0,10,0,24,10,5,10,0,0,25,nowin,loss,bust,plbust,0,10,14,195,0.379487179,0.056410256,0.569230769,0,0.017209119
7572,82,21263,4,4,8,10,0,26,9,7,10,0,0,26,nowin,loss,bust,plbust,0,10,8,225,0.408888889,0.075555556,0.577777778,0,0.028101874
7573,145,21263,7,3,3,10,0,23,9,7,10,0,0,26,nowin,loss,bust,plbust,0,10,10,188,0.441489362,0.031914894,0.622340426,2,0.617837093
7574,33,21263,6,10,0,9,0,25,9,7,10,0,0,26,nowin,loss,bust,plbust,0,10,16,192,0.4375,0.057291667,0.625,2,0.616208916
7575,102,21263,10,3,0,1,2,16,9,7,10,0,0,26,nowin,win,dlbust,bust,20,0,13,192,0.338541667,0.046875,0.5625,0,0.003306118
7576,29,21263,6,10,0,8,0,24,9,7,10,0,0,26,nowin,loss,bust,plbust,0,10,16,189,0.44973545,0.058201058,0.544973545,1,0.300349439
7577,102,21263,2,10,0,1,9,22,9,7,10,0,0,26,nowin,loss,bust,plbust,0,10,12,192,0.338541667,0.046875,0.5625,0,0.003306118
7578,78,21264,2,9,9,0,0,20,3,2,8,3,2,18,nowin,win,plwin,beat,20,0,11,201,0.517412935,0.034825871,0.587064677,3,0.95871112
7579,48,21264,10,10,0,0,0,20,3,2,8,3,2,18,nowin,win,plwin,beat,20,0,20,203,0.413793103,0.019704433,0.600985222,2,0.577280801
7580,28,21264,4,10,0,0,0,14,3,2,8,3,2,18,nowin,loss,beat,dlwin,0,10,14,199,0.422110553,0.045226131,0.542713568,1,0.282706618
7581,60,21264,4,2,10,0,0,16,3,2,8,3,2,18,nowin,loss,beat,dlwin,0,10,6,227,0.418502203,0.022026432,0.559471366,0,0.026496258
7582,114,21264,3,10,0,0,0,13,3,2,8,3,2,18,nowin,loss,beat,dlwin,0,10,13,198,0.47979798,0.025252525,0.611111111,3,0.937232995
7583,140,21264,2,10,0,9,0,21,3,2,8,3,2,18,nowin,win,plwin,beat,20,0,12,210,0.466666667,0.023809524,0.604761905,3,0.915293335
7584,85,21265,9,7,0,0,0,16,3,3,9,9,0,24,nowin,win,dlbust,bust,20,0,16,195,0.41025641,0.066666667,0.594871795,0,0.03269711
7585,99,21265,9,6,0,0,0,15,3,3,9,9,0,24,nowin,win,dlbust,bust,20,0,15,207,0.47826087,0.062801932,0.637681159,3,0.961418446
7586,114,21265,10,7,0,0,0,17,3,3,9,9,0,24,nowin,win,dlbust,bust,20,0,17,198,0.47979798,0.025252525,0.611111111,3,0.937232995
7587,15,21265,10,10,0,0,0,20,3,3,9,9,0,24,nowin,win,dlbust,bust,20,0,20,212,0.410377358,0.051886792,0.561320755,0,0.024517408
7588,148,21265,2,10,0,3,0,15,3,3,9,9,0,24,nowin,win,dlbust,bust,20,0,12,204,0.401960784,0.078431373,0.593137255,0,0.029789521
7589,142,21265,9,6,0,0,0,15,3,3,9,9,0,24,nowin,win,dlbust,bust,20,0,15,211,0.417061611,0.047393365,0.526066351,1,0.271531309
7590,29,21266,10,4,0,0,0,14,4,10,7,0,0,21,nowin,loss,beat,dlwin,0,10,14,189,0.44973545,0.058201058,0.544973545,1,0.300349439
7591,5,21266,10,9,0,0,0,19,4,10,7,0,0,21,nowin,loss,beat,dlwin,0,10,19,203,0.42364532,0.02955665,0.596059113,2,0.582508076
7592,93,21266,10,10,0,0,0,20,4,10,7,0,0,21,nowin,loss,beat,dlwin,0,10,20,175,0.485714286,0.051428571,0.548571429,1,0.323648091
7593,125,21266,10,11,0,0,0,21,4,10,7,0,0,21,win,push,push,push,10,0,21,219,0.438356164,0.050228311,0.575342466,1,0.308411257
7594,95,21266,7,4,3,0,0,14,4,10,7,0,0,21,nowin,loss,beat,dlwin,0,10,11,218,0.412844037,0.04587156,0.559633028,0,0.024842385
7595,121,21266,9,9,0,0,0,18,4,10,7,0,0,21,nowin,loss,beat,dlwin,0,10,18,195,0.456410256,0.025641026,0.512820513,1,0.288597791
7596,118,21267,7,5,0,9,0,21,10,10,0,0,0,20,nowin,win,plwin,beat,20,0,12,216,0.393518519,0.037037037,0.555555556,0,0.018059873
7597,58,21267,5,2,3,10,0,20,10,10,0,0,0,20,nowin,push,push,push,10,0,7,195,0.430769231,0.041025641,0.584615385,2,0.580497586
7598,52,21267,10,8,0,0,0,18,10,10,0,0,0,20,nowin,loss,beat,dlwin,0,10,18,217,0.414746544,0.02764977,0.599078341,2,0.576736024
7599,107,21267,2,1,10,9,0,22,10,10,0,0,0,20,nowin,loss,bust,plbust,0,10,3,218,0.444954128,0.073394495,0.600917431,2,0.605210014
7600,78,21267,2,10,0,3,10,25,10,10,0,0,0,20,nowin,loss,bust,plbust,0,10,12,201,0.517412935,0.034825871,0.587064677,3,0.95871112
7601,128,21267,10,10,0,0,0,20,10,10,0,0,0,20,nowin,push,push,push,10,0,20,227,0.356828194,0.052863436,0.577092511,0,0.012352564
7602,6,21268,11,7,0,0,0,18,8,7,1,6,0,22,nowin,win,dlbust,bust,20,0,18,191,0.439790576,0.047120419,0.581151832,1,0.31211505
7603,108,21268,10,7,0,0,0,17,8,7,1,6,0,22,nowin,win,dlbust,bust,20,0,17,193,0.435233161,0.056994819,0.559585492,1,0.298824795
7604,15,21268,10,11,0,0,0,21,8,7,1,6,0,22,win,win,dlbust,bust,25,0,21,212,0.410377358,0.051886792,0.561320755,0,0.024517408
7605,150,21268,10,6,0,3,0,19,8,7,1,6,0,22,nowin,win,dlbust,bust,20,0,16,192,0.401041667,0.036458333,0.567708333,0,0.023287458
7606,28,21268,10,7,0,0,0,17,8,7,1,6,0,22,nowin,win,dlbust,bust,20,0,17,199,0.422110553,0.045226131,0.542713568,1,0.282706618
7607,97,21268,5,10,0,6,0,21,8,7,1,6,0,22,nowin,win,dlbust,bust,20,0,15,182,0.450549451,0.06043956,0.692307692,2,0.677372279
7608,57,21269,10,6,0,3,0,19,7,10,0,0,0,17,nowin,win,plwin,beat,20,0,16,192,0.46875,0.052083333,0.59375,3,0.907001181
7609,52,21269,5,10,0,7,0,22,7,10,0,0,0,17,nowin,loss,bust,plbust,0,10,15,217,0.414746544,0.02764977,0.599078341,2,0.576736024
7610,66,21269,8,10,0,0,0,18,7,10,0,0,0,17,nowin,win,plwin,beat,20,0,18,217,0.456221198,0.064516129,0.626728111,3,0.924304367
7611,82,21269,8,10,0,0,0,18,7,10,0,0,0,17,nowin,win,plwin,beat,20,0,18,225,0.408888889,0.075555556,0.577777778,0,0.028101874
7612,47,21269,4,4,11,0,0,19,7,10,0,0,0,17,nowin,win,plwin,beat,20,0,8,210,0.438095238,0.057142857,0.623809524,2,0.615868808
7613,5,21269,8,10,0,0,0,18,7,10,0,0,0,17,nowin,win,plwin,beat,20,0,18,203,0.42364532,0.02955665,0.596059113,2,0.582508076
7614,61,21270,2,8,4,10,0,24,10,8,0,0,0,18,nowin,loss,bust,plbust,0,10,10,194,0.427835052,0.077319588,0.603092784,2,0.591437139
7615,5,21270,4,7,6,0,0,17,10,8,0,0,0,18,nowin,loss,beat,dlwin,0,10,11,203,0.42364532,0.02955665,0.596059113,2,0.582508076
7616,94,21270,2,3,8,7,0,20,10,8,0,0,0,18,nowin,win,plwin,beat,20,0,5,183,0.43715847,0.043715847,0.540983607,1,0.290866892
7617,55,21270,3,10,0,1,7,21,10,8,0,0,0,18,nowin,win,plwin,beat,20,0,13,191,0.371727749,0.057591623,0.54973822,0,0.01011347
7618,24,21270,10,2,0,7,0,19,10,8,0,0,0,18,nowin,win,plwin,beat,20,0,12,207,0.458937198,0.048309179,0.570048309,1,0.318138014
7619,14,21270,9,3,0,4,8,24,10,8,0,0,0,18,nowin,loss,bust,plbust,0,10,12,202,0.391089109,0.01980198,0.628712871,2,0.577264877
7620,51,21271,7,10,0,0,0,17,4,9,6,0,0,19,nowin,loss,beat,dlwin,0,10,17,189,0.529100529,0.068783069,0.608465608,3,0.993665715
7621,106,21271,2,10,0,0,0,12,4,9,6,0,0,19,nowin,loss,beat,dlwin,0,10,12,192,0.411458333,0.026041667,0.557291667,0,0.023854304
7622,68,21271,2,10,0,0,0,12,4,9,6,0,0,19,nowin,loss,beat,dlwin,0,10,12,205,0.434146341,0.029268293,0.6,2,0.59483189
7623,81,21271,10,8,0,0,0,18,4,9,6,0,0,19,nowin,loss,beat,dlwin,0,10,18,182,0.395604396,0.043956044,0.60989011,2,0.567491261
7624,135,21271,1,1,10,0,0,12,4,9,6,0,0,19,nowin,loss,beat,dlwin,0,10,2,179,0.391061453,0.067039106,0.586592179,0,0.024924662
7625,23,21271,10,5,0,0,0,15,4,9,6,0,0,19,nowin,loss,beat,dlwin,0,10,15,208,0.427884615,0.0625,0.552884615,1,0.29114424
7626,112,21272,10,5,0,0,0,15,3,10,10,0,0,23,nowin,win,dlbust,bust,20,0,15,203,0.448275862,0.054187192,0.600985222,3,0.889576933
7627,9,21272,5,10,0,0,0,15,3,10,10,0,0,23,nowin,win,dlbust,bust,20,0,15,194,0.37628866,0.015463918,0.541237113,0,0.009396796
7628,47,21272,10,10,0,0,0,20,3,10,10,0,0,23,nowin,win,dlbust,bust,20,0,20,210,0.438095238,0.057142857,0.623809524,2,0.615868808
7629,72,21272,10,10,0,0,0,20,3,10,10,0,0,23,nowin,win,dlbust,bust,20,0,20,185,0.394594595,0.032432432,0.508108108,0,0.006763115
7630,61,21272,2,7,9,0,0,18,3,10,10,0,0,23,nowin,win,dlbust,bust,20,0,9,194,0.427835052,0.077319588,0.603092784,2,0.591437139
7631,36,21272,3,3,10,0,0,16,3,10,10,0,0,23,nowin,win,dlbust,bust,20,0,6,229,0.445414847,0.056768559,0.655021834,2,0.645370571
7632,17,21273,6,10,0,3,0,19,10,8,0,0,0,18,nowin,win,plwin,beat,20,0,16,171,0.444444444,0.070175439,0.555555556,1,0.302364894
7633,33,21273,10,3,0,4,0,17,10,8,0,0,0,18,nowin,loss,beat,dlwin,0,10,13,192,0.4375,0.057291667,0.625,2,0.616208916
7634,4,21273,10,8,0,0,0,18,10,8,0,0,0,18,nowin,push,push,push,10,0,18,217,0.460829493,0.036866359,0.562211982,1,0.315432839
7635,31,21273,8,8,0,2,0,18,10,8,0,0,0,18,nowin,push,push,push,10,0,16,188,0.473404255,0.058510638,0.515957447,1,0.300306557
7636,101,21273,6,4,10,0,0,20,10,8,0,0,0,18,nowin,win,plwin,beat,20,0,10,205,0.424390244,0.068292683,0.63902439,2,0.614740646
7637,105,21273,7,4,2,7,0,20,10,8,0,0,0,18,nowin,win,plwin,beat,20,0,11,198,0.414141414,0.070707071,0.590909091,0,0.032889494
7638,23,21274,5,8,0,0,0,13,6,10,10,0,0,26,nowin,win,dlbust,bust,20,0,13,208,0.427884615,0.0625,0.552884615,1,0.29114424
7639,130,21274,6,8,0,0,0,14,6,10,10,0,0,26,nowin,win,dlbust,bust,20,0,14,219,0.410958904,0.03652968,0.566210046,0,0.025888739
7640,34,21274,2,7,10,0,0,19,6,10,10,0,0,26,nowin,win,dlbust,bust,20,0,9,202,0.5,0.079207921,0.618811881,3,0.968961434
7641,140,21274,3,6,3,0,0,12,6,10,10,0,0,26,nowin,win,dlbust,bust,20,0,9,210,0.466666667,0.023809524,0.604761905,3,0.915293335
7642,87,21274,8,10,0,0,0,18,6,10,10,0,0,26,nowin,win,dlbust,bust,20,0,18,202,0.405940594,0.054455446,0.628712871,2,0.590599801
7643,75,21274,9,5,0,0,0,14,6,10,10,0,0,26,nowin,win,dlbust,bust,20,0,14,191,0.418848168,0.052356021,0.570680628,0,0.029344702
7644,128,21275,4,3,7,0,0,14,2,8,2,2,6,20,nowin,loss,beat,dlwin,0,10,7,227,0.356828194,0.052863436,0.577092511,0,0.012352564
7645,86,21275,10,10,0,0,0,20,2,8,2,2,6,20,nowin,push,push,push,10,0,20,196,0.454081633,0.040816327,0.591836735,3,0.887566443
7646,118,21275,10,10,0,0,0,20,2,8,2,2,6,20,nowin,push,push,push,10,0,20,216,0.393518519,0.037037037,0.555555556,0,0.018059873
7647,124,21275,10,9,0,0,0,19,2,8,2,2,6,20,nowin,loss,beat,dlwin,0,10,19,202,0.47029703,0.064356436,0.584158416,3,0.899458193
7648,71,21275,7,10,0,0,0,17,2,8,2,2,6,20,nowin,loss,beat,dlwin,0,10,17,193,0.352331606,0.046632124,0.585492228,0,0.013063661
7649,25,21275,10,10,0,0,0,20,2,8,2,2,6,20,nowin,push,push,push,10,0,20,190,0.463157895,0.063157895,0.536842105,1,0.304401563
7650,6,21276,5,5,9,0,0,19,10,10,0,0,0,20,nowin,loss,beat,dlwin,0,10,10,191,0.439790576,0.047120419,0.581151832,1,0.31211505
7651,31,21276,6,10,0,7,0,23,10,10,0,0,0,20,nowin,loss,bust,plbust,0,10,16,188,0.473404255,0.058510638,0.515957447,1,0.300306557
7652,20,21276,8,10,0,0,0,18,10,10,0,0,0,20,nowin,loss,beat,dlwin,0,10,18,186,0.456989247,0.037634409,0.537634409,1,0.301097108
7653,87,21276,10,6,0,9,0,25,10,10,0,0,0,20,nowin,loss,bust,plbust,0,10,16,202,0.405940594,0.054455446,0.628712871,2,0.590599801
7654,66,21276,8,10,0,0,0,18,10,10,0,0,0,20,nowin,loss,beat,dlwin,0,10,18,217,0.456221198,0.064516129,0.626728111,3,0.924304367
7655,84,21276,10,10,0,0,0,20,10,10,0,0,0,20,nowin,push,push,push,10,0,20,195,0.379487179,0.056410256,0.569230769,0,0.017209119
7656,78,21277,10,7,0,0,0,17,6,10,1,0,0,17,nowin,push,push,push,10,0,17,201,0.517412935,0.034825871,0.587064677,3,0.95871112
7657,106,21277,8,6,0,0,0,14,6,10,1,0,0,17,nowin,loss,beat,dlwin,0,10,14,192,0.411458333,0.026041667,0.557291667,0,0.023854304
7658,33,21277,10,11,0,0,0,21,6,10,1,0,0,17,win,win,plwin,beat,25,0,21,192,0.4375,0.057291667,0.625,2,0.616208916
7659,129,21277,2,10,0,0,0,12,6,10,1,0,0,17,nowin,loss,beat,dlwin,0,10,12,201,0.422885572,0.064676617,0.55721393,0,0.027255383
7660,53,21277,10,11,0,0,0,21,6,10,1,0,0,17,win,win,plwin,beat,25,0,21,250,0.372,0.064,0.564,0,0.013687345
7661,113,21277,10,10,0,0,0,20,6,10,1,0,0,17,nowin,win,plwin,beat,20,0,20,199,0.407035176,0.055276382,0.668341709,2,0.620695264
7662,119,21278,4,10,0,8,0,22,9,10,0,0,0,19,nowin,loss,bust,plbust,0,10,14,190,0.405263158,0.068421053,0.515789474,0,0.011837158
7663,66,21278,3,10,0,1,2,16,9,10,0,0,0,19,nowin,loss,beat,dlwin,0,10,13,217,0.456221198,0.064516129,0.626728111,3,0.924304367
7664,69,21278,5,10,0,9,0,24,9,10,0,0,0,19,nowin,loss,bust,plbust,0,10,15,194,0.365979381,0.030927835,0.515463918,0,0
7665,103,21278,2,10,0,8,0,20,9,10,0,0,0,19,nowin,win,plwin,beat,20,0,12,203,0.379310345,0.064039409,0.551724138,0,0.012869209
7666,73,21278,10,3,0,3,2,18,9,10,0,0,0,19,nowin,loss,beat,dlwin,0,10,13,181,0.375690608,0.011049724,0.596685083,0,0.022795773
7667,120,21278,5,11,3,0,0,19,9,10,0,0,0,19,nowin,push,push,push,10,0,16,202,0.440594059,0.034653465,0.618811881,2,0.614441029
7668,87,21279,5,10,0,0,0,15,6,10,8,0,0,24,nowin,win,dlbust,bust,20,0,15,202,0.405940594,0.054455446,0.628712871,2,0.590599801
7669,10,21279,7,3,2,0,0,12,6,10,8,0,0,24,nowin,win,dlbust,bust,20,0,10,191,0.413612565,0.057591623,0.596858639,2,0.574087175
7670,99,21279,4,4,10,0,0,18,6,10,8,0,0,24,nowin,win,dlbust,bust,20,0,8,207,0.47826087,0.062801932,0.637681159,3,0.961418446
7671,107,21279,4,4,6,0,0,14,6,10,8,0,0,24,nowin,win,dlbust,bust,20,0,8,218,0.444954128,0.073394495,0.600917431,2,0.605210014
7672,126,21279,3,7,10,0,0,20,6,10,8,0,0,24,nowin,win,dlbust,bust,20,0,10,188,0.457446809,0.074468085,0.60106383,3,0.900633203
7673,120,21279,10,7,0,0,0,17,6,10,8,0,0,24,nowin,win,dlbust,bust,20,0,17,202,0.440594059,0.034653465,0.618811881,2,0.614441029
7674,52,21280,11,10,0,0,0,21,10,11,0,0,0,21,win,push,push,push,10,0,21,217,0.414746544,0.02764977,0.599078341,2,0.576736024
7675,75,21280,8,5,0,8,0,21,10,11,0,0,0,21,nowin,push,push,push,10,0,13,191,0.418848168,0.052356021,0.570680628,0,0.029344702
7676,99,21280,3,4,3,6,7,23,10,11,0,0,0,21,nowin,loss,bust,plbust,0,10,7,207,0.47826087,0.062801932,0.637681159,3,0.961418446
7677,109,21280,3,3,3,10,0,19,10,11,0,0,0,21,nowin,loss,beat,dlwin,0,10,6,221,0.461538462,0.058823529,0.597285068,3,0.901830309
7678,40,21280,4,5,8,0,0,17,10,11,0,0,0,21,nowin,loss,beat,dlwin,0,10,9,196,0.367346939,0.030612245,0.617346939,0,0.025358183
7679,81,21280,4,5,3,3,2,17,10,11,0,0,0,21,nowin,loss,beat,dlwin,0,10,9,182,0.395604396,0.043956044,0.60989011,2,0.567491261
7680,15,21281,5,5,10,0,0,20,10,3,10,0,0,23,nowin,win,dlbust,bust,20,0,10,212,0.410377358,0.051886792,0.561320755,0,0.024517408
7681,32,21281,4,3,10,0,0,17,10,3,10,0,0,23,nowin,win,dlbust,bust,20,0,7,189,0.391534392,0.037037037,0.53968254,0,0.013579086
7682,63,21281,10,10,0,0,0,20,10,3,10,0,0,23,nowin,win,dlbust,bust,20,0,20,216,0.467592593,0.037037037,0.62037037,3,0.931690496
7683,147,21281,10,6,0,1,0,17,10,3,10,0,0,23,nowin,win,dlbust,bust,20,0,16,205,0.380487805,0.014634146,0.536585366,0,0.00951447
7684,124,21281,3,10,0,3,5,21,10,3,10,0,0,23,nowin,win,dlbust,bust,20,0,13,202,0.47029703,0.064356436,0.584158416,3,0.899458193
7685,19,21281,9,5,0,8,0,22,10,3,10,0,0,23,nowin,loss,bust,plbust,0,10,14,237,0.41350211,0.054852321,0.628691983,2,0.597373826
7686,54,21282,1,6,5,4,9,25,7,10,0,0,0,17,nowin,loss,bust,plbust,0,10,7,185,0.437837838,0.032432432,0.556756757,1,0.29899854
7687,75,21282,7,7,0,2,8,24,7,10,0,0,0,17,nowin,loss,bust,plbust,0,10,14,191,0.418848168,0.052356021,0.570680628,0,0.029344702
7688,108,21282,2,6,10,0,0,18,7,10,0,0,0,17,nowin,win,plwin,beat,20,0,8,193,0.435233161,0.056994819,0.559585492,1,0.298824795
7689,93,21282,4,11,6,0,0,21,7,10,0,0,0,17,nowin,win,plwin,beat,20,0,15,175,0.485714286,0.051428571,0.548571429,1,0.323648091
7690,5,21282,10,11,0,0,0,21,7,10,0,0,0,17,win,win,plwin,beat,25,0,21,203,0.42364532,0.02955665,0.596059113,2,0.582508076
7691,46,21282,4,4,11,0,0,19,7,10,0,0,0,17,nowin,win,plwin,beat,20,0,8,186,0.403225806,0.048387097,0.591397849,0,0.029742194
7692,123,21283,3,10,0,0,0,13,6,2,4,10,0,22,nowin,win,dlbust,bust,20,0,13,205,0.43902439,0.034146341,0.614634146,2,0.609962544
7693,105,21283,2,5,11,0,0,18,6,2,4,10,0,22,nowin,win,dlbust,bust,20,0,7,198,0.414141414,0.070707071,0.590909091,0,0.032889494
7694,150,21283,10,3,0,0,0,13,6,2,4,10,0,22,nowin,win,dlbust,bust,20,0,13,192,0.401041667,0.036458333,0.567708333,0,0.023287458
7695,17,21283,9,6,0,0,0,15,6,2,4,10,0,22,nowin,win,dlbust,bust,20,0,15,171,0.444444444,0.070175439,0.555555556,1,0.302364894
7696,148,21283,11,10,0,0,0,21,6,2,4,10,0,22,win,win,dlbust,bust,25,0,21,204,0.401960784,0.078431373,0.593137255,0,0.029789521
7697,49,21283,6,7,0,0,0,13,6,2,4,10,0,22,nowin,win,dlbust,bust,20,0,13,207,0.396135266,0.053140097,0.594202899,0,0.028306925
7698,132,21284,10,10,0,0,0,20,4,4,9,0,0,17,nowin,win,plwin,beat,20,0,20,194,0.412371134,0.036082474,0.649484536,2,0.611633238
7699,111,21284,9,10,0,0,0,19,4,4,9,0,0,17,nowin,win,plwin,beat,20,0,19,180,0.433333333,0.055555556,0.611111111,2,0.602264492
7700,81,21284,8,10,0,0,0,18,4,4,9,0,0,17,nowin,win,plwin,beat,20,0,18,182,0.395604396,0.043956044,0.60989011,2,0.567491261
7701,37,21284,5,10,0,0,0,15,4,4,9,0,0,17,nowin,loss,beat,dlwin,0,10,15,208,0.394230769,0.038461538,0.581730769,0,0.024682772
7702,47,21284,2,6,2,10,0,20,4,4,9,0,0,17,nowin,win,plwin,beat,20,0,8,210,0.438095238,0.057142857,0.623809524,2,0.615868808
7703,130,21284,7,10,0,0,0,17,4,4,9,0,0,17,nowin,push,push,push,10,0,17,219,0.410958904,0.03652968,0.566210046,0,0.025888739
7704,2,21285,4,7,7,0,0,18,8,10,0,0,0,18,nowin,push,push,push,10,0,11,200,0.445,0.035,0.64,2,0.633962549
7705,55,21285,10,6,0,1,0,17,8,10,0,0,0,18,nowin,loss,beat,dlwin,0,10,16,191,0.371727749,0.057591623,0.54973822,0,0.01011347
7706,9,21285,3,10,0,10,0,23,8,10,0,0,0,18,nowin,loss,bust,plbust,0,10,13,194,0.37628866,0.015463918,0.541237113,0,0.009396796
7707,87,21285,6,2,11,0,0,19,8,10,0,0,0,18,nowin,win,plwin,beat,20,0,8,202,0.405940594,0.054455446,0.628712871,2,0.590599801
7708,70,21285,8,9,0,0,0,17,8,10,0,0,0,18,nowin,loss,beat,dlwin,0,10,17,228,0.385964912,0.039473684,0.557017544,0,0.016157125
7709,35,21285,11,10,0,0,0,21,8,10,0,0,0,18,win,win,plwin,beat,25,0,21,202,0.410891089,0.044554455,0.633663366,2,0.598681573
7710,27,21286,8,10,0,0,0,18,5,10,1,1,0,17,nowin,win,plwin,beat,20,0,18,178,0.370786517,0.016853933,0.573033708,0,0.015536309
7711,104,21286,8,3,5,0,0,16,5,10,1,1,0,17,nowin,loss,beat,dlwin,0,10,11,209,0.363636364,0.052631579,0.593301435,0,0.018359419
7712,87,21286,3,3,8,0,0,14,5,10,1,1,0,17,nowin,loss,beat,dlwin,0,10,6,202,0.405940594,0.054455446,0.628712871,2,0.590599801
7713,116,21286,2,10,0,0,0,12,5,10,1,1,0,17,nowin,loss,beat,dlwin,0,10,12,195,0.425641026,0.056410256,0.538461538,1,0.28273747
7714,137,21286,10,5,0,0,0,15,5,10,1,1,0,17,nowin,loss,beat,dlwin,0,10,15,194,0.417525773,0.046391753,0.536082474,1,0.276714602
7715,58,21286,8,10,0,0,0,18,5,10,1,1,0,17,nowin,win,plwin,beat,20,0,18,195,0.430769231,0.041025641,0.584615385,2,0.580497586
7716,43,21287,4,4,6,0,0,14,5,9,3,0,0,17,nowin,loss,beat,dlwin,0,10,8,192,0.40625,0.041666667,0.609375,2,0.576671372
7717,25,21287,10,11,0,0,0,21,5,9,3,0,0,17,win,win,plwin,beat,25,0,21,190,0.463157895,0.063157895,0.536842105,1,0.304401563
7718,46,21287,9,9,0,0,0,18,5,9,3,0,0,17,nowin,win,plwin,beat,20,0,18,186,0.403225806,0.048387097,0.591397849,0,0.029742194
7719,20,21287,10,7,0,0,0,17,5,9,3,0,0,17,nowin,push,push,push,10,0,17,186,0.456989247,0.037634409,0.537634409,1,0.301097108
7720,136,21287,2,9,10,0,0,21,5,9,3,0,0,17,nowin,win,plwin,beat,20,0,11,194,0.396907216,0.025773196,0.597938144,0,0.029452644
7721,86,21287,5,4,10,0,0,19,5,9,3,0,0,17,nowin,win,plwin,beat,20,0,9,196,0.454081633,0.040816327,0.591836735,3,0.887566443
7722,19,21288,10,6,0,10,0,26,10,11,0,0,0,21,nowin,loss,bust,plbust,0,10,16,237,0.41350211,0.054852321,0.628691983,2,0.597373826
7723,145,21288,7,9,0,3,0,19,10,11,0,0,0,21,nowin,loss,beat,dlwin,0,10,16,188,0.441489362,0.031914894,0.622340426,2,0.617837093
7724,101,21288,3,11,5,0,0,19,10,11,0,0,0,21,nowin,loss,beat,dlwin,0,10,14,205,0.424390244,0.068292683,0.63902439,2,0.614740646
7725,52,21288,4,3,10,0,0,17,10,11,0,0,0,21,nowin,loss,beat,dlwin,0,10,7,217,0.414746544,0.02764977,0.599078341,2,0.576736024
7726,83,21288,10,9,0,0,0,19,10,11,0,0,0,21,nowin,loss,beat,dlwin,0,10,19,193,0.424870466,0.051813472,0.678756477,2,0.644360335
7727,87,21288,10,6,0,5,0,21,10,11,0,0,0,21,nowin,push,push,push,10,0,16,202,0.405940594,0.054455446,0.628712871,2,0.590599801
7728,136,21289,7,2,10,0,0,19,11,4,2,0,0,17,nowin,win,plwin,beat,20,0,9,194,0.396907216,0.025773196,0.597938144,0,0.029452644
7729,51,21289,7,9,0,3,0,19,11,4,2,0,0,17,nowin,win,plwin,beat,20,0,16,189,0.529100529,0.068783069,0.608465608,3,0.993665715
7730,72,21289,4,10,0,10,0,24,11,4,2,0,0,17,nowin,loss,bust,plbust,0,10,14,185,0.394594595,0.032432432,0.508108108,0,0.006763115
7731,119,21289,7,6,0,1,10,24,11,4,2,0,0,17,nowin,loss,bust,plbust,0,10,13,190,0.405263158,0.068421053,0.515789474,0,0.011837158
7732,46,21289,2,6,10,0,0,18,11,4,2,0,0,17,nowin,win,plwin,beat,20,0,8,186,0.403225806,0.048387097,0.591397849,0,0.029742194
7733,83,21289,6,5,4,3,0,18,11,4,2,0,0,17,nowin,win,plwin,beat,20,0,11,193,0.424870466,0.051813472,0.678756477,2,0.644360335
7734,34,21290,10,3,0,10,0,23,7,10,0,0,0,17,nowin,loss,bust,plbust,0,10,13,202,0.5,0.079207921,0.618811881,3,0.968961434
7735,5,21290,9,11,0,0,0,20,7,10,0,0,0,17,nowin,win,plwin,beat,20,0,20,203,0.42364532,0.02955665,0.596059113,2,0.582508076
7736,34,21290,5,10,0,4,0,19,7,10,0,0,0,17,nowin,win,plwin,beat,20,0,15,202,0.5,0.079207921,0.618811881,3,0.968961434
7737,140,21290,10,2,0,3,1,16,7,10,0,0,0,17,nowin,loss,beat,dlwin,0,10,12,210,0.466666667,0.023809524,0.604761905,3,0.915293335
7738,24,21290,5,3,9,0,0,17,7,10,0,0,0,17,nowin,push,push,push,10,0,8,207,0.458937198,0.048309179,0.570048309,1,0.318138014
7739,89,21290,3,10,0,5,0,18,7,10,0,0,0,17,nowin,win,plwin,beat,20,0,13,212,0.537735849,0.047169811,0.594339623,3,0.990167191
7740,102,21291,10,3,0,0,0,13,5,10,10,0,0,25,nowin,win,dlbust,bust,20,0,13,192,0.338541667,0.046875,0.5625,0,0.003306118
7741,16,21291,10,3,0,0,0,13,5,10,10,0,0,25,nowin,win,dlbust,bust,20,0,13,220,0.427272727,0.081818182,0.6,2,0.588660176
7742,131,21291,4,1,9,0,0,14,5,10,10,0,0,25,nowin,win,dlbust,bust,20,0,5,217,0.410138249,0.069124424,0.543778802,0,0.02015021
7743,114,21291,5,6,2,0,0,13,5,10,10,0,0,25,nowin,win,dlbust,bust,20,0,11,198,0.47979798,0.025252525,0.611111111,3,0.937232995
7744,150,21291,10,9,0,0,0,19,5,10,10,0,0,25,nowin,win,dlbust,bust,20,0,19,192,0.401041667,0.036458333,0.567708333,0,0.023287458
7745,124,21291,2,3,9,0,0,14,5,10,10,0,0,25,nowin,win,dlbust,bust,20,0,5,202,0.47029703,0.064356436,0.584158416,3,0.899458193
7746,142,21292,6,10,0,1,0,17,9,8,0,0,0,17,nowin,push,push,push,10,0,16,211,0.417061611,0.047393365,0.526066351,1,0.271531309
7747,49,21292,9,10,0,0,0,19,9,8,0,0,0,17,nowin,win,plwin,beat,20,0,19,207,0.396135266,0.053140097,0.594202899,0,0.028306925
7748,82,21292,10,9,0,0,0,19,9,8,0,0,0,17,nowin,win,plwin,beat,20,0,19,225,0.408888889,0.075555556,0.577777778,0,0.028101874
7749,112,21292,10,10,0,0,0,20,9,8,0,0,0,17,nowin,win,plwin,beat,20,0,20,203,0.448275862,0.054187192,0.600985222,3,0.889576933
7750,86,21292,9,10,0,0,0,19,9,8,0,0,0,17,nowin,win,plwin,beat,20,0,19,196,0.454081633,0.040816327,0.591836735,3,0.887566443
7751,112,21292,4,4,10,0,0,18,9,8,0,0,0,17,nowin,win,plwin,beat,20,0,8,203,0.448275862,0.054187192,0.600985222,3,0.889576933
7752,35,21293,10,10,0,0,0,20,10,6,9,0,0,25,nowin,win,dlbust,bust,20,0,20,202,0.410891089,0.044554455,0.633663366,2,0.598681573
7753,133,21293,10,10,0,0,0,20,10,6,9,0,0,25,nowin,win,dlbust,bust,20,0,20,201,0.47761194,0.064676617,0.611940299,3,0.935428111
7754,35,21293,10,4,0,10,0,24,10,6,9,0,0,25,nowin,loss,bust,plbust,0,10,14,202,0.410891089,0.044554455,0.633663366,2,0.598681573
7755,137,21293,7,2,5,7,0,21,10,6,9,0,0,25,nowin,win,dlbust,bust,20,0,9,194,0.417525773,0.046391753,0.536082474,1,0.276714602
7756,138,21293,10,4,0,9,0,23,10,6,9,0,0,25,nowin,loss,bust,plbust,0,10,14,190,0.442105263,0.047368421,0.610526316,2,0.609711065
7757,106,21293,6,10,0,10,0,26,10,6,9,0,0,25,nowin,loss,bust,plbust,0,10,16,192,0.411458333,0.026041667,0.557291667,0,0.023854304
7758,28,21294,6,3,10,0,0,19,9,10,0,0,0,19,nowin,push,push,push,10,0,9,199,0.422110553,0.045226131,0.542713568,1,0.282706618
7759,4,21294,2,4,8,2,10,26,9,10,0,0,0,19,nowin,loss,bust,plbust,0,10,6,217,0.460829493,0.036866359,0.562211982,1,0.315432839
7760,115,21294,10,10,0,0,0,20,9,10,0,0,0,19,nowin,win,plwin,beat,20,0,20,194,0.427835052,0.041237113,0.592783505,2,0.583863602
7761,150,21294,4,3,10,0,0,17,9,10,0,0,0,19,nowin,loss,beat,dlwin,0,10,7,192,0.401041667,0.036458333,0.567708333,0,0.023287458
7762,121,21294,10,10,0,0,0,20,9,10,0,0,0,19,nowin,win,plwin,beat,20,0,20,195,0.456410256,0.025641026,0.512820513,1,0.288597791
7763,116,21294,3,10,0,9,0,22,9,10,0,0,0,19,nowin,loss,bust,plbust,0,10,13,195,0.425641026,0.056410256,0.538461538,1,0.28273747
7764,112,21295,6,10,0,4,0,20,11,10,0,0,0,21,nowin,loss,beat,dlwin,0,10,16,203,0.448275862,0.054187192,0.600985222,3,0.889576933
7765,150,21295,10,4,0,10,0,24,11,10,0,0,0,21,nowin,loss,bust,plbust,0,10,14,192,0.401041667,0.036458333,0.567708333,0,0.023287458
7766,54,21295,2,7,3,10,0,22,11,10,0,0,0,21,nowin,loss,bust,plbust,0,10,9,185,0.437837838,0.032432432,0.556756757,1,0.29899854
7767,81,21295,3,10,0,2,10,25,11,10,0,0,0,21,nowin,loss,bust,plbust,0,10,13,182,0.395604396,0.043956044,0.60989011,2,0.567491261
7768,108,21295,11,9,0,0,0,20,11,10,0,0,0,21,nowin,loss,beat,dlwin,0,10,20,193,0.435233161,0.056994819,0.559585492,1,0.298824795
7769,35,21295,10,6,0,10,0,26,11,10,0,0,0,21,nowin,loss,bust,plbust,0,10,16,202,0.410891089,0.044554455,0.633663366,2,0.598681573
7770,34,21296,1,4,8,0,0,13,2,7,9,0,0,18,nowin,loss,beat,dlwin,0,10,5,202,0.5,0.079207921,0.618811881,3,0.968961434
7771,78,21296,9,10,0,0,0,19,2,7,9,0,0,18,nowin,win,plwin,beat,20,0,19,201,0.517412935,0.034825871,0.587064677,3,0.95871112
7772,6,21296,10,10,0,0,0,20,2,7,9,0,0,18,nowin,win,plwin,beat,20,0,20,191,0.439790576,0.047120419,0.581151832,1,0.31211505
7773,8,21296,11,1,2,0,0,14,2,7,9,0,0,18,nowin,loss,beat,dlwin,0,10,12,181,0.44198895,0.071823204,0.596685083,2,0.599438402
7774,10,21296,7,5,0,10,0,22,2,7,9,0,0,18,nowin,loss,bust,plbust,0,10,12,191,0.413612565,0.057591623,0.596858639,2,0.574087175
7775,31,21296,10,5,0,0,0,15,2,7,9,0,0,18,nowin,loss,beat,dlwin,0,10,15,188,0.473404255,0.058510638,0.515957447,1,0.300306557
7776,62,21297,10,10,0,0,0,20,10,10,0,0,0,20,nowin,push,push,push,10,0,20,178,0.370786517,0.028089888,0.54494382,0,0.008657722
7777,85,21297,10,2,0,8,0,20,10,10,0,0,0,20,nowin,push,push,push,10,0,12,195,0.41025641,0.066666667,0.594871795,0,0.03269711
7778,122,21297,5,9,0,8,0,22,10,10,0,0,0,20,nowin,loss,bust,plbust,0,10,14,210,0.347619048,0.052380952,0.59047619,0,0.012873677
7779,34,21297,5,7,0,2,5,19,10,10,0,0,0,20,nowin,loss,beat,dlwin,0,10,12,202,0.5,0.079207921,0.618811881,3,0.968961434
7780,24,21297,9,10,0,0,0,19,10,10,0,0,0,20,nowin,loss,beat,dlwin,0,10,19,207,0.458937198,0.048309179,0.570048309,1,0.318138014
7781,104,21297,6,1,10,0,0,17,10,10,0,0,0,20,nowin,loss,beat,dlwin,0,10,7,209,0.363636364,0.052631579,0.593301435,0,0.018359419
7782,85,21298,8,9,0,0,0,17,1,2,10,3,4,20,nowin,loss,beat,dlwin,0,10,17,195,0.41025641,0.066666667,0.594871795,0,0.03269711
7783,91,21298,8,4,0,9,0,21,1,2,10,3,4,20,nowin,win,plwin,beat,20,0,12,194,0.417525773,0.046391753,0.515463918,1,0.266616552
7784,41,21298,4,8,0,8,0,20,1,2,10,3,4,20,nowin,push,push,push,10,0,12,192,0.364583333,0.036458333,0.520833333,0,0.00089702
7785,57,21298,2,9,10,0,0,21,1,2,10,3,4,20,nowin,win,plwin,beat,20,0,11,192,0.46875,0.052083333,0.59375,3,0.907001181
7786,35,21298,10,2,0,1,4,17,1,2,10,3,4,20,nowin,loss,beat,dlwin,0,10,12,202,0.410891089,0.044554455,0.633663366,2,0.598681573
7787,72,21298,2,3,3,4,5,17,1,2,10,3,4,20,nowin,loss,beat,dlwin,0,10,5,185,0.394594595,0.032432432,0.508108108,0,0.006763115
7788,14,21299,5,10,0,0,0,15,4,3,10,0,0,17,nowin,loss,beat,dlwin,0,10,15,202,0.391089109,0.01980198,0.628712871,2,0.577264877
7789,70,21299,7,10,0,0,0,17,4,3,10,0,0,17,nowin,push,push,push,10,0,17,228,0.385964912,0.039473684,0.557017544,0,0.016157125
7790,113,21299,10,6,0,0,0,16,4,3,10,0,0,17,nowin,loss,beat,dlwin,0,10,16,199,0.407035176,0.055276382,0.668341709,2,0.620695264
7791,147,21299,9,9,0,0,0,18,4,3,10,0,0,17,nowin,win,plwin,beat,20,0,18,205,0.380487805,0.014634146,0.536585366,0,0.00951447
7792,101,21299,4,7,3,0,0,14,4,3,10,0,0,17,nowin,loss,beat,dlwin,0,10,11,205,0.424390244,0.068292683,0.63902439,2,0.614740646
7793,109,21299,10,2,0,0,0,12,4,3,10,0,0,17,nowin,loss,beat,dlwin,0,10,12,221,0.461538462,0.058823529,0.597285068,3,0.901830309
7794,107,21300,7,11,0,0,0,18,10,3,8,0,0,21,nowin,loss,beat,dlwin,0,10,18,218,0.444954128,0.073394495,0.600917431,2,0.605210014
7795,149,21300,5,9,0,4,0,18,10,3,8,0,0,21,nowin,loss,beat,dlwin,0,10,14,225,0.457777778,0.057777778,0.648888889,2,0.651965595
7796,65,21300,10,2,0,9,0,21,10,3,8,0,0,21,nowin,push,push,push,10,0,12,203,0.492610837,0.054187192,0.571428571,3,0.913702814
7797,29,21300,7,10,0,0,0,17,10,3,8,0,0,21,nowin,loss,beat,dlwin,0,10,17,189,0.44973545,0.058201058,0.544973545,1,0.300349439
7798,119,21300,7,3,2,5,0,17,10,3,8,0,0,21,nowin,loss,beat,dlwin,0,10,10,190,0.405263158,0.068421053,0.515789474,0,0.011837158
7799,127,21300,9,3,0,6,0,18,10,3,8,0,0,21,nowin,loss,beat,dlwin,0,10,12,201,0.402985075,0.029850746,0.60199005,0,0.032263937
7800,52,21301,9,3,0,10,0,22,10,10,0,0,0,20,nowin,loss,bust,plbust,0,10,12,217,0.414746544,0.02764977,0.599078341,2,0.576736024
7801,79,21301,1,4,10,7,0,22,10,10,0,0,0,20,nowin,loss,bust,plbust,0,10,5,211,0.436018957,0.028436019,0.672985782,2,0.650131054
7802,37,21301,2,10,0,10,0,22,10,10,0,0,0,20,nowin,loss,bust,plbust,0,10,12,208,0.394230769,0.038461538,0.581730769,0,0.024682772
7803,104,21301,6,10,0,10,0,26,10,10,0,0,0,20,nowin,loss,bust,plbust,0,10,16,209,0.363636364,0.052631579,0.593301435,0,0.018359419
7804,51,21301,9,5,0,1,6,21,10,10,0,0,0,20,nowin,win,plwin,beat,20,0,14,189,0.529100529,0.068783069,0.608465608,3,0.993665715
7805,74,21301,6,9,0,5,0,20,10,10,0,0,0,20,nowin,push,push,push,10,0,15,209,0.411483254,0.04784689,0.531100478,0,0.017448125
7806,126,21302,3,8,3,4,0,18,11,10,0,0,0,21,nowin,loss,beat,dlwin,0,10,11,188,0.457446809,0.074468085,0.60106383,3,0.900633203
7807,46,21302,10,10,0,0,0,20,11,10,0,0,0,21,nowin,loss,beat,dlwin,0,10,20,186,0.403225806,0.048387097,0.591397849,0,0.029742194
7808,117,21302,3,4,6,6,0,19,11,10,0,0,0,21,nowin,loss,beat,dlwin,0,10,7,173,0.410404624,0.069364162,0.606936416,2,0.578610282
7809,109,21302,6,10,0,10,0,26,11,10,0,0,0,21,nowin,loss,bust,plbust,0,10,16,221,0.461538462,0.058823529,0.597285068,3,0.901830309
7810,118,21302,3,9,0,10,0,22,11,10,0,0,0,21,nowin,loss,bust,plbust,0,10,12,216,0.393518519,0.037037037,0.555555556,0,0.018059873
7811,141,21302,10,9,0,0,0,19,11,10,0,0,0,21,nowin,loss,beat,dlwin,0,10,19,202,0.420792079,0.074257426,0.564356436,0,0.028377851
7812,79,21303,10,7,0,0,0,17,8,10,0,0,0,18,nowin,loss,beat,dlwin,0,10,17,211,0.436018957,0.028436019,0.672985782,2,0.650131054
7813,139,21303,6,2,9,0,0,17,8,10,0,0,0,18,nowin,loss,beat,dlwin,0,10,8,192,0.380208333,0.036458333,0.59375,0,0.023429169
7814,19,21303,2,7,10,0,0,19,8,10,0,0,0,18,nowin,win,plwin,beat,20,0,9,237,0.41350211,0.054852321,0.628691983,2,0.597373826
7815,31,21303,6,8,0,4,0,18,8,10,0,0,0,18,nowin,push,push,push,10,0,14,188,0.473404255,0.058510638,0.515957447,1,0.300306557
7816,137,21303,11,3,6,0,0,20,8,10,0,0,0,18,nowin,win,plwin,beat,20,0,14,194,0.417525773,0.046391753,0.536082474,1,0.276714602
7817,25,21303,2,10,0,1,7,20,8,10,0,0,0,18,nowin,win,plwin,beat,20,0,12,190,0.463157895,0.063157895,0.536842105,1,0.304401563
7818,137,21304,11,10,0,0,0,21,10,4,10,0,0,24,win,win,dlbust,bust,25,0,21,194,0.417525773,0.046391753,0.536082474,1,0.276714602
7819,70,21304,2,6,8,2,0,18,10,4,10,0,0,24,nowin,win,dlbust,bust,20,0,8,228,0.385964912,0.039473684,0.557017544,0,0.016157125
7820,26,21304,6,8,0,1,10,25,10,4,10,0,0,24,nowin,loss,bust,plbust,0,10,14,203,0.463054187,0.0591133,0.541871921,1,0.306802864
7821,69,21304,9,3,0,10,0,22,10,4,10,0,0,24,nowin,loss,bust,plbust,0,10,12,194,0.365979381,0.030927835,0.515463918,0,0
7822,67,21304,11,2,5,0,0,18,10,4,10,0,0,24,nowin,win,dlbust,bust,20,0,13,195,0.369230769,0.041025641,0.569230769,0,0.014139427
7823,11,21304,11,5,2,0,0,18,10,4,10,0,0,24,nowin,win,dlbust,bust,20,0,16,236,0.457627119,0.016949153,0.588983051,3,0.889015813
7824,41,21305,4,10,0,0,0,14,6,7,1,6,0,20,nowin,loss,beat,dlwin,0,10,14,192,0.364583333,0.036458333,0.520833333,0,0.00089702
7825,65,21305,3,10,0,0,0,13,6,7,1,6,0,20,nowin,loss,beat,dlwin,0,10,13,203,0.492610837,0.054187192,0.571428571,3,0.913702814
7826,35,21305,6,4,4,0,0,14,6,7,1,6,0,20,nowin,loss,beat,dlwin,0,10,10,202,0.410891089,0.044554455,0.633663366,2,0.598681573
7827,142,21305,5,6,10,0,0,21,6,7,1,6,0,20,nowin,win,plwin,beat,20,0,11,211,0.417061611,0.047393365,0.526066351,1,0.271531309
7828,62,21305,2,10,0,0,0,12,6,7,1,6,0,20,nowin,loss,beat,dlwin,0,10,12,178,0.370786517,0.028089888,0.54494382,0,0.008657722
7829,74,21305,10,5,0,0,0,15,6,7,1,6,0,20,nowin,loss,beat,dlwin,0,10,15,209,0.411483254,0.04784689,0.531100478,0,0.017448125
7830,97,21306,9,10,0,0,0,19,4,2,3,2,2,13,nowin,win,plwin,beat,20,0,19,182,0.450549451,0.06043956,0.692307692,2,0.677372279
7831,90,21306,10,10,0,0,0,20,4,2,3,2,2,13,nowin,win,plwin,beat,20,0,20,201,0.447761194,0.049751244,0.60199005,3,0.889945023
7832,18,21306,3,5,10,0,0,18,4,2,3,2,2,13,nowin,win,plwin,beat,20,0,8,182,0.461538462,0.043956044,0.587912088,3,0.892649374
7833,117,21306,4,6,8,0,0,18,4,2,3,2,2,13,nowin,win,plwin,beat,20,0,10,173,0.410404624,0.069364162,0.606936416,2,0.578610282
7834,121,21306,2,10,0,0,0,12,4,2,3,2,2,13,nowin,loss,beat,dlwin,0,10,12,195,0.456410256,0.025641026,0.512820513,1,0.288597791
7835,143,21306,11,10,0,0,0,21,4,2,3,2,2,13,win,win,plwin,beat,25,0,21,203,0.463054187,0.044334975,0.57635468,3,0.883143365
7836,129,21307,3,6,5,0,0,14,2,10,8,0,0,20,nowin,loss,beat,dlwin,0,10,9,201,0.422885572,0.064676617,0.55721393,0,0.027255383
7837,128,21307,9,10,0,0,0,19,2,10,8,0,0,20,nowin,loss,beat,dlwin,0,10,19,227,0.356828194,0.052863436,0.577092511,0,0.012352564
7838,55,21307,9,10,0,0,0,19,2,10,8,0,0,20,nowin,loss,beat,dlwin,0,10,19,191,0.371727749,0.057591623,0.54973822,0,0.01011347
7839,67,21307,8,7,0,0,0,15,2,10,8,0,0,20,nowin,loss,beat,dlwin,0,10,15,195,0.369230769,0.041025641,0.569230769,0,0.014139427
7840,53,21307,2,10,0,10,0,22,2,10,8,0,0,20,nowin,loss,bust,plbust,0,10,12,250,0.372,0.064,0.564,0,0.013687345
7841,49,21307,9,10,0,0,0,19,2,10,8,0,0,20,nowin,loss,beat,dlwin,0,10,19,207,0.396135266,0.053140097,0.594202899,0,0.028306925
7842,23,21308,10,7,0,0,0,17,10,6,5,0,0,21,nowin,loss,beat,dlwin,0,10,17,208,0.427884615,0.0625,0.552884615,1,0.29114424
7843,26,21308,7,10,0,0,0,17,10,6,5,0,0,21,nowin,loss,beat,dlwin,0,10,17,203,0.463054187,0.0591133,0.541871921,1,0.306802864
7844,19,21308,10,4,0,3,0,17,10,6,5,0,0,21,nowin,loss,beat,dlwin,0,10,14,237,0.41350211,0.054852321,0.628691983,2,0.597373826
7845,6,21308,9,9,0,0,0,18,10,6,5,0,0,21,nowin,loss,beat,dlwin,0,10,18,191,0.439790576,0.047120419,0.581151832,1,0.31211505
7846,104,21308,5,10,0,10,0,25,10,6,5,0,0,21,nowin,loss,bust,plbust,0,10,15,209,0.363636364,0.052631579,0.593301435,0,0.018359419
7847,77,21308,5,2,10,0,0,17,10,6,5,0,0,21,nowin,loss,beat,dlwin,0,10,7,200,0.455,0.04,0.62,3,0.916252116
7848,108,21309,8,10,0,0,0,18,6,7,7,0,0,20,nowin,loss,beat,dlwin,0,10,18,193,0.435233161,0.056994819,0.559585492,1,0.298824795
7849,141,21309,3,10,0,0,0,13,6,7,7,0,0,20,nowin,loss,beat,dlwin,0,10,13,202,0.420792079,0.074257426,0.564356436,0,0.028377851
7850,133,21309,10,10,0,0,0,20,6,7,7,0,0,20,nowin,push,push,push,10,0,20,201,0.47761194,0.064676617,0.611940299,3,0.935428111
7851,66,21309,3,1,10,0,0,14,6,7,7,0,0,20,nowin,loss,beat,dlwin,0,10,4,217,0.456221198,0.064516129,0.626728111,3,0.924304367
7852,96,21309,4,4,9,0,0,17,6,7,7,0,0,20,nowin,loss,beat,dlwin,0,10,8,190,0.468421053,0.057894737,0.584210526,3,0.897263354
7853,141,21309,10,10,0,0,0,20,6,7,7,0,0,20,nowin,push,push,push,10,0,20,202,0.420792079,0.074257426,0.564356436,0,0.028377851
7854,14,21310,10,11,0,0,0,21,8,10,0,0,0,18,win,win,plwin,beat,25,0,21,202,0.391089109,0.01980198,0.628712871,2,0.577264877
7855,114,21310,3,5,10,0,0,18,8,10,0,0,0,18,nowin,push,push,push,10,0,8,198,0.47979798,0.025252525,0.611111111,3,0.937232995
7856,57,21310,10,5,0,10,0,25,8,10,0,0,0,18,nowin,loss,bust,plbust,0,10,15,192,0.46875,0.052083333,0.59375,3,0.907001181
7857,8,21310,1,1,10,4,7,23,8,10,0,0,0,18,nowin,loss,bust,plbust,0,10,2,181,0.44198895,0.071823204,0.596685083,2,0.599438402
7858,129,21310,7,3,10,0,0,20,8,10,0,0,0,18,nowin,win,plwin,beat,20,0,10,201,0.422885572,0.064676617,0.55721393,0,0.027255383
7859,87,21310,5,4,10,0,0,19,8,10,0,0,0,18,nowin,win,plwin,beat,20,0,9,202,0.405940594,0.054455446,0.628712871,2,0.590599801
7860,82,21311,5,4,7,2,0,18,10,7,0,0,0,17,nowin,win,plwin,beat,20,0,9,225,0.408888889,0.075555556,0.577777778,0,0.028101874
7861,8,21311,5,8,0,10,0,23,10,7,0,0,0,17,nowin,loss,bust,plbust,0,10,13,181,0.44198895,0.071823204,0.596685083,2,0.599438402
7862,143,21311,11,2,1,10,0,24,10,7,0,0,0,17,nowin,loss,bust,plbust,0,10,13,203,0.463054187,0.044334975,0.57635468,3,0.883143365
7863,128,21311,10,6,0,1,0,17,10,7,0,0,0,17,nowin,push,push,push,10,0,16,227,0.356828194,0.052863436,0.577092511,0,0.012352564
7864,93,21311,7,10,0,0,0,17,10,7,0,0,0,17,nowin,push,push,push,10,0,17,175,0.485714286,0.051428571,0.548571429,1,0.323648091
7865,44,21311,10,11,0,0,0,21,10,7,0,0,0,17,win,win,plwin,beat,25,0,21,219,0.433789954,0.050228311,0.534246575,1,0.285551035
7866,62,21312,3,5,6,0,0,14,5,9,7,0,0,21,nowin,loss,beat,dlwin,0,10,8,178,0.370786517,0.028089888,0.54494382,0,0.008657722
7867,66,21312,2,9,6,0,0,17,5,9,7,0,0,21,nowin,loss,beat,dlwin,0,10,11,217,0.456221198,0.064516129,0.626728111,3,0.924304367
7868,120,21312,10,10,0,0,0,20,5,9,7,0,0,21,nowin,loss,beat,dlwin,0,10,20,202,0.440594059,0.034653465,0.618811881,2,0.614441029
7869,127,21312,4,10,0,0,0,14,5,9,7,0,0,21,nowin,loss,beat,dlwin,0,10,14,201,0.402985075,0.029850746,0.60199005,0,0.032263937
7870,87,21312,11,8,0,0,0,19,5,9,7,0,0,21,nowin,loss,beat,dlwin,0,10,19,202,0.405940594,0.054455446,0.628712871,2,0.590599801
7871,78,21312,2,10,0,0,0,12,5,9,7,0,0,21,nowin,loss,beat,dlwin,0,10,12,201,0.517412935,0.034825871,0.587064677,3,0.95871112
7872,63,21313,11,10,0,0,0,21,8,3,3,2,6,22,win,win,dlbust,bust,25,0,21,216,0.467592593,0.037037037,0.62037037,3,0.931690496
7873,104,21313,10,4,0,10,0,24,8,3,3,2,6,22,nowin,loss,bust,plbust,0,10,14,209,0.363636364,0.052631579,0.593301435,0,0.018359419
7874,44,21313,4,10,0,4,0,18,8,3,3,2,6,22,nowin,win,dlbust,bust,20,0,14,219,0.433789954,0.050228311,0.534246575,1,0.285551035
7875,6,21313,9,6,0,10,0,25,8,3,3,2,6,22,nowin,loss,bust,plbust,0,10,15,191,0.439790576,0.047120419,0.581151832,1,0.31211505
7876,116,21313,5,9,0,10,0,24,8,3,3,2,6,22,nowin,loss,bust,plbust,0,10,14,195,0.425641026,0.056410256,0.538461538,1,0.28273747
7877,17,21313,10,5,0,10,0,25,8,3,3,2,6,22,nowin,loss,bust,plbust,0,10,15,171,0.444444444,0.070175439,0.555555556,1,0.302364894
7878,126,21314,8,7,0,10,0,25,11,10,0,0,0,21,nowin,loss,bust,plbust,0,10,15,188,0.457446809,0.074468085,0.60106383,3,0.900633203
7879,3,21314,4,10,0,3,0,17,11,10,0,0,0,21,nowin,loss,beat,dlwin,0,10,14,190,0.431578947,0.026315789,0.542105263,1,0.288076384
7880,46,21314,10,8,0,0,0,18,11,10,0,0,0,21,nowin,loss,beat,dlwin,0,10,18,186,0.403225806,0.048387097,0.591397849,0,0.029742194
7881,127,21314,10,4,0,10,0,24,11,10,0,0,0,21,nowin,loss,bust,plbust,0,10,14,201,0.402985075,0.029850746,0.60199005,0,0.032263937
7882,57,21314,4,10,0,7,0,21,11,10,0,0,0,21,nowin,push,push,push,10,0,14,192,0.46875,0.052083333,0.59375,3,0.907001181
7883,2,21314,6,10,0,6,0,22,11,10,0,0,0,21,nowin,loss,bust,plbust,0,10,16,200,0.445,0.035,0.64,2,0.633962549
7884,48,21315,8,10,0,0,0,18,4,3,10,0,0,17,nowin,win,plwin,beat,20,0,18,203,0.413793103,0.019704433,0.600985222,2,0.577280801
7885,112,21315,7,9,0,0,0,16,4,3,10,0,0,17,nowin,loss,beat,dlwin,0,10,16,203,0.448275862,0.054187192,0.600985222,3,0.889576933
7886,69,21315,7,3,2,0,0,12,4,3,10,0,0,17,nowin,loss,beat,dlwin,0,10,10,194,0.365979381,0.030927835,0.515463918,0,0
7887,122,21315,4,10,0,0,0,14,4,3,10,0,0,17,nowin,loss,beat,dlwin,0,10,14,210,0.347619048,0.052380952,0.59047619,0,0.012873677
7888,89,21315,9,9,0,0,0,18,4,3,10,0,0,17,nowin,win,plwin,beat,20,0,18,212,0.537735849,0.047169811,0.594339623,3,0.990167191
7889,80,21315,9,10,0,0,0,19,4,3,10,0,0,17,nowin,win,plwin,beat,20,0,19,186,0.419354839,0.059139785,0.623655914,2,0.59892924
7890,13,21316,4,10,0,0,0,14,3,5,10,0,0,18,nowin,loss,beat,dlwin,0,10,14,206,0.417475728,0.063106796,0.621359223,2,0.59555479
7891,84,21316,4,8,0,1,0,13,3,5,10,0,0,18,nowin,loss,beat,dlwin,0,10,12,195,0.379487179,0.056410256,0.569230769,0,0.017209119
7892,78,21316,10,10,0,0,0,20,3,5,10,0,0,18,nowin,win,plwin,beat,20,0,20,201,0.517412935,0.034825871,0.587064677,3,0.95871112
7893,140,21316,7,5,0,3,0,15,3,5,10,0,0,18,nowin,loss,beat,dlwin,0,10,12,210,0.466666667,0.023809524,0.604761905,3,0.915293335
7894,41,21316,9,8,0,0,0,17,3,5,10,0,0,18,nowin,loss,beat,dlwin,0,10,17,192,0.364583333,0.036458333,0.520833333,0,0.00089702
7895,109,21316,5,10,0,0,0,15,3,5,10,0,0,18,nowin,loss,beat,dlwin,0,10,15,221,0.461538462,0.058823529,0.597285068,3,0.901830309
7896,79,21317,11,9,0,0,0,20,10,10,0,0,0,20,nowin,push,push,push,10,0,20,211,0.436018957,0.028436019,0.672985782,2,0.650131054
7897,29,21317,8,7,0,7,0,22,10,10,0,0,0,20,nowin,loss,bust,plbust,0,10,15,189,0.44973545,0.058201058,0.544973545,1,0.300349439
7898,84,21317,2,6,11,0,0,19,10,10,0,0,0,20,nowin,loss,beat,dlwin,0,10,8,195,0.379487179,0.056410256,0.569230769,0,0.017209119
7899,105,21317,10,9,0,0,0,19,10,10,0,0,0,20,nowin,loss,beat,dlwin,0,10,19,198,0.414141414,0.070707071,0.590909091,0,0.032889494
7900,100,21317,9,10,0,0,0,19,10,10,0,0,0,20,nowin,loss,beat,dlwin,0,10,19,190,0.452631579,0.036842105,0.594736842,3,0.888671154
7901,74,21317,10,11,0,0,0,21,10,10,0,0,0,20,win,win,plwin,beat,25,0,21,209,0.411483254,0.04784689,0.531100478,0,0.017448125
7902,148,21318,9,8,0,0,0,17,10,10,0,0,0,20,nowin,loss,beat,dlwin,0,10,17,204,0.401960784,0.078431373,0.593137255,0,0.029789521
7903,92,21318,2,10,0,1,5,18,10,10,0,0,0,20,nowin,loss,beat,dlwin,0,10,12,186,0.446236559,0.059139785,0.564516129,1,0.307826125
7904,56,21318,4,1,7,4,9,25,10,10,0,0,0,20,nowin,loss,bust,plbust,0,10,5,175,0.4,0.057142857,0.582857143,0,0.026685297
7905,58,21318,4,10,0,6,0,20,10,10,0,0,0,20,nowin,push,push,push,10,0,14,195,0.430769231,0.041025641,0.584615385,2,0.580497586
7906,6,21318,10,9,0,0,0,19,10,10,0,0,0,20,nowin,loss,beat,dlwin,0,10,19,191,0.439790576,0.047120419,0.581151832,1,0.31211505
7907,79,21318,7,10,0,0,0,17,10,10,0,0,0,20,nowin,loss,beat,dlwin,0,10,17,211,0.436018957,0.028436019,0.672985782,2,0.650131054
7908,104,21319,11,10,0,0,0,21,6,10,5,0,0,21,win,push,push,push,10,0,21,209,0.363636364,0.052631579,0.593301435,0,0.018359419
7909,101,21319,7,11,0,0,0,18,6,10,5,0,0,21,nowin,loss,beat,dlwin,0,10,18,205,0.424390244,0.068292683,0.63902439,2,0.614740646
7910,82,21319,6,10,0,0,0,16,6,10,5,0,0,21,nowin,loss,beat,dlwin,0,10,16,225,0.408888889,0.075555556,0.577777778,0,0.028101874
7911,117,21319,5,10,0,0,0,15,6,10,5,0,0,21,nowin,loss,beat,dlwin,0,10,15,173,0.410404624,0.069364162,0.606936416,2,0.578610282
7912,113,21319,11,9,0,0,0,20,6,10,5,0,0,21,nowin,loss,beat,dlwin,0,10,20,199,0.407035176,0.055276382,0.668341709,2,0.620695264
7913,73,21319,10,8,0,0,0,18,6,10,5,0,0,21,nowin,loss,beat,dlwin,0,10,18,181,0.375690608,0.011049724,0.596685083,0,0.022795773
7914,136,21320,2,7,8,0,0,17,9,10,0,0,0,19,nowin,loss,beat,dlwin,0,10,9,194,0.396907216,0.025773196,0.597938144,0,0.029452644
7915,34,21320,10,5,0,8,0,23,9,10,0,0,0,19,nowin,loss,bust,plbust,0,10,15,202,0.5,0.079207921,0.618811881,3,0.968961434
7916,123,21320,6,9,0,1,6,22,9,10,0,0,0,19,nowin,loss,bust,plbust,0,10,15,205,0.43902439,0.034146341,0.614634146,2,0.609962544
7917,148,21320,11,7,0,0,0,18,9,10,0,0,0,19,nowin,loss,beat,dlwin,0,10,18,204,0.401960784,0.078431373,0.593137255,0,0.029789521
7918,6,21320,6,1,6,10,0,23,9,10,0,0,0,19,nowin,loss,bust,plbust,0,10,7,191,0.439790576,0.047120419,0.581151832,1,0.31211505
7919,129,21320,10,5,0,7,0,22,9,10,0,0,0,19,nowin,loss,bust,plbust,0,10,15,201,0.422885572,0.064676617,0.55721393,0,0.027255383
7920,134,21321,8,4,0,10,0,22,8,10,0,0,0,18,nowin,loss,bust,plbust,0,10,12,185,0.443243243,0.021621622,0.545945946,1,0.296939509
7921,66,21321,4,10,0,3,0,17,8,10,0,0,0,18,nowin,loss,beat,dlwin,0,10,14,217,0.456221198,0.064516129,0.626728111,3,0.924304367
7922,17,21321,9,2,6,0,0,17,8,10,0,0,0,18,nowin,loss,beat,dlwin,0,10,11,171,0.444444444,0.070175439,0.555555556,1,0.302364894
7923,51,21321,10,9,0,0,0,19,8,10,0,0,0,18,nowin,win,plwin,beat,20,0,19,189,0.529100529,0.068783069,0.608465608,3,0.993665715
7924,41,21321,7,10,0,0,0,17,8,10,0,0,0,18,nowin,loss,beat,dlwin,0,10,17,192,0.364583333,0.036458333,0.520833333,0,0.00089702
7925,142,21321,10,10,0,0,0,20,8,10,0,0,0,18,nowin,win,plwin,beat,20,0,20,211,0.417061611,0.047393365,0.526066351,1,0.271531309
7926,121,21322,5,6,10,0,0,21,2,8,9,0,0,19,nowin,win,plwin,beat,20,0,11,195,0.456410256,0.025641026,0.512820513,1,0.288597791
7927,16,21322,7,10,0,0,0,17,2,8,9,0,0,19,nowin,loss,beat,dlwin,0,10,17,220,0.427272727,0.081818182,0.6,2,0.588660176
7928,20,21322,11,10,0,0,0,21,2,8,9,0,0,19,win,win,plwin,beat,25,0,21,186,0.456989247,0.037634409,0.537634409,1,0.301097108
7929,62,21322,3,10,0,0,0,13,2,8,9,0,0,19,nowin,loss,beat,dlwin,0,10,13,178,0.370786517,0.028089888,0.54494382,0,0.008657722
7930,6,21322,5,4,11,0,0,20,2,8,9,0,0,19,nowin,win,plwin,beat,20,0,9,191,0.439790576,0.047120419,0.581151832,1,0.31211505
7931,74,21322,11,4,6,0,0,21,2,8,9,0,0,19,nowin,win,plwin,beat,20,0,15,209,0.411483254,0.04784689,0.531100478,0,0.017448125
7932,135,21323,3,5,10,0,0,18,10,10,0,0,0,20,nowin,loss,beat,dlwin,0,10,8,179,0.391061453,0.067039106,0.586592179,0,0.024924662
7933,74,21323,6,7,0,4,0,17,10,10,0,0,0,20,nowin,loss,beat,dlwin,0,10,13,209,0.411483254,0.04784689,0.531100478,0,0.017448125
7934,67,21323,2,4,4,10,0,20,10,10,0,0,0,20,nowin,push,push,push,10,0,6,195,0.369230769,0.041025641,0.569230769,0,0.014139427
7935,128,21323,6,3,3,3,8,23,10,10,0,0,0,20,nowin,loss,bust,plbust,0,10,9,227,0.356828194,0.052863436,0.577092511,0,0.012352564
7936,140,21323,5,5,7,0,0,17,10,10,0,0,0,20,nowin,loss,beat,dlwin,0,10,10,210,0.466666667,0.023809524,0.604761905,3,0.915293335
7937,121,21323,10,3,0,10,0,23,10,10,0,0,0,20,nowin,loss,bust,plbust,0,10,13,195,0.456410256,0.025641026,0.512820513,1,0.288597791
7938,140,21324,4,11,3,0,0,18,5,10,9,0,0,24,nowin,win,dlbust,bust,20,0,15,210,0.466666667,0.023809524,0.604761905,3,0.915293335
7939,101,21324,10,2,0,0,0,12,5,10,9,0,0,24,nowin,win,dlbust,bust,20,0,12,205,0.424390244,0.068292683,0.63902439,2,0.614740646
7940,133,21324,10,10,0,0,0,20,5,10,9,0,0,24,nowin,win,dlbust,bust,20,0,20,201,0.47761194,0.064676617,0.611940299,3,0.935428111
7941,49,21324,3,11,3,0,0,17,5,10,9,0,0,24,nowin,win,dlbust,bust,20,0,14,207,0.396135266,0.053140097,0.594202899,0,0.028306925
7942,35,21324,10,5,0,0,0,15,5,10,9,0,0,24,nowin,win,dlbust,bust,20,0,15,202,0.410891089,0.044554455,0.633663366,2,0.598681573
7943,14,21324,3,4,7,0,0,14,5,10,9,0,0,24,nowin,win,dlbust,bust,20,0,7,202,0.391089109,0.01980198,0.628712871,2,0.577264877
7944,23,21325,3,10,0,6,0,19,10,7,0,0,0,17,nowin,win,plwin,beat,20,0,13,208,0.427884615,0.0625,0.552884615,1,0.29114424
7945,94,21325,10,4,0,6,0,20,10,7,0,0,0,17,nowin,win,plwin,beat,20,0,14,183,0.43715847,0.043715847,0.540983607,1,0.290866892
7946,149,21325,2,9,8,0,0,19,10,7,0,0,0,17,nowin,win,plwin,beat,20,0,11,225,0.457777778,0.057777778,0.648888889,2,0.651965595
7947,46,21325,9,10,0,0,0,19,10,7,0,0,0,17,nowin,win,plwin,beat,20,0,19,186,0.403225806,0.048387097,0.591397849,0,0.029742194
7948,93,21325,5,11,3,0,0,19,10,7,0,0,0,17,nowin,win,plwin,beat,20,0,16,175,0.485714286,0.051428571,0.548571429,1,0.323648091
7949,47,21325,6,8,0,6,0,20,10,7,0,0,0,17,nowin,win,plwin,beat,20,0,14,210,0.438095238,0.057142857,0.623809524,2,0.615868808
7950,45,21326,10,10,0,0,0,20,9,3,10,0,0,22,nowin,win,dlbust,bust,20,0,20,196,0.428571429,0.051020408,0.612244898,2,0.598821767
7951,66,21326,3,11,5,0,0,19,9,3,10,0,0,22,nowin,win,dlbust,bust,20,0,14,217,0.456221198,0.064516129,0.626728111,3,0.924304367
7952,110,21326,6,2,10,0,0,18,9,3,10,0,0,22,nowin,win,dlbust,bust,20,0,8,192,0.416666667,0.046875,0.557291667,0,0.025413132
7953,61,21326,4,5,4,5,0,18,9,3,10,0,0,22,nowin,win,dlbust,bust,20,0,9,194,0.427835052,0.077319588,0.603092784,2,0.591437139
7954,26,21326,10,9,0,0,0,19,9,3,10,0,0,22,nowin,win,dlbust,bust,20,0,19,203,0.463054187,0.0591133,0.541871921,1,0.306802864
7955,115,21326,2,10,0,8,0,20,9,3,10,0,0,22,nowin,win,dlbust,bust,20,0,12,194,0.427835052,0.041237113,0.592783505,2,0.583863602
7956,129,21327,9,10,0,0,0,19,4,6,11,0,0,21,nowin,loss,beat,dlwin,0,10,19,201,0.422885572,0.064676617,0.55721393,0,0.027255383
7957,107,21327,9,3,0,0,0,12,4,6,11,0,0,21,nowin,loss,beat,dlwin,0,10,12,218,0.444954128,0.073394495,0.600917431,2,0.605210014
7958,133,21327,3,10,0,0,0,13,4,6,11,0,0,21,nowin,loss,beat,dlwin,0,10,13,201,0.47761194,0.064676617,0.611940299,3,0.935428111
7959,122,21327,2,10,0,0,0,12,4,6,11,0,0,21,nowin,loss,beat,dlwin,0,10,12,210,0.347619048,0.052380952,0.59047619,0,0.012873677
7960,105,21327,10,10,0,0,0,20,4,6,11,0,0,21,nowin,loss,beat,dlwin,0,10,20,198,0.414141414,0.070707071,0.590909091,0,0.032889494
7961,112,21327,5,2,9,0,0,16,4,6,11,0,0,21,nowin,loss,beat,dlwin,0,10,7,203,0.448275862,0.054187192,0.600985222,3,0.889576933
7962,71,21328,10,10,0,0,0,20,8,3,7,0,0,18,nowin,win,plwin,beat,20,0,20,193,0.352331606,0.046632124,0.585492228,0,0.013063661
7963,59,21328,10,2,0,1,4,17,8,3,7,0,0,18,nowin,loss,beat,dlwin,0,10,12,228,0.429824561,0.048245614,0.543859649,1,0.287885446
7964,67,21328,6,10,0,3,0,19,8,3,7,0,0,18,nowin,win,plwin,beat,20,0,16,195,0.369230769,0.041025641,0.569230769,0,0.014139427
7965,137,21328,2,8,4,9,0,23,8,3,7,0,0,18,nowin,loss,bust,plbust,0,10,10,194,0.417525773,0.046391753,0.536082474,1,0.276714602
7966,137,21328,6,10,0,10,0,26,8,3,7,0,0,18,nowin,loss,bust,plbust,0,10,16,194,0.417525773,0.046391753,0.536082474,1,0.276714602
7967,126,21328,7,10,0,0,0,17,8,3,7,0,0,18,nowin,loss,beat,dlwin,0,10,17,188,0.457446809,0.074468085,0.60106383,3,0.900633203
7968,18,21329,4,3,2,10,0,19,5,2,3,5,10,25,nowin,win,dlbust,bust,20,0,7,182,0.461538462,0.043956044,0.587912088,3,0.892649374
7969,10,21329,11,10,0,0,0,21,5,2,3,5,10,25,win,win,dlbust,bust,25,0,21,191,0.413612565,0.057591623,0.596858639,2,0.574087175
7970,125,21329,8,10,0,0,0,18,5,2,3,5,10,25,nowin,win,dlbust,bust,20,0,18,219,0.438356164,0.050228311,0.575342466,1,0.308411257
7971,90,21329,3,3,6,0,0,12,5,2,3,5,10,25,nowin,win,dlbust,bust,20,0,6,201,0.447761194,0.049751244,0.60199005,3,0.889945023
7972,1,21329,10,9,0,0,0,19,5,2,3,5,10,25,nowin,win,dlbust,bust,20,0,19,197,0.406091371,0.025380711,0.649746193,2,0.606186955
7973,1,21329,11,1,8,0,0,20,5,2,3,5,10,25,nowin,win,dlbust,bust,20,0,12,197,0.406091371,0.025380711,0.649746193,2,0.606186955
7974,25,21330,6,3,10,0,0,19,3,5,10,0,0,18,nowin,win,plwin,beat,20,0,9,190,0.463157895,0.063157895,0.536842105,1,0.304401563
7975,108,21330,10,10,0,0,0,20,3,5,10,0,0,18,nowin,win,plwin,beat,20,0,20,193,0.435233161,0.056994819,0.559585492,1,0.298824795
7976,113,21330,10,4,0,0,0,14,3,5,10,0,0,18,nowin,loss,beat,dlwin,0,10,14,199,0.407035176,0.055276382,0.668341709,2,0.620695264
7977,15,21330,10,3,0,0,0,13,3,5,10,0,0,18,nowin,loss,beat,dlwin,0,10,13,212,0.410377358,0.051886792,0.561320755,0,0.024517408
7978,45,21330,5,2,2,10,0,19,3,5,10,0,0,18,nowin,win,plwin,beat,20,0,7,196,0.428571429,0.051020408,0.612244898,2,0.598821767
7979,127,21330,10,10,0,0,0,20,3,5,10,0,0,18,nowin,win,plwin,beat,20,0,20,201,0.402985075,0.029850746,0.60199005,0,0.032263937
7980,84,21331,10,6,0,0,0,16,6,4,4,6,0,20,nowin,loss,beat,dlwin,0,10,16,195,0.379487179,0.056410256,0.569230769,0,0.017209119
7981,147,21331,10,10,0,0,0,20,6,4,4,6,0,20,nowin,push,push,push,10,0,20,205,0.380487805,0.014634146,0.536585366,0,0.00951447
7982,3,21331,3,4,5,0,0,12,6,4,4,6,0,20,nowin,loss,beat,dlwin,0,10,7,190,0.431578947,0.026315789,0.542105263,1,0.288076384
7983,74,21331,3,10,0,0,0,13,6,4,4,6,0,20,nowin,loss,beat,dlwin,0,10,13,209,0.411483254,0.04784689,0.531100478,0,0.017448125
7984,46,21331,10,2,0,0,0,12,6,4,4,6,0,20,nowin,loss,beat,dlwin,0,10,12,186,0.403225806,0.048387097,0.591397849,0,0.029742194
7985,84,21331,11,10,0,0,0,21,6,4,4,6,0,20,win,win,plwin,beat,25,0,21,195,0.379487179,0.056410256,0.569230769,0,0.017209119
7986,81,21332,9,5,0,10,0,24,10,8,0,0,0,18,nowin,loss,bust,plbust,0,10,14,182,0.395604396,0.043956044,0.60989011,2,0.567491261
7987,95,21332,6,8,0,5,0,19,10,8,0,0,0,18,nowin,win,plwin,beat,20,0,14,218,0.412844037,0.04587156,0.559633028,0,0.024842385
7988,81,21332,9,2,10,0,0,21,10,8,0,0,0,18,nowin,win,plwin,beat,20,0,11,182,0.395604396,0.043956044,0.60989011,2,0.567491261
7989,4,21332,11,10,0,0,0,21,10,8,0,0,0,18,win,win,plwin,beat,25,0,21,217,0.460829493,0.036866359,0.562211982,1,0.315432839
7990,62,21332,8,5,0,10,0,23,10,8,0,0,0,18,nowin,loss,bust,plbust,0,10,13,178,0.370786517,0.028089888,0.54494382,0,0.008657722
7991,123,21332,10,10,0,0,0,20,10,8,0,0,0,18,nowin,win,plwin,beat,20,0,20,205,0.43902439,0.034146341,0.614634146,2,0.609962544
7992,7,21333,10,2,0,10,0,22,8,11,0,0,0,19,nowin,loss,bust,plbust,0,10,12,183,0.442622951,0.06010929,0.62295082,2,0.619303341
7993,8,21333,10,10,0,0,0,20,8,11,0,0,0,19,nowin,win,plwin,beat,20,0,20,181,0.44198895,0.071823204,0.596685083,2,0.599438402
7994,39,21333,9,3,0,10,0,22,8,11,0,0,0,19,nowin,loss,bust,plbust,0,10,12,191,0.429319372,0.062827225,0.57591623,0,0.033760763
7995,113,21333,4,6,10,0,0,20,8,11,0,0,0,19,nowin,win,plwin,beat,20,0,10,199,0.407035176,0.055276382,0.668341709,2,0.620695264
7996,87,21333,4,8,0,5,0,17,8,11,0,0,0,19,nowin,loss,beat,dlwin,0,10,12,202,0.405940594,0.054455446,0.628712871,2,0.590599801
7997,19,21333,10,10,0,0,0,20,8,11,0,0,0,19,nowin,win,plwin,beat,20,0,20,237,0.41350211,0.054852321,0.628691983,2,0.597373826
7998,91,21334,2,5,11,0,0,18,8,2,2,1,10,23,nowin,win,dlbust,bust,20,0,7,194,0.417525773,0.046391753,0.515463918,1,0.266616552
7999,108,21334,2,7,10,0,0,19,8,2,2,1,10,23,nowin,win,dlbust,bust,20,0,9,193,0.435233161,0.056994819,0.559585492,1,0.298824795
8000,24,21334,5,8,0,10,0,23,8,2,2,1,10,23,nowin,loss,bust,plbust,0,10,13,207,0.458937198,0.048309179,0.570048309,1,0.318138014
8001,52,21334,10,2,0,5,0,17,8,2,2,1,10,23,nowin,win,dlbust,bust,20,0,12,217,0.414746544,0.02764977,0.599078341,2,0.576736024
8002,144,21334,7,10,0,0,0,17,8,2,2,1,10,23,nowin,win,dlbust,bust,20,0,17,202,0.386138614,0.054455446,0.564356436,0,0.018006244
8003,86,21334,3,5,10,0,0,18,8,2,2,1,10,23,nowin,win,dlbust,bust,20,0,8,196,0.454081633,0.040816327,0.591836735,3,0.887566443
8004,118,21335,3,8,2,10,0,23,10,10,0,0,0,20,nowin,loss,bust,plbust,0,10,11,216,0.393518519,0.037037037,0.555555556,0,0.018059873
8005,93,21335,10,10,0,0,0,20,10,10,0,0,0,20,nowin,push,push,push,10,0,20,175,0.485714286,0.051428571,0.548571429,1,0.323648091
8006,149,21335,3,10,0,6,0,19,10,10,0,0,0,20,nowin,loss,beat,dlwin,0,10,13,225,0.457777778,0.057777778,0.648888889,2,0.651965595
8007,123,21335,8,10,0,0,0,18,10,10,0,0,0,20,nowin,loss,beat,dlwin,0,10,18,205,0.43902439,0.034146341,0.614634146,2,0.609962544
8008,110,21335,7,7,0,4,0,18,10,10,0,0,0,20,nowin,loss,beat,dlwin,0,10,14,192,0.416666667,0.046875,0.557291667,0,0.025413132
8009,39,21335,10,11,0,0,0,21,10,10,0,0,0,20,win,win,plwin,beat,25,0,21,191,0.429319372,0.062827225,0.57591623,0,0.033760763
8010,17,21336,3,3,8,10,0,24,10,8,0,0,0,18,nowin,loss,bust,plbust,0,10,6,171,0.444444444,0.070175439,0.555555556,1,0.302364894
8011,70,21336,7,3,10,0,0,20,10,8,0,0,0,18,nowin,win,plwin,beat,20,0,10,228,0.385964912,0.039473684,0.557017544,0,0.016157125
8012,107,21336,7,4,9,0,0,20,10,8,0,0,0,18,nowin,win,plwin,beat,20,0,11,218,0.444954128,0.073394495,0.600917431,2,0.605210014
8013,24,21336,4,10,0,10,0,24,10,8,0,0,0,18,nowin,loss,bust,plbust,0,10,14,207,0.458937198,0.048309179,0.570048309,1,0.318138014
8014,136,21336,9,8,0,0,0,17,10,8,0,0,0,18,nowin,loss,beat,dlwin,0,10,17,194,0.396907216,0.025773196,0.597938144,0,0.029452644
8015,44,21336,9,8,0,0,0,17,10,8,0,0,0,18,nowin,loss,beat,dlwin,0,10,17,219,0.433789954,0.050228311,0.534246575,1,0.285551035
8016,94,21337,11,2,8,0,0,21,2,5,10,0,0,17,nowin,win,plwin,beat,20,0,13,183,0.43715847,0.043715847,0.540983607,1,0.290866892
8017,2,21337,10,4,0,0,0,14,2,5,10,0,0,17,nowin,loss,beat,dlwin,0,10,14,200,0.445,0.035,0.64,2,0.633962549
8018,133,21337,9,10,0,0,0,19,2,5,10,0,0,17,nowin,win,plwin,beat,20,0,19,201,0.47761194,0.064676617,0.611940299,3,0.935428111
8019,106,21337,3,8,4,0,0,15,2,5,10,0,0,17,nowin,loss,beat,dlwin,0,10,11,192,0.411458333,0.026041667,0.557291667,0,0.023854304
8020,145,21337,8,5,0,0,0,13,2,5,10,0,0,17,nowin,loss,beat,dlwin,0,10,13,188,0.441489362,0.031914894,0.622340426,2,0.617837093
8021,82,21337,6,1,7,0,0,14,2,5,10,0,0,17,nowin,loss,beat,dlwin,0,10,7,225,0.408888889,0.075555556,0.577777778,0,0.028101874
8022,50,21338,11,10,0,0,0,21,10,10,0,0,0,20,win,win,plwin,beat,25,0,21,202,0.405940594,0.04950495,0.54950495,0,0.020296079
8023,85,21338,10,10,0,0,0,20,10,10,0,0,0,20,nowin,push,push,push,10,0,20,195,0.41025641,0.066666667,0.594871795,0,0.03269711
8024,62,21338,10,10,0,0,0,20,10,10,0,0,0,20,nowin,push,push,push,10,0,20,178,0.370786517,0.028089888,0.54494382,0,0.008657722
8025,60,21338,2,10,0,2,7,21,10,10,0,0,0,20,nowin,win,plwin,beat,20,0,12,227,0.418502203,0.022026432,0.559471366,0,0.026496258
8026,44,21338,11,10,0,0,0,21,10,10,0,0,0,20,win,win,plwin,beat,25,0,21,219,0.433789954,0.050228311,0.534246575,1,0.285551035
8027,73,21338,9,3,0,3,10,25,10,10,0,0,0,20,nowin,loss,bust,plbust,0,10,12,181,0.375690608,0.011049724,0.596685083,0,0.022795773
8028,124,21339,7,10,0,0,0,17,1,1,10,4,9,25,nowin,win,dlbust,bust,20,0,17,202,0.47029703,0.064356436,0.584158416,3,0.899458193
8029,59,21339,9,7,0,7,0,23,1,1,10,4,9,25,nowin,loss,bust,plbust,0,10,16,228,0.429824561,0.048245614,0.543859649,1,0.287885446
8030,69,21339,10,3,0,7,0,20,1,1,10,4,9,25,nowin,win,dlbust,bust,20,0,13,194,0.365979381,0.030927835,0.515463918,0,0
8031,88,21339,9,2,5,5,0,21,1,1,10,4,9,25,nowin,win,dlbust,bust,20,0,11,206,0.466019417,0.033980583,0.54368932,1,0.309467903
8032,124,21339,10,3,0,10,0,23,1,1,10,4,9,25,nowin,loss,bust,plbust,0,10,13,202,0.47029703,0.064356436,0.584158416,3,0.899458193
8033,46,21339,10,11,0,0,0,21,1,1,10,4,9,25,win,win,dlbust,bust,25,0,21,186,0.403225806,0.048387097,0.591397849,0,0.029742194
8034,1,21340,9,10,0,0,0,19,5,10,10,0,0,25,nowin,win,dlbust,bust,20,0,19,197,0.406091371,0.025380711,0.649746193,2,0.606186955
8035,68,21340,10,10,0,0,0,20,5,10,10,0,0,25,nowin,win,dlbust,bust,20,0,20,205,0.434146341,0.029268293,0.6,2,0.59483189
8036,32,21340,7,7,0,0,0,14,5,10,10,0,0,25,nowin,win,dlbust,bust,20,0,14,189,0.391534392,0.037037037,0.53968254,0,0.013579086
8037,58,21340,11,10,0,0,0,21,5,10,10,0,0,25,win,win,dlbust,bust,25,0,21,195,0.430769231,0.041025641,0.584615385,2,0.580497586
8038,21,21340,8,2,9,0,0,19,5,10,10,0,0,25,nowin,win,dlbust,bust,20,0,10,214,0.359813084,0.042056075,0.626168224,0,0.025263474
8039,103,21340,5,3,6,0,0,14,5,10,10,0,0,25,nowin,win,dlbust,bust,20,0,8,203,0.379310345,0.064039409,0.551724138,0,0.012869209
8040,106,21341,11,2,6,0,0,19,7,9,8,0,0,24,nowin,win,dlbust,bust,20,0,13,192,0.411458333,0.026041667,0.557291667,0,0.023854304
8041,4,21341,10,10,0,0,0,20,7,9,8,0,0,24,nowin,win,dlbust,bust,20,0,20,217,0.460829493,0.036866359,0.562211982,1,0.315432839
8042,65,21341,10,6,0,10,0,26,7,9,8,0,0,24,nowin,loss,bust,plbust,0,10,16,203,0.492610837,0.054187192,0.571428571,3,0.913702814
8043,76,21341,4,3,5,8,0,20,7,9,8,0,0,24,nowin,win,dlbust,bust,20,0,7,189,0.534391534,0.079365079,0.608465608,3,1
8044,75,21341,9,11,0,0,0,20,7,9,8,0,0,24,nowin,win,dlbust,bust,20,0,20,191,0.418848168,0.052356021,0.570680628,0,0.029344702
8045,79,21341,8,6,0,4,0,18,7,9,8,0,0,24,nowin,win,dlbust,bust,20,0,14,211,0.436018957,0.028436019,0.672985782,2,0.650131054
8046,64,21342,11,10,0,0,0,21,4,3,10,0,0,17,win,win,plwin,beat,25,0,21,187,0.363636364,0.048128342,0.631016043,0,0.027594885
8047,102,21342,2,10,0,0,0,12,4,3,10,0,0,17,nowin,loss,beat,dlwin,0,10,12,192,0.338541667,0.046875,0.5625,0,0.003306118
8048,106,21342,8,9,0,0,0,17,4,3,10,0,0,17,nowin,push,push,push,10,0,17,192,0.411458333,0.026041667,0.557291667,0,0.023854304
8049,41,21342,7,6,0,0,0,13,4,3,10,0,0,17,nowin,loss,beat,dlwin,0,10,13,192,0.364583333,0.036458333,0.520833333,0,0.00089702
8050,121,21342,7,9,0,0,0,16,4,3,10,0,0,17,nowin,loss,beat,dlwin,0,10,16,195,0.456410256,0.025641026,0.512820513,1,0.288597791
8051,24,21342,2,4,8,0,0,14,4,3,10,0,0,17,nowin,loss,beat,dlwin,0,10,6,207,0.458937198,0.048309179,0.570048309,1,0.318138014
8052,37,21343,7,10,0,0,0,17,7,6,2,1,4,20,nowin,loss,beat,dlwin,0,10,17,208,0.394230769,0.038461538,0.581730769,0,0.024682772
8053,134,21343,9,10,0,0,0,19,7,6,2,1,4,20,nowin,loss,beat,dlwin,0,10,19,185,0.443243243,0.021621622,0.545945946,1,0.296939509
8054,119,21343,6,11,4,0,0,21,7,6,2,1,4,20,nowin,win,plwin,beat,20,0,17,190,0.405263158,0.068421053,0.515789474,0,0.011837158
8055,127,21343,8,10,0,0,0,18,7,6,2,1,4,20,nowin,loss,beat,dlwin,0,10,18,201,0.402985075,0.029850746,0.60199005,0,0.032263937
8056,103,21343,10,10,0,0,0,20,7,6,2,1,4,20,nowin,push,push,push,10,0,20,203,0.379310345,0.064039409,0.551724138,0,0.012869209
8057,9,21343,10,10,0,0,0,20,7,6,2,1,4,20,nowin,push,push,push,10,0,20,194,0.37628866,0.015463918,0.541237113,0,0.009396796
8058,18,21344,5,5,10,0,0,20,10,7,0,0,0,17,nowin,win,plwin,beat,20,0,10,182,0.461538462,0.043956044,0.587912088,3,0.892649374
8059,42,21344,8,10,0,0,0,18,10,7,0,0,0,17,nowin,win,plwin,beat,20,0,18,212,0.443396226,0.051886792,0.570754717,1,0.309181312
8060,54,21344,2,2,9,2,3,18,10,7,0,0,0,17,nowin,win,plwin,beat,20,0,4,185,0.437837838,0.032432432,0.556756757,1,0.29899854
8061,51,21344,10,10,0,0,0,20,10,7,0,0,0,17,nowin,win,plwin,beat,20,0,20,189,0.529100529,0.068783069,0.608465608,3,0.993665715
8062,59,21344,4,10,0,10,0,24,10,7,0,0,0,17,nowin,loss,bust,plbust,0,10,14,228,0.429824561,0.048245614,0.543859649,1,0.287885446
8063,23,21344,2,10,0,6,0,18,10,7,0,0,0,17,nowin,win,plwin,beat,20,0,12,208,0.427884615,0.0625,0.552884615,1,0.29114424
8064,87,21345,8,10,0,0,0,18,5,7,6,0,0,18,nowin,push,push,push,10,0,18,202,0.405940594,0.054455446,0.628712871,2,0.590599801
8065,88,21345,10,4,0,0,0,14,5,7,6,0,0,18,nowin,loss,beat,dlwin,0,10,14,206,0.466019417,0.033980583,0.54368932,1,0.309467903
8066,88,21345,5,11,5,0,0,21,5,7,6,0,0,18,nowin,win,plwin,beat,20,0,16,206,0.466019417,0.033980583,0.54368932,1,0.309467903
8067,24,21345,10,4,0,0,0,14,5,7,6,0,0,18,nowin,loss,beat,dlwin,0,10,14,207,0.458937198,0.048309179,0.570048309,1,0.318138014
8068,104,21345,10,7,0,0,0,17,5,7,6,0,0,18,nowin,loss,beat,dlwin,0,10,17,209,0.363636364,0.052631579,0.593301435,0,0.018359419
8069,89,21345,6,3,10,0,0,19,5,7,6,0,0,18,nowin,win,plwin,beat,20,0,9,212,0.537735849,0.047169811,0.594339623,3,0.990167191
8070,102,21346,5,10,0,10,0,25,11,4,5,0,0,20,nowin,loss,bust,plbust,0,10,15,192,0.338541667,0.046875,0.5625,0,0.003306118
8071,38,21346,3,4,7,10,0,24,11,4,5,0,0,20,nowin,loss,bust,plbust,0,10,7,202,0.361386139,0.03960396,0.564356436,0,0.010597953
8072,127,21346,6,3,3,10,0,22,11,4,5,0,0,20,nowin,loss,bust,plbust,0,10,9,201,0.402985075,0.029850746,0.60199005,0,0.032263937
8073,51,21346,9,11,0,0,0,20,11,4,5,0,0,20,nowin,push,push,push,10,0,20,189,0.529100529,0.068783069,0.608465608,3,0.993665715
8074,101,21346,10,2,0,10,0,22,11,4,5,0,0,20,nowin,loss,bust,plbust,0,10,12,205,0.424390244,0.068292683,0.63902439,2,0.614740646
8075,103,21346,8,10,0,0,0,18,11,4,5,0,0,20,nowin,loss,beat,dlwin,0,10,18,203,0.379310345,0.064039409,0.551724138,0,0.012869209
8076,1,21347,9,6,0,7,0,22,10,9,0,0,0,19,nowin,loss,bust,plbust,0,10,15,197,0.406091371,0.025380711,0.649746193,2,0.606186955
8077,79,21347,1,5,9,3,0,18,10,9,0,0,0,19,nowin,loss,beat,dlwin,0,10,6,211,0.436018957,0.028436019,0.672985782,2,0.650131054
8078,147,21347,4,6,8,0,0,18,10,9,0,0,0,19,nowin,loss,beat,dlwin,0,10,10,205,0.380487805,0.014634146,0.536585366,0,0.00951447
8079,120,21347,10,10,0,0,0,20,10,9,0,0,0,19,nowin,win,plwin,beat,20,0,20,202,0.440594059,0.034653465,0.618811881,2,0.614441029
8080,108,21347,4,2,10,6,0,22,10,9,0,0,0,19,nowin,loss,bust,plbust,0,10,6,193,0.435233161,0.056994819,0.559585492,1,0.298824795
8081,91,21347,3,10,0,10,0,23,10,9,0,0,0,19,nowin,loss,bust,plbust,0,10,13,194,0.417525773,0.046391753,0.515463918,1,0.266616552
8082,120,21348,5,5,9,0,0,19,10,3,4,0,0,17,nowin,win,plwin,beat,20,0,10,202,0.440594059,0.034653465,0.618811881,2,0.614441029
8083,108,21348,11,4,1,6,0,22,10,3,4,0,0,17,nowin,loss,bust,plbust,0,10,15,193,0.435233161,0.056994819,0.559585492,1,0.298824795
8084,93,21348,10,5,0,1,6,22,10,3,4,0,0,17,nowin,loss,bust,plbust,0,10,15,175,0.485714286,0.051428571,0.548571429,1,0.323648091
8085,34,21348,4,9,0,10,0,23,10,3,4,0,0,17,nowin,loss,bust,plbust,0,10,13,202,0.5,0.079207921,0.618811881,3,0.968961434
8086,142,21348,11,10,0,0,0,21,10,3,4,0,0,17,win,win,plwin,beat,25,0,21,211,0.417061611,0.047393365,0.526066351,1,0.271531309
8087,143,21348,10,7,0,0,0,17,10,3,4,0,0,17,nowin,push,push,push,10,0,17,203,0.463054187,0.044334975,0.57635468,3,0.883143365
8088,116,21349,1,4,10,10,0,25,10,10,0,0,0,20,nowin,loss,bust,plbust,0,10,5,195,0.425641026,0.056410256,0.538461538,1,0.28273747
8089,83,21349,3,9,0,10,0,22,10,10,0,0,0,20,nowin,loss,bust,plbust,0,10,12,193,0.424870466,0.051813472,0.678756477,2,0.644360335
8090,104,21349,4,4,11,0,0,19,10,10,0,0,0,20,nowin,loss,beat,dlwin,0,10,8,209,0.363636364,0.052631579,0.593301435,0,0.018359419
8091,58,21349,7,10,0,0,0,17,10,10,0,0,0,20,nowin,loss,beat,dlwin,0,10,17,195,0.430769231,0.041025641,0.584615385,2,0.580497586
8092,49,21349,10,9,0,0,0,19,10,10,0,0,0,20,nowin,loss,beat,dlwin,0,10,19,207,0.396135266,0.053140097,0.594202899,0,0.028306925
8093,92,21349,9,5,0,10,0,24,10,10,0,0,0,20,nowin,loss,bust,plbust,0,10,14,186,0.446236559,0.059139785,0.564516129,1,0.307826125
8094,64,21350,2,6,10,0,0,18,9,10,0,0,0,19,nowin,loss,beat,dlwin,0,10,8,187,0.363636364,0.048128342,0.631016043,0,0.027594885
8095,39,21350,8,5,0,10,0,23,9,10,0,0,0,19,nowin,loss,bust,plbust,0,10,13,191,0.429319372,0.062827225,0.57591623,0,0.033760763
8096,69,21350,9,10,0,0,0,19,9,10,0,0,0,19,nowin,push,push,push,10,0,19,194,0.365979381,0.030927835,0.515463918,0,0
8097,34,21350,10,10,0,0,0,20,9,10,0,0,0,19,nowin,win,plwin,beat,20,0,20,202,0.5,0.079207921,0.618811881,3,0.968961434
8098,33,21350,9,10,0,0,0,19,9,10,0,0,0,19,nowin,push,push,push,10,0,19,192,0.4375,0.057291667,0.625,2,0.616208916
8099,101,21350,10,4,0,7,0,21,9,10,0,0,0,19,nowin,win,plwin,beat,20,0,14,205,0.424390244,0.068292683,0.63902439,2,0.614740646
8100,6,21351,1,2,10,0,0,13,4,11,1,8,0,24,nowin,win,dlbust,bust,20,0,3,191,0.439790576,0.047120419,0.581151832,1,0.31211505
8101,72,21351,1,6,6,0,0,13,4,11,1,8,0,24,nowin,win,dlbust,bust,20,0,7,185,0.394594595,0.032432432,0.508108108,0,0.006763115
8102,86,21351,9,10,0,0,0,19,4,11,1,8,0,24,nowin,win,dlbust,bust,20,0,19,196,0.454081633,0.040816327,0.591836735,3,0.887566443
8103,89,21351,8,8,0,0,0,16,4,11,1,8,0,24,nowin,win,dlbust,bust,20,0,16,212,0.537735849,0.047169811,0.594339623,3,0.990167191
8104,42,21351,10,8,0,0,0,18,4,11,1,8,0,24,nowin,win,dlbust,bust,20,0,18,212,0.443396226,0.051886792,0.570754717,1,0.309181312
8105,47,21351,7,10,0,0,0,17,4,11,1,8,0,24,nowin,win,dlbust,bust,20,0,17,210,0.438095238,0.057142857,0.623809524,2,0.615868808
8106,36,21352,1,5,8,8,0,22,1,2,10,10,0,23,nowin,loss,bust,plbust,0,10,6,229,0.445414847,0.056768559,0.655021834,2,0.645370571
8107,107,21352,10,11,0,0,0,21,1,2,10,10,0,23,win,win,dlbust,bust,25,0,21,218,0.444954128,0.073394495,0.600917431,2,0.605210014
8108,130,21352,6,9,0,10,0,25,1,2,10,10,0,23,nowin,loss,bust,plbust,0,10,15,219,0.410958904,0.03652968,0.566210046,0,0.025888739
8109,97,21352,7,7,0,10,0,24,1,2,10,10,0,23,nowin,loss,bust,plbust,0,10,14,182,0.450549451,0.06043956,0.692307692,2,0.677372279
8110,59,21352,2,3,6,1,6,18,1,2,10,10,0,23,nowin,win,dlbust,bust,20,0,5,228,0.429824561,0.048245614,0.543859649,1,0.287885446
8111,6,21352,8,9,0,0,0,17,1,2,10,10,0,23,nowin,win,dlbust,bust,20,0,17,191,0.439790576,0.047120419,0.581151832,1,0.31211505
8112,63,21353,4,10,0,1,5,20,9,4,7,0,0,20,nowin,push,push,push,10,0,14,216,0.467592593,0.037037037,0.62037037,3,0.931690496
8113,116,21353,2,7,3,2,10,24,9,4,7,0,0,20,nowin,loss,bust,plbust,0,10,9,195,0.425641026,0.056410256,0.538461538,1,0.28273747
8114,29,21353,9,5,0,4,0,18,9,4,7,0,0,20,nowin,loss,beat,dlwin,0,10,14,189,0.44973545,0.058201058,0.544973545,1,0.300349439
8115,110,21353,3,10,0,5,0,18,9,4,7,0,0,20,nowin,loss,beat,dlwin,0,10,13,192,0.416666667,0.046875,0.557291667,0,0.025413132
8116,47,21353,9,3,0,3,9,24,9,4,7,0,0,20,nowin,loss,bust,plbust,0,10,12,210,0.438095238,0.057142857,0.623809524,2,0.615868808
8117,122,21353,4,10,0,5,0,19,9,4,7,0,0,20,nowin,loss,beat,dlwin,0,10,14,210,0.347619048,0.052380952,0.59047619,0,0.012873677
8118,109,21354,6,5,4,0,0,15,3,6,10,0,0,19,nowin,loss,beat,dlwin,0,10,11,221,0.461538462,0.058823529,0.597285068,3,0.901830309
8119,45,21354,8,10,0,0,0,18,3,6,10,0,0,19,nowin,loss,beat,dlwin,0,10,18,196,0.428571429,0.051020408,0.612244898,2,0.598821767
8120,101,21354,3,5,5,0,0,13,3,6,10,0,0,19,nowin,loss,beat,dlwin,0,10,8,205,0.424390244,0.068292683,0.63902439,2,0.614740646
8121,33,21354,10,10,0,0,0,20,3,6,10,0,0,19,nowin,win,plwin,beat,20,0,20,192,0.4375,0.057291667,0.625,2,0.616208916
8122,12,21354,2,11,6,0,0,19,3,6,10,0,0,19,nowin,push,push,push,10,0,13,189,0.470899471,0.015873016,0.613756614,3,0.929171178
8123,140,21354,11,7,0,0,0,18,3,6,10,0,0,19,nowin,loss,beat,dlwin,0,10,18,210,0.466666667,0.023809524,0.604761905,3,0.915293335
8124,13,21355,11,10,0,0,0,21,11,7,0,0,0,18,win,win,plwin,beat,25,0,21,206,0.417475728,0.063106796,0.621359223,2,0.59555479
8125,4,21355,6,10,0,5,0,21,11,7,0,0,0,18,nowin,win,plwin,beat,20,0,16,217,0.460829493,0.036866359,0.562211982,1,0.315432839
8126,15,21355,10,10,0,0,0,20,11,7,0,0,0,18,nowin,win,plwin,beat,20,0,20,212,0.410377358,0.051886792,0.561320755,0,0.024517408
8127,111,21355,9,10,0,0,0,19,11,7,0,0,0,18,nowin,win,plwin,beat,20,0,19,180,0.433333333,0.055555556,0.611111111,2,0.602264492
8128,47,21355,4,4,4,1,4,17,11,7,0,0,0,18,nowin,loss,beat,dlwin,0,10,8,210,0.438095238,0.057142857,0.623809524,2,0.615868808
8129,20,21355,2,10,0,8,0,20,11,7,0,0,0,18,nowin,win,plwin,beat,20,0,12,186,0.456989247,0.037634409,0.537634409,1,0.301097108
8130,52,21356,11,2,1,0,0,14,5,2,4,7,0,18,nowin,loss,beat,dlwin,0,10,13,217,0.414746544,0.02764977,0.599078341,2,0.576736024
8131,117,21356,6,7,0,0,0,13,5,2,4,7,0,18,nowin,loss,beat,dlwin,0,10,13,173,0.410404624,0.069364162,0.606936416,2,0.578610282
8132,124,21356,3,10,0,0,0,13,5,2,4,7,0,18,nowin,loss,beat,dlwin,0,10,13,202,0.47029703,0.064356436,0.584158416,3,0.899458193
8133,108,21356,6,10,0,0,0,16,5,2,4,7,0,18,nowin,loss,beat,dlwin,0,10,16,193,0.435233161,0.056994819,0.559585492,1,0.298824795
8134,107,21356,4,2,10,0,0,16,5,2,4,7,0,18,nowin,loss,beat,dlwin,0,10,6,218,0.444954128,0.073394495,0.600917431,2,0.605210014
8135,144,21356,10,10,0,0,0,20,5,2,4,7,0,18,nowin,win,plwin,beat,20,0,20,202,0.386138614,0.054455446,0.564356436,0,0.018006244
8136,124,21357,7,6,0,0,0,13,3,7,10,0,0,20,nowin,loss,beat,dlwin,0,10,13,202,0.47029703,0.064356436,0.584158416,3,0.899458193
8137,30,21357,5,4,5,0,0,14,3,7,10,0,0,20,nowin,loss,beat,dlwin,0,10,9,206,0.393203883,0.033980583,0.601941748,0,0.029324648
8138,39,21357,10,2,0,3,0,15,3,7,10,0,0,20,nowin,loss,beat,dlwin,0,10,12,191,0.429319372,0.062827225,0.57591623,0,0.033760763
8139,38,21357,3,6,5,0,0,14,3,7,10,0,0,20,nowin,loss,beat,dlwin,0,10,9,202,0.361386139,0.03960396,0.564356436,0,0.010597953
8140,132,21357,10,9,0,0,0,19,3,7,10,0,0,20,nowin,loss,beat,dlwin,0,10,19,194,0.412371134,0.036082474,0.649484536,2,0.611633238
8141,137,21357,9,7,0,0,0,16,3,7,10,0,0,20,nowin,loss,beat,dlwin,0,10,16,194,0.417525773,0.046391753,0.536082474,1,0.276714602
8142,103,21358,10,5,0,10,0,25,9,10,0,0,0,19,nowin,loss,bust,plbust,0,10,15,203,0.379310345,0.064039409,0.551724138,0,0.012869209
8143,75,21358,10,4,0,6,0,20,9,10,0,0,0,19,nowin,win,plwin,beat,20,0,14,191,0.418848168,0.052356021,0.570680628,0,0.029344702
8144,108,21358,6,10,0,9,0,25,9,10,0,0,0,19,nowin,loss,bust,plbust,0,10,16,193,0.435233161,0.056994819,0.559585492,1,0.298824795
8145,120,21358,3,2,4,2,9,20,9,10,0,0,0,19,nowin,win,plwin,beat,20,0,5,202,0.440594059,0.034653465,0.618811881,2,0.614441029
8146,114,21358,9,10,0,0,0,19,9,10,0,0,0,19,nowin,push,push,push,10,0,19,198,0.47979798,0.025252525,0.611111111,3,0.937232995
8147,141,21358,8,8,0,1,0,17,9,10,0,0,0,19,nowin,loss,beat,dlwin,0,10,16,202,0.420792079,0.074257426,0.564356436,0,0.028377851
8148,123,21359,10,7,0,0,0,17,10,9,0,0,0,19,nowin,loss,beat,dlwin,0,10,17,205,0.43902439,0.034146341,0.614634146,2,0.609962544
8149,57,21359,2,7,3,8,0,20,10,9,0,0,0,19,nowin,win,plwin,beat,20,0,9,192,0.46875,0.052083333,0.59375,3,0.907001181
8150,18,21359,10,2,0,10,0,22,10,9,0,0,0,19,nowin,loss,bust,plbust,0,10,12,182,0.461538462,0.043956044,0.587912088,3,0.892649374
8151,53,21359,10,10,0,0,0,20,10,9,0,0,0,19,nowin,win,plwin,beat,20,0,20,250,0.372,0.064,0.564,0,0.013687345
8152,80,21359,4,10,0,4,0,18,10,9,0,0,0,19,nowin,loss,beat,dlwin,0,10,14,186,0.419354839,0.059139785,0.623655914,2,0.59892924
8153,45,21359,10,8,0,0,0,18,10,9,0,0,0,19,nowin,loss,beat,dlwin,0,10,18,196,0.428571429,0.051020408,0.612244898,2,0.598821767
8154,94,21360,3,10,0,0,0,13,6,6,2,1,3,18,nowin,loss,beat,dlwin,0,10,13,183,0.43715847,0.043715847,0.540983607,1,0.290866892
8155,48,21360,2,11,1,0,0,14,6,6,2,1,3,18,nowin,loss,beat,dlwin,0,10,13,203,0.413793103,0.019704433,0.600985222,2,0.577280801
8156,88,21360,9,9,0,0,0,18,6,6,2,1,3,18,nowin,push,push,push,10,0,18,206,0.466019417,0.033980583,0.54368932,1,0.309467903
8157,46,21360,5,8,0,0,0,13,6,6,2,1,3,18,nowin,loss,beat,dlwin,0,10,13,186,0.403225806,0.048387097,0.591397849,0,0.029742194
8158,61,21360,10,7,0,0,0,17,6,6,2,1,3,18,nowin,loss,beat,dlwin,0,10,17,194,0.427835052,0.077319588,0.603092784,2,0.591437139
8159,86,21360,2,10,0,0,0,12,6,6,2,1,3,18,nowin,loss,beat,dlwin,0,10,12,196,0.454081633,0.040816327,0.591836735,3,0.887566443
8160,32,21361,10,6,0,10,0,26,10,9,0,0,0,19,nowin,loss,bust,plbust,0,10,16,189,0.391534392,0.037037037,0.53968254,0,0.013579086
8161,96,21361,3,11,7,0,0,21,10,9,0,0,0,19,nowin,win,plwin,beat,20,0,14,190,0.468421053,0.057894737,0.584210526,3,0.897263354
8162,58,21361,8,9,0,0,0,17,10,9,0,0,0,19,nowin,loss,beat,dlwin,0,10,17,195,0.430769231,0.041025641,0.584615385,2,0.580497586
8163,129,21361,9,5,0,10,0,24,10,9,0,0,0,19,nowin,loss,bust,plbust,0,10,14,201,0.422885572,0.064676617,0.55721393,0,0.027255383
8164,74,21361,10,10,0,0,0,20,10,9,0,0,0,19,nowin,win,plwin,beat,20,0,20,209,0.411483254,0.04784689,0.531100478,0,0.017448125
8165,19,21361,10,10,0,0,0,20,10,9,0,0,0,19,nowin,win,plwin,beat,20,0,20,237,0.41350211,0.054852321,0.628691983,2,0.597373826
8166,54,21362,8,11,0,0,0,19,9,3,2,2,8,24,nowin,win,dlbust,bust,20,0,19,185,0.437837838,0.032432432,0.556756757,1,0.29899854
8167,23,21362,8,10,0,0,0,18,9,3,2,2,8,24,nowin,win,dlbust,bust,20,0,18,208,0.427884615,0.0625,0.552884615,1,0.29114424
8168,82,21362,10,9,0,0,0,19,9,3,2,2,8,24,nowin,win,dlbust,bust,20,0,19,225,0.408888889,0.075555556,0.577777778,0,0.028101874
8169,116,21362,7,4,4,3,0,18,9,3,2,2,8,24,nowin,win,dlbust,bust,20,0,11,195,0.425641026,0.056410256,0.538461538,1,0.28273747
8170,38,21362,8,9,0,0,0,17,9,3,2,2,8,24,nowin,win,dlbust,bust,20,0,17,202,0.361386139,0.03960396,0.564356436,0,0.010597953
8171,15,21362,10,10,0,0,0,20,9,3,2,2,8,24,nowin,win,dlbust,bust,20,0,20,212,0.410377358,0.051886792,0.561320755,0,0.024517408
8172,17,21363,7,2,6,10,0,25,10,9,0,0,0,19,nowin,loss,bust,plbust,0,10,9,171,0.444444444,0.070175439,0.555555556,1,0.302364894
8173,33,21363,8,8,0,1,0,17,10,9,0,0,0,19,nowin,loss,beat,dlwin,0,10,16,192,0.4375,0.057291667,0.625,2,0.616208916
8174,14,21363,8,6,0,4,0,18,10,9,0,0,0,19,nowin,loss,beat,dlwin,0,10,14,202,0.391089109,0.01980198,0.628712871,2,0.577264877
8175,59,21363,5,11,4,0,0,20,10,9,0,0,0,19,nowin,win,plwin,beat,20,0,16,228,0.429824561,0.048245614,0.543859649,1,0.287885446
8176,88,21363,4,6,10,0,0,20,10,9,0,0,0,19,nowin,win,plwin,beat,20,0,10,206,0.466019417,0.033980583,0.54368932,1,0.309467903
8177,105,21363,3,2,6,3,10,24,10,9,0,0,0,19,nowin,loss,bust,plbust,0,10,5,198,0.414141414,0.070707071,0.590909091,0,0.032889494
8178,84,21364,10,8,0,0,0,18,10,9,0,0,0,19,nowin,loss,beat,dlwin,0,10,18,195,0.379487179,0.056410256,0.569230769,0,0.017209119
8179,53,21364,5,3,10,0,0,18,10,9,0,0,0,19,nowin,loss,beat,dlwin,0,10,8,250,0.372,0.064,0.564,0,0.013687345
8180,96,21364,1,4,10,6,0,21,10,9,0,0,0,19,nowin,win,plwin,beat,20,0,5,190,0.468421053,0.057894737,0.584210526,3,0.897263354
8181,121,21364,8,7,0,5,0,20,10,9,0,0,0,19,nowin,win,plwin,beat,20,0,15,195,0.456410256,0.025641026,0.512820513,1,0.288597791
8182,143,21364,9,11,0,0,0,20,10,9,0,0,0,19,nowin,win,plwin,beat,20,0,20,203,0.463054187,0.044334975,0.57635468,3,0.883143365
8183,108,21364,6,10,0,6,0,22,10,9,0,0,0,19,nowin,loss,bust,plbust,0,10,16,193,0.435233161,0.056994819,0.559585492,1,0.298824795
8184,109,21365,11,10,0,0,0,21,7,9,10,0,0,26,win,win,dlbust,bust,25,0,21,221,0.461538462,0.058823529,0.597285068,3,0.901830309
8185,56,21365,11,2,4,0,0,17,7,9,10,0,0,26,nowin,win,dlbust,bust,20,0,13,175,0.4,0.057142857,0.582857143,0,0.026685297
8186,8,21365,7,11,0,0,0,18,7,9,10,0,0,26,nowin,win,dlbust,bust,20,0,18,181,0.44198895,0.071823204,0.596685083,2,0.599438402
8187,1,21365,3,10,0,10,0,23,7,9,10,0,0,26,nowin,loss,bust,plbust,0,10,13,197,0.406091371,0.025380711,0.649746193,2,0.606186955
8188,95,21365,10,9,0,0,0,19,7,9,10,0,0,26,nowin,win,dlbust,bust,20,0,19,218,0.412844037,0.04587156,0.559633028,0,0.024842385
8189,51,21365,10,10,0,0,0,20,7,9,10,0,0,26,nowin,win,dlbust,bust,20,0,20,189,0.529100529,0.068783069,0.608465608,3,0.993665715
8190,73,21366,4,10,0,0,0,14,5,3,2,10,0,20,nowin,loss,beat,dlwin,0,10,14,181,0.375690608,0.011049724,0.596685083,0,0.022795773
8191,132,21366,3,11,6,0,0,20,5,3,2,10,0,20,nowin,push,push,push,10,0,14,194,0.412371134,0.036082474,0.649484536,2,0.611633238
8192,42,21366,10,6,0,0,0,16,5,3,2,10,0,20,nowin,loss,beat,dlwin,0,10,16,212,0.443396226,0.051886792,0.570754717,1,0.309181312
8193,87,21366,6,10,0,0,0,16,5,3,2,10,0,20,nowin,loss,beat,dlwin,0,10,16,202,0.405940594,0.054455446,0.628712871,2,0.590599801
8194,82,21366,8,10,0,0,0,18,5,3,2,10,0,20,nowin,loss,beat,dlwin,0,10,18,225,0.408888889,0.075555556,0.577777778,0,0.028101874
8195,38,21366,11,9,0,0,0,20,5,3,2,10,0,20,nowin,push,push,push,10,0,20,202,0.361386139,0.03960396,0.564356436,0,0.010597953
8196,88,21367,10,3,0,0,0,13,6,10,1,0,0,17,nowin,loss,beat,dlwin,0,10,13,206,0.466019417,0.033980583,0.54368932,1,0.309467903
8197,17,21367,2,9,2,0,0,13,6,10,1,0,0,17,nowin,loss,beat,dlwin,0,10,11,171,0.444444444,0.070175439,0.555555556,1,0.302364894
8198,47,21367,11,10,0,0,0,21,6,10,1,0,0,17,win,win,plwin,beat,25,0,21,210,0.438095238,0.057142857,0.623809524,2,0.615868808
8199,127,21367,8,10,0,0,0,18,6,10,1,0,0,17,nowin,win,plwin,beat,20,0,18,201,0.402985075,0.029850746,0.60199005,0,0.032263937
8200,67,21367,3,4,10,0,0,17,6,10,1,0,0,17,nowin,push,push,push,10,0,7,195,0.369230769,0.041025641,0.569230769,0,0.014139427
8201,58,21367,4,11,5,0,0,20,6,10,1,0,0,17,nowin,win,plwin,beat,20,0,15,195,0.430769231,0.041025641,0.584615385,2,0.580497586
8202,97,21368,10,8,0,0,0,18,10,4,10,0,0,24,nowin,win,dlbust,bust,20,0,18,182,0.450549451,0.06043956,0.692307692,2,0.677372279
8203,91,21368,10,10,0,0,0,20,10,4,10,0,0,24,nowin,win,dlbust,bust,20,0,20,194,0.417525773,0.046391753,0.515463918,1,0.266616552
8204,70,21368,10,7,0,0,0,17,10,4,10,0,0,24,nowin,win,dlbust,bust,20,0,17,228,0.385964912,0.039473684,0.557017544,0,0.016157125
8205,134,21368,8,10,0,0,0,18,10,4,10,0,0,24,nowin,win,dlbust,bust,20,0,18,185,0.443243243,0.021621622,0.545945946,1,0.296939509
8206,73,21368,11,9,0,0,0,20,10,4,10,0,0,24,nowin,win,dlbust,bust,20,0,20,181,0.375690608,0.011049724,0.596685083,0,0.022795773
8207,71,21368,9,10,0,0,0,19,10,4,10,0,0,24,nowin,win,dlbust,bust,20,0,19,193,0.352331606,0.046632124,0.585492228,0,0.013063661
8208,57,21369,2,8,10,0,0,20,7,7,3,0,0,17,nowin,win,plwin,beat,20,0,10,192,0.46875,0.052083333,0.59375,3,0.907001181
8209,97,21369,11,7,0,0,0,18,7,7,3,0,0,17,nowin,win,plwin,beat,20,0,18,182,0.450549451,0.06043956,0.692307692,2,0.677372279
8210,38,21369,10,4,0,6,0,20,7,7,3,0,0,17,nowin,win,plwin,beat,20,0,14,202,0.361386139,0.03960396,0.564356436,0,0.010597953
8211,9,21369,3,1,10,10,0,24,7,7,3,0,0,17,nowin,loss,bust,plbust,0,10,4,194,0.37628866,0.015463918,0.541237113,0,0.009396796
8212,101,21369,6,10,0,10,0,26,7,7,3,0,0,17,nowin,loss,bust,plbust,0,10,16,205,0.424390244,0.068292683,0.63902439,2,0.614740646
8213,147,21369,2,4,10,10,0,26,7,7,3,0,0,17,nowin,loss,bust,plbust,0,10,6,205,0.380487805,0.014634146,0.536585366,0,0.00951447
8214,126,21370,8,7,0,0,0,15,5,1,7,3,2,18,nowin,loss,beat,dlwin,0,10,15,188,0.457446809,0.074468085,0.60106383,3,0.900633203
8215,47,21370,8,11,0,0,0,19,5,1,7,3,2,18,nowin,win,plwin,beat,20,0,19,210,0.438095238,0.057142857,0.623809524,2,0.615868808
8216,47,21370,9,3,0,0,0,12,5,1,7,3,2,18,nowin,loss,beat,dlwin,0,10,12,210,0.438095238,0.057142857,0.623809524,2,0.615868808
8217,92,21370,4,10,0,0,0,14,5,1,7,3,2,18,nowin,loss,beat,dlwin,0,10,14,186,0.446236559,0.059139785,0.564516129,1,0.307826125
8218,20,21370,6,8,0,0,0,14,5,1,7,3,2,18,nowin,loss,beat,dlwin,0,10,14,186,0.456989247,0.037634409,0.537634409,1,0.301097108
8219,55,21370,5,10,0,0,0,15,5,1,7,3,2,18,nowin,loss,beat,dlwin,0,10,15,191,0.371727749,0.057591623,0.54973822,0,0.01011347
8220,70,21371,8,9,0,0,0,17,2,6,5,5,0,18,nowin,loss,beat,dlwin,0,10,17,228,0.385964912,0.039473684,0.557017544,0,0.016157125
8221,108,21371,10,2,0,3,0,15,2,6,5,5,0,18,nowin,loss,beat,dlwin,0,10,12,193,0.435233161,0.056994819,0.559585492,1,0.298824795
8222,8,21371,10,5,0,0,0,15,2,6,5,5,0,18,nowin,loss,beat,dlwin,0,10,15,181,0.44198895,0.071823204,0.596685083,2,0.599438402
8223,117,21371,2,10,0,8,0,20,2,6,5,5,0,18,nowin,win,plwin,beat,20,0,12,173,0.410404624,0.069364162,0.606936416,2,0.578610282
8224,90,21371,3,1,9,0,0,13,2,6,5,5,0,18,nowin,loss,beat,dlwin,0,10,4,201,0.447761194,0.049751244,0.60199005,3,0.889945023
8225,124,21371,6,8,0,0,0,14,2,6,5,5,0,18,nowin,loss,beat,dlwin,0,10,14,202,0.47029703,0.064356436,0.584158416,3,0.899458193
8226,128,21372,3,2,6,10,0,21,10,11,0,0,0,21,nowin,push,push,push,10,0,5,227,0.356828194,0.052863436,0.577092511,0,0.012352564
8227,136,21372,7,9,0,10,0,26,10,11,0,0,0,21,nowin,loss,bust,plbust,0,10,16,194,0.396907216,0.025773196,0.597938144,0,0.029452644
8228,127,21372,10,10,0,0,0,20,10,11,0,0,0,21,nowin,loss,beat,dlwin,0,10,20,201,0.402985075,0.029850746,0.60199005,0,0.032263937
8229,149,21372,11,10,0,0,0,21,10,11,0,0,0,21,win,push,push,push,10,0,21,225,0.457777778,0.057777778,0.648888889,2,0.651965595
8230,35,21372,8,4,0,3,2,17,10,11,0,0,0,21,nowin,loss,beat,dlwin,0,10,12,202,0.410891089,0.044554455,0.633663366,2,0.598681573
8231,48,21372,3,3,8,2,9,25,10,11,0,0,0,21,nowin,loss,bust,plbust,0,10,6,203,0.413793103,0.019704433,0.600985222,2,0.577280801
8232,17,21373,5,5,10,0,0,20,10,11,0,0,0,21,nowin,loss,beat,dlwin,0,10,10,171,0.444444444,0.070175439,0.555555556,1,0.302364894
8233,128,21373,10,2,0,10,0,22,10,11,0,0,0,21,nowin,loss,bust,plbust,0,10,12,227,0.356828194,0.052863436,0.577092511,0,0.012352564
8234,137,21373,7,6,0,2,10,25,10,11,0,0,0,21,nowin,loss,bust,plbust,0,10,13,194,0.417525773,0.046391753,0.536082474,1,0.276714602
8235,92,21373,5,5,2,2,5,19,10,11,0,0,0,21,nowin,loss,beat,dlwin,0,10,10,186,0.446236559,0.059139785,0.564516129,1,0.307826125
8236,113,21373,4,8,0,6,0,18,10,11,0,0,0,21,nowin,loss,beat,dlwin,0,10,12,199,0.407035176,0.055276382,0.668341709,2,0.620695264
8237,69,21373,10,10,0,0,0,20,10,11,0,0,0,21,nowin,loss,beat,dlwin,0,10,20,194,0.365979381,0.030927835,0.515463918,0,0
8238,78,21374,10,4,0,3,0,17,10,10,0,0,0,20,nowin,loss,beat,dlwin,0,10,14,201,0.517412935,0.034825871,0.587064677,3,0.95871112
8239,108,21374,3,6,3,6,0,18,10,10,0,0,0,20,nowin,loss,beat,dlwin,0,10,9,193,0.435233161,0.056994819,0.559585492,1,0.298824795
8240,84,21374,10,10,0,0,0,20,10,10,0,0,0,20,nowin,push,push,push,10,0,20,195,0.379487179,0.056410256,0.569230769,0,0.017209119
8241,89,21374,4,10,0,9,0,23,10,10,0,0,0,20,nowin,loss,bust,plbust,0,10,14,212,0.537735849,0.047169811,0.594339623,3,0.990167191
8242,102,21374,10,10,0,0,0,20,10,10,0,0,0,20,nowin,push,push,push,10,0,20,192,0.338541667,0.046875,0.5625,0,0.003306118
8243,115,21374,10,10,0,0,0,20,10,10,0,0,0,20,nowin,push,push,push,10,0,20,194,0.427835052,0.041237113,0.592783505,2,0.583863602
8244,53,21375,7,10,0,0,0,17,8,8,2,0,0,18,nowin,loss,beat,dlwin,0,10,17,250,0.372,0.064,0.564,0,0.013687345
8245,126,21375,11,10,0,0,0,21,8,8,2,0,0,18,win,win,plwin,beat,25,0,21,188,0.457446809,0.074468085,0.60106383,3,0.900633203
8246,48,21375,10,9,0,0,0,19,8,8,2,0,0,18,nowin,win,plwin,beat,20,0,19,203,0.413793103,0.019704433,0.600985222,2,0.577280801
8247,15,21375,7,10,0,0,0,17,8,8,2,0,0,18,nowin,loss,beat,dlwin,0,10,17,212,0.410377358,0.051886792,0.561320755,0,0.024517408
8248,136,21375,8,10,0,0,0,18,8,8,2,0,0,18,nowin,push,push,push,10,0,18,194,0.396907216,0.025773196,0.597938144,0,0.029452644
8249,28,21375,2,8,10,0,0,20,8,8,2,0,0,18,nowin,win,plwin,beat,20,0,10,199,0.422110553,0.045226131,0.542713568,1,0.282706618
8250,81,21376,9,2,1,10,0,22,10,5,3,0,0,18,nowin,loss,bust,plbust,0,10,11,182,0.395604396,0.043956044,0.60989011,2,0.567491261
8251,35,21376,10,11,0,0,0,21,10,5,3,0,0,18,win,win,plwin,beat,25,0,21,202,0.410891089,0.044554455,0.633663366,2,0.598681573
8252,86,21376,5,7,0,10,0,22,10,5,3,0,0,18,nowin,loss,bust,plbust,0,10,12,196,0.454081633,0.040816327,0.591836735,3,0.887566443
8253,42,21376,3,10,0,7,0,20,10,5,3,0,0,18,nowin,win,plwin,beat,20,0,13,212,0.443396226,0.051886792,0.570754717,1,0.309181312
8254,147,21376,10,5,0,3,0,18,10,5,3,0,0,18,nowin,push,push,push,10,0,15,205,0.380487805,0.014634146,0.536585366,0,0.00951447
8255,47,21376,1,1,10,10,0,22,10,5,3,0,0,18,nowin,loss,bust,plbust,0,10,2,210,0.438095238,0.057142857,0.623809524,2,0.615868808
8256,109,21377,9,4,0,0,0,13,3,10,10,0,0,23,nowin,win,dlbust,bust,20,0,13,221,0.461538462,0.058823529,0.597285068,3,0.901830309
8257,61,21377,10,5,0,0,0,15,3,10,10,0,0,23,nowin,win,dlbust,bust,20,0,15,194,0.427835052,0.077319588,0.603092784,2,0.591437139
8258,150,21377,8,7,0,0,0,15,3,10,10,0,0,23,nowin,win,dlbust,bust,20,0,15,192,0.401041667,0.036458333,0.567708333,0,0.023287458
8259,103,21377,5,6,5,0,0,16,3,10,10,0,0,23,nowin,win,dlbust,bust,20,0,11,203,0.379310345,0.064039409,0.551724138,0,0.012869209
8260,89,21377,9,10,0,0,0,19,3,10,10,0,0,23,nowin,win,dlbust,bust,20,0,19,212,0.537735849,0.047169811,0.594339623,3,0.990167191
8261,40,21377,6,5,6,0,0,17,3,10,10,0,0,23,nowin,win,dlbust,bust,20,0,11,196,0.367346939,0.030612245,0.617346939,0,0.025358183
8262,50,21378,11,3,3,0,0,17,3,10,2,10,0,25,nowin,win,dlbust,bust,20,0,14,202,0.405940594,0.04950495,0.54950495,0,0.020296079
8263,48,21378,10,3,0,0,0,13,3,10,2,10,0,25,nowin,win,dlbust,bust,20,0,13,203,0.413793103,0.019704433,0.600985222,2,0.577280801
8264,104,21378,10,10,0,0,0,20,3,10,2,10,0,25,nowin,win,dlbust,bust,20,0,20,209,0.363636364,0.052631579,0.593301435,0,0.018359419
8265,1,21378,6,10,0,0,0,16,3,10,2,10,0,25,nowin,win,dlbust,bust,20,0,16,197,0.406091371,0.025380711,0.649746193,2,0.606186955
8266,106,21378,8,10,0,0,0,18,3,10,2,10,0,25,nowin,win,dlbust,bust,20,0,18,192,0.411458333,0.026041667,0.557291667,0,0.023854304
8267,29,21378,2,7,9,0,0,18,3,10,2,10,0,25,nowin,win,dlbust,bust,20,0,9,189,0.44973545,0.058201058,0.544973545,1,0.300349439
8268,62,21379,10,9,0,0,0,19,10,11,0,0,0,21,nowin,loss,beat,dlwin,0,10,19,178,0.370786517,0.028089888,0.54494382,0,0.008657722
8269,10,21379,2,8,6,6,0,22,10,11,0,0,0,21,nowin,loss,bust,plbust,0,10,10,191,0.413612565,0.057591623,0.596858639,2,0.574087175
8270,33,21379,6,5,10,0,0,21,10,11,0,0,0,21,nowin,push,push,push,10,0,11,192,0.4375,0.057291667,0.625,2,0.616208916
8271,109,21379,5,11,5,0,0,21,10,11,0,0,0,21,nowin,push,push,push,10,0,16,221,0.461538462,0.058823529,0.597285068,3,0.901830309
8272,1,21379,10,7,0,0,0,17,10,11,0,0,0,21,nowin,loss,beat,dlwin,0,10,17,197,0.406091371,0.025380711,0.649746193,2,0.606186955
8273,135,21379,8,2,5,7,0,22,10,11,0,0,0,21,nowin,loss,bust,plbust,0,10,10,179,0.391061453,0.067039106,0.586592179,0,0.024924662
8274,57,21380,10,10,0,0,0,20,9,9,0,0,0,18,nowin,win,plwin,beat,20,0,20,192,0.46875,0.052083333,0.59375,3,0.907001181
8275,54,21380,8,10,0,0,0,18,9,9,0,0,0,18,nowin,push,push,push,10,0,18,185,0.437837838,0.032432432,0.556756757,1,0.29899854
8276,51,21380,10,2,0,3,10,25,9,9,0,0,0,18,nowin,loss,bust,plbust,0,10,12,189,0.529100529,0.068783069,0.608465608,3,0.993665715
8277,2,21380,10,10,0,0,0,20,9,9,0,0,0,18,nowin,win,plwin,beat,20,0,20,200,0.445,0.035,0.64,2,0.633962549
8278,76,21380,1,1,10,9,0,21,9,9,0,0,0,18,nowin,win,plwin,beat,20,0,2,189,0.534391534,0.079365079,0.608465608,3,1
8279,69,21380,10,9,0,0,0,19,9,9,0,0,0,18,nowin,win,plwin,beat,20,0,19,194,0.365979381,0.030927835,0.515463918,0,0
8280,69,21381,6,7,0,0,0,13,4,10,10,0,0,24,nowin,win,dlbust,bust,20,0,13,194,0.365979381,0.030927835,0.515463918,0,0
8281,80,21381,4,6,10,0,0,20,4,10,10,0,0,24,nowin,win,dlbust,bust,20,0,10,186,0.419354839,0.059139785,0.623655914,2,0.59892924
8282,21,21381,2,6,8,0,0,16,4,10,10,0,0,24,nowin,win,dlbust,bust,20,0,8,214,0.359813084,0.042056075,0.626168224,0,0.025263474
8283,24,21381,8,10,0,0,0,18,4,10,10,0,0,24,nowin,win,dlbust,bust,20,0,18,207,0.458937198,0.048309179,0.570048309,1,0.318138014
8284,30,21381,8,10,0,0,0,18,4,10,10,0,0,24,nowin,win,dlbust,bust,20,0,18,206,0.393203883,0.033980583,0.601941748,0,0.029324648
8285,148,21381,10,11,0,0,0,21,4,10,10,0,0,24,win,win,dlbust,bust,25,0,21,204,0.401960784,0.078431373,0.593137255,0,0.029789521
8286,12,21382,10,10,0,0,0,20,11,10,0,0,0,21,nowin,loss,beat,dlwin,0,10,20,189,0.470899471,0.015873016,0.613756614,3,0.929171178
8287,109,21382,10,10,0,0,0,20,11,10,0,0,0,21,nowin,loss,beat,dlwin,0,10,20,221,0.461538462,0.058823529,0.597285068,3,0.901830309
8288,52,21382,2,10,0,10,0,22,11,10,0,0,0,21,nowin,loss,bust,plbust,0,10,12,217,0.414746544,0.02764977,0.599078341,2,0.576736024
8289,107,21382,4,1,10,2,0,17,11,10,0,0,0,21,nowin,loss,beat,dlwin,0,10,5,218,0.444954128,0.073394495,0.600917431,2,0.605210014
8290,93,21382,9,5,0,10,0,24,11,10,0,0,0,21,nowin,loss,bust,plbust,0,10,14,175,0.485714286,0.051428571,0.548571429,1,0.323648091
8291,148,21382,10,8,0,0,0,18,11,10,0,0,0,21,nowin,loss,beat,dlwin,0,10,18,204,0.401960784,0.078431373,0.593137255,0,0.029789521
8292,58,21383,10,6,0,1,0,17,10,3,4,0,0,17,nowin,push,push,push,10,0,16,195,0.430769231,0.041025641,0.584615385,2,0.580497586
8293,28,21383,7,2,9,0,0,18,10,3,4,0,0,17,nowin,win,plwin,beat,20,0,9,199,0.422110553,0.045226131,0.542713568,1,0.282706618
8294,40,21383,3,3,11,0,0,17,10,3,4,0,0,17,nowin,push,push,push,10,0,6,196,0.367346939,0.030612245,0.617346939,0,0.025358183
8295,19,21383,9,9,0,0,0,18,10,3,4,0,0,17,nowin,win,plwin,beat,20,0,18,237,0.41350211,0.054852321,0.628691983,2,0.597373826
8296,94,21383,10,7,0,0,0,17,10,3,4,0,0,17,nowin,push,push,push,10,0,17,183,0.43715847,0.043715847,0.540983607,1,0.290866892
8297,75,21383,11,10,0,0,0,21,10,3,4,0,0,17,win,win,plwin,beat,25,0,21,191,0.418848168,0.052356021,0.570680628,0,0.029344702
8298,32,21384,8,7,0,0,0,15,5,10,5,0,0,20,nowin,loss,beat,dlwin,0,10,15,189,0.391534392,0.037037037,0.53968254,0,0.013579086
8299,53,21384,7,9,0,0,0,16,5,10,5,0,0,20,nowin,loss,beat,dlwin,0,10,16,250,0.372,0.064,0.564,0,0.013687345
8300,39,21384,9,8,0,0,0,17,5,10,5,0,0,20,nowin,loss,beat,dlwin,0,10,17,191,0.429319372,0.062827225,0.57591623,0,0.033760763
8301,72,21384,4,5,4,0,0,13,5,10,5,0,0,20,nowin,loss,beat,dlwin,0,10,9,185,0.394594595,0.032432432,0.508108108,0,0.006763115
8302,132,21384,4,5,7,0,0,16,5,10,5,0,0,20,nowin,loss,beat,dlwin,0,10,9,194,0.412371134,0.036082474,0.649484536,2,0.611633238
8303,2,21384,8,2,11,0,0,21,5,10,5,0,0,20,nowin,win,plwin,beat,20,0,10,200,0.445,0.035,0.64,2,0.633962549
8304,78,21385,5,10,0,0,0,15,6,10,10,0,0,26,nowin,win,dlbust,bust,20,0,15,201,0.517412935,0.034825871,0.587064677,3,0.95871112
8305,69,21385,2,8,4,0,0,14,6,10,10,0,0,26,nowin,win,dlbust,bust,20,0,10,194,0.365979381,0.030927835,0.515463918,0,0
8306,36,21385,9,5,0,0,0,14,6,10,10,0,0,26,nowin,win,dlbust,bust,20,0,14,229,0.445414847,0.056768559,0.655021834,2,0.645370571
8307,79,21385,10,6,0,0,0,16,6,10,10,0,0,26,nowin,win,dlbust,bust,20,0,16,211,0.436018957,0.028436019,0.672985782,2,0.650131054
8308,108,21385,10,2,0,0,0,12,6,10,10,0,0,26,nowin,win,dlbust,bust,20,0,12,193,0.435233161,0.056994819,0.559585492,1,0.298824795
8309,100,21385,10,7,0,0,0,17,6,10,10,0,0,26,nowin,win,dlbust,bust,20,0,17,190,0.452631579,0.036842105,0.594736842,3,0.888671154
8310,115,21386,11,10,0,0,0,21,5,3,10,0,0,18,win,win,plwin,beat,25,0,21,194,0.427835052,0.041237113,0.592783505,2,0.583863602
8311,36,21386,9,11,0,0,0,20,5,3,10,0,0,18,nowin,win,plwin,beat,20,0,20,229,0.445414847,0.056768559,0.655021834,2,0.645370571
8312,128,21386,10,8,0,0,0,18,5,3,10,0,0,18,nowin,push,push,push,10,0,18,227,0.356828194,0.052863436,0.577092511,0,0.012352564
8313,30,21386,2,2,5,7,0,16,5,3,10,0,0,18,nowin,loss,beat,dlwin,0,10,4,206,0.393203883,0.033980583,0.601941748,0,0.029324648
8314,52,21386,11,9,0,0,0,20,5,3,10,0,0,18,nowin,win,plwin,beat,20,0,20,217,0.414746544,0.02764977,0.599078341,2,0.576736024
8315,69,21386,10,10,0,0,0,20,5,3,10,0,0,18,nowin,win,plwin,beat,20,0,20,194,0.365979381,0.030927835,0.515463918,0,0
8316,105,21387,2,9,10,0,0,21,5,1,6,9,0,21,nowin,push,push,push,10,0,11,198,0.414141414,0.070707071,0.590909091,0,0.032889494
8317,30,21387,4,8,0,0,0,12,5,1,6,9,0,21,nowin,loss,beat,dlwin,0,10,12,206,0.393203883,0.033980583,0.601941748,0,0.029324648
8318,81,21387,10,7,0,0,0,17,5,1,6,9,0,21,nowin,loss,beat,dlwin,0,10,17,182,0.395604396,0.043956044,0.60989011,2,0.567491261
8319,1,21387,1,4,10,0,0,15,5,1,6,9,0,21,nowin,loss,beat,dlwin,0,10,5,197,0.406091371,0.025380711,0.649746193,2,0.606186955
8320,87,21387,10,10,0,0,0,20,5,1,6,9,0,21,nowin,loss,beat,dlwin,0,10,20,202,0.405940594,0.054455446,0.628712871,2,0.590599801
8321,74,21387,10,8,0,0,0,18,5,1,6,9,0,21,nowin,loss,beat,dlwin,0,10,18,209,0.411483254,0.04784689,0.531100478,0,0.017448125
8322,27,21388,9,4,0,10,0,23,11,5,3,0,0,19,nowin,loss,bust,plbust,0,10,13,178,0.370786517,0.016853933,0.573033708,0,0.015536309
8323,130,21388,6,7,0,6,0,19,11,5,3,0,0,19,nowin,push,push,push,10,0,13,219,0.410958904,0.03652968,0.566210046,0,0.025888739
8324,1,21388,10,10,0,0,0,20,11,5,3,0,0,19,nowin,win,plwin,beat,20,0,20,197,0.406091371,0.025380711,0.649746193,2,0.606186955
8325,139,21388,10,3,0,9,0,22,11,5,3,0,0,19,nowin,loss,bust,plbust,0,10,13,192,0.380208333,0.036458333,0.59375,0,0.023429169
8326,138,21388,4,1,7,10,0,22,11,5,3,0,0,19,nowin,loss,bust,plbust,0,10,5,190,0.442105263,0.047368421,0.610526316,2,0.609711065
8327,5,21388,4,8,0,7,0,19,11,5,3,0,0,19,nowin,push,push,push,10,0,12,203,0.42364532,0.02955665,0.596059113,2,0.582508076
8328,78,21389,3,11,6,0,0,20,5,9,1,10,0,25,nowin,win,dlbust,bust,20,0,14,201,0.517412935,0.034825871,0.587064677,3,0.95871112
8329,68,21389,11,6,4,0,0,21,5,9,1,10,0,25,nowin,win,dlbust,bust,20,0,17,205,0.434146341,0.029268293,0.6,2,0.59483189
8330,112,21389,3,2,10,0,0,15,5,9,1,10,0,25,nowin,win,dlbust,bust,20,0,5,203,0.448275862,0.054187192,0.600985222,3,0.889576933
8331,55,21389,10,5,0,0,0,15,5,9,1,10,0,25,nowin,win,dlbust,bust,20,0,15,191,0.371727749,0.057591623,0.54973822,0,0.01011347
8332,140,21389,1,6,10,0,0,17,5,9,1,10,0,25,nowin,win,dlbust,bust,20,0,7,210,0.466666667,0.023809524,0.604761905,3,0.915293335
8333,76,21389,6,3,10,0,0,19,5,9,1,10,0,25,nowin,win,dlbust,bust,20,0,9,189,0.534391534,0.079365079,0.608465608,3,1
8334,69,21390,2,10,0,4,0,16,3,9,4,4,0,20,nowin,loss,beat,dlwin,0,10,12,194,0.365979381,0.030927835,0.515463918,0,0
8335,59,21390,10,10,0,0,0,20,3,9,4,4,0,20,nowin,push,push,push,10,0,20,228,0.429824561,0.048245614,0.543859649,1,0.287885446
8336,107,21390,7,6,0,0,0,13,3,9,4,4,0,20,nowin,loss,beat,dlwin,0,10,13,218,0.444954128,0.073394495,0.600917431,2,0.605210014
8337,108,21390,3,10,0,0,0,13,3,9,4,4,0,20,nowin,loss,beat,dlwin,0,10,13,193,0.435233161,0.056994819,0.559585492,1,0.298824795
8338,14,21390,3,10,0,0,0,13,3,9,4,4,0,20,nowin,loss,beat,dlwin,0,10,13,202,0.391089109,0.01980198,0.628712871,2,0.577264877
8339,34,21390,10,9,0,0,0,19,3,9,4,4,0,20,nowin,loss,beat,dlwin,0,10,19,202,0.5,0.079207921,0.618811881,3,0.968961434
8340,35,21391,4,3,10,0,0,17,7,7,9,0,0,23,nowin,win,dlbust,bust,20,0,7,202,0.410891089,0.044554455,0.633663366,2,0.598681573
8341,41,21391,10,5,0,7,0,22,7,7,9,0,0,23,nowin,loss,bust,plbust,0,10,15,192,0.364583333,0.036458333,0.520833333,0,0.00089702
8342,116,21391,10,11,0,0,0,21,7,7,9,0,0,23,win,win,dlbust,bust,25,0,21,195,0.425641026,0.056410256,0.538461538,1,0.28273747
8343,39,21391,7,3,4,5,0,19,7,7,9,0,0,23,nowin,win,dlbust,bust,20,0,10,191,0.429319372,0.062827225,0.57591623,0,0.033760763
8344,89,21391,7,10,0,0,0,17,7,7,9,0,0,23,nowin,win,dlbust,bust,20,0,17,212,0.537735849,0.047169811,0.594339623,3,0.990167191
8345,86,21391,3,10,0,10,0,23,7,7,9,0,0,23,nowin,loss,bust,plbust,0,10,13,196,0.454081633,0.040816327,0.591836735,3,0.887566443
8346,114,21392,10,2,0,4,10,26,10,7,0,0,0,17,nowin,loss,bust,plbust,0,10,12,198,0.47979798,0.025252525,0.611111111,3,0.937232995
8347,12,21392,5,2,7,8,0,22,10,7,0,0,0,17,nowin,loss,bust,plbust,0,10,7,189,0.470899471,0.015873016,0.613756614,3,0.929171178
8348,132,21392,4,5,10,0,0,19,10,7,0,0,0,17,nowin,win,plwin,beat,20,0,9,194,0.412371134,0.036082474,0.649484536,2,0.611633238
8349,131,21392,2,10,0,7,0,19,10,7,0,0,0,17,nowin,win,plwin,beat,20,0,12,217,0.410138249,0.069124424,0.543778802,0,0.02015021
8350,51,21392,10,11,0,0,0,21,10,7,0,0,0,17,win,win,plwin,beat,25,0,21,189,0.529100529,0.068783069,0.608465608,3,0.993665715
8351,42,21392,10,5,0,8,0,23,10,7,0,0,0,17,nowin,loss,bust,plbust,0,10,15,212,0.443396226,0.051886792,0.570754717,1,0.309181312
8352,95,21393,3,5,10,0,0,18,6,10,3,0,0,19,nowin,loss,beat,dlwin,0,10,8,218,0.412844037,0.04587156,0.559633028,0,0.024842385
8353,84,21393,9,10,0,0,0,19,6,10,3,0,0,19,nowin,push,push,push,10,0,19,195,0.379487179,0.056410256,0.569230769,0,0.017209119
8354,55,21393,8,7,0,0,0,15,6,10,3,0,0,19,nowin,loss,beat,dlwin,0,10,15,191,0.371727749,0.057591623,0.54973822,0,0.01011347
8355,138,21393,5,4,6,0,0,15,6,10,3,0,0,19,nowin,loss,beat,dlwin,0,10,9,190,0.442105263,0.047368421,0.610526316,2,0.609711065
8356,131,21393,6,1,10,0,0,17,6,10,3,0,0,19,nowin,loss,beat,dlwin,0,10,7,217,0.410138249,0.069124424,0.543778802,0,0.02015021
8357,118,21393,6,9,0,0,0,15,6,10,3,0,0,19,nowin,loss,beat,dlwin,0,10,15,216,0.393518519,0.037037037,0.555555556,0,0.018059873
8358,96,21394,7,10,0,0,0,17,11,8,0,0,0,19,nowin,loss,beat,dlwin,0,10,17,190,0.468421053,0.057894737,0.584210526,3,0.897263354
8359,104,21394,1,5,10,8,0,24,11,8,0,0,0,19,nowin,loss,bust,plbust,0,10,6,209,0.363636364,0.052631579,0.593301435,0,0.018359419
8360,48,21394,10,5,0,10,0,25,11,8,0,0,0,19,nowin,loss,bust,plbust,0,10,15,203,0.413793103,0.019704433,0.600985222,2,0.577280801
8361,102,21394,9,2,10,0,0,21,11,8,0,0,0,19,nowin,win,plwin,beat,20,0,11,192,0.338541667,0.046875,0.5625,0,0.003306118
8362,40,21394,7,5,0,10,0,22,11,8,0,0,0,19,nowin,loss,bust,plbust,0,10,12,196,0.367346939,0.030612245,0.617346939,0,0.025358183
8363,59,21394,5,3,9,0,0,17,11,8,0,0,0,19,nowin,loss,beat,dlwin,0,10,8,228,0.429824561,0.048245614,0.543859649,1,0.287885446
8364,42,21395,4,8,0,0,0,12,6,8,7,0,0,21,nowin,loss,beat,dlwin,0,10,12,212,0.443396226,0.051886792,0.570754717,1,0.309181312
8365,150,21395,7,10,0,0,0,17,6,8,7,0,0,21,nowin,loss,beat,dlwin,0,10,17,192,0.401041667,0.036458333,0.567708333,0,0.023287458
8366,132,21395,8,10,0,0,0,18,6,8,7,0,0,21,nowin,loss,beat,dlwin,0,10,18,194,0.412371134,0.036082474,0.649484536,2,0.611633238
8367,122,21395,10,11,0,0,0,21,6,8,7,0,0,21,win,push,push,push,10,0,21,210,0.347619048,0.052380952,0.59047619,0,0.012873677
8368,126,21395,10,10,0,0,0,20,6,8,7,0,0,21,nowin,loss,beat,dlwin,0,10,20,188,0.457446809,0.074468085,0.60106383,3,0.900633203
8369,125,21395,2,10,0,0,0,12,6,8,7,0,0,21,nowin,loss,beat,dlwin,0,10,12,219,0.438356164,0.050228311,0.575342466,1,0.308411257
8370,16,21396,3,2,9,5,0,19,7,3,9,0,0,19,nowin,push,push,push,10,0,5,220,0.427272727,0.081818182,0.6,2,0.588660176
8371,132,21396,5,2,6,5,0,18,7,3,9,0,0,19,nowin,loss,beat,dlwin,0,10,7,194,0.412371134,0.036082474,0.649484536,2,0.611633238
8372,13,21396,8,2,10,0,0,20,7,3,9,0,0,19,nowin,win,plwin,beat,20,0,10,206,0.417475728,0.063106796,0.621359223,2,0.59555479
8373,88,21396,10,11,0,0,0,21,7,3,9,0,0,19,win,win,plwin,beat,25,0,21,206,0.466019417,0.033980583,0.54368932,1,0.309467903
8374,140,21396,10,11,0,0,0,21,7,3,9,0,0,19,win,win,plwin,beat,25,0,21,210,0.466666667,0.023809524,0.604761905,3,0.915293335
8375,132,21396,3,10,0,7,0,20,7,3,9,0,0,19,nowin,win,plwin,beat,20,0,13,194,0.412371134,0.036082474,0.649484536,2,0.611633238
8376,29,21397,8,10,0,0,0,18,6,11,0,0,0,17,nowin,win,plwin,beat,20,0,18,189,0.44973545,0.058201058,0.544973545,1,0.300349439
8377,92,21397,2,11,4,0,0,17,6,11,0,0,0,17,nowin,push,push,push,10,0,13,186,0.446236559,0.059139785,0.564516129,1,0.307826125
8378,84,21397,8,11,0,0,0,19,6,11,0,0,0,17,nowin,win,plwin,beat,20,0,19,195,0.379487179,0.056410256,0.569230769,0,0.017209119
8379,10,21397,10,4,0,0,0,14,6,11,0,0,0,17,nowin,loss,beat,dlwin,0,10,14,191,0.413612565,0.057591623,0.596858639,2,0.574087175
8380,1,21397,11,1,5,0,0,17,6,11,0,0,0,17,nowin,push,push,push,10,0,12,197,0.406091371,0.025380711,0.649746193,2,0.606186955
8381,9,21397,4,10,0,0,0,14,6,11,0,0,0,17,nowin,loss,beat,dlwin,0,10,14,194,0.37628866,0.015463918,0.541237113,0,0.009396796
8382,103,21398,2,10,0,0,0,12,4,5,10,0,0,19,nowin,loss,beat,dlwin,0,10,12,203,0.379310345,0.064039409,0.551724138,0,0.012869209
8383,90,21398,11,3,6,0,0,20,4,5,10,0,0,19,nowin,win,plwin,beat,20,0,14,201,0.447761194,0.049751244,0.60199005,3,0.889945023
8384,71,21398,5,6,5,0,0,16,4,5,10,0,0,19,nowin,loss,beat,dlwin,0,10,11,193,0.352331606,0.046632124,0.585492228,0,0.013063661
8385,94,21398,10,10,0,0,0,20,4,5,10,0,0,19,nowin,win,plwin,beat,20,0,20,183,0.43715847,0.043715847,0.540983607,1,0.290866892
8386,75,21398,10,4,0,0,0,14,4,5,10,0,0,19,nowin,loss,beat,dlwin,0,10,14,191,0.418848168,0.052356021,0.570680628,0,0.029344702
8387,4,21398,6,10,0,0,0,16,4,5,10,0,0,19,nowin,loss,beat,dlwin,0,10,16,217,0.460829493,0.036866359,0.562211982,1,0.315432839
8388,84,21399,10,6,0,0,0,16,2,6,7,1,10,26,nowin,win,dlbust,bust,20,0,16,195,0.379487179,0.056410256,0.569230769,0,0.017209119
8389,115,21399,10,10,0,0,0,20,2,6,7,1,10,26,nowin,win,dlbust,bust,20,0,20,194,0.427835052,0.041237113,0.592783505,2,0.583863602
8390,66,21399,5,10,0,0,0,15,2,6,7,1,10,26,nowin,win,dlbust,bust,20,0,15,217,0.456221198,0.064516129,0.626728111,3,0.924304367
8391,41,21399,6,1,8,0,0,15,2,6,7,1,10,26,nowin,win,dlbust,bust,20,0,7,192,0.364583333,0.036458333,0.520833333,0,0.00089702
8392,45,21399,8,10,0,0,0,18,2,6,7,1,10,26,nowin,win,dlbust,bust,20,0,18,196,0.428571429,0.051020408,0.612244898,2,0.598821767
8393,38,21399,6,10,0,0,0,16,2,6,7,1,10,26,nowin,win,dlbust,bust,20,0,16,202,0.361386139,0.03960396,0.564356436,0,0.010597953
8394,73,21400,8,8,0,0,0,16,6,5,10,0,0,21,nowin,loss,beat,dlwin,0,10,16,181,0.375690608,0.011049724,0.596685083,0,0.022795773
8395,122,21400,7,10,0,0,0,17,6,5,10,0,0,21,nowin,loss,beat,dlwin,0,10,17,210,0.347619048,0.052380952,0.59047619,0,0.012873677
8396,135,21400,3,9,0,0,0,12,6,5,10,0,0,21,nowin,loss,beat,dlwin,0,10,12,179,0.391061453,0.067039106,0.586592179,0,0.024924662
8397,122,21400,7,10,0,0,0,17,6,5,10,0,0,21,nowin,loss,beat,dlwin,0,10,17,210,0.347619048,0.052380952,0.59047619,0,0.012873677
8398,8,21400,1,4,8,0,0,13,6,5,10,0,0,21,nowin,loss,beat,dlwin,0,10,5,181,0.44198895,0.071823204,0.596685083,2,0.599438402
8399,148,21400,3,8,1,0,0,12,6,5,10,0,0,21,nowin,loss,beat,dlwin,0,10,11,204,0.401960784,0.078431373,0.593137255,0,0.029789521
8400,78,21401,9,9,0,0,0,18,7,7,9,0,0,23,nowin,win,dlbust,bust,20,0,18,201,0.517412935,0.034825871,0.587064677,3,0.95871112
8401,46,21401,6,4,9,0,0,19,7,7,9,0,0,23,nowin,win,dlbust,bust,20,0,10,186,0.403225806,0.048387097,0.591397849,0,0.029742194
8402,50,21401,11,3,6,0,0,20,7,7,9,0,0,23,nowin,win,dlbust,bust,20,0,14,202,0.405940594,0.04950495,0.54950495,0,0.020296079
8403,111,21401,4,6,10,0,0,20,7,7,9,0,0,23,nowin,win,dlbust,bust,20,0,10,180,0.433333333,0.055555556,0.611111111,2,0.602264492
8404,86,21401,9,7,0,6,0,22,7,7,9,0,0,23,nowin,loss,bust,plbust,0,10,16,196,0.454081633,0.040816327,0.591836735,3,0.887566443
8405,140,21401,11,1,3,6,0,21,7,7,9,0,0,23,nowin,win,dlbust,bust,20,0,12,210,0.466666667,0.023809524,0.604761905,3,0.915293335
8406,89,21402,10,2,0,0,0,12,5,9,10,0,0,24,nowin,win,dlbust,bust,20,0,12,212,0.537735849,0.047169811,0.594339623,3,0.990167191
8407,148,21402,4,1,8,0,0,13,5,9,10,0,0,24,nowin,win,dlbust,bust,20,0,5,204,0.401960784,0.078431373,0.593137255,0,0.029789521
8408,62,21402,6,10,0,0,0,16,5,9,10,0,0,24,nowin,win,dlbust,bust,20,0,16,178,0.370786517,0.028089888,0.54494382,0,0.008657722
8409,140,21402,4,2,6,0,0,12,5,9,10,0,0,24,nowin,win,dlbust,bust,20,0,6,210,0.466666667,0.023809524,0.604761905,3,0.915293335
8410,117,21402,10,3,0,0,0,13,5,9,10,0,0,24,nowin,win,dlbust,bust,20,0,13,173,0.410404624,0.069364162,0.606936416,2,0.578610282
8411,54,21402,5,10,0,0,0,15,5,9,10,0,0,24,nowin,win,dlbust,bust,20,0,15,185,0.437837838,0.032432432,0.556756757,1,0.29899854
8412,46,21403,9,10,0,0,0,19,7,11,0,0,0,18,nowin,win,plwin,beat,20,0,19,186,0.403225806,0.048387097,0.591397849,0,0.029742194
8413,84,21403,10,10,0,0,0,20,7,11,0,0,0,18,nowin,win,plwin,beat,20,0,20,195,0.379487179,0.056410256,0.569230769,0,0.017209119
8414,27,21403,9,11,0,0,0,20,7,11,0,0,0,18,nowin,win,plwin,beat,20,0,20,178,0.370786517,0.016853933,0.573033708,0,0.015536309
8415,72,21403,5,7,0,2,7,21,7,11,0,0,0,18,nowin,win,plwin,beat,20,0,12,185,0.394594595,0.032432432,0.508108108,0,0.006763115
8416,5,21403,10,11,0,0,0,21,7,11,0,0,0,18,win,win,plwin,beat,25,0,21,203,0.42364532,0.02955665,0.596059113,2,0.582508076
8417,86,21403,6,8,0,1,10,25,7,11,0,0,0,18,nowin,loss,bust,plbust,0,10,14,196,0.454081633,0.040816327,0.591836735,3,0.887566443
8418,52,21404,2,9,8,0,0,19,8,10,0,0,0,18,nowin,win,plwin,beat,20,0,11,217,0.414746544,0.02764977,0.599078341,2,0.576736024
8419,47,21404,8,10,0,0,0,18,8,10,0,0,0,18,nowin,push,push,push,10,0,18,210,0.438095238,0.057142857,0.623809524,2,0.615868808
8420,100,21404,10,10,0,0,0,20,8,10,0,0,0,18,nowin,win,plwin,beat,20,0,20,190,0.452631579,0.036842105,0.594736842,3,0.888671154
8421,40,21404,10,6,0,10,0,26,8,10,0,0,0,18,nowin,loss,bust,plbust,0,10,16,196,0.367346939,0.030612245,0.617346939,0,0.025358183
8422,14,21404,10,7,0,0,0,17,8,10,0,0,0,18,nowin,loss,beat,dlwin,0,10,17,202,0.391089109,0.01980198,0.628712871,2,0.577264877
8423,46,21404,3,10,0,7,0,20,8,10,0,0,0,18,nowin,win,plwin,beat,20,0,13,186,0.403225806,0.048387097,0.591397849,0,0.029742194
8424,86,21405,9,5,0,0,0,14,6,6,10,0,0,22,nowin,win,dlbust,bust,20,0,14,196,0.454081633,0.040816327,0.591836735,3,0.887566443
8425,34,21405,10,10,0,0,0,20,6,6,10,0,0,22,nowin,win,dlbust,bust,20,0,20,202,0.5,0.079207921,0.618811881,3,0.968961434
8426,69,21405,3,6,5,0,0,14,6,6,10,0,0,22,nowin,win,dlbust,bust,20,0,9,194,0.365979381,0.030927835,0.515463918,0,0
8427,108,21405,10,10,0,0,0,20,6,6,10,0,0,22,nowin,win,dlbust,bust,20,0,20,193,0.435233161,0.056994819,0.559585492,1,0.298824795
8428,142,21405,10,5,0,0,0,15,6,6,10,0,0,22,nowin,win,dlbust,bust,20,0,15,211,0.417061611,0.047393365,0.526066351,1,0.271531309
8429,45,21405,2,9,7,0,0,18,6,6,10,0,0,22,nowin,win,dlbust,bust,20,0,11,196,0.428571429,0.051020408,0.612244898,2,0.598821767
8430,123,21406,10,3,0,4,0,17,7,10,0,0,0,17,nowin,push,push,push,10,0,13,205,0.43902439,0.034146341,0.614634146,2,0.609962544
8431,66,21406,3,1,9,1,1,15,7,10,0,0,0,17,nowin,loss,beat,dlwin,0,10,4,217,0.456221198,0.064516129,0.626728111,3,0.924304367
8432,26,21406,10,11,0,0,0,21,7,10,0,0,0,17,win,win,plwin,beat,25,0,21,203,0.463054187,0.0591133,0.541871921,1,0.306802864
8433,100,21406,7,3,4,4,0,18,7,10,0,0,0,17,nowin,win,plwin,beat,20,0,10,190,0.452631579,0.036842105,0.594736842,3,0.888671154
8434,132,21406,7,5,0,10,0,22,7,10,0,0,0,17,nowin,loss,bust,plbust,0,10,12,194,0.412371134,0.036082474,0.649484536,2,0.611633238
8435,85,21406,10,9,0,0,0,19,7,10,0,0,0,17,nowin,win,plwin,beat,20,0,19,195,0.41025641,0.066666667,0.594871795,0,0.03269711
8436,85,21407,7,10,0,0,0,17,10,10,0,0,0,20,nowin,loss,beat,dlwin,0,10,17,195,0.41025641,0.066666667,0.594871795,0,0.03269711
8437,101,21407,10,11,0,0,0,21,10,10,0,0,0,20,win,win,plwin,beat,25,0,21,205,0.424390244,0.068292683,0.63902439,2,0.614740646
8438,13,21407,8,5,0,10,0,23,10,10,0,0,0,20,nowin,loss,bust,plbust,0,10,13,206,0.417475728,0.063106796,0.621359223,2,0.59555479
8439,141,21407,10,4,0,7,0,21,10,10,0,0,0,20,nowin,win,plwin,beat,20,0,14,202,0.420792079,0.074257426,0.564356436,0,0.028377851
8440,90,21407,5,9,0,10,0,24,10,10,0,0,0,20,nowin,loss,bust,plbust,0,10,14,201,0.447761194,0.049751244,0.60199005,3,0.889945023
8441,18,21407,7,10,0,0,0,17,10,10,0,0,0,20,nowin,loss,beat,dlwin,0,10,17,182,0.461538462,0.043956044,0.587912088,3,0.892649374
8442,58,21408,10,4,0,10,0,24,7,11,0,0,0,18,nowin,loss,bust,plbust,0,10,14,195,0.430769231,0.041025641,0.584615385,2,0.580497586
8443,14,21408,11,7,0,0,0,18,7,11,0,0,0,18,nowin,push,push,push,10,0,18,202,0.391089109,0.01980198,0.628712871,2,0.577264877
8444,116,21408,6,8,0,5,0,19,7,11,0,0,0,18,nowin,win,plwin,beat,20,0,14,195,0.425641026,0.056410256,0.538461538,1,0.28273747
8445,128,21408,10,5,0,10,0,25,7,11,0,0,0,18,nowin,loss,bust,plbust,0,10,15,227,0.356828194,0.052863436,0.577092511,0,0.012352564
8446,70,21408,10,5,0,4,0,19,7,11,0,0,0,18,nowin,win,plwin,beat,20,0,15,228,0.385964912,0.039473684,0.557017544,0,0.016157125
8447,146,21408,10,9,0,0,0,19,7,11,0,0,0,18,nowin,win,plwin,beat,20,0,19,221,0.43438914,0.040723982,0.542986425,1,0.290190091
8448,131,21409,11,10,0,0,0,21,5,4,10,0,0,19,win,win,plwin,beat,25,0,21,217,0.410138249,0.069124424,0.543778802,0,0.02015021
8449,76,21409,10,11,0,0,0,21,5,4,10,0,0,19,win,win,plwin,beat,25,0,21,189,0.534391534,0.079365079,0.608465608,3,1
8450,55,21409,6,10,0,0,0,16,5,4,10,0,0,19,nowin,loss,beat,dlwin,0,10,16,191,0.371727749,0.057591623,0.54973822,0,0.01011347
8451,67,21409,5,3,10,0,0,18,5,4,10,0,0,19,nowin,loss,beat,dlwin,0,10,8,195,0.369230769,0.041025641,0.569230769,0,0.014139427
8452,140,21409,10,10,0,0,0,20,5,4,10,0,0,19,nowin,win,plwin,beat,20,0,20,210,0.466666667,0.023809524,0.604761905,3,0.915293335
8453,109,21409,4,10,0,0,0,14,5,4,10,0,0,19,nowin,loss,beat,dlwin,0,10,14,221,0.461538462,0.058823529,0.597285068,3,0.901830309
8454,130,21410,7,8,0,0,0,15,2,10,3,9,0,24,nowin,win,dlbust,bust,20,0,15,219,0.410958904,0.03652968,0.566210046,0,0.025888739
8455,21,21410,7,4,7,0,0,18,2,10,3,9,0,24,nowin,win,dlbust,bust,20,0,11,214,0.359813084,0.042056075,0.626168224,0,0.025263474
8456,128,21410,9,7,0,0,0,16,2,10,3,9,0,24,nowin,win,dlbust,bust,20,0,16,227,0.356828194,0.052863436,0.577092511,0,0.012352564
8457,137,21410,7,3,10,0,0,20,2,10,3,9,0,24,nowin,win,dlbust,bust,20,0,10,194,0.417525773,0.046391753,0.536082474,1,0.276714602
8458,93,21410,4,6,4,0,0,14,2,10,3,9,0,24,nowin,win,dlbust,bust,20,0,10,175,0.485714286,0.051428571,0.548571429,1,0.323648091
8459,123,21410,10,4,0,0,0,14,2,10,3,9,0,24,nowin,win,dlbust,bust,20,0,14,205,0.43902439,0.034146341,0.614634146,2,0.609962544
8460,14,21411,1,6,5,0,0,12,5,10,10,0,0,25,nowin,win,dlbust,bust,20,0,7,202,0.391089109,0.01980198,0.628712871,2,0.577264877
8461,52,21411,10,5,0,0,0,15,5,10,10,0,0,25,nowin,win,dlbust,bust,20,0,15,217,0.414746544,0.02764977,0.599078341,2,0.576736024
8462,105,21411,2,7,10,0,0,19,5,10,10,0,0,25,nowin,win,dlbust,bust,20,0,9,198,0.414141414,0.070707071,0.590909091,0,0.032889494
8463,149,21411,4,11,2,0,0,17,5,10,10,0,0,25,nowin,win,dlbust,bust,20,0,15,225,0.457777778,0.057777778,0.648888889,2,0.651965595
8464,135,21411,7,11,0,0,0,18,5,10,10,0,0,25,nowin,win,dlbust,bust,20,0,18,179,0.391061453,0.067039106,0.586592179,0,0.024924662
8465,93,21411,9,7,0,0,0,16,5,10,10,0,0,25,nowin,win,dlbust,bust,20,0,16,175,0.485714286,0.051428571,0.548571429,1,0.323648091
8466,26,21412,10,9,0,0,0,19,10,7,0,0,0,17,nowin,win,plwin,beat,20,0,19,203,0.463054187,0.0591133,0.541871921,1,0.306802864
8467,21,21412,3,6,4,1,4,18,10,7,0,0,0,17,nowin,win,plwin,beat,20,0,9,214,0.359813084,0.042056075,0.626168224,0,0.025263474
8468,93,21412,10,9,0,0,0,19,10,7,0,0,0,17,nowin,win,plwin,beat,20,0,19,175,0.485714286,0.051428571,0.548571429,1,0.323648091
8469,74,21412,6,7,0,10,0,23,10,7,0,0,0,17,nowin,loss,bust,plbust,0,10,13,209,0.411483254,0.04784689,0.531100478,0,0.017448125
8470,132,21412,7,9,0,10,0,26,10,7,0,0,0,17,nowin,loss,bust,plbust,0,10,16,194,0.412371134,0.036082474,0.649484536,2,0.611633238
8471,106,21412,1,4,10,10,0,25,10,7,0,0,0,17,nowin,loss,bust,plbust,0,10,5,192,0.411458333,0.026041667,0.557291667,0,0.023854304
8472,26,21413,5,1,10,8,0,24,10,3,9,0,0,22,nowin,loss,bust,plbust,0,10,6,203,0.463054187,0.0591133,0.541871921,1,0.306802864
8473,64,21413,7,2,5,10,0,24,10,3,9,0,0,22,nowin,loss,bust,plbust,0,10,9,187,0.363636364,0.048128342,0.631016043,0,0.027594885
8474,16,21413,2,10,0,10,0,22,10,3,9,0,0,22,nowin,loss,bust,plbust,0,10,12,220,0.427272727,0.081818182,0.6,2,0.588660176
8475,147,21413,10,10,0,0,0,20,10,3,9,0,0,22,nowin,win,dlbust,bust,20,0,20,205,0.380487805,0.014634146,0.536585366,0,0.00951447
8476,139,21413,10,10,0,0,0,20,10,3,9,0,0,22,nowin,win,dlbust,bust,20,0,20,192,0.380208333,0.036458333,0.59375,0,0.023429169
8477,16,21413,10,10,0,0,0,20,10,3,9,0,0,22,nowin,win,dlbust,bust,20,0,20,220,0.427272727,0.081818182,0.6,2,0.588660176
8478,22,21414,6,8,0,10,0,24,10,10,0,0,0,20,nowin,loss,bust,plbust,0,10,14,187,0.481283422,0.042780749,0.577540107,3,0.906128176
8479,111,21414,3,7,9,0,0,19,10,10,0,0,0,20,nowin,loss,beat,dlwin,0,10,10,180,0.433333333,0.055555556,0.611111111,2,0.602264492
8480,7,21414,1,4,10,4,0,19,10,10,0,0,0,20,nowin,loss,beat,dlwin,0,10,5,183,0.442622951,0.06010929,0.62295082,2,0.619303341
8481,21,21414,8,8,0,10,0,26,10,10,0,0,0,20,nowin,loss,bust,plbust,0,10,16,214,0.359813084,0.042056075,0.626168224,0,0.025263474
8482,140,21414,10,11,0,0,0,21,10,10,0,0,0,20,win,win,plwin,beat,25,0,21,210,0.466666667,0.023809524,0.604761905,3,0.915293335
8483,18,21414,5,10,0,8,0,23,10,10,0,0,0,20,nowin,loss,bust,plbust,0,10,15,182,0.461538462,0.043956044,0.587912088,3,0.892649374
8484,30,21415,11,7,0,0,0,18,8,7,4,0,0,19,nowin,loss,beat,dlwin,0,10,18,206,0.393203883,0.033980583,0.601941748,0,0.029324648
8485,27,21415,8,3,10,0,0,21,8,7,4,0,0,19,nowin,win,plwin,beat,20,0,11,178,0.370786517,0.016853933,0.573033708,0,0.015536309
8486,139,21415,10,6,0,10,0,26,8,7,4,0,0,19,nowin,loss,bust,plbust,0,10,16,192,0.380208333,0.036458333,0.59375,0,0.023429169
8487,40,21415,10,10,0,0,0,20,8,7,4,0,0,19,nowin,win,plwin,beat,20,0,20,196,0.367346939,0.030612245,0.617346939,0,0.025358183
8488,88,21415,10,3,0,3,10,26,8,7,4,0,0,19,nowin,loss,bust,plbust,0,10,13,206,0.466019417,0.033980583,0.54368932,1,0.309467903
8489,128,21415,6,10,0,5,0,21,8,7,4,0,0,19,nowin,win,plwin,beat,20,0,16,227,0.356828194,0.052863436,0.577092511,0,0.012352564
8490,30,21416,4,9,0,0,0,13,5,10,10,0,0,25,nowin,win,dlbust,bust,20,0,13,206,0.393203883,0.033980583,0.601941748,0,0.029324648
8491,67,21416,2,5,2,10,0,19,5,10,10,0,0,25,nowin,win,dlbust,bust,20,0,7,195,0.369230769,0.041025641,0.569230769,0,0.014139427
8492,65,21416,10,6,0,0,0,16,5,10,10,0,0,25,nowin,win,dlbust,bust,20,0,16,203,0.492610837,0.054187192,0.571428571,3,0.913702814
8493,50,21416,11,10,0,0,0,21,5,10,10,0,0,25,win,win,dlbust,bust,25,0,21,202,0.405940594,0.04950495,0.54950495,0,0.020296079
8494,6,21416,6,10,0,0,0,16,5,10,10,0,0,25,nowin,win,dlbust,bust,20,0,16,191,0.439790576,0.047120419,0.581151832,1,0.31211505
8495,4,21416,10,10,0,0,0,20,5,10,10,0,0,25,nowin,win,dlbust,bust,20,0,20,217,0.460829493,0.036866359,0.562211982,1,0.315432839
8496,40,21417,7,10,0,0,0,17,10,7,0,0,0,17,nowin,push,push,push,10,0,17,196,0.367346939,0.030612245,0.617346939,0,0.025358183
8497,27,21417,6,3,2,7,0,18,10,7,0,0,0,17,nowin,win,plwin,beat,20,0,9,178,0.370786517,0.016853933,0.573033708,0,0.015536309
8498,142,21417,9,7,0,10,0,26,10,7,0,0,0,17,nowin,loss,bust,plbust,0,10,16,211,0.417061611,0.047393365,0.526066351,1,0.271531309
8499,143,21417,4,7,6,0,0,17,10,7,0,0,0,17,nowin,push,push,push,10,0,11,203,0.463054187,0.044334975,0.57635468,3,0.883143365
8500,65,21417,11,4,5,0,0,20,10,7,0,0,0,17,nowin,win,plwin,beat,20,0,15,203,0.492610837,0.054187192,0.571428571,3,0.913702814
8501,127,21417,5,11,2,0,0,18,10,7,0,0,0,17,nowin,win,plwin,beat,20,0,16,201,0.402985075,0.029850746,0.60199005,0,0.032263937
8502,129,21418,10,5,0,9,0,24,10,3,2,7,0,22,nowin,loss,bust,plbust,0,10,15,201,0.422885572,0.064676617,0.55721393,0,0.027255383
8503,137,21418,7,7,0,7,0,21,10,3,2,7,0,22,nowin,win,dlbust,bust,20,0,14,194,0.417525773,0.046391753,0.536082474,1,0.276714602
8504,2,21418,3,10,0,4,0,17,10,3,2,7,0,22,nowin,win,dlbust,bust,20,0,13,200,0.445,0.035,0.64,2,0.633962549
8505,146,21418,10,10,0,0,0,20,10,3,2,7,0,22,nowin,win,dlbust,bust,20,0,20,221,0.43438914,0.040723982,0.542986425,1,0.290190091
8506,55,21418,10,7,0,0,0,17,10,3,2,7,0,22,nowin,win,dlbust,bust,20,0,17,191,0.371727749,0.057591623,0.54973822,0,0.01011347
8507,38,21418,4,2,4,1,5,16,10,3,2,7,0,22,nowin,win,dlbust,bust,20,0,6,202,0.361386139,0.03960396,0.564356436,0,0.010597953
8508,41,21419,10,8,0,0,0,18,4,6,4,4,0,18,nowin,push,push,push,10,0,18,192,0.364583333,0.036458333,0.520833333,0,0.00089702
8509,53,21419,11,8,0,0,0,19,4,6,4,4,0,18,nowin,win,plwin,beat,20,0,19,250,0.372,0.064,0.564,0,0.013687345
8510,131,21419,9,6,0,0,0,15,4,6,4,4,0,18,nowin,loss,beat,dlwin,0,10,15,217,0.410138249,0.069124424,0.543778802,0,0.02015021
8511,117,21419,5,7,0,0,0,12,4,6,4,4,0,18,nowin,loss,beat,dlwin,0,10,12,173,0.410404624,0.069364162,0.606936416,2,0.578610282
8512,7,21419,10,10,0,0,0,20,4,6,4,4,0,18,nowin,win,plwin,beat,20,0,20,183,0.442622951,0.06010929,0.62295082,2,0.619303341
8513,56,21419,2,2,3,9,0,16,4,6,4,4,0,18,nowin,loss,beat,dlwin,0,10,4,175,0.4,0.057142857,0.582857143,0,0.026685297
8514,142,21420,2,2,3,5,0,12,4,6,9,0,0,19,nowin,loss,beat,dlwin,0,10,4,211,0.417061611,0.047393365,0.526066351,1,0.271531309
8515,65,21420,6,10,0,0,0,16,4,6,9,0,0,19,nowin,loss,beat,dlwin,0,10,16,203,0.492610837,0.054187192,0.571428571,3,0.913702814
8516,98,21420,10,9,0,0,0,19,4,6,9,0,0,19,nowin,push,push,push,10,0,19,220,0.422727273,0.054545455,0.55,1,0.28664435
8517,107,21420,8,5,0,0,0,13,4,6,9,0,0,19,nowin,loss,beat,dlwin,0,10,13,218,0.444954128,0.073394495,0.600917431,2,0.605210014
8518,137,21420,10,4,0,0,0,14,4,6,9,0,0,19,nowin,loss,beat,dlwin,0,10,14,194,0.417525773,0.046391753,0.536082474,1,0.276714602
8519,37,21420,7,7,0,0,0,14,4,6,9,0,0,19,nowin,loss,beat,dlwin,0,10,14,208,0.394230769,0.038461538,0.581730769,0,0.024682772
8520,141,21421,8,4,0,7,0,19,9,4,5,0,0,18,nowin,win,plwin,beat,20,0,12,202,0.420792079,0.074257426,0.564356436,0,0.028377851
8521,66,21421,10,4,0,10,0,24,9,4,5,0,0,18,nowin,loss,bust,plbust,0,10,14,217,0.456221198,0.064516129,0.626728111,3,0.924304367
8522,58,21421,10,8,0,0,0,18,9,4,5,0,0,18,nowin,push,push,push,10,0,18,195,0.430769231,0.041025641,0.584615385,2,0.580497586
8523,95,21421,3,6,4,10,0,23,9,4,5,0,0,18,nowin,loss,bust,plbust,0,10,9,218,0.412844037,0.04587156,0.559633028,0,0.024842385
8524,56,21421,7,5,0,10,0,22,9,4,5,0,0,18,nowin,loss,bust,plbust,0,10,12,175,0.4,0.057142857,0.582857143,0,0.026685297
8525,73,21421,10,2,0,2,10,24,9,4,5,0,0,18,nowin,loss,bust,plbust,0,10,12,181,0.375690608,0.011049724,0.596685083,0,0.022795773
8526,124,21422,10,6,0,4,0,20,10,10,0,0,0,20,nowin,push,push,push,10,0,16,202,0.47029703,0.064356436,0.584158416,3,0.899458193
8527,132,21422,4,1,8,2,8,23,10,10,0,0,0,20,nowin,loss,bust,plbust,0,10,5,194,0.412371134,0.036082474,0.649484536,2,0.611633238
8528,138,21422,10,9,0,0,0,19,10,10,0,0,0,20,nowin,loss,beat,dlwin,0,10,19,190,0.442105263,0.047368421,0.610526316,2,0.609711065
8529,87,21422,7,8,0,10,0,25,10,10,0,0,0,20,nowin,loss,bust,plbust,0,10,15,202,0.405940594,0.054455446,0.628712871,2,0.590599801
8530,107,21422,2,3,7,10,0,22,10,10,0,0,0,20,nowin,loss,bust,plbust,0,10,5,218,0.444954128,0.073394495,0.600917431,2,0.605210014
8531,89,21422,4,4,8,5,0,21,10,10,0,0,0,20,nowin,win,plwin,beat,20,0,8,212,0.537735849,0.047169811,0.594339623,3,0.990167191
8532,71,21423,7,3,8,0,0,18,10,10,0,0,0,20,nowin,loss,beat,dlwin,0,10,10,193,0.352331606,0.046632124,0.585492228,0,0.013063661
8533,13,21423,6,2,4,10,0,22,10,10,0,0,0,20,nowin,loss,bust,plbust,0,10,8,206,0.417475728,0.063106796,0.621359223,2,0.59555479
8534,31,21423,10,6,0,9,0,25,10,10,0,0,0,20,nowin,loss,bust,plbust,0,10,16,188,0.473404255,0.058510638,0.515957447,1,0.300306557
8535,50,21423,9,10,0,0,0,19,10,10,0,0,0,20,nowin,loss,beat,dlwin,0,10,19,202,0.405940594,0.04950495,0.54950495,0,0.020296079
8536,2,21423,5,11,2,0,0,18,10,10,0,0,0,20,nowin,loss,beat,dlwin,0,10,16,200,0.445,0.035,0.64,2,0.633962549
8537,91,21423,5,9,0,7,0,21,10,10,0,0,0,20,nowin,win,plwin,beat,20,0,14,194,0.417525773,0.046391753,0.515463918,1,0.266616552
8538,11,21424,10,10,0,0,0,20,9,10,0,0,0,19,nowin,win,plwin,beat,20,0,20,236,0.457627119,0.016949153,0.588983051,3,0.889015813
8539,71,21424,6,8,0,8,0,22,9,10,0,0,0,19,nowin,loss,bust,plbust,0,10,14,193,0.352331606,0.046632124,0.585492228,0,0.013063661
8540,118,21424,9,8,0,0,0,17,9,10,0,0,0,19,nowin,loss,beat,dlwin,0,10,17,216,0.393518519,0.037037037,0.555555556,0,0.018059873
8541,4,21424,9,7,0,8,0,24,9,10,0,0,0,19,nowin,loss,bust,plbust,0,10,16,217,0.460829493,0.036866359,0.562211982,1,0.315432839
8542,93,21424,5,10,0,10,0,25,9,10,0,0,0,19,nowin,loss,bust,plbust,0,10,15,175,0.485714286,0.051428571,0.548571429,1,0.323648091
8543,47,21424,7,10,0,0,0,17,9,10,0,0,0,19,nowin,loss,beat,dlwin,0,10,17,210,0.438095238,0.057142857,0.623809524,2,0.615868808
8544,61,21425,2,10,0,5,0,17,10,2,5,0,0,17,nowin,push,push,push,10,0,12,194,0.427835052,0.077319588,0.603092784,2,0.591437139
8545,136,21425,10,10,0,0,0,20,10,2,5,0,0,17,nowin,win,plwin,beat,20,0,20,194,0.396907216,0.025773196,0.597938144,0,0.029452644
8546,50,21425,11,6,2,0,0,19,10,2,5,0,0,17,nowin,win,plwin,beat,20,0,17,202,0.405940594,0.04950495,0.54950495,0,0.020296079
8547,149,21425,8,6,0,2,7,23,10,2,5,0,0,17,nowin,loss,bust,plbust,0,10,14,225,0.457777778,0.057777778,0.648888889,2,0.651965595
8548,68,21425,10,5,0,5,0,20,10,2,5,0,0,17,nowin,win,plwin,beat,20,0,15,205,0.434146341,0.029268293,0.6,2,0.59483189
8549,61,21425,3,2,10,3,0,18,10,2,5,0,0,17,nowin,win,plwin,beat,20,0,5,194,0.427835052,0.077319588,0.603092784,2,0.591437139
8550,31,21426,10,4,0,3,0,17,7,2,4,3,10,26,nowin,win,dlbust,bust,20,0,14,188,0.473404255,0.058510638,0.515957447,1,0.300306557
8551,26,21426,10,10,0,0,0,20,7,2,4,3,10,26,nowin,win,dlbust,bust,20,0,20,203,0.463054187,0.0591133,0.541871921,1,0.306802864
8552,34,21426,6,10,0,10,0,26,7,2,4,3,10,26,nowin,loss,bust,plbust,0,10,16,202,0.5,0.079207921,0.618811881,3,0.968961434
8553,42,21426,9,10,0,0,0,19,7,2,4,3,10,26,nowin,win,dlbust,bust,20,0,19,212,0.443396226,0.051886792,0.570754717,1,0.309181312
8554,103,21426,11,6,1,0,0,18,7,2,4,3,10,26,nowin,win,dlbust,bust,20,0,17,203,0.379310345,0.064039409,0.551724138,0,0.012869209
8555,107,21426,6,10,0,7,0,23,7,2,4,3,10,26,nowin,loss,bust,plbust,0,10,16,218,0.444954128,0.073394495,0.600917431,2,0.605210014
8556,148,21427,10,2,0,0,0,12,4,2,7,3,7,23,nowin,win,dlbust,bust,20,0,12,204,0.401960784,0.078431373,0.593137255,0,0.029789521
8557,79,21427,9,10,0,0,0,19,4,2,7,3,7,23,nowin,win,dlbust,bust,20,0,19,211,0.436018957,0.028436019,0.672985782,2,0.650131054
8558,94,21427,10,3,0,0,0,13,4,2,7,3,7,23,nowin,win,dlbust,bust,20,0,13,183,0.43715847,0.043715847,0.540983607,1,0.290866892
8559,91,21427,3,5,5,0,0,13,4,2,7,3,7,23,nowin,win,dlbust,bust,20,0,8,194,0.417525773,0.046391753,0.515463918,1,0.266616552
8560,62,21427,7,10,0,0,0,17,4,2,7,3,7,23,nowin,win,dlbust,bust,20,0,17,178,0.370786517,0.028089888,0.54494382,0,0.008657722
8561,113,21427,8,2,10,0,0,20,4,2,7,3,7,23,nowin,win,dlbust,bust,20,0,10,199,0.407035176,0.055276382,0.668341709,2,0.620695264
8562,134,21428,8,7,0,10,0,25,9,10,0,0,0,19,nowin,loss,bust,plbust,0,10,15,185,0.443243243,0.021621622,0.545945946,1,0.296939509
8563,85,21428,10,10,0,0,0,20,9,10,0,0,0,19,nowin,win,plwin,beat,20,0,20,195,0.41025641,0.066666667,0.594871795,0,0.03269711
8564,58,21428,5,8,0,10,0,23,9,10,0,0,0,19,nowin,loss,bust,plbust,0,10,13,195,0.430769231,0.041025641,0.584615385,2,0.580497586
8565,68,21428,10,10,0,0,0,20,9,10,0,0,0,19,nowin,win,plwin,beat,20,0,20,205,0.434146341,0.029268293,0.6,2,0.59483189
8566,60,21428,8,9,0,0,0,17,9,10,0,0,0,19,nowin,loss,beat,dlwin,0,10,17,227,0.418502203,0.022026432,0.559471366,0,0.026496258
8567,29,21428,10,10,0,0,0,20,9,10,0,0,0,19,nowin,win,plwin,beat,20,0,20,189,0.44973545,0.058201058,0.544973545,1,0.300349439
8568,41,21429,5,4,6,4,0,19,10,10,0,0,0,20,nowin,loss,beat,dlwin,0,10,9,192,0.364583333,0.036458333,0.520833333,0,0.00089702
8569,100,21429,11,1,2,5,0,19,10,10,0,0,0,20,nowin,loss,beat,dlwin,0,10,12,190,0.452631579,0.036842105,0.594736842,3,0.888671154
8570,122,21429,9,10,0,0,0,19,10,10,0,0,0,20,nowin,loss,beat,dlwin,0,10,19,210,0.347619048,0.052380952,0.59047619,0,0.012873677
8571,68,21429,4,9,0,1,1,15,10,10,0,0,0,20,nowin,loss,beat,dlwin,0,10,13,205,0.434146341,0.029268293,0.6,2,0.59483189
8572,102,21429,2,10,0,10,0,22,10,10,0,0,0,20,nowin,loss,bust,plbust,0,10,12,192,0.338541667,0.046875,0.5625,0,0.003306118
8573,79,21429,10,6,0,1,0,17,10,10,0,0,0,20,nowin,loss,beat,dlwin,0,10,16,211,0.436018957,0.028436019,0.672985782,2,0.650131054
8574,15,21430,8,10,0,0,0,18,8,10,0,0,0,18,nowin,push,push,push,10,0,18,212,0.410377358,0.051886792,0.561320755,0,0.024517408
8575,16,21430,7,10,0,0,0,17,8,10,0,0,0,18,nowin,loss,beat,dlwin,0,10,17,220,0.427272727,0.081818182,0.6,2,0.588660176
8576,92,21430,6,8,0,10,0,24,8,10,0,0,0,18,nowin,loss,bust,plbust,0,10,14,186,0.446236559,0.059139785,0.564516129,1,0.307826125
8577,43,21430,8,3,4,10,0,25,8,10,0,0,0,18,nowin,loss,bust,plbust,0,10,11,192,0.40625,0.041666667,0.609375,2,0.576671372
8578,89,21430,3,8,10,0,0,21,8,10,0,0,0,18,nowin,win,plwin,beat,20,0,11,212,0.537735849,0.047169811,0.594339623,3,0.990167191
8579,75,21430,9,3,0,2,3,17,8,10,0,0,0,18,nowin,loss,beat,dlwin,0,10,12,191,0.418848168,0.052356021,0.570680628,0,0.029344702
8580,103,21431,11,7,0,0,0,18,2,7,10,0,0,19,nowin,loss,beat,dlwin,0,10,18,203,0.379310345,0.064039409,0.551724138,0,0.012869209
8581,76,21431,11,10,0,0,0,21,2,7,10,0,0,19,win,win,plwin,beat,25,0,21,189,0.534391534,0.079365079,0.608465608,3,1
8582,108,21431,5,3,5,0,0,13,2,7,10,0,0,19,nowin,loss,beat,dlwin,0,10,8,193,0.435233161,0.056994819,0.559585492,1,0.298824795
8583,59,21431,10,2,0,10,0,22,2,7,10,0,0,19,nowin,loss,bust,plbust,0,10,12,228,0.429824561,0.048245614,0.543859649,1,0.287885446
8584,145,21431,6,6,0,10,0,22,2,7,10,0,0,19,nowin,loss,bust,plbust,0,10,12,188,0.441489362,0.031914894,0.622340426,2,0.617837093
8585,86,21431,9,4,0,0,0,13,2,7,10,0,0,19,nowin,loss,beat,dlwin,0,10,13,196,0.454081633,0.040816327,0.591836735,3,0.887566443
8586,116,21432,6,10,0,9,0,25,10,10,0,0,0,20,nowin,loss,bust,plbust,0,10,16,195,0.425641026,0.056410256,0.538461538,1,0.28273747
8587,87,21432,8,2,5,10,0,25,10,10,0,0,0,20,nowin,loss,bust,plbust,0,10,10,202,0.405940594,0.054455446,0.628712871,2,0.590599801
8588,95,21432,4,10,0,8,0,22,10,10,0,0,0,20,nowin,loss,bust,plbust,0,10,14,218,0.412844037,0.04587156,0.559633028,0,0.024842385
8589,130,21432,8,3,5,10,0,26,10,10,0,0,0,20,nowin,loss,bust,plbust,0,10,11,219,0.410958904,0.03652968,0.566210046,0,0.025888739
8590,101,21432,8,10,0,0,0,18,10,10,0,0,0,20,nowin,loss,beat,dlwin,0,10,18,205,0.424390244,0.068292683,0.63902439,2,0.614740646
8591,25,21432,10,9,0,0,0,19,10,10,0,0,0,20,nowin,loss,beat,dlwin,0,10,19,190,0.463157895,0.063157895,0.536842105,1,0.304401563
8592,73,21433,2,3,10,0,0,15,6,5,3,4,0,18,nowin,loss,beat,dlwin,0,10,5,181,0.375690608,0.011049724,0.596685083,0,0.022795773
8593,101,21433,8,8,0,0,0,16,6,5,3,4,0,18,nowin,loss,beat,dlwin,0,10,16,205,0.424390244,0.068292683,0.63902439,2,0.614740646
8594,78,21433,10,10,0,0,0,20,6,5,3,4,0,18,nowin,win,plwin,beat,20,0,20,201,0.517412935,0.034825871,0.587064677,3,0.95871112
8595,70,21433,4,1,8,0,0,13,6,5,3,4,0,18,nowin,loss,beat,dlwin,0,10,5,228,0.385964912,0.039473684,0.557017544,0,0.016157125
8596,18,21433,3,5,10,0,0,18,6,5,3,4,0,18,nowin,push,push,push,10,0,8,182,0.461538462,0.043956044,0.587912088,3,0.892649374
8597,77,21433,4,5,10,0,0,19,6,5,3,4,0,18,nowin,win,plwin,beat,20,0,9,200,0.455,0.04,0.62,3,0.916252116
8598,139,21434,10,10,0,0,0,20,7,7,1,10,0,25,nowin,win,dlbust,bust,20,0,20,192,0.380208333,0.036458333,0.59375,0,0.023429169
8599,73,21434,9,8,0,0,0,17,7,7,1,10,0,25,nowin,win,dlbust,bust,20,0,17,181,0.375690608,0.011049724,0.596685083,0,0.022795773
8600,150,21434,2,8,4,1,8,23,7,7,1,10,0,25,nowin,loss,bust,plbust,0,10,10,192,0.401041667,0.036458333,0.567708333,0,0.023287458
8601,130,21434,6,6,0,8,0,20,7,7,1,10,0,25,nowin,win,dlbust,bust,20,0,12,219,0.410958904,0.03652968,0.566210046,0,0.025888739
8602,143,21434,10,8,0,0,0,18,7,7,1,10,0,25,nowin,win,dlbust,bust,20,0,18,203,0.463054187,0.044334975,0.57635468,3,0.883143365
8603,33,21434,7,8,0,4,0,19,7,7,1,10,0,25,nowin,win,dlbust,bust,20,0,15,192,0.4375,0.057291667,0.625,2,0.616208916
8604,44,21435,7,10,0,0,0,17,6,2,7,4,0,19,nowin,loss,beat,dlwin,0,10,17,219,0.433789954,0.050228311,0.534246575,1,0.285551035
8605,137,21435,2,9,10,0,0,21,6,2,7,4,0,19,nowin,win,plwin,beat,20,0,11,194,0.417525773,0.046391753,0.536082474,1,0.276714602
8606,26,21435,2,7,10,0,0,19,6,2,7,4,0,19,nowin,push,push,push,10,0,9,203,0.463054187,0.0591133,0.541871921,1,0.306802864
8607,125,21435,9,4,0,0,0,13,6,2,7,4,0,19,nowin,loss,beat,dlwin,0,10,13,219,0.438356164,0.050228311,0.575342466,1,0.308411257
8608,109,21435,10,11,0,0,0,21,6,2,7,4,0,19,win,win,plwin,beat,25,0,21,221,0.461538462,0.058823529,0.597285068,3,0.901830309
8609,135,21435,6,8,0,0,0,14,6,2,7,4,0,19,nowin,loss,beat,dlwin,0,10,14,179,0.391061453,0.067039106,0.586592179,0,0.024924662
8610,76,21436,5,9,0,6,0,20,10,10,0,0,0,20,nowin,push,push,push,10,0,14,189,0.534391534,0.079365079,0.608465608,3,1
8611,29,21436,10,7,0,0,0,17,10,10,0,0,0,20,nowin,loss,beat,dlwin,0,10,17,189,0.44973545,0.058201058,0.544973545,1,0.300349439
8612,35,21436,10,10,0,0,0,20,10,10,0,0,0,20,nowin,push,push,push,10,0,20,202,0.410891089,0.044554455,0.633663366,2,0.598681573
8613,103,21436,11,10,0,0,0,21,10,10,0,0,0,20,win,win,plwin,beat,25,0,21,203,0.379310345,0.064039409,0.551724138,0,0.012869209
8614,51,21436,9,11,0,0,0,20,10,10,0,0,0,20,nowin,push,push,push,10,0,20,189,0.529100529,0.068783069,0.608465608,3,0.993665715
8615,76,21436,10,10,0,0,0,20,10,10,0,0,0,20,nowin,push,push,push,10,0,20,189,0.534391534,0.079365079,0.608465608,3,1
8616,112,21437,10,11,0,0,0,21,9,6,9,0,0,24,win,win,dlbust,bust,25,0,21,203,0.448275862,0.054187192,0.600985222,3,0.889576933
8617,89,21437,6,5,4,8,0,23,9,6,9,0,0,24,nowin,loss,bust,plbust,0,10,11,212,0.537735849,0.047169811,0.594339623,3,0.990167191
8618,75,21437,9,8,0,0,0,17,9,6,9,0,0,24,nowin,win,dlbust,bust,20,0,17,191,0.418848168,0.052356021,0.570680628,0,0.029344702
8619,90,21437,2,10,0,8,0,20,9,6,9,0,0,24,nowin,win,dlbust,bust,20,0,12,201,0.447761194,0.049751244,0.60199005,3,0.889945023
8620,138,21437,2,10,0,2,1,15,9,6,9,0,0,24,nowin,win,dlbust,bust,20,0,12,190,0.442105263,0.047368421,0.610526316,2,0.609711065
8621,131,21437,3,9,0,7,0,19,9,6,9,0,0,24,nowin,win,dlbust,bust,20,0,12,217,0.410138249,0.069124424,0.543778802,0,0.02015021
8622,150,21438,10,3,0,1,7,21,10,10,0,0,0,20,nowin,win,plwin,beat,20,0,13,192,0.401041667,0.036458333,0.567708333,0,0.023287458
8623,76,21438,3,10,0,5,0,18,10,10,0,0,0,20,nowin,loss,beat,dlwin,0,10,13,189,0.534391534,0.079365079,0.608465608,3,1
8624,100,21438,10,9,0,0,0,19,10,10,0,0,0,20,nowin,loss,beat,dlwin,0,10,19,190,0.452631579,0.036842105,0.594736842,3,0.888671154
8625,50,21438,10,5,0,3,0,18,10,10,0,0,0,20,nowin,loss,beat,dlwin,0,10,15,202,0.405940594,0.04950495,0.54950495,0,0.020296079
8626,57,21438,4,9,0,6,0,19,10,10,0,0,0,20,nowin,loss,beat,dlwin,0,10,13,192,0.46875,0.052083333,0.59375,3,0.907001181
8627,68,21438,9,5,0,6,0,20,10,10,0,0,0,20,nowin,push,push,push,10,0,14,205,0.434146341,0.029268293,0.6,2,0.59483189
8628,106,21439,8,10,0,0,0,18,9,9,0,0,0,18,nowin,push,push,push,10,0,18,192,0.411458333,0.026041667,0.557291667,0,0.023854304
8629,145,21439,9,10,0,0,0,19,9,9,0,0,0,18,nowin,win,plwin,beat,20,0,19,188,0.441489362,0.031914894,0.622340426,2,0.617837093
8630,86,21439,11,9,0,0,0,20,9,9,0,0,0,18,nowin,win,plwin,beat,20,0,20,196,0.454081633,0.040816327,0.591836735,3,0.887566443
8631,19,21439,10,10,0,0,0,20,9,9,0,0,0,18,nowin,win,plwin,beat,20,0,20,237,0.41350211,0.054852321,0.628691983,2,0.597373826
8632,149,21439,3,4,7,3,0,17,9,9,0,0,0,18,nowin,loss,beat,dlwin,0,10,7,225,0.457777778,0.057777778,0.648888889,2,0.651965595
8633,48,21439,10,5,0,3,0,18,9,9,0,0,0,18,nowin,push,push,push,10,0,15,203,0.413793103,0.019704433,0.600985222,2,0.577280801
8634,38,21440,8,11,0,0,0,19,4,10,6,0,0,20,nowin,loss,beat,dlwin,0,10,19,202,0.361386139,0.03960396,0.564356436,0,0.010597953
8635,70,21440,6,2,4,0,0,12,4,10,6,0,0,20,nowin,loss,beat,dlwin,0,10,8,228,0.385964912,0.039473684,0.557017544,0,0.016157125
8636,114,21440,1,6,10,0,0,17,4,10,6,0,0,20,nowin,loss,beat,dlwin,0,10,7,198,0.47979798,0.025252525,0.611111111,3,0.937232995
8637,7,21440,2,4,9,0,0,15,4,10,6,0,0,20,nowin,loss,beat,dlwin,0,10,6,183,0.442622951,0.06010929,0.62295082,2,0.619303341
8638,73,21440,2,10,0,0,0,12,4,10,6,0,0,20,nowin,loss,beat,dlwin,0,10,12,181,0.375690608,0.011049724,0.596685083,0,0.022795773
8639,76,21440,8,11,0,0,0,19,4,10,6,0,0,20,nowin,loss,beat,dlwin,0,10,19,189,0.534391534,0.079365079,0.608465608,3,1
8640,120,21441,11,3,3,0,0,17,2,7,9,0,0,18,nowin,loss,beat,dlwin,0,10,14,202,0.440594059,0.034653465,0.618811881,2,0.614441029
8641,77,21441,7,11,0,0,0,18,2,7,9,0,0,18,nowin,push,push,push,10,0,18,200,0.455,0.04,0.62,3,0.916252116
8642,72,21441,11,8,0,0,0,19,2,7,9,0,0,18,nowin,win,plwin,beat,20,0,19,185,0.394594595,0.032432432,0.508108108,0,0.006763115
8643,36,21441,10,10,0,0,0,20,2,7,9,0,0,18,nowin,win,plwin,beat,20,0,20,229,0.445414847,0.056768559,0.655021834,2,0.645370571
8644,126,21441,10,3,0,0,0,13,2,7,9,0,0,18,nowin,loss,beat,dlwin,0,10,13,188,0.457446809,0.074468085,0.60106383,3,0.900633203
8645,36,21441,5,5,8,0,0,18,2,7,9,0,0,18,nowin,push,push,push,10,0,10,229,0.445414847,0.056768559,0.655021834,2,0.645370571
8646,139,21442,10,2,0,6,0,18,10,5,10,0,0,25,nowin,win,dlbust,bust,20,0,12,192,0.380208333,0.036458333,0.59375,0,0.023429169
8647,52,21442,9,2,8,0,0,19,10,5,10,0,0,25,nowin,win,dlbust,bust,20,0,11,217,0.414746544,0.02764977,0.599078341,2,0.576736024
8648,24,21442,10,4,0,7,0,21,10,5,10,0,0,25,nowin,win,dlbust,bust,20,0,14,207,0.458937198,0.048309179,0.570048309,1,0.318138014
8649,66,21442,5,5,10,0,0,20,10,5,10,0,0,25,nowin,win,dlbust,bust,20,0,10,217,0.456221198,0.064516129,0.626728111,3,0.924304367
8650,34,21442,11,10,0,0,0,21,10,5,10,0,0,25,win,win,dlbust,bust,25,0,21,202,0.5,0.079207921,0.618811881,3,0.968961434
8651,89,21442,6,7,0,9,0,22,10,5,10,0,0,25,nowin,loss,bust,plbust,0,10,13,212,0.537735849,0.047169811,0.594339623,3,0.990167191
8652,77,21443,7,10,0,0,0,17,4,10,2,10,0,26,nowin,win,dlbust,bust,20,0,17,200,0.455,0.04,0.62,3,0.916252116
8653,116,21443,10,4,0,0,0,14,4,10,2,10,0,26,nowin,win,dlbust,bust,20,0,14,195,0.425641026,0.056410256,0.538461538,1,0.28273747
8654,111,21443,11,9,0,0,0,20,4,10,2,10,0,26,nowin,win,dlbust,bust,20,0,20,180,0.433333333,0.055555556,0.611111111,2,0.602264492
8655,11,21443,2,6,2,10,0,20,4,10,2,10,0,26,nowin,win,dlbust,bust,20,0,8,236,0.457627119,0.016949153,0.588983051,3,0.889015813
8656,16,21443,6,10,0,0,0,16,4,10,2,10,0,26,nowin,win,dlbust,bust,20,0,16,220,0.427272727,0.081818182,0.6,2,0.588660176
8657,41,21443,4,10,0,0,0,14,4,10,2,10,0,26,nowin,win,dlbust,bust,20,0,14,192,0.364583333,0.036458333,0.520833333,0,0.00089702
8658,34,21444,11,1,7,0,0,19,2,10,2,9,0,23,nowin,win,dlbust,bust,20,0,12,202,0.5,0.079207921,0.618811881,3,0.968961434
8659,24,21444,6,4,4,0,0,14,2,10,2,9,0,23,nowin,win,dlbust,bust,20,0,10,207,0.458937198,0.048309179,0.570048309,1,0.318138014
8660,150,21444,2,8,6,0,0,16,2,10,2,9,0,23,nowin,win,dlbust,bust,20,0,10,192,0.401041667,0.036458333,0.567708333,0,0.023287458
8661,75,21444,10,11,0,0,0,21,2,10,2,9,0,23,win,win,dlbust,bust,25,0,21,191,0.418848168,0.052356021,0.570680628,0,0.029344702
8662,38,21444,5,3,8,0,0,16,2,10,2,9,0,23,nowin,win,dlbust,bust,20,0,8,202,0.361386139,0.03960396,0.564356436,0,0.010597953
8663,90,21444,10,9,0,0,0,19,2,10,2,9,0,23,nowin,win,dlbust,bust,20,0,19,201,0.447761194,0.049751244,0.60199005,3,0.889945023
8664,31,21445,9,10,0,0,0,19,8,7,10,0,0,25,nowin,win,dlbust,bust,20,0,19,188,0.473404255,0.058510638,0.515957447,1,0.300306557
8665,110,21445,6,10,0,8,0,24,8,7,10,0,0,25,nowin,loss,bust,plbust,0,10,16,192,0.416666667,0.046875,0.557291667,0,0.025413132
8666,85,21445,9,2,3,9,0,23,8,7,10,0,0,25,nowin,loss,bust,plbust,0,10,11,195,0.41025641,0.066666667,0.594871795,0,0.03269711
8667,3,21445,6,4,10,0,0,20,8,7,10,0,0,25,nowin,win,dlbust,bust,20,0,10,190,0.431578947,0.026315789,0.542105263,1,0.288076384
8668,47,21445,7,4,9,0,0,20,8,7,10,0,0,25,nowin,win,dlbust,bust,20,0,11,210,0.438095238,0.057142857,0.623809524,2,0.615868808
8669,67,21445,7,5,0,5,0,17,8,7,10,0,0,25,nowin,win,dlbust,bust,20,0,12,195,0.369230769,0.041025641,0.569230769,0,0.014139427
8670,62,21446,10,7,0,0,0,17,5,10,1,10,0,26,nowin,win,dlbust,bust,20,0,17,178,0.370786517,0.028089888,0.54494382,0,0.008657722
8671,36,21446,10,4,0,0,0,14,5,10,1,10,0,26,nowin,win,dlbust,bust,20,0,14,229,0.445414847,0.056768559,0.655021834,2,0.645370571
8672,36,21446,6,7,0,0,0,13,5,10,1,10,0,26,nowin,win,dlbust,bust,20,0,13,229,0.445414847,0.056768559,0.655021834,2,0.645370571
8673,113,21446,6,10,0,0,0,16,5,10,1,10,0,26,nowin,win,dlbust,bust,20,0,16,199,0.407035176,0.055276382,0.668341709,2,0.620695264
8674,43,21446,10,10,0,0,0,20,5,10,1,10,0,26,nowin,win,dlbust,bust,20,0,20,192,0.40625,0.041666667,0.609375,2,0.576671372
8675,77,21446,3,9,0,0,0,12,5,10,1,10,0,26,nowin,win,dlbust,bust,20,0,12,200,0.455,0.04,0.62,3,0.916252116
8676,114,21447,8,9,0,0,0,17,11,4,2,0,0,17,nowin,push,push,push,10,0,17,198,0.47979798,0.025252525,0.611111111,3,0.937232995
8677,20,21447,10,10,0,0,0,20,11,4,2,0,0,17,nowin,win,plwin,beat,20,0,20,186,0.456989247,0.037634409,0.537634409,1,0.301097108
8678,45,21447,11,10,0,0,0,21,11,4,2,0,0,17,win,win,plwin,beat,25,0,21,196,0.428571429,0.051020408,0.612244898,2,0.598821767
8679,123,21447,5,10,0,9,0,24,11,4,2,0,0,17,nowin,loss,bust,plbust,0,10,15,205,0.43902439,0.034146341,0.614634146,2,0.609962544
8680,87,21447,10,2,0,6,0,18,11,4,2,0,0,17,nowin,win,plwin,beat,20,0,12,202,0.405940594,0.054455446,0.628712871,2,0.590599801
8681,105,21447,5,10,0,6,0,21,11,4,2,0,0,17,nowin,win,plwin,beat,20,0,15,198,0.414141414,0.070707071,0.590909091,0,0.032889494
8682,135,21448,7,3,10,0,0,20,10,4,10,0,0,24,nowin,win,dlbust,bust,20,0,10,179,0.391061453,0.067039106,0.586592179,0,0.024924662
8683,55,21448,8,5,0,2,2,17,10,4,10,0,0,24,nowin,win,dlbust,bust,20,0,13,191,0.371727749,0.057591623,0.54973822,0,0.01011347
8684,53,21448,5,10,0,10,0,25,10,4,10,0,0,24,nowin,loss,bust,plbust,0,10,15,250,0.372,0.064,0.564,0,0.013687345
8685,122,21448,8,10,0,0,0,18,10,4,10,0,0,24,nowin,win,dlbust,bust,20,0,18,210,0.347619048,0.052380952,0.59047619,0,0.012873677
8686,78,21448,10,2,0,7,0,19,10,4,10,0,0,24,nowin,win,dlbust,bust,20,0,12,201,0.517412935,0.034825871,0.587064677,3,0.95871112
8687,93,21448,7,9,0,1,0,17,10,4,10,0,0,24,nowin,win,dlbust,bust,20,0,16,175,0.485714286,0.051428571,0.548571429,1,0.323648091
8688,123,21449,10,9,0,0,0,19,10,5,10,0,0,25,nowin,win,dlbust,bust,20,0,19,205,0.43902439,0.034146341,0.614634146,2,0.609962544
8689,34,21449,11,8,0,0,0,19,10,5,10,0,0,25,nowin,win,dlbust,bust,20,0,19,202,0.5,0.079207921,0.618811881,3,0.968961434
8690,95,21449,10,6,0,1,0,17,10,5,10,0,0,25,nowin,win,dlbust,bust,20,0,16,218,0.412844037,0.04587156,0.559633028,0,0.024842385
8691,60,21449,2,3,6,10,0,21,10,5,10,0,0,25,nowin,win,dlbust,bust,20,0,5,227,0.418502203,0.022026432,0.559471366,0,0.026496258
8692,144,21449,10,10,0,0,0,20,10,5,10,0,0,25,nowin,win,dlbust,bust,20,0,20,202,0.386138614,0.054455446,0.564356436,0,0.018006244
8693,5,21449,7,4,4,6,0,21,10,5,10,0,0,25,nowin,win,dlbust,bust,20,0,11,203,0.42364532,0.02955665,0.596059113,2,0.582508076
8694,74,21450,10,5,0,3,0,18,7,10,0,0,0,17,nowin,win,plwin,beat,20,0,15,209,0.411483254,0.04784689,0.531100478,0,0.017448125
8695,80,21450,10,4,0,10,0,24,7,10,0,0,0,17,nowin,loss,bust,plbust,0,10,14,186,0.419354839,0.059139785,0.623655914,2,0.59892924
8696,35,21450,10,3,0,10,0,23,7,10,0,0,0,17,nowin,loss,bust,plbust,0,10,13,202,0.410891089,0.044554455,0.633663366,2,0.598681573
8697,48,21450,10,3,0,2,5,20,7,10,0,0,0,17,nowin,win,plwin,beat,20,0,13,203,0.413793103,0.019704433,0.600985222,2,0.577280801
8698,23,21450,2,3,2,10,0,17,7,10,0,0,0,17,nowin,push,push,push,10,0,5,208,0.427884615,0.0625,0.552884615,1,0.29114424
8699,8,21450,9,2,10,0,0,21,7,10,0,0,0,17,nowin,win,plwin,beat,20,0,11,181,0.44198895,0.071823204,0.596685083,2,0.599438402
8700,111,21451,4,1,10,7,0,22,10,3,1,10,0,24,nowin,loss,bust,plbust,0,10,5,180,0.433333333,0.055555556,0.611111111,2,0.602264492
8701,5,21451,2,10,0,8,0,20,10,3,1,10,0,24,nowin,win,dlbust,bust,20,0,12,203,0.42364532,0.02955665,0.596059113,2,0.582508076
8702,63,21451,10,10,0,0,0,20,10,3,1,10,0,24,nowin,win,dlbust,bust,20,0,20,216,0.467592593,0.037037037,0.62037037,3,0.931690496
8703,142,21451,7,10,0,0,0,17,10,3,1,10,0,24,nowin,win,dlbust,bust,20,0,17,211,0.417061611,0.047393365,0.526066351,1,0.271531309
8704,137,21451,7,10,0,0,0,17,10,3,1,10,0,24,nowin,win,dlbust,bust,20,0,17,194,0.417525773,0.046391753,0.536082474,1,0.276714602
8705,3,21451,10,4,0,10,0,24,10,3,1,10,0,24,nowin,loss,bust,plbust,0,10,14,190,0.431578947,0.026315789,0.542105263,1,0.288076384
8706,22,21452,4,5,8,0,0,17,6,7,9,0,0,22,nowin,win,dlbust,bust,20,0,9,187,0.481283422,0.042780749,0.577540107,3,0.906128176
8707,112,21452,3,9,0,0,0,12,6,7,9,0,0,22,nowin,win,dlbust,bust,20,0,12,203,0.448275862,0.054187192,0.600985222,3,0.889576933
8708,116,21452,5,2,7,0,0,14,6,7,9,0,0,22,nowin,win,dlbust,bust,20,0,7,195,0.425641026,0.056410256,0.538461538,1,0.28273747
8709,68,21452,3,10,0,0,0,13,6,7,9,0,0,22,nowin,win,dlbust,bust,20,0,13,205,0.434146341,0.029268293,0.6,2,0.59483189
8710,115,21452,4,1,7,0,0,12,6,7,9,0,0,22,nowin,win,dlbust,bust,20,0,5,194,0.427835052,0.041237113,0.592783505,2,0.583863602
8711,86,21452,10,10,0,0,0,20,6,7,9,0,0,22,nowin,win,dlbust,bust,20,0,20,196,0.454081633,0.040816327,0.591836735,3,0.887566443
8712,38,21453,10,4,0,10,0,24,8,9,0,0,0,17,nowin,loss,bust,plbust,0,10,14,202,0.361386139,0.03960396,0.564356436,0,0.010597953
8713,27,21453,7,10,0,0,0,17,8,9,0,0,0,17,nowin,push,push,push,10,0,17,178,0.370786517,0.016853933,0.573033708,0,0.015536309
8714,127,21453,5,1,8,10,0,24,8,9,0,0,0,17,nowin,loss,bust,plbust,0,10,6,201,0.402985075,0.029850746,0.60199005,0,0.032263937
8715,101,21453,3,4,6,5,0,18,8,9,0,0,0,17,nowin,win,plwin,beat,20,0,7,205,0.424390244,0.068292683,0.63902439,2,0.614740646
8716,73,21453,10,10,0,0,0,20,8,9,0,0,0,17,nowin,win,plwin,beat,20,0,20,181,0.375690608,0.011049724,0.596685083,0,0.022795773
8717,51,21453,9,5,0,7,0,21,8,9,0,0,0,17,nowin,win,plwin,beat,20,0,14,189,0.529100529,0.068783069,0.608465608,3,0.993665715
8718,31,21454,2,8,10,0,0,20,8,5,1,10,0,24,nowin,win,dlbust,bust,20,0,10,188,0.473404255,0.058510638,0.515957447,1,0.300306557
8719,102,21454,4,7,7,0,0,18,8,5,1,10,0,24,nowin,win,dlbust,bust,20,0,11,192,0.338541667,0.046875,0.5625,0,0.003306118
8720,43,21454,6,10,0,2,0,18,8,5,1,10,0,24,nowin,win,dlbust,bust,20,0,16,192,0.40625,0.041666667,0.609375,2,0.576671372
8721,98,21454,11,10,0,0,0,21,8,5,1,10,0,24,win,win,dlbust,bust,25,0,21,220,0.422727273,0.054545455,0.55,1,0.28664435
8722,63,21454,8,2,9,0,0,19,8,5,1,10,0,24,nowin,win,dlbust,bust,20,0,10,216,0.467592593,0.037037037,0.62037037,3,0.931690496
8723,146,21454,2,4,10,10,0,26,8,5,1,10,0,24,nowin,loss,bust,plbust,0,10,6,221,0.43438914,0.040723982,0.542986425,1,0.290190091
8724,120,21455,10,4,0,0,0,14,5,7,8,0,0,20,nowin,loss,beat,dlwin,0,10,14,202,0.440594059,0.034653465,0.618811881,2,0.614441029
8725,102,21455,10,3,0,0,0,13,5,7,8,0,0,20,nowin,loss,beat,dlwin,0,10,13,192,0.338541667,0.046875,0.5625,0,0.003306118
8726,147,21455,3,10,0,0,0,13,5,7,8,0,0,20,nowin,loss,beat,dlwin,0,10,13,205,0.380487805,0.014634146,0.536585366,0,0.00951447
8727,113,21455,10,10,0,0,0,20,5,7,8,0,0,20,nowin,push,push,push,10,0,20,199,0.407035176,0.055276382,0.668341709,2,0.620695264
8728,80,21455,9,10,0,0,0,19,5,7,8,0,0,20,nowin,loss,beat,dlwin,0,10,19,186,0.419354839,0.059139785,0.623655914,2,0.59892924
8729,62,21455,10,10,0,0,0,20,5,7,8,0,0,20,nowin,push,push,push,10,0,20,178,0.370786517,0.028089888,0.54494382,0,0.008657722
8730,26,21456,10,3,0,0,0,13,5,9,5,0,0,19,nowin,loss,beat,dlwin,0,10,13,203,0.463054187,0.0591133,0.541871921,1,0.306802864
8731,102,21456,10,10,0,0,0,20,5,9,5,0,0,19,nowin,win,plwin,beat,20,0,20,192,0.338541667,0.046875,0.5625,0,0.003306118
8732,92,21456,10,3,0,0,0,13,5,9,5,0,0,19,nowin,loss,beat,dlwin,0,10,13,186,0.446236559,0.059139785,0.564516129,1,0.307826125
8733,117,21456,10,6,0,0,0,16,5,9,5,0,0,19,nowin,loss,beat,dlwin,0,10,16,173,0.410404624,0.069364162,0.606936416,2,0.578610282
8734,114,21456,2,5,2,3,0,12,5,9,5,0,0,19,nowin,loss,beat,dlwin,0,10,7,198,0.47979798,0.025252525,0.611111111,3,0.937232995
8735,52,21456,10,10,0,0,0,20,5,9,5,0,0,19,nowin,win,plwin,beat,20,0,20,217,0.414746544,0.02764977,0.599078341,2,0.576736024
8736,130,21457,8,2,8,0,0,18,9,2,8,0,0,19,nowin,loss,beat,dlwin,0,10,10,219,0.410958904,0.03652968,0.566210046,0,0.025888739
8737,12,21457,5,9,0,10,0,24,9,2,8,0,0,19,nowin,loss,bust,plbust,0,10,14,189,0.470899471,0.015873016,0.613756614,3,0.929171178
8738,52,21457,4,10,0,1,9,24,9,2,8,0,0,19,nowin,loss,bust,plbust,0,10,14,217,0.414746544,0.02764977,0.599078341,2,0.576736024
8739,140,21457,10,10,0,0,0,20,9,2,8,0,0,19,nowin,win,plwin,beat,20,0,20,210,0.466666667,0.023809524,0.604761905,3,0.915293335
8740,80,21457,10,8,0,0,0,18,9,2,8,0,0,19,nowin,loss,beat,dlwin,0,10,18,186,0.419354839,0.059139785,0.623655914,2,0.59892924
8741,128,21457,10,2,0,10,0,22,9,2,8,0,0,19,nowin,loss,bust,plbust,0,10,12,227,0.356828194,0.052863436,0.577092511,0,0.012352564
8742,120,21458,1,1,10,7,0,19,3,4,10,0,0,17,nowin,win,plwin,beat,20,0,2,202,0.440594059,0.034653465,0.618811881,2,0.614441029
8743,28,21458,3,8,10,0,0,21,3,4,10,0,0,17,nowin,win,plwin,beat,20,0,11,199,0.422110553,0.045226131,0.542713568,1,0.282706618
8744,132,21458,10,10,0,0,0,20,3,4,10,0,0,17,nowin,win,plwin,beat,20,0,20,194,0.412371134,0.036082474,0.649484536,2,0.611633238
8745,52,21458,9,9,0,0,0,18,3,4,10,0,0,17,nowin,win,plwin,beat,20,0,18,217,0.414746544,0.02764977,0.599078341,2,0.576736024
8746,149,21458,3,7,8,0,0,18,3,4,10,0,0,17,nowin,win,plwin,beat,20,0,10,225,0.457777778,0.057777778,0.648888889,2,0.651965595
8747,134,21458,10,5,0,0,0,15,3,4,10,0,0,17,nowin,loss,beat,dlwin,0,10,15,185,0.443243243,0.021621622,0.545945946,1,0.296939509
8748,42,21459,2,5,11,0,0,18,3,6,10,0,0,19,nowin,loss,beat,dlwin,0,10,7,212,0.443396226,0.051886792,0.570754717,1,0.309181312
8749,12,21459,6,8,0,0,0,14,3,6,10,0,0,19,nowin,loss,beat,dlwin,0,10,14,189,0.470899471,0.015873016,0.613756614,3,0.929171178
8750,11,21459,3,8,9,0,0,20,3,6,10,0,0,19,nowin,win,plwin,beat,20,0,11,236,0.457627119,0.016949153,0.588983051,3,0.889015813
8751,47,21459,10,8,0,0,0,18,3,6,10,0,0,19,nowin,loss,beat,dlwin,0,10,18,210,0.438095238,0.057142857,0.623809524,2,0.615868808
8752,73,21459,9,10,0,0,0,19,3,6,10,0,0,19,nowin,push,push,push,10,0,19,181,0.375690608,0.011049724,0.596685083,0,0.022795773
8753,64,21459,10,11,0,0,0,21,3,6,10,0,0,19,win,win,plwin,beat,25,0,21,187,0.363636364,0.048128342,0.631016043,0,0.027594885
8754,52,21460,10,6,0,10,0,26,10,3,6,0,0,19,nowin,loss,bust,plbust,0,10,16,217,0.414746544,0.02764977,0.599078341,2,0.576736024
8755,51,21460,10,11,0,0,0,21,10,3,6,0,0,19,win,win,plwin,beat,25,0,21,189,0.529100529,0.068783069,0.608465608,3,0.993665715
8756,106,21460,7,10,0,0,0,17,10,3,6,0,0,19,nowin,loss,beat,dlwin,0,10,17,192,0.411458333,0.026041667,0.557291667,0,0.023854304
8757,112,21460,10,8,0,0,0,18,10,3,6,0,0,19,nowin,loss,beat,dlwin,0,10,18,203,0.448275862,0.054187192,0.600985222,3,0.889576933
8758,25,21460,10,4,0,7,0,21,10,3,6,0,0,19,nowin,win,plwin,beat,20,0,14,190,0.463157895,0.063157895,0.536842105,1,0.304401563
8759,136,21460,6,6,0,7,0,19,10,3,6,0,0,19,nowin,push,push,push,10,0,12,194,0.396907216,0.025773196,0.597938144,0,0.029452644
8760,88,21461,3,10,0,10,0,23,8,5,8,0,0,21,nowin,loss,bust,plbust,0,10,13,206,0.466019417,0.033980583,0.54368932,1,0.309467903
8761,90,21461,6,10,0,5,0,21,8,5,8,0,0,21,nowin,push,push,push,10,0,16,201,0.447761194,0.049751244,0.60199005,3,0.889945023
8762,73,21461,4,5,10,0,0,19,8,5,8,0,0,21,nowin,loss,beat,dlwin,0,10,9,181,0.375690608,0.011049724,0.596685083,0,0.022795773
8763,82,21461,9,10,0,0,0,19,8,5,8,0,0,21,nowin,loss,beat,dlwin,0,10,19,225,0.408888889,0.075555556,0.577777778,0,0.028101874
8764,139,21461,7,10,0,0,0,17,8,5,8,0,0,21,nowin,loss,beat,dlwin,0,10,17,192,0.380208333,0.036458333,0.59375,0,0.023429169
8765,138,21461,10,4,0,10,0,24,8,5,8,0,0,21,nowin,loss,bust,plbust,0,10,14,190,0.442105263,0.047368421,0.610526316,2,0.609711065
8766,81,21462,6,6,0,3,0,15,2,6,10,0,0,18,nowin,loss,beat,dlwin,0,10,12,182,0.395604396,0.043956044,0.60989011,2,0.567491261
8767,103,21462,9,2,6,0,0,17,2,6,10,0,0,18,nowin,loss,beat,dlwin,0,10,11,203,0.379310345,0.064039409,0.551724138,0,0.012869209
8768,101,21462,2,10,0,3,0,15,2,6,10,0,0,18,nowin,loss,beat,dlwin,0,10,12,205,0.424390244,0.068292683,0.63902439,2,0.614740646
8769,23,21462,9,2,10,0,0,21,2,6,10,0,0,18,nowin,win,plwin,beat,20,0,11,208,0.427884615,0.0625,0.552884615,1,0.29114424
8770,121,21462,2,10,0,4,0,16,2,6,10,0,0,18,nowin,loss,beat,dlwin,0,10,12,195,0.456410256,0.025641026,0.512820513,1,0.288597791
8771,96,21462,6,9,0,0,0,15,2,6,10,0,0,18,nowin,loss,beat,dlwin,0,10,15,190,0.468421053,0.057894737,0.584210526,3,0.897263354
8772,141,21463,6,10,0,0,0,16,5,8,6,0,0,19,nowin,loss,beat,dlwin,0,10,16,202,0.420792079,0.074257426,0.564356436,0,0.028377851
8773,12,21463,8,6,0,0,0,14,5,8,6,0,0,19,nowin,loss,beat,dlwin,0,10,14,189,0.470899471,0.015873016,0.613756614,3,0.929171178
8774,6,21463,6,9,0,0,0,15,5,8,6,0,0,19,nowin,loss,beat,dlwin,0,10,15,191,0.439790576,0.047120419,0.581151832,1,0.31211505
8775,50,21463,3,5,9,0,0,17,5,8,6,0,0,19,nowin,loss,beat,dlwin,0,10,8,202,0.405940594,0.04950495,0.54950495,0,0.020296079
8776,139,21463,3,3,10,0,0,16,5,8,6,0,0,19,nowin,loss,beat,dlwin,0,10,6,192,0.380208333,0.036458333,0.59375,0,0.023429169
8777,4,21463,6,10,0,0,0,16,5,8,6,0,0,19,nowin,loss,beat,dlwin,0,10,16,217,0.460829493,0.036866359,0.562211982,1,0.315432839
8778,144,21464,5,10,0,5,0,20,8,3,8,0,0,19,nowin,win,plwin,beat,20,0,15,202,0.386138614,0.054455446,0.564356436,0,0.018006244
8779,10,21464,3,10,0,10,0,23,8,3,8,0,0,19,nowin,loss,bust,plbust,0,10,13,191,0.413612565,0.057591623,0.596858639,2,0.574087175
8780,91,21464,11,10,0,0,0,21,8,3,8,0,0,19,win,win,plwin,beat,25,0,21,194,0.417525773,0.046391753,0.515463918,1,0.266616552
8781,100,21464,10,7,0,0,0,17,8,3,8,0,0,19,nowin,loss,beat,dlwin,0,10,17,190,0.452631579,0.036842105,0.594736842,3,0.888671154
8782,127,21464,9,4,0,10,0,23,8,3,8,0,0,19,nowin,loss,bust,plbust,0,10,13,201,0.402985075,0.029850746,0.60199005,0,0.032263937
8783,78,21464,10,5,0,6,0,21,8,3,8,0,0,19,nowin,win,plwin,beat,20,0,15,201,0.517412935,0.034825871,0.587064677,3,0.95871112
8784,3,21465,6,10,0,2,0,18,10,11,0,0,0,21,nowin,loss,beat,dlwin,0,10,16,190,0.431578947,0.026315789,0.542105263,1,0.288076384
8785,115,21465,10,6,0,2,0,18,10,11,0,0,0,21,nowin,loss,beat,dlwin,0,10,16,194,0.427835052,0.041237113,0.592783505,2,0.583863602
8786,73,21465,2,4,2,10,0,18,10,11,0,0,0,21,nowin,loss,beat,dlwin,0,10,6,181,0.375690608,0.011049724,0.596685083,0,0.022795773
8787,146,21465,10,7,0,0,0,17,10,11,0,0,0,21,nowin,loss,beat,dlwin,0,10,17,221,0.43438914,0.040723982,0.542986425,1,0.290190091
8788,134,21465,7,9,0,6,0,22,10,11,0,0,0,21,nowin,loss,bust,plbust,0,10,16,185,0.443243243,0.021621622,0.545945946,1,0.296939509
8789,29,21465,4,10,0,3,0,17,10,11,0,0,0,21,nowin,loss,beat,dlwin,0,10,14,189,0.44973545,0.058201058,0.544973545,1,0.300349439
8790,63,21466,10,10,0,0,0,20,8,4,10,0,0,22,nowin,win,dlbust,bust,20,0,20,216,0.467592593,0.037037037,0.62037037,3,0.931690496
8791,90,21466,6,7,0,9,0,22,8,4,10,0,0,22,nowin,loss,bust,plbust,0,10,13,201,0.447761194,0.049751244,0.60199005,3,0.889945023
8792,139,21466,3,5,5,4,0,17,8,4,10,0,0,22,nowin,win,dlbust,bust,20,0,8,192,0.380208333,0.036458333,0.59375,0,0.023429169
8793,132,21466,5,6,2,2,8,23,8,4,10,0,0,22,nowin,loss,bust,plbust,0,10,11,194,0.412371134,0.036082474,0.649484536,2,0.611633238
8794,136,21466,10,10,0,0,0,20,8,4,10,0,0,22,nowin,win,dlbust,bust,20,0,20,194,0.396907216,0.025773196,0.597938144,0,0.029452644
8795,20,21466,4,10,0,2,5,21,8,4,10,0,0,22,nowin,win,dlbust,bust,20,0,14,186,0.456989247,0.037634409,0.537634409,1,0.301097108
8796,39,21467,9,9,0,0,0,18,6,10,9,0,0,25,nowin,win,dlbust,bust,20,0,18,191,0.429319372,0.062827225,0.57591623,0,0.033760763
8797,13,21467,5,5,6,0,0,16,6,10,9,0,0,25,nowin,win,dlbust,bust,20,0,10,206,0.417475728,0.063106796,0.621359223,2,0.59555479
8798,21,21467,6,10,0,0,0,16,6,10,9,0,0,25,nowin,win,dlbust,bust,20,0,16,214,0.359813084,0.042056075,0.626168224,0,0.025263474
8799,141,21467,1,2,10,0,0,13,6,10,9,0,0,25,nowin,win,dlbust,bust,20,0,3,202,0.420792079,0.074257426,0.564356436,0,0.028377851
8800,97,21467,10,10,0,0,0,20,6,10,9,0,0,25,nowin,win,dlbust,bust,20,0,20,182,0.450549451,0.06043956,0.692307692,2,0.677372279
8801,23,21467,10,6,0,0,0,16,6,10,9,0,0,25,nowin,win,dlbust,bust,20,0,16,208,0.427884615,0.0625,0.552884615,1,0.29114424
8802,56,21468,2,1,10,10,0,23,10,2,5,0,0,17,nowin,loss,bust,plbust,0,10,3,175,0.4,0.057142857,0.582857143,0,0.026685297
8803,74,21468,3,3,2,10,0,18,10,2,5,0,0,17,nowin,win,plwin,beat,20,0,6,209,0.411483254,0.04784689,0.531100478,0,0.017448125
8804,144,21468,3,8,3,1,4,19,10,2,5,0,0,17,nowin,win,plwin,beat,20,0,11,202,0.386138614,0.054455446,0.564356436,0,0.018006244
8805,90,21468,8,10,0,0,0,18,10,2,5,0,0,17,nowin,win,plwin,beat,20,0,18,201,0.447761194,0.049751244,0.60199005,3,0.889945023
8806,67,21468,11,8,0,0,0,19,10,2,5,0,0,17,nowin,win,plwin,beat,20,0,19,195,0.369230769,0.041025641,0.569230769,0,0.014139427
8807,113,21468,5,3,5,3,1,17,10,2,5,0,0,17,nowin,push,push,push,10,0,8,199,0.407035176,0.055276382,0.668341709,2,0.620695264
8808,21,21469,10,10,0,0,0,20,10,10,0,0,0,20,nowin,push,push,push,10,0,20,214,0.359813084,0.042056075,0.626168224,0,0.025263474
8809,53,21469,5,10,0,10,0,25,10,10,0,0,0,20,nowin,loss,bust,plbust,0,10,15,250,0.372,0.064,0.564,0,0.013687345
8810,89,21469,11,7,0,0,0,18,10,10,0,0,0,20,nowin,loss,beat,dlwin,0,10,18,212,0.537735849,0.047169811,0.594339623,3,0.990167191
8811,25,21469,10,3,0,8,0,21,10,10,0,0,0,20,nowin,win,plwin,beat,20,0,13,190,0.463157895,0.063157895,0.536842105,1,0.304401563
8812,106,21469,10,4,0,9,0,23,10,10,0,0,0,20,nowin,loss,bust,plbust,0,10,14,192,0.411458333,0.026041667,0.557291667,0,0.023854304
8813,27,21469,5,6,2,10,0,23,10,10,0,0,0,20,nowin,loss,bust,plbust,0,10,11,178,0.370786517,0.016853933,0.573033708,0,0.015536309
8814,147,21470,9,6,0,7,0,22,10,4,7,0,0,21,nowin,loss,bust,plbust,0,10,15,205,0.380487805,0.014634146,0.536585366,0,0.00951447
8815,147,21470,8,9,0,0,0,17,10,4,7,0,0,21,nowin,loss,beat,dlwin,0,10,17,205,0.380487805,0.014634146,0.536585366,0,0.00951447
8816,80,21470,10,5,0,9,0,24,10,4,7,0,0,21,nowin,loss,bust,plbust,0,10,15,186,0.419354839,0.059139785,0.623655914,2,0.59892924
8817,109,21470,6,10,0,3,0,19,10,4,7,0,0,21,nowin,loss,beat,dlwin,0,10,16,221,0.461538462,0.058823529,0.597285068,3,0.901830309
8818,23,21470,4,4,5,9,0,22,10,4,7,0,0,21,nowin,loss,bust,plbust,0,10,8,208,0.427884615,0.0625,0.552884615,1,0.29114424
8819,74,21470,3,10,0,10,0,23,10,4,7,0,0,21,nowin,loss,bust,plbust,0,10,13,209,0.411483254,0.04784689,0.531100478,0,0.017448125
8820,118,21471,9,10,0,0,0,19,6,10,4,0,0,20,nowin,loss,beat,dlwin,0,10,19,216,0.393518519,0.037037037,0.555555556,0,0.018059873
8821,24,21471,3,5,8,0,0,16,6,10,4,0,0,20,nowin,loss,beat,dlwin,0,10,8,207,0.458937198,0.048309179,0.570048309,1,0.318138014
8822,99,21471,10,7,0,0,0,17,6,10,4,0,0,20,nowin,loss,beat,dlwin,0,10,17,207,0.47826087,0.062801932,0.637681159,3,0.961418446
8823,127,21471,8,5,0,0,0,13,6,10,4,0,0,20,nowin,loss,beat,dlwin,0,10,13,201,0.402985075,0.029850746,0.60199005,0,0.032263937
8824,117,21471,6,11,1,0,0,18,6,10,4,0,0,20,nowin,loss,beat,dlwin,0,10,17,173,0.410404624,0.069364162,0.606936416,2,0.578610282
8825,91,21471,2,5,10,0,0,17,6,10,4,0,0,20,nowin,loss,beat,dlwin,0,10,7,194,0.417525773,0.046391753,0.515463918,1,0.266616552
8826,42,21472,3,5,9,0,0,17,1,5,10,8,0,24,nowin,win,dlbust,bust,20,0,8,212,0.443396226,0.051886792,0.570754717,1,0.309181312
8827,104,21472,10,6,0,8,0,24,1,5,10,8,0,24,nowin,loss,bust,plbust,0,10,16,209,0.363636364,0.052631579,0.593301435,0,0.018359419
8828,27,21472,6,8,0,7,0,21,1,5,10,8,0,24,nowin,win,dlbust,bust,20,0,14,178,0.370786517,0.016853933,0.573033708,0,0.015536309
8829,21,21472,10,10,0,0,0,20,1,5,10,8,0,24,nowin,win,dlbust,bust,20,0,20,214,0.359813084,0.042056075,0.626168224,0,0.025263474
8830,53,21472,6,8,0,7,0,21,1,5,10,8,0,24,nowin,win,dlbust,bust,20,0,14,250,0.372,0.064,0.564,0,0.013687345
8831,143,21472,3,11,5,0,0,19,1,5,10,8,0,24,nowin,win,dlbust,bust,20,0,14,203,0.463054187,0.044334975,0.57635468,3,0.883143365
8832,106,21473,4,8,0,4,2,18,9,5,8,0,0,22,nowin,win,dlbust,bust,20,0,12,192,0.411458333,0.026041667,0.557291667,0,0.023854304
8833,108,21473,7,2,4,10,0,23,9,5,8,0,0,22,nowin,loss,bust,plbust,0,10,9,193,0.435233161,0.056994819,0.559585492,1,0.298824795
8834,22,21473,4,3,10,0,0,17,9,5,8,0,0,22,nowin,win,dlbust,bust,20,0,7,187,0.481283422,0.042780749,0.577540107,3,0.906128176
8835,89,21473,9,7,0,10,0,26,9,5,8,0,0,22,nowin,loss,bust,plbust,0,10,16,212,0.537735849,0.047169811,0.594339623,3,0.990167191
8836,119,21473,9,10,0,0,0,19,9,5,8,0,0,22,nowin,win,dlbust,bust,20,0,19,190,0.405263158,0.068421053,0.515789474,0,0.011837158
8837,106,21473,1,1,10,5,0,17,9,5,8,0,0,22,nowin,win,dlbust,bust,20,0,2,192,0.411458333,0.026041667,0.557291667,0,0.023854304
8838,88,21474,5,7,0,1,10,23,8,10,0,0,0,18,nowin,loss,bust,plbust,0,10,12,206,0.466019417,0.033980583,0.54368932,1,0.309467903
8839,107,21474,9,2,10,0,0,21,8,10,0,0,0,18,nowin,win,plwin,beat,20,0,11,218,0.444954128,0.073394495,0.600917431,2,0.605210014
8840,28,21474,6,11,4,0,0,21,8,10,0,0,0,18,nowin,win,plwin,beat,20,0,17,199,0.422110553,0.045226131,0.542713568,1,0.282706618
8841,54,21474,9,10,0,0,0,19,8,10,0,0,0,18,nowin,win,plwin,beat,20,0,19,185,0.437837838,0.032432432,0.556756757,1,0.29899854
8842,74,21474,9,3,0,7,0,19,8,10,0,0,0,18,nowin,win,plwin,beat,20,0,12,209,0.411483254,0.04784689,0.531100478,0,0.017448125
8843,10,21474,11,2,3,3,0,19,8,10,0,0,0,18,nowin,win,plwin,beat,20,0,13,191,0.413612565,0.057591623,0.596858639,2,0.574087175
8844,68,21475,7,8,0,10,0,25,10,4,1,3,0,18,nowin,loss,bust,plbust,0,10,15,205,0.434146341,0.029268293,0.6,2,0.59483189
8845,18,21475,9,8,0,0,0,17,10,4,1,3,0,18,nowin,loss,beat,dlwin,0,10,17,182,0.461538462,0.043956044,0.587912088,3,0.892649374
8846,112,21475,9,10,0,0,0,19,10,4,1,3,0,18,nowin,win,plwin,beat,20,0,19,203,0.448275862,0.054187192,0.600985222,3,0.889576933
8847,93,21475,10,10,0,0,0,20,10,4,1,3,0,18,nowin,win,plwin,beat,20,0,20,175,0.485714286,0.051428571,0.548571429,1,0.323648091
8848,77,21475,10,10,0,0,0,20,10,4,1,3,0,18,nowin,win,plwin,beat,20,0,20,200,0.455,0.04,0.62,3,0.916252116
8849,69,21475,10,6,0,6,0,22,10,4,1,3,0,18,nowin,loss,bust,plbust,0,10,16,194,0.365979381,0.030927835,0.515463918,0,0
8850,137,21476,11,5,3,0,0,19,10,11,0,0,0,21,nowin,loss,beat,dlwin,0,10,16,194,0.417525773,0.046391753,0.536082474,1,0.276714602
8851,58,21476,10,11,0,0,0,21,10,11,0,0,0,21,win,push,push,push,10,0,21,195,0.430769231,0.041025641,0.584615385,2,0.580497586
8852,61,21476,11,5,4,0,0,20,10,11,0,0,0,21,nowin,loss,beat,dlwin,0,10,16,194,0.427835052,0.077319588,0.603092784,2,0.591437139
8853,73,21476,3,7,4,2,10,26,10,11,0,0,0,21,nowin,loss,bust,plbust,0,10,10,181,0.375690608,0.011049724,0.596685083,0,0.022795773
8854,14,21476,10,10,0,0,0,20,10,11,0,0,0,21,nowin,loss,beat,dlwin,0,10,20,202,0.391089109,0.01980198,0.628712871,2,0.577264877
8855,81,21476,9,5,0,3,0,17,10,11,0,0,0,21,nowin,loss,beat,dlwin,0,10,14,182,0.395604396,0.043956044,0.60989011,2,0.567491261
8856,22,21477,3,8,2,0,0,13,2,2,3,10,0,17,nowin,loss,beat,dlwin,0,10,11,187,0.481283422,0.042780749,0.577540107,3,0.906128176
8857,100,21477,6,3,9,0,0,18,2,2,3,10,0,17,nowin,win,plwin,beat,20,0,9,190,0.452631579,0.036842105,0.594736842,3,0.888671154
8858,32,21477,10,3,0,0,0,13,2,2,3,10,0,17,nowin,loss,beat,dlwin,0,10,13,189,0.391534392,0.037037037,0.53968254,0,0.013579086
8859,33,21477,6,7,0,0,0,13,2,2,3,10,0,17,nowin,loss,beat,dlwin,0,10,13,192,0.4375,0.057291667,0.625,2,0.616208916
8860,51,21477,10,9,0,0,0,19,2,2,3,10,0,17,nowin,win,plwin,beat,20,0,19,189,0.529100529,0.068783069,0.608465608,3,0.993665715
8861,85,21477,5,7,0,7,0,19,2,2,3,10,0,17,nowin,win,plwin,beat,20,0,12,195,0.41025641,0.066666667,0.594871795,0,0.03269711
8862,104,21478,11,10,0,0,0,21,10,2,7,0,0,19,win,win,plwin,beat,25,0,21,209,0.363636364,0.052631579,0.593301435,0,0.018359419
8863,85,21478,6,4,6,2,0,18,10,2,7,0,0,19,nowin,loss,beat,dlwin,0,10,10,195,0.41025641,0.066666667,0.594871795,0,0.03269711
8864,94,21478,4,7,3,1,10,25,10,2,7,0,0,19,nowin,loss,bust,plbust,0,10,11,183,0.43715847,0.043715847,0.540983607,1,0.290866892
8865,2,21478,8,9,0,0,0,17,10,2,7,0,0,19,nowin,loss,beat,dlwin,0,10,17,200,0.445,0.035,0.64,2,0.633962549
8866,122,21478,7,7,0,9,0,23,10,2,7,0,0,19,nowin,loss,bust,plbust,0,10,14,210,0.347619048,0.052380952,0.59047619,0,0.012873677
8867,72,21478,6,10,0,5,0,21,10,2,7,0,0,19,nowin,win,plwin,beat,20,0,16,185,0.394594595,0.032432432,0.508108108,0,0.006763115
8868,134,21479,10,10,0,0,0,20,8,7,10,0,0,25,nowin,win,dlbust,bust,20,0,20,185,0.443243243,0.021621622,0.545945946,1,0.296939509
8869,118,21479,7,5,0,4,1,17,8,7,10,0,0,25,nowin,win,dlbust,bust,20,0,12,216,0.393518519,0.037037037,0.555555556,0,0.018059873
8870,119,21479,5,4,10,0,0,19,8,7,10,0,0,25,nowin,win,dlbust,bust,20,0,9,190,0.405263158,0.068421053,0.515789474,0,0.011837158
8871,8,21479,11,10,0,0,0,21,8,7,10,0,0,25,win,win,dlbust,bust,25,0,21,181,0.44198895,0.071823204,0.596685083,2,0.599438402
8872,149,21479,5,10,0,2,0,17,8,7,10,0,0,25,nowin,win,dlbust,bust,20,0,15,225,0.457777778,0.057777778,0.648888889,2,0.651965595
8873,35,21479,7,11,0,0,0,18,8,7,10,0,0,25,nowin,win,dlbust,bust,20,0,18,202,0.410891089,0.044554455,0.633663366,2,0.598681573
8874,145,21480,1,3,10,0,0,14,5,10,10,0,0,25,nowin,win,dlbust,bust,20,0,4,188,0.441489362,0.031914894,0.622340426,2,0.617837093
8875,8,21480,8,10,0,0,0,18,5,10,10,0,0,25,nowin,win,dlbust,bust,20,0,18,181,0.44198895,0.071823204,0.596685083,2,0.599438402
8876,4,21480,1,5,10,0,0,16,5,10,10,0,0,25,nowin,win,dlbust,bust,20,0,6,217,0.460829493,0.036866359,0.562211982,1,0.315432839
8877,121,21480,10,7,0,0,0,17,5,10,10,0,0,25,nowin,win,dlbust,bust,20,0,17,195,0.456410256,0.025641026,0.512820513,1,0.288597791
8878,77,21480,10,5,0,0,0,15,5,10,10,0,0,25,nowin,win,dlbust,bust,20,0,15,200,0.455,0.04,0.62,3,0.916252116
8879,66,21480,4,3,8,0,0,15,5,10,10,0,0,25,nowin,win,dlbust,bust,20,0,7,217,0.456221198,0.064516129,0.626728111,3,0.924304367
8880,36,21481,10,11,0,0,0,21,8,10,0,0,0,18,win,win,plwin,beat,25,0,21,229,0.445414847,0.056768559,0.655021834,2,0.645370571
8881,22,21481,8,6,0,7,0,21,8,10,0,0,0,18,nowin,win,plwin,beat,20,0,14,187,0.481283422,0.042780749,0.577540107,3,0.906128176
8882,35,21481,3,2,10,1,8,24,8,10,0,0,0,18,nowin,loss,bust,plbust,0,10,5,202,0.410891089,0.044554455,0.633663366,2,0.598681573
8883,51,21481,2,10,0,4,2,18,8,10,0,0,0,18,nowin,push,push,push,10,0,12,189,0.529100529,0.068783069,0.608465608,3,0.993665715
8884,104,21481,10,4,0,3,0,17,8,10,0,0,0,18,nowin,loss,beat,dlwin,0,10,14,209,0.363636364,0.052631579,0.593301435,0,0.018359419
8885,45,21481,7,11,0,0,0,18,8,10,0,0,0,18,nowin,push,push,push,10,0,18,196,0.428571429,0.051020408,0.612244898,2,0.598821767
8886,135,21482,4,8,0,10,0,22,10,3,8,0,0,21,nowin,loss,bust,plbust,0,10,12,179,0.391061453,0.067039106,0.586592179,0,0.024924662
8887,35,21482,10,10,0,0,0,20,10,3,8,0,0,21,nowin,loss,beat,dlwin,0,10,20,202,0.410891089,0.044554455,0.633663366,2,0.598681573
8888,85,21482,6,6,0,9,0,21,10,3,8,0,0,21,nowin,push,push,push,10,0,12,195,0.41025641,0.066666667,0.594871795,0,0.03269711
8889,134,21482,9,7,0,10,0,26,10,3,8,0,0,21,nowin,loss,bust,plbust,0,10,16,185,0.443243243,0.021621622,0.545945946,1,0.296939509
8890,4,21482,6,2,7,9,0,24,10,3,8,0,0,21,nowin,loss,bust,plbust,0,10,8,217,0.460829493,0.036866359,0.562211982,1,0.315432839
8891,44,21482,10,10,0,0,0,20,10,3,8,0,0,21,nowin,loss,beat,dlwin,0,10,20,219,0.433789954,0.050228311,0.534246575,1,0.285551035
8892,9,21483,10,9,0,0,0,19,3,2,10,8,0,23,nowin,win,dlbust,bust,20,0,19,194,0.37628866,0.015463918,0.541237113,0,0.009396796
8893,21,21483,7,10,0,0,0,17,3,2,10,8,0,23,nowin,win,dlbust,bust,20,0,17,214,0.359813084,0.042056075,0.626168224,0,0.025263474
8894,48,21483,8,11,0,0,0,19,3,2,10,8,0,23,nowin,win,dlbust,bust,20,0,19,203,0.413793103,0.019704433,0.600985222,2,0.577280801
8895,31,21483,3,10,0,0,0,13,3,2,10,8,0,23,nowin,win,dlbust,bust,20,0,13,188,0.473404255,0.058510638,0.515957447,1,0.300306557
8896,62,21483,2,4,8,0,0,14,3,2,10,8,0,23,nowin,win,dlbust,bust,20,0,6,178,0.370786517,0.028089888,0.54494382,0,0.008657722
8897,108,21483,11,10,0,0,0,21,3,2,10,8,0,23,win,win,dlbust,bust,25,0,21,193,0.435233161,0.056994819,0.559585492,1,0.298824795
8898,63,21484,8,5,0,0,0,13,6,3,10,0,0,19,nowin,loss,beat,dlwin,0,10,13,216,0.467592593,0.037037037,0.62037037,3,0.931690496
8899,29,21484,5,10,0,0,0,15,6,3,10,0,0,19,nowin,loss,beat,dlwin,0,10,15,189,0.44973545,0.058201058,0.544973545,1,0.300349439
8900,77,21484,7,7,0,0,0,14,6,3,10,0,0,19,nowin,loss,beat,dlwin,0,10,14,200,0.455,0.04,0.62,3,0.916252116
8901,75,21484,8,10,0,0,0,18,6,3,10,0,0,19,nowin,loss,beat,dlwin,0,10,18,191,0.418848168,0.052356021,0.570680628,0,0.029344702
8902,59,21484,4,10,0,0,0,14,6,3,10,0,0,19,nowin,loss,beat,dlwin,0,10,14,228,0.429824561,0.048245614,0.543859649,1,0.287885446
8903,73,21484,6,9,0,0,0,15,6,3,10,0,0,19,nowin,loss,beat,dlwin,0,10,15,181,0.375690608,0.011049724,0.596685083,0,0.022795773
8904,57,21485,5,5,10,0,0,20,4,10,10,0,0,24,nowin,win,dlbust,bust,20,0,10,192,0.46875,0.052083333,0.59375,3,0.907001181
8905,108,21485,9,8,0,0,0,17,4,10,10,0,0,24,nowin,win,dlbust,bust,20,0,17,193,0.435233161,0.056994819,0.559585492,1,0.298824795
8906,33,21485,10,7,0,0,0,17,4,10,10,0,0,24,nowin,win,dlbust,bust,20,0,17,192,0.4375,0.057291667,0.625,2,0.616208916
8907,92,21485,3,2,10,0,0,15,4,10,10,0,0,24,nowin,win,dlbust,bust,20,0,5,186,0.446236559,0.059139785,0.564516129,1,0.307826125
8908,95,21485,4,10,0,0,0,14,4,10,10,0,0,24,nowin,win,dlbust,bust,20,0,14,218,0.412844037,0.04587156,0.559633028,0,0.024842385
8909,140,21485,8,10,0,0,0,18,4,10,10,0,0,24,nowin,win,dlbust,bust,20,0,18,210,0.466666667,0.023809524,0.604761905,3,0.915293335
8910,102,21486,10,2,0,3,7,22,7,7,2,4,0,20,nowin,loss,bust,plbust,0,10,12,192,0.338541667,0.046875,0.5625,0,0.003306118
8911,38,21486,11,7,0,0,0,18,7,7,2,4,0,20,nowin,loss,beat,dlwin,0,10,18,202,0.361386139,0.03960396,0.564356436,0,0.010597953
8912,48,21486,3,2,10,6,0,21,7,7,2,4,0,20,nowin,win,plwin,beat,20,0,5,203,0.413793103,0.019704433,0.600985222,2,0.577280801
8913,33,21486,6,10,0,9,0,25,7,7,2,4,0,20,nowin,loss,bust,plbust,0,10,16,192,0.4375,0.057291667,0.625,2,0.616208916
8914,27,21486,9,7,0,2,0,18,7,7,2,4,0,20,nowin,loss,beat,dlwin,0,10,16,178,0.370786517,0.016853933,0.573033708,0,0.015536309
8915,66,21486,10,10,0,0,0,20,7,7,2,4,0,20,nowin,push,push,push,10,0,20,217,0.456221198,0.064516129,0.626728111,3,0.924304367
8916,61,21487,10,5,0,3,0,18,10,10,0,0,0,20,nowin,loss,beat,dlwin,0,10,15,194,0.427835052,0.077319588,0.603092784,2,0.591437139
8917,117,21487,7,6,0,10,0,23,10,10,0,0,0,20,nowin,loss,bust,plbust,0,10,13,173,0.410404624,0.069364162,0.606936416,2,0.578610282
8918,126,21487,6,3,10,0,0,19,10,10,0,0,0,20,nowin,loss,beat,dlwin,0,10,9,188,0.457446809,0.074468085,0.60106383,3,0.900633203
8919,86,21487,10,9,0,0,0,19,10,10,0,0,0,20,nowin,loss,beat,dlwin,0,10,19,196,0.454081633,0.040816327,0.591836735,3,0.887566443
8920,145,21487,4,7,8,0,0,19,10,10,0,0,0,20,nowin,loss,beat,dlwin,0,10,11,188,0.441489362,0.031914894,0.622340426,2,0.617837093
8921,62,21487,2,5,10,0,0,17,10,10,0,0,0,20,nowin,loss,beat,dlwin,0,10,7,178,0.370786517,0.028089888,0.54494382,0,0.008657722
8922,69,21488,2,10,0,3,4,19,10,10,0,0,0,20,nowin,loss,beat,dlwin,0,10,12,194,0.365979381,0.030927835,0.515463918,0,0
8923,7,21488,3,10,0,10,0,23,10,10,0,0,0,20,nowin,loss,bust,plbust,0,10,13,183,0.442622951,0.06010929,0.62295082,2,0.619303341
8924,130,21488,11,9,0,0,0,20,10,10,0,0,0,20,nowin,push,push,push,10,0,20,219,0.410958904,0.03652968,0.566210046,0,0.025888739
8925,13,21488,11,5,2,0,0,18,10,10,0,0,0,20,nowin,loss,beat,dlwin,0,10,16,206,0.417475728,0.063106796,0.621359223,2,0.59555479
8926,57,21488,6,11,1,0,0,18,10,10,0,0,0,20,nowin,loss,beat,dlwin,0,10,17,192,0.46875,0.052083333,0.59375,3,0.907001181
8927,24,21488,10,4,0,10,0,24,10,10,0,0,0,20,nowin,loss,bust,plbust,0,10,14,207,0.458937198,0.048309179,0.570048309,1,0.318138014
8928,33,21489,10,10,0,0,0,20,10,11,0,0,0,21,nowin,loss,beat,dlwin,0,10,20,192,0.4375,0.057291667,0.625,2,0.616208916
8929,24,21489,5,9,0,7,0,21,10,11,0,0,0,21,nowin,push,push,push,10,0,14,207,0.458937198,0.048309179,0.570048309,1,0.318138014
8930,1,21489,10,10,0,0,0,20,10,11,0,0,0,21,nowin,loss,beat,dlwin,0,10,20,197,0.406091371,0.025380711,0.649746193,2,0.606186955
8931,75,21489,6,3,6,10,0,25,10,11,0,0,0,21,nowin,loss,bust,plbust,0,10,9,191,0.418848168,0.052356021,0.570680628,0,0.029344702
8932,102,21489,4,9,0,10,0,23,10,11,0,0,0,21,nowin,loss,bust,plbust,0,10,13,192,0.338541667,0.046875,0.5625,0,0.003306118
8933,6,21489,9,5,0,5,0,19,10,11,0,0,0,21,nowin,loss,beat,dlwin,0,10,14,191,0.439790576,0.047120419,0.581151832,1,0.31211505
8934,2,21490,5,10,0,0,0,15,6,8,8,0,0,22,nowin,win,dlbust,bust,20,0,15,200,0.445,0.035,0.64,2,0.633962549
8935,7,21490,9,7,0,0,0,16,6,8,8,0,0,22,nowin,win,dlbust,bust,20,0,16,183,0.442622951,0.06010929,0.62295082,2,0.619303341
8936,147,21490,5,5,10,0,0,20,6,8,8,0,0,22,nowin,win,dlbust,bust,20,0,10,205,0.380487805,0.014634146,0.536585366,0,0.00951447
8937,138,21490,10,2,0,0,0,12,6,8,8,0,0,22,nowin,win,dlbust,bust,20,0,12,190,0.442105263,0.047368421,0.610526316,2,0.609711065
8938,95,21490,9,10,0,0,0,19,6,8,8,0,0,22,nowin,win,dlbust,bust,20,0,19,218,0.412844037,0.04587156,0.559633028,0,0.024842385
8939,120,21490,10,5,0,0,0,15,6,8,8,0,0,22,nowin,win,dlbust,bust,20,0,15,202,0.440594059,0.034653465,0.618811881,2,0.614441029
8940,80,21491,9,4,0,0,0,13,5,9,10,0,0,24,nowin,win,dlbust,bust,20,0,13,186,0.419354839,0.059139785,0.623655914,2,0.59892924
8941,22,21491,7,7,0,0,0,14,5,9,10,0,0,24,nowin,win,dlbust,bust,20,0,14,187,0.481283422,0.042780749,0.577540107,3,0.906128176
8942,96,21491,11,8,0,0,0,19,5,9,10,0,0,24,nowin,win,dlbust,bust,20,0,19,190,0.468421053,0.057894737,0.584210526,3,0.897263354
8943,108,21491,5,6,10,0,0,21,5,9,10,0,0,24,nowin,win,dlbust,bust,20,0,11,193,0.435233161,0.056994819,0.559585492,1,0.298824795
8944,105,21491,10,10,0,0,0,20,5,9,10,0,0,24,nowin,win,dlbust,bust,20,0,20,198,0.414141414,0.070707071,0.590909091,0,0.032889494
8945,105,21491,10,10,0,0,0,20,5,9,10,0,0,24,nowin,win,dlbust,bust,20,0,20,198,0.414141414,0.070707071,0.590909091,0,0.032889494
8946,26,21492,10,10,0,0,0,20,8,10,0,0,0,18,nowin,win,plwin,beat,20,0,20,203,0.463054187,0.0591133,0.541871921,1,0.306802864
8947,68,21492,8,3,4,2,0,17,8,10,0,0,0,18,nowin,loss,beat,dlwin,0,10,11,205,0.434146341,0.029268293,0.6,2,0.59483189
8948,32,21492,11,4,5,0,0,20,8,10,0,0,0,18,nowin,win,plwin,beat,20,0,15,189,0.391534392,0.037037037,0.53968254,0,0.013579086
8949,5,21492,4,1,9,6,0,20,8,10,0,0,0,18,nowin,win,plwin,beat,20,0,5,203,0.42364532,0.02955665,0.596059113,2,0.582508076
8950,140,21492,6,9,0,3,0,18,8,10,0,0,0,18,nowin,push,push,push,10,0,15,210,0.466666667,0.023809524,0.604761905,3,0.915293335
8951,97,21492,2,10,0,7,0,19,8,10,0,0,0,18,nowin,win,plwin,beat,20,0,12,182,0.450549451,0.06043956,0.692307692,2,0.677372279
8952,67,21493,6,7,0,6,0,19,1,3,10,3,0,17,nowin,win,plwin,beat,20,0,13,195,0.369230769,0.041025641,0.569230769,0,0.014139427
8953,48,21493,10,10,0,0,0,20,1,3,10,3,0,17,nowin,win,plwin,beat,20,0,20,203,0.413793103,0.019704433,0.600985222,2,0.577280801
8954,50,21493,10,11,0,0,0,21,1,3,10,3,0,17,win,win,plwin,beat,25,0,21,202,0.405940594,0.04950495,0.54950495,0,0.020296079
8955,114,21493,9,5,0,3,0,17,1,3,10,3,0,17,nowin,push,push,push,10,0,14,198,0.47979798,0.025252525,0.611111111,3,0.937232995
8956,19,21493,10,5,0,7,0,22,1,3,10,3,0,17,nowin,loss,bust,plbust,0,10,15,237,0.41350211,0.054852321,0.628691983,2,0.597373826
8957,29,21493,10,10,0,0,0,20,1,3,10,3,0,17,nowin,win,plwin,beat,20,0,20,189,0.44973545,0.058201058,0.544973545,1,0.300349439
8958,17,21494,2,7,10,0,0,19,9,8,0,0,0,17,nowin,win,plwin,beat,20,0,9,171,0.444444444,0.070175439,0.555555556,1,0.302364894
8959,123,21494,3,4,2,7,10,26,9,8,0,0,0,17,nowin,loss,bust,plbust,0,10,7,205,0.43902439,0.034146341,0.614634146,2,0.609962544
8960,132,21494,7,10,0,0,0,17,9,8,0,0,0,17,nowin,push,push,push,10,0,17,194,0.412371134,0.036082474,0.649484536,2,0.611633238
8961,24,21494,10,7,0,0,0,17,9,8,0,0,0,17,nowin,push,push,push,10,0,17,207,0.458937198,0.048309179,0.570048309,1,0.318138014
8962,43,21494,9,10,0,0,0,19,9,8,0,0,0,17,nowin,win,plwin,beat,20,0,19,192,0.40625,0.041666667,0.609375,2,0.576671372
8963,123,21494,10,4,0,5,0,19,9,8,0,0,0,17,nowin,win,plwin,beat,20,0,14,205,0.43902439,0.034146341,0.614634146,2,0.609962544
8964,145,21495,3,9,0,9,0,21,10,6,10,0,0,26,nowin,win,dlbust,bust,20,0,12,188,0.441489362,0.031914894,0.622340426,2,0.617837093
8965,43,21495,10,11,0,0,0,21,10,6,10,0,0,26,win,win,dlbust,bust,25,0,21,192,0.40625,0.041666667,0.609375,2,0.576671372
8966,35,21495,2,6,5,8,0,21,10,6,10,0,0,26,nowin,win,dlbust,bust,20,0,8,202,0.410891089,0.044554455,0.633663366,2,0.598681573
8967,20,21495,4,10,0,6,0,20,10,6,10,0,0,26,nowin,win,dlbust,bust,20,0,14,186,0.456989247,0.037634409,0.537634409,1,0.301097108
8968,16,21495,10,7,0,0,0,17,10,6,10,0,0,26,nowin,win,dlbust,bust,20,0,17,220,0.427272727,0.081818182,0.6,2,0.588660176
8969,57,21495,8,4,0,3,1,16,10,6,10,0,0,26,nowin,win,dlbust,bust,20,0,12,192,0.46875,0.052083333,0.59375,3,0.907001181
8970,80,21496,10,3,0,0,0,13,6,10,10,0,0,26,nowin,win,dlbust,bust,20,0,13,186,0.419354839,0.059139785,0.623655914,2,0.59892924
8971,91,21496,6,9,0,0,0,15,6,10,10,0,0,26,nowin,win,dlbust,bust,20,0,15,194,0.417525773,0.046391753,0.515463918,1,0.266616552
8972,43,21496,9,10,0,0,0,19,6,10,10,0,0,26,nowin,win,dlbust,bust,20,0,19,192,0.40625,0.041666667,0.609375,2,0.576671372
8973,31,21496,11,10,0,0,0,21,6,10,10,0,0,26,win,win,dlbust,bust,25,0,21,188,0.473404255,0.058510638,0.515957447,1,0.300306557
8974,39,21496,10,10,0,0,0,20,6,10,10,0,0,26,nowin,win,dlbust,bust,20,0,20,191,0.429319372,0.062827225,0.57591623,0,0.033760763
8975,49,21496,5,2,4,5,0,16,6,10,10,0,0,26,nowin,win,dlbust,bust,20,0,7,207,0.396135266,0.053140097,0.594202899,0,0.028306925
8976,64,21497,6,9,0,0,0,15,3,1,10,4,0,18,nowin,loss,beat,dlwin,0,10,15,187,0.363636364,0.048128342,0.631016043,0,0.027594885
8977,32,21497,10,2,0,10,0,22,3,1,10,4,0,18,nowin,loss,bust,plbust,0,10,12,189,0.391534392,0.037037037,0.53968254,0,0.013579086
8978,100,21497,3,1,8,10,0,22,3,1,10,4,0,18,nowin,loss,bust,plbust,0,10,4,190,0.452631579,0.036842105,0.594736842,3,0.888671154
8979,63,21497,2,10,0,5,0,17,3,1,10,4,0,18,nowin,loss,beat,dlwin,0,10,12,216,0.467592593,0.037037037,0.62037037,3,0.931690496
8980,132,21497,10,5,0,0,0,15,3,1,10,4,0,18,nowin,loss,beat,dlwin,0,10,15,194,0.412371134,0.036082474,0.649484536,2,0.611633238
8981,7,21497,10,3,0,0,0,13,3,1,10,4,0,18,nowin,loss,beat,dlwin,0,10,13,183,0.442622951,0.06010929,0.62295082,2,0.619303341
8982,102,21498,9,10,0,0,0,19,5,6,3,9,0,23,nowin,win,dlbust,bust,20,0,19,192,0.338541667,0.046875,0.5625,0,0.003306118
8983,85,21498,10,5,0,0,0,15,5,6,3,9,0,23,nowin,win,dlbust,bust,20,0,15,195,0.41025641,0.066666667,0.594871795,0,0.03269711
8984,143,21498,10,8,0,0,0,18,5,6,3,9,0,23,nowin,win,dlbust,bust,20,0,18,203,0.463054187,0.044334975,0.57635468,3,0.883143365
8985,38,21498,7,10,0,0,0,17,5,6,3,9,0,23,nowin,win,dlbust,bust,20,0,17,202,0.361386139,0.03960396,0.564356436,0,0.010597953
8986,93,21498,7,6,0,0,0,13,5,6,3,9,0,23,nowin,win,dlbust,bust,20,0,13,175,0.485714286,0.051428571,0.548571429,1,0.323648091
8987,135,21498,9,4,0,0,0,13,5,6,3,9,0,23,nowin,win,dlbust,bust,20,0,13,179,0.391061453,0.067039106,0.586592179,0,0.024924662
8988,32,21499,10,5,0,3,0,18,10,5,9,0,0,24,nowin,win,dlbust,bust,20,0,15,189,0.391534392,0.037037037,0.53968254,0,0.013579086
8989,130,21499,9,9,0,0,0,18,10,5,9,0,0,24,nowin,win,dlbust,bust,20,0,18,219,0.410958904,0.03652968,0.566210046,0,0.025888739
8990,99,21499,2,10,0,10,0,22,10,5,9,0,0,24,nowin,loss,bust,plbust,0,10,12,207,0.47826087,0.062801932,0.637681159,3,0.961418446
8991,146,21499,4,10,0,2,8,24,10,5,9,0,0,24,nowin,loss,bust,plbust,0,10,14,221,0.43438914,0.040723982,0.542986425,1,0.290190091
8992,28,21499,3,10,0,3,10,26,10,5,9,0,0,24,nowin,loss,bust,plbust,0,10,13,199,0.422110553,0.045226131,0.542713568,1,0.282706618
8993,64,21499,7,2,10,0,0,19,10,5,9,0,0,24,nowin,win,dlbust,bust,20,0,9,187,0.363636364,0.048128342,0.631016043,0,0.027594885
8994,83,21500,7,7,0,6,0,20,7,5,5,0,0,17,nowin,win,plwin,beat,20,0,14,193,0.424870466,0.051813472,0.678756477,2,0.644360335
8995,16,21500,7,3,11,0,0,21,7,5,5,0,0,17,nowin,win,plwin,beat,20,0,10,220,0.427272727,0.081818182,0.6,2,0.588660176
8996,116,21500,10,11,0,0,0,21,7,5,5,0,0,17,win,win,plwin,beat,25,0,21,195,0.425641026,0.056410256,0.538461538,1,0.28273747
8997,143,21500,10,10,0,0,0,20,7,5,5,0,0,17,nowin,win,plwin,beat,20,0,20,203,0.463054187,0.044334975,0.57635468,3,0.883143365
8998,100,21500,11,10,0,0,0,21,7,5,5,0,0,17,win,win,plwin,beat,25,0,21,190,0.452631579,0.036842105,0.594736842,3,0.888671154
8999,88,21500,1,5,10,7,0,23,7,5,5,0,0,17,nowin,loss,bust,plbust,0,10,6,206,0.466019417,0.033980583,0.54368932,1,0.309467903
9000,140,21501,4,1,9,0,0,14,6,2,10,0,0,18,nowin,loss,beat,dlwin,0,10,5,210,0.466666667,0.023809524,0.604761905,3,0.915293335
9001,149,21501,3,3,4,7,0,17,6,2,10,0,0,18,nowin,loss,beat,dlwin,0,10,6,225,0.457777778,0.057777778,0.648888889,2,0.651965595
9002,58,21501,5,6,10,0,0,21,6,2,10,0,0,18,nowin,win,plwin,beat,20,0,11,195,0.430769231,0.041025641,0.584615385,2,0.580497586
9003,52,21501,10,10,0,0,0,20,6,2,10,0,0,18,nowin,win,plwin,beat,20,0,20,217,0.414746544,0.02764977,0.599078341,2,0.576736024
9004,113,21501,9,4,0,0,0,13,6,2,10,0,0,18,nowin,loss,beat,dlwin,0,10,13,199,0.407035176,0.055276382,0.668341709,2,0.620695264
9005,93,21501,2,6,8,0,0,16,6,2,10,0,0,18,nowin,loss,beat,dlwin,0,10,8,175,0.485714286,0.051428571,0.548571429,1,0.323648091
9006,10,21502,10,8,0,0,0,18,5,3,9,0,0,17,nowin,win,plwin,beat,20,0,18,191,0.413612565,0.057591623,0.596858639,2,0.574087175
9007,96,21502,10,10,0,0,0,20,5,3,9,0,0,17,nowin,win,plwin,beat,20,0,20,190,0.468421053,0.057894737,0.584210526,3,0.897263354
9008,73,21502,10,8,0,0,0,18,5,3,9,0,0,17,nowin,win,plwin,beat,20,0,18,181,0.375690608,0.011049724,0.596685083,0,0.022795773
9009,117,21502,5,9,0,0,0,14,5,3,9,0,0,17,nowin,loss,beat,dlwin,0,10,14,173,0.410404624,0.069364162,0.606936416,2,0.578610282
9010,126,21502,6,7,0,0,0,13,5,3,9,0,0,17,nowin,loss,beat,dlwin,0,10,13,188,0.457446809,0.074468085,0.60106383,3,0.900633203
9011,47,21502,10,7,0,0,0,17,5,3,9,0,0,17,nowin,push,push,push,10,0,17,210,0.438095238,0.057142857,0.623809524,2,0.615868808
9012,23,21503,3,1,8,5,0,17,2,3,10,9,0,24,nowin,win,dlbust,bust,20,0,4,208,0.427884615,0.0625,0.552884615,1,0.29114424
9013,26,21503,10,8,0,0,0,18,2,3,10,9,0,24,nowin,win,dlbust,bust,20,0,18,203,0.463054187,0.0591133,0.541871921,1,0.306802864
9014,106,21503,8,2,5,0,0,15,2,3,10,9,0,24,nowin,win,dlbust,bust,20,0,10,192,0.411458333,0.026041667,0.557291667,0,0.023854304
9015,51,21503,3,7,10,0,0,20,2,3,10,9,0,24,nowin,win,dlbust,bust,20,0,10,189,0.529100529,0.068783069,0.608465608,3,0.993665715
9016,29,21503,10,11,0,0,0,21,2,3,10,9,0,24,win,win,dlbust,bust,25,0,21,189,0.44973545,0.058201058,0.544973545,1,0.300349439
9017,139,21503,10,2,0,10,0,22,2,3,10,9,0,24,nowin,loss,bust,plbust,0,10,12,192,0.380208333,0.036458333,0.59375,0,0.023429169
9018,56,21504,4,7,5,5,0,21,11,5,3,0,0,19,nowin,win,plwin,beat,20,0,11,175,0.4,0.057142857,0.582857143,0,0.026685297
9019,102,21504,1,6,10,0,0,17,11,5,3,0,0,19,nowin,loss,beat,dlwin,0,10,7,192,0.338541667,0.046875,0.5625,0,0.003306118
9020,36,21504,5,6,9,0,0,20,11,5,3,0,0,19,nowin,win,plwin,beat,20,0,11,229,0.445414847,0.056768559,0.655021834,2,0.645370571
9021,35,21504,4,10,0,3,0,17,11,5,3,0,0,19,nowin,loss,beat,dlwin,0,10,14,202,0.410891089,0.044554455,0.633663366,2,0.598681573
9022,121,21504,10,8,0,0,0,18,11,5,3,0,0,19,nowin,loss,beat,dlwin,0,10,18,195,0.456410256,0.025641026,0.512820513,1,0.288597791
9023,123,21504,10,2,0,2,2,16,11,5,3,0,0,19,nowin,loss,beat,dlwin,0,10,12,205,0.43902439,0.034146341,0.614634146,2,0.609962544
9024,80,21505,7,9,0,10,0,26,8,9,0,0,0,17,nowin,loss,bust,plbust,0,10,16,186,0.419354839,0.059139785,0.623655914,2,0.59892924
9025,61,21505,10,10,0,0,0,20,8,9,0,0,0,17,nowin,win,plwin,beat,20,0,20,194,0.427835052,0.077319588,0.603092784,2,0.591437139
9026,25,21505,7,11,0,0,0,18,8,9,0,0,0,17,nowin,win,plwin,beat,20,0,18,190,0.463157895,0.063157895,0.536842105,1,0.304401563
9027,131,21505,5,4,8,0,0,17,8,9,0,0,0,17,nowin,push,push,push,10,0,9,217,0.410138249,0.069124424,0.543778802,0,0.02015021
9028,51,21505,5,11,5,0,0,21,8,9,0,0,0,17,nowin,win,plwin,beat,20,0,16,189,0.529100529,0.068783069,0.608465608,3,0.993665715
9029,62,21505,4,10,0,5,0,19,8,9,0,0,0,17,nowin,win,plwin,beat,20,0,14,178,0.370786517,0.028089888,0.54494382,0,0.008657722
9030,102,21506,4,4,10,0,0,18,9,11,0,0,0,20,nowin,loss,beat,dlwin,0,10,8,192,0.338541667,0.046875,0.5625,0,0.003306118
9031,37,21506,11,5,4,0,0,20,9,11,0,0,0,20,nowin,push,push,push,10,0,16,208,0.394230769,0.038461538,0.581730769,0,0.024682772
9032,141,21506,4,10,0,2,4,20,9,11,0,0,0,20,nowin,push,push,push,10,0,14,202,0.420792079,0.074257426,0.564356436,0,0.028377851
9033,77,21506,11,1,1,2,7,22,9,11,0,0,0,20,nowin,loss,bust,plbust,0,10,12,200,0.455,0.04,0.62,3,0.916252116
9034,103,21506,4,10,0,8,0,22,9,11,0,0,0,20,nowin,loss,bust,plbust,0,10,14,203,0.379310345,0.064039409,0.551724138,0,0.012869209
9035,66,21506,10,10,0,0,0,20,9,11,0,0,0,20,nowin,push,push,push,10,0,20,217,0.456221198,0.064516129,0.626728111,3,0.924304367
9036,41,21507,6,1,8,0,0,15,4,10,10,0,0,24,nowin,win,dlbust,bust,20,0,7,192,0.364583333,0.036458333,0.520833333,0,0.00089702
9037,100,21507,10,10,0,0,0,20,4,10,10,0,0,24,nowin,win,dlbust,bust,20,0,20,190,0.452631579,0.036842105,0.594736842,3,0.888671154
9038,98,21507,10,6,0,0,0,16,4,10,10,0,0,24,nowin,win,dlbust,bust,20,0,16,220,0.422727273,0.054545455,0.55,1,0.28664435
9039,97,21507,9,10,0,0,0,19,4,10,10,0,0,24,nowin,win,dlbust,bust,20,0,19,182,0.450549451,0.06043956,0.692307692,2,0.677372279
9040,27,21507,6,10,0,0,0,16,4,10,10,0,0,24,nowin,win,dlbust,bust,20,0,16,178,0.370786517,0.016853933,0.573033708,0,0.015536309
9041,84,21507,10,11,0,0,0,21,4,10,10,0,0,24,win,win,dlbust,bust,25,0,21,195,0.379487179,0.056410256,0.569230769,0,0.017209119
9042,123,21508,8,10,0,0,0,18,2,7,11,0,0,20,nowin,loss,beat,dlwin,0,10,18,205,0.43902439,0.034146341,0.614634146,2,0.609962544
9043,144,21508,3,10,0,0,0,13,2,7,11,0,0,20,nowin,loss,beat,dlwin,0,10,13,202,0.386138614,0.054455446,0.564356436,0,0.018006244
9044,104,21508,3,8,2,0,0,13,2,7,11,0,0,20,nowin,loss,beat,dlwin,0,10,11,209,0.363636364,0.052631579,0.593301435,0,0.018359419
9045,82,21508,10,10,0,0,0,20,2,7,11,0,0,20,nowin,push,push,push,10,0,20,225,0.408888889,0.075555556,0.577777778,0,0.028101874
9046,66,21508,2,10,0,10,0,22,2,7,11,0,0,20,nowin,loss,bust,plbust,0,10,12,217,0.456221198,0.064516129,0.626728111,3,0.924304367
9047,141,21508,8,10,0,0,0,18,2,7,11,0,0,20,nowin,loss,beat,dlwin,0,10,18,202,0.420792079,0.074257426,0.564356436,0,0.028377851
9048,59,21509,11,4,6,0,0,21,10,10,0,0,0,20,nowin,win,plwin,beat,20,0,15,228,0.429824561,0.048245614,0.543859649,1,0.287885446
9049,39,21509,7,5,0,10,0,22,10,10,0,0,0,20,nowin,loss,bust,plbust,0,10,12,191,0.429319372,0.062827225,0.57591623,0,0.033760763
9050,78,21509,5,7,0,3,7,22,10,10,0,0,0,20,nowin,loss,bust,plbust,0,10,12,201,0.517412935,0.034825871,0.587064677,3,0.95871112
9051,131,21509,2,4,10,10,0,26,10,10,0,0,0,20,nowin,loss,bust,plbust,0,10,6,217,0.410138249,0.069124424,0.543778802,0,0.02015021
9052,86,21509,7,5,0,7,0,19,10,10,0,0,0,20,nowin,loss,beat,dlwin,0,10,12,196,0.454081633,0.040816327,0.591836735,3,0.887566443
9053,62,21509,6,6,0,9,0,21,10,10,0,0,0,20,nowin,win,plwin,beat,20,0,12,178,0.370786517,0.028089888,0.54494382,0,0.008657722
9054,95,21510,7,4,3,5,0,19,10,4,1,9,0,24,nowin,win,dlbust,bust,20,0,11,218,0.412844037,0.04587156,0.559633028,0,0.024842385
9055,89,21510,10,10,0,0,0,20,10,4,1,9,0,24,nowin,win,dlbust,bust,20,0,20,212,0.537735849,0.047169811,0.594339623,3,0.990167191
9056,15,21510,10,9,0,0,0,19,10,4,1,9,0,24,nowin,win,dlbust,bust,20,0,19,212,0.410377358,0.051886792,0.561320755,0,0.024517408
9057,82,21510,10,4,0,8,0,22,10,4,1,9,0,24,nowin,loss,bust,plbust,0,10,14,225,0.408888889,0.075555556,0.577777778,0,0.028101874
9058,149,21510,2,10,0,2,10,24,10,4,1,9,0,24,nowin,loss,bust,plbust,0,10,12,225,0.457777778,0.057777778,0.648888889,2,0.651965595
9059,64,21510,9,10,0,0,0,19,10,4,1,9,0,24,nowin,win,dlbust,bust,20,0,19,187,0.363636364,0.048128342,0.631016043,0,0.027594885
9060,117,21511,4,2,10,0,0,16,4,10,3,0,0,17,nowin,loss,beat,dlwin,0,10,6,173,0.410404624,0.069364162,0.606936416,2,0.578610282
9061,58,21511,6,10,0,0,0,16,4,10,3,0,0,17,nowin,loss,beat,dlwin,0,10,16,195,0.430769231,0.041025641,0.584615385,2,0.580497586
9062,118,21511,1,3,10,0,0,14,4,10,3,0,0,17,nowin,loss,beat,dlwin,0,10,4,216,0.393518519,0.037037037,0.555555556,0,0.018059873
9063,67,21511,9,5,0,0,0,14,4,10,3,0,0,17,nowin,loss,beat,dlwin,0,10,14,195,0.369230769,0.041025641,0.569230769,0,0.014139427
9064,83,21511,5,6,4,0,0,15,4,10,3,0,0,17,nowin,loss,beat,dlwin,0,10,11,193,0.424870466,0.051813472,0.678756477,2,0.644360335
9065,139,21511,3,6,7,0,0,16,4,10,3,0,0,17,nowin,loss,beat,dlwin,0,10,9,192,0.380208333,0.036458333,0.59375,0,0.023429169
9066,108,21512,10,10,0,0,0,20,7,8,9,0,0,24,nowin,win,dlbust,bust,20,0,20,193,0.435233161,0.056994819,0.559585492,1,0.298824795
9067,48,21512,10,9,0,0,0,19,7,8,9,0,0,24,nowin,win,dlbust,bust,20,0,19,203,0.413793103,0.019704433,0.600985222,2,0.577280801
9068,24,21512,7,10,0,0,0,17,7,8,9,0,0,24,nowin,win,dlbust,bust,20,0,17,207,0.458937198,0.048309179,0.570048309,1,0.318138014
9069,120,21512,10,3,0,6,0,19,7,8,9,0,0,24,nowin,win,dlbust,bust,20,0,13,202,0.440594059,0.034653465,0.618811881,2,0.614441029
9070,108,21512,10,10,0,0,0,20,7,8,9,0,0,24,nowin,win,dlbust,bust,20,0,20,193,0.435233161,0.056994819,0.559585492,1,0.298824795
9071,51,21512,4,5,5,6,0,20,7,8,9,0,0,24,nowin,win,dlbust,bust,20,0,9,189,0.529100529,0.068783069,0.608465608,3,0.993665715
9072,72,21513,8,10,0,0,0,18,2,10,2,7,0,21,nowin,loss,beat,dlwin,0,10,18,185,0.394594595,0.032432432,0.508108108,0,0.006763115
9073,74,21513,10,6,0,0,0,16,2,10,2,7,0,21,nowin,loss,beat,dlwin,0,10,16,209,0.411483254,0.04784689,0.531100478,0,0.017448125
9074,91,21513,10,10,0,0,0,20,2,10,2,7,0,21,nowin,loss,beat,dlwin,0,10,20,194,0.417525773,0.046391753,0.515463918,1,0.266616552
9075,150,21513,10,9,0,0,0,19,2,10,2,7,0,21,nowin,loss,beat,dlwin,0,10,19,192,0.401041667,0.036458333,0.567708333,0,0.023287458
9076,147,21513,9,10,0,0,0,19,2,10,2,7,0,21,nowin,loss,beat,dlwin,0,10,19,205,0.380487805,0.014634146,0.536585366,0,0.00951447
9077,94,21513,10,3,0,0,0,13,2,10,2,7,0,21,nowin,loss,beat,dlwin,0,10,13,183,0.43715847,0.043715847,0.540983607,1,0.290866892
9078,133,21514,2,3,10,0,0,15,2,9,3,5,0,19,nowin,loss,beat,dlwin,0,10,5,201,0.47761194,0.064676617,0.611940299,3,0.935428111
9079,34,21514,7,10,0,0,0,17,2,9,3,5,0,19,nowin,loss,beat,dlwin,0,10,17,202,0.5,0.079207921,0.618811881,3,0.968961434
9080,30,21514,3,3,3,5,0,14,2,9,3,5,0,19,nowin,loss,beat,dlwin,0,10,6,206,0.393203883,0.033980583,0.601941748,0,0.029324648
9081,70,21514,2,10,0,3,0,15,2,9,3,5,0,19,nowin,loss,beat,dlwin,0,10,12,228,0.385964912,0.039473684,0.557017544,0,0.016157125
9082,23,21514,8,6,0,0,0,14,2,9,3,5,0,19,nowin,loss,beat,dlwin,0,10,14,208,0.427884615,0.0625,0.552884615,1,0.29114424
9083,87,21514,7,11,0,0,0,18,2,9,3,5,0,19,nowin,loss,beat,dlwin,0,10,18,202,0.405940594,0.054455446,0.628712871,2,0.590599801
9084,62,21515,8,5,0,10,0,23,10,10,0,0,0,20,nowin,loss,bust,plbust,0,10,13,178,0.370786517,0.028089888,0.54494382,0,0.008657722
9085,49,21515,10,10,0,0,0,20,10,10,0,0,0,20,nowin,push,push,push,10,0,20,207,0.396135266,0.053140097,0.594202899,0,0.028306925
9086,45,21515,7,10,0,0,0,17,10,10,0,0,0,20,nowin,loss,beat,dlwin,0,10,17,196,0.428571429,0.051020408,0.612244898,2,0.598821767
9087,28,21515,2,5,2,4,6,19,10,10,0,0,0,20,nowin,loss,beat,dlwin,0,10,7,199,0.422110553,0.045226131,0.542713568,1,0.282706618
9088,114,21515,9,9,0,0,0,18,10,10,0,0,0,20,nowin,loss,beat,dlwin,0,10,18,198,0.47979798,0.025252525,0.611111111,3,0.937232995
9089,129,21515,10,10,0,0,0,20,10,10,0,0,0,20,nowin,push,push,push,10,0,20,201,0.422885572,0.064676617,0.55721393,0,0.027255383
9090,3,21516,10,10,0,0,0,20,10,10,0,0,0,20,nowin,push,push,push,10,0,20,190,0.431578947,0.026315789,0.542105263,1,0.288076384
9091,64,21516,3,6,8,0,0,17,10,10,0,0,0,20,nowin,loss,beat,dlwin,0,10,9,187,0.363636364,0.048128342,0.631016043,0,0.027594885
9092,148,21516,10,2,0,7,0,19,10,10,0,0,0,20,nowin,loss,beat,dlwin,0,10,12,204,0.401960784,0.078431373,0.593137255,0,0.029789521
9093,130,21516,6,8,0,2,10,26,10,10,0,0,0,20,nowin,loss,bust,plbust,0,10,14,219,0.410958904,0.03652968,0.566210046,0,0.025888739
9094,111,21516,10,6,0,10,0,26,10,10,0,0,0,20,nowin,loss,bust,plbust,0,10,16,180,0.433333333,0.055555556,0.611111111,2,0.602264492
9095,1,21516,3,4,5,7,0,19,10,10,0,0,0,20,nowin,loss,beat,dlwin,0,10,7,197,0.406091371,0.025380711,0.649746193,2,0.606186955
9096,149,21517,6,7,0,0,0,13,3,6,5,10,0,24,nowin,win,dlbust,bust,20,0,13,225,0.457777778,0.057777778,0.648888889,2,0.651965595
9097,4,21517,10,10,0,0,0,20,3,6,5,10,0,24,nowin,win,dlbust,bust,20,0,20,217,0.460829493,0.036866359,0.562211982,1,0.315432839
9098,132,21517,11,10,0,0,0,21,3,6,5,10,0,24,win,win,dlbust,bust,25,0,21,194,0.412371134,0.036082474,0.649484536,2,0.611633238
9099,13,21517,10,2,0,5,0,17,3,6,5,10,0,24,nowin,win,dlbust,bust,20,0,12,206,0.417475728,0.063106796,0.621359223,2,0.59555479
9100,145,21517,10,7,0,0,0,17,3,6,5,10,0,24,nowin,win,dlbust,bust,20,0,17,188,0.441489362,0.031914894,0.622340426,2,0.617837093
9101,96,21517,9,11,0,0,0,20,3,6,5,10,0,24,nowin,win,dlbust,bust,20,0,20,190,0.468421053,0.057894737,0.584210526,3,0.897263354
9102,86,21518,10,9,0,0,0,19,5,5,8,0,0,18,nowin,win,plwin,beat,20,0,19,196,0.454081633,0.040816327,0.591836735,3,0.887566443
9103,20,21518,5,9,0,0,0,14,5,5,8,0,0,18,nowin,loss,beat,dlwin,0,10,14,186,0.456989247,0.037634409,0.537634409,1,0.301097108
9104,42,21518,4,10,0,0,0,14,5,5,8,0,0,18,nowin,loss,beat,dlwin,0,10,14,212,0.443396226,0.051886792,0.570754717,1,0.309181312
9105,7,21518,3,2,3,3,7,18,5,5,8,0,0,18,nowin,push,push,push,10,0,5,183,0.442622951,0.06010929,0.62295082,2,0.619303341
9106,42,21518,3,8,2,0,0,13,5,5,8,0,0,18,nowin,loss,beat,dlwin,0,10,11,212,0.443396226,0.051886792,0.570754717,1,0.309181312
9107,1,21518,8,10,0,0,0,18,5,5,8,0,0,18,nowin,push,push,push,10,0,18,197,0.406091371,0.025380711,0.649746193,2,0.606186955
9108,125,21519,10,11,0,0,0,21,10,10,0,0,0,20,win,win,plwin,beat,25,0,21,219,0.438356164,0.050228311,0.575342466,1,0.308411257
9109,118,21519,2,11,2,10,0,25,10,10,0,0,0,20,nowin,loss,bust,plbust,0,10,13,216,0.393518519,0.037037037,0.555555556,0,0.018059873
9110,13,21519,10,5,0,2,0,17,10,10,0,0,0,20,nowin,loss,beat,dlwin,0,10,15,206,0.417475728,0.063106796,0.621359223,2,0.59555479
9111,99,21519,10,4,0,10,0,24,10,10,0,0,0,20,nowin,loss,bust,plbust,0,10,14,207,0.47826087,0.062801932,0.637681159,3,0.961418446
9112,149,21519,7,4,9,0,0,20,10,10,0,0,0,20,nowin,push,push,push,10,0,11,225,0.457777778,0.057777778,0.648888889,2,0.651965595
9113,77,21519,11,8,0,0,0,19,10,10,0,0,0,20,nowin,loss,beat,dlwin,0,10,19,200,0.455,0.04,0.62,3,0.916252116
9114,53,21520,1,5,10,6,0,22,9,3,8,0,0,20,nowin,loss,bust,plbust,0,10,6,250,0.372,0.064,0.564,0,0.013687345
9115,130,21520,6,4,8,0,0,18,9,3,8,0,0,20,nowin,loss,beat,dlwin,0,10,10,219,0.410958904,0.03652968,0.566210046,0,0.025888739
9116,50,21520,5,2,10,0,0,17,9,3,8,0,0,20,nowin,loss,beat,dlwin,0,10,7,202,0.405940594,0.04950495,0.54950495,0,0.020296079
9117,86,21520,10,3,0,6,0,19,9,3,8,0,0,20,nowin,loss,beat,dlwin,0,10,13,196,0.454081633,0.040816327,0.591836735,3,0.887566443
9118,87,21520,7,5,0,5,0,17,9,3,8,0,0,20,nowin,loss,beat,dlwin,0,10,12,202,0.405940594,0.054455446,0.628712871,2,0.590599801
9119,145,21520,2,2,6,10,0,20,9,3,8,0,0,20,nowin,push,push,push,10,0,4,188,0.441489362,0.031914894,0.622340426,2,0.617837093
9120,94,21521,3,4,3,10,0,20,3,3,6,7,0,19,nowin,win,plwin,beat,20,0,7,183,0.43715847,0.043715847,0.540983607,1,0.290866892
9121,28,21521,6,10,0,0,0,16,3,3,6,7,0,19,nowin,loss,beat,dlwin,0,10,16,199,0.422110553,0.045226131,0.542713568,1,0.282706618
9122,42,21521,10,4,0,0,0,14,3,3,6,7,0,19,nowin,loss,beat,dlwin,0,10,14,212,0.443396226,0.051886792,0.570754717,1,0.309181312
9123,16,21521,10,10,0,0,0,20,3,3,6,7,0,19,nowin,win,plwin,beat,20,0,20,220,0.427272727,0.081818182,0.6,2,0.588660176
9124,114,21521,9,9,0,0,0,18,3,3,6,7,0,19,nowin,loss,beat,dlwin,0,10,18,198,0.47979798,0.025252525,0.611111111,3,0.937232995
9125,1,21521,3,10,0,0,0,13,3,3,6,7,0,19,nowin,loss,beat,dlwin,0,10,13,197,0.406091371,0.025380711,0.649746193,2,0.606186955
9126,9,21522,8,8,0,0,0,16,3,4,2,5,3,17,nowin,loss,beat,dlwin,0,10,16,194,0.37628866,0.015463918,0.541237113,0,0.009396796
9127,134,21522,5,10,0,0,0,15,3,4,2,5,3,17,nowin,loss,beat,dlwin,0,10,15,185,0.443243243,0.021621622,0.545945946,1,0.296939509
9128,50,21522,10,10,0,0,0,20,3,4,2,5,3,17,nowin,win,plwin,beat,20,0,20,202,0.405940594,0.04950495,0.54950495,0,0.020296079
9129,75,21522,4,8,0,10,0,22,3,4,2,5,3,17,nowin,loss,bust,plbust,0,10,12,191,0.418848168,0.052356021,0.570680628,0,0.029344702
9130,1,21522,10,10,0,0,0,20,3,4,2,5,3,17,nowin,win,plwin,beat,20,0,20,197,0.406091371,0.025380711,0.649746193,2,0.606186955
9131,82,21522,3,4,10,0,0,17,3,4,2,5,3,17,nowin,push,push,push,10,0,7,225,0.408888889,0.075555556,0.577777778,0,0.028101874
9132,116,21523,10,10,0,0,0,20,10,10,0,0,0,20,nowin,push,push,push,10,0,20,195,0.425641026,0.056410256,0.538461538,1,0.28273747
9133,60,21523,10,6,0,2,0,18,10,10,0,0,0,20,nowin,loss,beat,dlwin,0,10,16,227,0.418502203,0.022026432,0.559471366,0,0.026496258
9134,150,21523,2,7,8,0,0,17,10,10,0,0,0,20,nowin,loss,beat,dlwin,0,10,9,192,0.401041667,0.036458333,0.567708333,0,0.023287458
9135,131,21523,6,10,0,9,0,25,10,10,0,0,0,20,nowin,loss,bust,plbust,0,10,16,217,0.410138249,0.069124424,0.543778802,0,0.02015021
9136,2,21523,3,10,0,6,0,19,10,10,0,0,0,20,nowin,loss,beat,dlwin,0,10,13,200,0.445,0.035,0.64,2,0.633962549
9137,69,21523,10,8,0,0,0,18,10,10,0,0,0,20,nowin,loss,beat,dlwin,0,10,18,194,0.365979381,0.030927835,0.515463918,0,0
9138,14,21524,10,10,0,0,0,20,5,7,7,0,0,19,nowin,win,plwin,beat,20,0,20,202,0.391089109,0.01980198,0.628712871,2,0.577264877
9139,47,21524,2,10,0,0,0,12,5,7,7,0,0,19,nowin,loss,beat,dlwin,0,10,12,210,0.438095238,0.057142857,0.623809524,2,0.615868808
9140,85,21524,6,10,0,0,0,16,5,7,7,0,0,19,nowin,loss,beat,dlwin,0,10,16,195,0.41025641,0.066666667,0.594871795,0,0.03269711
9141,16,21524,10,5,0,0,0,15,5,7,7,0,0,19,nowin,loss,beat,dlwin,0,10,15,220,0.427272727,0.081818182,0.6,2,0.588660176
9142,120,21524,10,10,0,0,0,20,5,7,7,0,0,19,nowin,win,plwin,beat,20,0,20,202,0.440594059,0.034653465,0.618811881,2,0.614441029
9143,99,21524,7,10,0,0,0,17,5,7,7,0,0,19,nowin,loss,beat,dlwin,0,10,17,207,0.47826087,0.062801932,0.637681159,3,0.961418446
9144,80,21525,10,4,0,1,5,20,10,10,0,0,0,20,nowin,push,push,push,10,0,14,186,0.419354839,0.059139785,0.623655914,2,0.59892924
9145,130,21525,2,4,9,2,0,17,10,10,0,0,0,20,nowin,loss,beat,dlwin,0,10,6,219,0.410958904,0.03652968,0.566210046,0,0.025888739
9146,20,21525,2,1,10,4,0,17,10,10,0,0,0,20,nowin,loss,beat,dlwin,0,10,3,186,0.456989247,0.037634409,0.537634409,1,0.301097108
9147,92,21525,8,7,0,5,0,20,10,10,0,0,0,20,nowin,push,push,push,10,0,15,186,0.446236559,0.059139785,0.564516129,1,0.307826125
9148,70,21525,7,9,0,4,0,20,10,10,0,0,0,20,nowin,push,push,push,10,0,16,228,0.385964912,0.039473684,0.557017544,0,0.016157125
9149,14,21525,8,8,0,6,0,22,10,10,0,0,0,20,nowin,loss,bust,plbust,0,10,16,202,0.391089109,0.01980198,0.628712871,2,0.577264877
9150,50,21526,5,6,10,0,0,21,3,10,8,0,0,21,nowin,push,push,push,10,0,11,202,0.405940594,0.04950495,0.54950495,0,0.020296079
9151,146,21526,1,6,5,8,0,20,3,10,8,0,0,21,nowin,loss,beat,dlwin,0,10,7,221,0.43438914,0.040723982,0.542986425,1,0.290190091
9152,63,21526,5,8,0,0,0,13,3,10,8,0,0,21,nowin,loss,beat,dlwin,0,10,13,216,0.467592593,0.037037037,0.62037037,3,0.931690496
9153,8,21526,3,11,4,0,0,18,3,10,8,0,0,21,nowin,loss,beat,dlwin,0,10,14,181,0.44198895,0.071823204,0.596685083,2,0.599438402
9154,27,21526,10,10,0,0,0,20,3,10,8,0,0,21,nowin,loss,beat,dlwin,0,10,20,178,0.370786517,0.016853933,0.573033708,0,0.015536309
9155,111,21526,10,5,0,0,0,15,3,10,8,0,0,21,nowin,loss,beat,dlwin,0,10,15,180,0.433333333,0.055555556,0.611111111,2,0.602264492
9156,5,21527,10,10,0,0,0,20,4,6,9,0,0,19,nowin,win,plwin,beat,20,0,20,203,0.42364532,0.02955665,0.596059113,2,0.582508076
9157,95,21527,9,10,0,0,0,19,4,6,9,0,0,19,nowin,push,push,push,10,0,19,218,0.412844037,0.04587156,0.559633028,0,0.024842385
9158,113,21527,4,10,0,0,0,14,4,6,9,0,0,19,nowin,loss,beat,dlwin,0,10,14,199,0.407035176,0.055276382,0.668341709,2,0.620695264
9159,37,21527,8,5,0,0,0,13,4,6,9,0,0,19,nowin,loss,beat,dlwin,0,10,13,208,0.394230769,0.038461538,0.581730769,0,0.024682772
9160,101,21527,11,10,0,0,0,21,4,6,9,0,0,19,win,win,plwin,beat,25,0,21,205,0.424390244,0.068292683,0.63902439,2,0.614740646
9161,49,21527,4,8,0,0,0,12,4,6,9,0,0,19,nowin,loss,beat,dlwin,0,10,12,207,0.396135266,0.053140097,0.594202899,0,0.028306925
9162,1,21528,5,5,7,0,0,17,3,10,3,10,0,26,nowin,win,dlbust,bust,20,0,10,197,0.406091371,0.025380711,0.649746193,2,0.606186955
9163,131,21528,11,2,1,0,0,14,3,10,3,10,0,26,nowin,win,dlbust,bust,20,0,13,217,0.410138249,0.069124424,0.543778802,0,0.02015021
9164,2,21528,2,2,7,3,0,14,3,10,3,10,0,26,nowin,win,dlbust,bust,20,0,4,200,0.445,0.035,0.64,2,0.633962549
9165,5,21528,10,6,0,0,0,16,3,10,3,10,0,26,nowin,win,dlbust,bust,20,0,16,203,0.42364532,0.02955665,0.596059113,2,0.582508076
9166,92,21528,2,6,10,0,0,18,3,10,3,10,0,26,nowin,win,dlbust,bust,20,0,8,186,0.446236559,0.059139785,0.564516129,1,0.307826125
9167,9,21528,2,10,0,10,0,22,3,10,3,10,0,26,nowin,loss,bust,plbust,0,10,12,194,0.37628866,0.015463918,0.541237113,0,0.009396796
9168,85,21529,11,1,5,0,0,17,2,10,10,0,0,22,nowin,win,dlbust,bust,20,0,12,195,0.41025641,0.066666667,0.594871795,0,0.03269711
9169,66,21529,10,6,0,0,0,16,2,10,10,0,0,22,nowin,win,dlbust,bust,20,0,16,217,0.456221198,0.064516129,0.626728111,3,0.924304367
9170,14,21529,10,3,0,0,0,13,2,10,10,0,0,22,nowin,win,dlbust,bust,20,0,13,202,0.391089109,0.01980198,0.628712871,2,0.577264877
9171,139,21529,10,9,0,0,0,19,2,10,10,0,0,22,nowin,win,dlbust,bust,20,0,19,192,0.380208333,0.036458333,0.59375,0,0.023429169
9172,4,21529,10,9,0,0,0,19,2,10,10,0,0,22,nowin,win,dlbust,bust,20,0,19,217,0.460829493,0.036866359,0.562211982,1,0.315432839
9173,56,21529,10,10,0,0,0,20,2,10,10,0,0,22,nowin,win,dlbust,bust,20,0,20,175,0.4,0.057142857,0.582857143,0,0.026685297
9174,16,21530,7,9,0,0,0,16,3,9,8,0,0,20,nowin,loss,beat,dlwin,0,10,16,220,0.427272727,0.081818182,0.6,2,0.588660176
9175,59,21530,5,7,0,8,0,20,3,9,8,0,0,20,nowin,push,push,push,10,0,12,228,0.429824561,0.048245614,0.543859649,1,0.287885446
9176,10,21530,3,4,5,4,0,16,3,9,8,0,0,20,nowin,loss,beat,dlwin,0,10,7,191,0.413612565,0.057591623,0.596858639,2,0.574087175
9177,76,21530,10,10,0,0,0,20,3,9,8,0,0,20,nowin,push,push,push,10,0,20,189,0.534391534,0.079365079,0.608465608,3,1
9178,60,21530,9,3,0,9,0,21,3,9,8,0,0,20,nowin,win,plwin,beat,20,0,12,227,0.418502203,0.022026432,0.559471366,0,0.026496258
9179,34,21530,8,5,0,0,0,13,3,9,8,0,0,20,nowin,loss,beat,dlwin,0,10,13,202,0.5,0.079207921,0.618811881,3,0.968961434
9180,26,21531,8,10,0,0,0,18,4,1,10,10,0,25,nowin,win,dlbust,bust,20,0,18,203,0.463054187,0.0591133,0.541871921,1,0.306802864
9181,32,21531,10,5,0,0,0,15,4,1,10,10,0,25,nowin,win,dlbust,bust,20,0,15,189,0.391534392,0.037037037,0.53968254,0,0.013579086
9182,83,21531,1,2,10,0,0,13,4,1,10,10,0,25,nowin,win,dlbust,bust,20,0,3,193,0.424870466,0.051813472,0.678756477,2,0.644360335
9183,42,21531,6,9,0,0,0,15,4,1,10,10,0,25,nowin,win,dlbust,bust,20,0,15,212,0.443396226,0.051886792,0.570754717,1,0.309181312
9184,81,21531,9,4,0,0,0,13,4,1,10,10,0,25,nowin,win,dlbust,bust,20,0,13,182,0.395604396,0.043956044,0.60989011,2,0.567491261
9185,38,21531,6,6,0,0,0,12,4,1,10,10,0,25,nowin,win,dlbust,bust,20,0,12,202,0.361386139,0.03960396,0.564356436,0,0.010597953
9186,54,21532,5,10,0,0,0,15,4,4,4,3,6,21,nowin,loss,beat,dlwin,0,10,15,185,0.437837838,0.032432432,0.556756757,1,0.29899854
9187,63,21532,5,3,3,10,0,21,4,4,4,3,6,21,nowin,push,push,push,10,0,8,216,0.467592593,0.037037037,0.62037037,3,0.931690496
9188,4,21532,8,3,4,0,0,15,4,4,4,3,6,21,nowin,loss,beat,dlwin,0,10,11,217,0.460829493,0.036866359,0.562211982,1,0.315432839
9189,40,21532,2,9,9,0,0,20,4,4,4,3,6,21,nowin,loss,beat,dlwin,0,10,11,196,0.367346939,0.030612245,0.617346939,0,0.025358183
9190,53,21532,9,11,0,0,0,20,4,4,4,3,6,21,nowin,loss,beat,dlwin,0,10,20,250,0.372,0.064,0.564,0,0.013687345
9191,76,21532,9,10,0,0,0,19,4,4,4,3,6,21,nowin,loss,beat,dlwin,0,10,19,189,0.534391534,0.079365079,0.608465608,3,1
9192,93,21533,10,2,0,0,0,12,5,10,8,0,0,23,nowin,win,dlbust,bust,20,0,12,175,0.485714286,0.051428571,0.548571429,1,0.323648091
9193,41,21533,4,11,5,0,0,20,5,10,8,0,0,23,nowin,win,dlbust,bust,20,0,15,192,0.364583333,0.036458333,0.520833333,0,0.00089702
9194,120,21533,4,11,4,0,0,19,5,10,8,0,0,23,nowin,win,dlbust,bust,20,0,15,202,0.440594059,0.034653465,0.618811881,2,0.614441029
9195,116,21533,7,5,0,0,0,12,5,10,8,0,0,23,nowin,win,dlbust,bust,20,0,12,195,0.425641026,0.056410256,0.538461538,1,0.28273747
9196,46,21533,2,5,2,1,6,16,5,10,8,0,0,23,nowin,win,dlbust,bust,20,0,7,186,0.403225806,0.048387097,0.591397849,0,0.029742194
9197,79,21533,8,8,0,0,0,16,5,10,8,0,0,23,nowin,win,dlbust,bust,20,0,16,211,0.436018957,0.028436019,0.672985782,2,0.650131054
9198,69,21534,10,4,0,3,0,17,8,3,9,0,0,20,nowin,loss,beat,dlwin,0,10,14,194,0.365979381,0.030927835,0.515463918,0,0
9199,56,21534,11,7,0,0,0,18,8,3,9,0,0,20,nowin,loss,beat,dlwin,0,10,18,175,0.4,0.057142857,0.582857143,0,0.026685297
9200,29,21534,10,10,0,0,0,20,8,3,9,0,0,20,nowin,push,push,push,10,0,20,189,0.44973545,0.058201058,0.544973545,1,0.300349439
9201,15,21534,5,8,0,1,7,21,8,3,9,0,0,20,nowin,win,plwin,beat,20,0,13,212,0.410377358,0.051886792,0.561320755,0,0.024517408
9202,146,21534,9,8,0,0,0,17,8,3,9,0,0,20,nowin,loss,beat,dlwin,0,10,17,221,0.43438914,0.040723982,0.542986425,1,0.290190091
9203,142,21534,6,2,2,1,10,21,8,3,9,0,0,20,nowin,win,plwin,beat,20,0,8,211,0.417061611,0.047393365,0.526066351,1,0.271531309
9204,62,21535,7,6,0,0,0,13,4,10,4,0,0,18,nowin,loss,beat,dlwin,0,10,13,178,0.370786517,0.028089888,0.54494382,0,0.008657722
9205,107,21535,6,10,0,0,0,16,4,10,4,0,0,18,nowin,loss,beat,dlwin,0,10,16,218,0.444954128,0.073394495,0.600917431,2,0.605210014
9206,68,21535,10,6,0,0,0,16,4,10,4,0,0,18,nowin,loss,beat,dlwin,0,10,16,205,0.434146341,0.029268293,0.6,2,0.59483189
9207,128,21535,10,5,0,0,0,15,4,10,4,0,0,18,nowin,loss,beat,dlwin,0,10,15,227,0.356828194,0.052863436,0.577092511,0,0.012352564
9208,136,21535,5,9,0,0,0,14,4,10,4,0,0,18,nowin,loss,beat,dlwin,0,10,14,194,0.396907216,0.025773196,0.597938144,0,0.029452644
9209,7,21535,3,10,0,0,0,13,4,10,4,0,0,18,nowin,loss,beat,dlwin,0,10,13,183,0.442622951,0.06010929,0.62295082,2,0.619303341
9210,82,21536,3,3,6,0,0,12,4,5,10,0,0,19,nowin,loss,beat,dlwin,0,10,6,225,0.408888889,0.075555556,0.577777778,0,0.028101874
9211,48,21536,4,3,10,0,0,17,4,5,10,0,0,19,nowin,loss,beat,dlwin,0,10,7,203,0.413793103,0.019704433,0.600985222,2,0.577280801
9212,60,21536,9,7,0,0,0,16,4,5,10,0,0,19,nowin,loss,beat,dlwin,0,10,16,227,0.418502203,0.022026432,0.559471366,0,0.026496258
9213,65,21536,10,10,0,0,0,20,4,5,10,0,0,19,nowin,win,plwin,beat,20,0,20,203,0.492610837,0.054187192,0.571428571,3,0.913702814
9214,116,21536,7,7,0,0,0,14,4,5,10,0,0,19,nowin,loss,beat,dlwin,0,10,14,195,0.425641026,0.056410256,0.538461538,1,0.28273747
9215,25,21536,7,8,0,0,0,15,4,5,10,0,0,19,nowin,loss,beat,dlwin,0,10,15,190,0.463157895,0.063157895,0.536842105,1,0.304401563
9216,129,21537,7,11,0,0,0,18,11,10,0,0,0,21,nowin,loss,beat,dlwin,0,10,18,201,0.422885572,0.064676617,0.55721393,0,0.027255383
9217,44,21537,3,4,7,5,0,19,11,10,0,0,0,21,nowin,loss,beat,dlwin,0,10,7,219,0.433789954,0.050228311,0.534246575,1,0.285551035
9218,116,21537,10,10,0,0,0,20,11,10,0,0,0,21,nowin,loss,beat,dlwin,0,10,20,195,0.425641026,0.056410256,0.538461538,1,0.28273747
9219,3,21537,10,4,0,1,3,18,11,10,0,0,0,21,nowin,loss,beat,dlwin,0,10,14,190,0.431578947,0.026315789,0.542105263,1,0.288076384
9220,3,21537,6,5,5,7,0,23,11,10,0,0,0,21,nowin,loss,bust,plbust,0,10,11,190,0.431578947,0.026315789,0.542105263,1,0.288076384
9221,144,21537,8,7,0,8,0,23,11,10,0,0,0,21,nowin,loss,bust,plbust,0,10,15,202,0.386138614,0.054455446,0.564356436,0,0.018006244
9222,127,21538,10,6,0,0,0,16,5,4,7,9,0,25,nowin,win,dlbust,bust,20,0,16,201,0.402985075,0.029850746,0.60199005,0,0.032263937
9223,101,21538,10,2,0,0,0,12,5,4,7,9,0,25,nowin,win,dlbust,bust,20,0,12,205,0.424390244,0.068292683,0.63902439,2,0.614740646
9224,129,21538,11,7,0,0,0,18,5,4,7,9,0,25,nowin,win,dlbust,bust,20,0,18,201,0.422885572,0.064676617,0.55721393,0,0.027255383
9225,3,21538,10,11,0,0,0,21,5,4,7,9,0,25,win,win,dlbust,bust,25,0,21,190,0.431578947,0.026315789,0.542105263,1,0.288076384
9226,101,21538,10,10,0,0,0,20,5,4,7,9,0,25,nowin,win,dlbust,bust,20,0,20,205,0.424390244,0.068292683,0.63902439,2,0.614740646
9227,18,21538,2,5,10,0,0,17,5,4,7,9,0,25,nowin,win,dlbust,bust,20,0,7,182,0.461538462,0.043956044,0.587912088,3,0.892649374
9228,18,21539,10,10,0,0,0,20,3,6,8,0,0,17,nowin,win,plwin,beat,20,0,20,182,0.461538462,0.043956044,0.587912088,3,0.892649374
9229,136,21539,10,10,0,0,0,20,3,6,8,0,0,17,nowin,win,plwin,beat,20,0,20,194,0.396907216,0.025773196,0.597938144,0,0.029452644
9230,83,21539,6,10,0,0,0,16,3,6,8,0,0,17,nowin,loss,beat,dlwin,0,10,16,193,0.424870466,0.051813472,0.678756477,2,0.644360335
9231,3,21539,5,4,10,0,0,19,3,6,8,0,0,17,nowin,win,plwin,beat,20,0,9,190,0.431578947,0.026315789,0.542105263,1,0.288076384
9232,74,21539,3,10,0,0,0,13,3,6,8,0,0,17,nowin,loss,beat,dlwin,0,10,13,209,0.411483254,0.04784689,0.531100478,0,0.017448125
9233,30,21539,5,10,0,0,0,15,3,6,8,0,0,17,nowin,loss,beat,dlwin,0,10,15,206,0.393203883,0.033980583,0.601941748,0,0.029324648
9234,134,21540,8,2,7,0,0,17,9,3,4,4,0,20,nowin,loss,beat,dlwin,0,10,10,185,0.443243243,0.021621622,0.545945946,1,0.296939509
9235,109,21540,2,9,6,0,0,17,9,3,4,4,0,20,nowin,loss,beat,dlwin,0,10,11,221,0.461538462,0.058823529,0.597285068,3,0.901830309
9236,80,21540,10,11,0,0,0,21,9,3,4,4,0,20,win,win,plwin,beat,25,0,21,186,0.419354839,0.059139785,0.623655914,2,0.59892924
9237,18,21540,4,3,6,3,9,25,9,3,4,4,0,20,nowin,loss,bust,plbust,0,10,7,182,0.461538462,0.043956044,0.587912088,3,0.892649374
9238,65,21540,6,9,0,10,0,25,9,3,4,4,0,20,nowin,loss,bust,plbust,0,10,15,203,0.492610837,0.054187192,0.571428571,3,0.913702814
9239,66,21540,1,3,8,2,4,18,9,3,4,4,0,20,nowin,loss,beat,dlwin,0,10,4,217,0.456221198,0.064516129,0.626728111,3,0.924304367
9240,131,21541,10,8,0,0,0,18,10,9,0,0,0,19,nowin,loss,beat,dlwin,0,10,18,217,0.410138249,0.069124424,0.543778802,0,0.02015021
9241,17,21541,10,8,0,0,0,18,10,9,0,0,0,19,nowin,loss,beat,dlwin,0,10,18,171,0.444444444,0.070175439,0.555555556,1,0.302364894
9242,18,21541,2,10,0,1,6,19,10,9,0,0,0,19,nowin,push,push,push,10,0,12,182,0.461538462,0.043956044,0.587912088,3,0.892649374
9243,19,21541,10,8,0,0,0,18,10,9,0,0,0,19,nowin,loss,beat,dlwin,0,10,18,237,0.41350211,0.054852321,0.628691983,2,0.597373826
9244,13,21541,2,10,0,10,0,22,10,9,0,0,0,19,nowin,loss,bust,plbust,0,10,12,206,0.417475728,0.063106796,0.621359223,2,0.59555479
9245,60,21541,7,9,0,10,0,26,10,9,0,0,0,19,nowin,loss,bust,plbust,0,10,16,227,0.418502203,0.022026432,0.559471366,0,0.026496258
9246,86,21542,4,8,0,8,0,20,10,4,1,6,0,21,nowin,loss,beat,dlwin,0,10,12,196,0.454081633,0.040816327,0.591836735,3,0.887566443
9247,60,21542,2,2,8,8,0,20,10,4,1,6,0,21,nowin,loss,beat,dlwin,0,10,4,227,0.418502203,0.022026432,0.559471366,0,0.026496258
9248,81,21542,5,10,0,2,0,17,10,4,1,6,0,21,nowin,loss,beat,dlwin,0,10,15,182,0.395604396,0.043956044,0.60989011,2,0.567491261
9249,110,21542,5,7,0,1,6,19,10,4,1,6,0,21,nowin,loss,beat,dlwin,0,10,12,192,0.416666667,0.046875,0.557291667,0,0.025413132
9250,80,21542,5,10,0,10,0,25,10,4,1,6,0,21,nowin,loss,bust,plbust,0,10,15,186,0.419354839,0.059139785,0.623655914,2,0.59892924
9251,54,21542,2,5,8,10,0,25,10,4,1,6,0,21,nowin,loss,bust,plbust,0,10,7,185,0.437837838,0.032432432,0.556756757,1,0.29899854
9252,73,21543,8,10,0,0,0,18,10,3,7,0,0,20,nowin,loss,beat,dlwin,0,10,18,181,0.375690608,0.011049724,0.596685083,0,0.022795773
9253,24,21543,11,4,2,0,0,17,10,3,7,0,0,20,nowin,loss,beat,dlwin,0,10,15,207,0.458937198,0.048309179,0.570048309,1,0.318138014
9254,86,21543,10,9,0,0,0,19,10,3,7,0,0,20,nowin,loss,beat,dlwin,0,10,19,196,0.454081633,0.040816327,0.591836735,3,0.887566443
9255,5,21543,10,3,0,7,0,20,10,3,7,0,0,20,nowin,push,push,push,10,0,13,203,0.42364532,0.02955665,0.596059113,2,0.582508076
9256,78,21543,11,2,1,10,0,24,10,3,7,0,0,20,nowin,loss,bust,plbust,0,10,13,201,0.517412935,0.034825871,0.587064677,3,0.95871112
9257,10,21543,10,9,0,0,0,19,10,3,7,0,0,20,nowin,loss,beat,dlwin,0,10,19,191,0.413612565,0.057591623,0.596858639,2,0.574087175
9258,109,21544,9,6,0,0,0,15,2,4,8,7,0,21,nowin,loss,beat,dlwin,0,10,15,221,0.461538462,0.058823529,0.597285068,3,0.901830309
9259,145,21544,10,10,0,0,0,20,2,4,8,7,0,21,nowin,loss,beat,dlwin,0,10,20,188,0.441489362,0.031914894,0.622340426,2,0.617837093
9260,133,21544,10,6,0,0,0,16,2,4,8,7,0,21,nowin,loss,beat,dlwin,0,10,16,201,0.47761194,0.064676617,0.611940299,3,0.935428111
9261,131,21544,8,2,10,0,0,20,2,4,8,7,0,21,nowin,loss,beat,dlwin,0,10,10,217,0.410138249,0.069124424,0.543778802,0,0.02015021
9262,53,21544,8,6,0,0,0,14,2,4,8,7,0,21,nowin,loss,beat,dlwin,0,10,14,250,0.372,0.064,0.564,0,0.013687345
9263,107,21544,4,9,0,0,0,13,2,4,8,7,0,21,nowin,loss,beat,dlwin,0,10,13,218,0.444954128,0.073394495,0.600917431,2,0.605210014
9264,60,21545,6,9,0,4,0,19,9,10,0,0,0,19,nowin,push,push,push,10,0,15,227,0.418502203,0.022026432,0.559471366,0,0.026496258
9265,142,21545,7,7,0,1,10,25,9,10,0,0,0,19,nowin,loss,bust,plbust,0,10,14,211,0.417061611,0.047393365,0.526066351,1,0.271531309
9266,64,21545,3,7,4,10,0,24,9,10,0,0,0,19,nowin,loss,bust,plbust,0,10,10,187,0.363636364,0.048128342,0.631016043,0,0.027594885
9267,145,21545,8,10,0,0,0,18,9,10,0,0,0,19,nowin,loss,beat,dlwin,0,10,18,188,0.441489362,0.031914894,0.622340426,2,0.617837093
9268,90,21545,2,6,9,0,0,17,9,10,0,0,0,19,nowin,loss,beat,dlwin,0,10,8,201,0.447761194,0.049751244,0.60199005,3,0.889945023
9269,106,21545,10,8,0,0,0,18,9,10,0,0,0,19,nowin,loss,beat,dlwin,0,10,18,192,0.411458333,0.026041667,0.557291667,0,0.023854304
9270,112,21546,5,5,8,0,0,18,11,10,0,0,0,21,nowin,loss,beat,dlwin,0,10,10,203,0.448275862,0.054187192,0.600985222,3,0.889576933
9271,129,21546,3,11,4,0,0,18,11,10,0,0,0,21,nowin,loss,beat,dlwin,0,10,14,201,0.422885572,0.064676617,0.55721393,0,0.027255383
9272,11,21546,10,7,0,0,0,17,11,10,0,0,0,21,nowin,loss,beat,dlwin,0,10,17,236,0.457627119,0.016949153,0.588983051,3,0.889015813
9273,9,21546,8,9,0,0,0,17,11,10,0,0,0,21,nowin,loss,beat,dlwin,0,10,17,194,0.37628866,0.015463918,0.541237113,0,0.009396796
9274,120,21546,8,6,0,2,6,22,11,10,0,0,0,21,nowin,loss,bust,plbust,0,10,14,202,0.440594059,0.034653465,0.618811881,2,0.614441029
9275,99,21546,10,7,0,0,0,17,11,10,0,0,0,21,nowin,loss,beat,dlwin,0,10,17,207,0.47826087,0.062801932,0.637681159,3,0.961418446
9276,16,21547,10,10,0,0,0,20,10,11,0,0,0,21,nowin,loss,beat,dlwin,0,10,20,220,0.427272727,0.081818182,0.6,2,0.588660176
9277,61,21547,5,10,0,6,0,21,10,11,0,0,0,21,nowin,push,push,push,10,0,15,194,0.427835052,0.077319588,0.603092784,2,0.591437139
9278,147,21547,3,7,5,10,0,25,10,11,0,0,0,21,nowin,loss,bust,plbust,0,10,10,205,0.380487805,0.014634146,0.536585366,0,0.00951447
9279,55,21547,2,10,0,5,0,17,10,11,0,0,0,21,nowin,loss,beat,dlwin,0,10,12,191,0.371727749,0.057591623,0.54973822,0,0.01011347
9280,126,21547,10,11,0,0,0,21,10,11,0,0,0,21,win,push,push,push,10,0,21,188,0.457446809,0.074468085,0.60106383,3,0.900633203
9281,131,21547,3,10,0,8,0,21,10,11,0,0,0,21,nowin,push,push,push,10,0,13,217,0.410138249,0.069124424,0.543778802,0,0.02015021
9282,130,21548,10,4,0,6,0,20,10,7,0,0,0,17,nowin,win,plwin,beat,20,0,14,219,0.410958904,0.03652968,0.566210046,0,0.025888739
9283,5,21548,4,6,11,0,0,21,10,7,0,0,0,17,nowin,win,plwin,beat,20,0,10,203,0.42364532,0.02955665,0.596059113,2,0.582508076
9284,131,21548,9,11,0,0,0,20,10,7,0,0,0,17,nowin,win,plwin,beat,20,0,20,217,0.410138249,0.069124424,0.543778802,0,0.02015021
9285,134,21548,10,10,0,0,0,20,10,7,0,0,0,17,nowin,win,plwin,beat,20,0,20,185,0.443243243,0.021621622,0.545945946,1,0.296939509
9286,138,21548,10,4,0,10,0,24,10,7,0,0,0,17,nowin,loss,bust,plbust,0,10,14,190,0.442105263,0.047368421,0.610526316,2,0.609711065
9287,106,21548,10,8,0,0,0,18,10,7,0,0,0,17,nowin,win,plwin,beat,20,0,18,192,0.411458333,0.026041667,0.557291667,0,0.023854304
9288,125,21549,8,11,0,0,0,19,10,10,0,0,0,20,nowin,loss,beat,dlwin,0,10,19,219,0.438356164,0.050228311,0.575342466,1,0.308411257
9289,43,21549,6,9,0,10,0,25,10,10,0,0,0,20,nowin,loss,bust,plbust,0,10,15,192,0.40625,0.041666667,0.609375,2,0.576671372
9290,73,21549,11,7,0,0,0,18,10,10,0,0,0,20,nowin,loss,beat,dlwin,0,10,18,181,0.375690608,0.011049724,0.596685083,0,0.022795773
9291,76,21549,6,6,0,10,0,22,10,10,0,0,0,20,nowin,loss,bust,plbust,0,10,12,189,0.534391534,0.079365079,0.608465608,3,1
9292,72,21549,10,6,0,10,0,26,10,10,0,0,0,20,nowin,loss,bust,plbust,0,10,16,185,0.394594595,0.032432432,0.508108108,0,0.006763115
9293,77,21549,10,10,0,0,0,20,10,10,0,0,0,20,nowin,push,push,push,10,0,20,200,0.455,0.04,0.62,3,0.916252116
9294,69,21550,10,10,0,0,0,20,2,2,7,8,0,19,nowin,win,plwin,beat,20,0,20,194,0.365979381,0.030927835,0.515463918,0,0
9295,30,21550,10,8,0,0,0,18,2,2,7,8,0,19,nowin,loss,beat,dlwin,0,10,18,206,0.393203883,0.033980583,0.601941748,0,0.029324648
9296,39,21550,9,5,0,0,0,14,2,2,7,8,0,19,nowin,loss,beat,dlwin,0,10,14,191,0.429319372,0.062827225,0.57591623,0,0.033760763
9297,64,21550,10,10,0,0,0,20,2,2,7,8,0,19,nowin,win,plwin,beat,20,0,20,187,0.363636364,0.048128342,0.631016043,0,0.027594885
9298,66,21550,8,9,0,0,0,17,2,2,7,8,0,19,nowin,loss,beat,dlwin,0,10,17,217,0.456221198,0.064516129,0.626728111,3,0.924304367
9299,100,21550,10,5,0,0,0,15,2,2,7,8,0,19,nowin,loss,beat,dlwin,0,10,15,190,0.452631579,0.036842105,0.594736842,3,0.888671154
9300,52,21551,10,10,0,0,0,20,3,10,8,0,0,21,nowin,loss,beat,dlwin,0,10,20,217,0.414746544,0.02764977,0.599078341,2,0.576736024
9301,96,21551,10,5,0,0,0,15,3,10,8,0,0,21,nowin,loss,beat,dlwin,0,10,15,190,0.468421053,0.057894737,0.584210526,3,0.897263354
9302,58,21551,10,8,0,0,0,18,3,10,8,0,0,21,nowin,loss,beat,dlwin,0,10,18,195,0.430769231,0.041025641,0.584615385,2,0.580497586
9303,64,21551,10,11,0,0,0,21,3,10,8,0,0,21,win,push,push,push,10,0,21,187,0.363636364,0.048128342,0.631016043,0,0.027594885
9304,14,21551,8,2,9,0,0,19,3,10,8,0,0,21,nowin,loss,beat,dlwin,0,10,10,202,0.391089109,0.01980198,0.628712871,2,0.577264877
9305,74,21551,10,10,0,0,0,20,3,10,8,0,0,21,nowin,loss,beat,dlwin,0,10,20,209,0.411483254,0.04784689,0.531100478,0,0.017448125
9306,11,21552,10,10,0,0,0,20,3,4,10,0,0,17,nowin,win,plwin,beat,20,0,20,236,0.457627119,0.016949153,0.588983051,3,0.889015813
9307,97,21552,10,5,0,0,0,15,3,4,10,0,0,17,nowin,loss,beat,dlwin,0,10,15,182,0.450549451,0.06043956,0.692307692,2,0.677372279
9308,71,21552,8,10,0,0,0,18,3,4,10,0,0,17,nowin,win,plwin,beat,20,0,18,193,0.352331606,0.046632124,0.585492228,0,0.013063661
9309,50,21552,7,10,0,0,0,17,3,4,10,0,0,17,nowin,push,push,push,10,0,17,202,0.405940594,0.04950495,0.54950495,0,0.020296079
9310,68,21552,2,2,7,10,0,21,3,4,10,0,0,17,nowin,win,plwin,beat,20,0,4,205,0.434146341,0.029268293,0.6,2,0.59483189
9311,92,21552,8,11,0,0,0,19,3,4,10,0,0,17,nowin,win,plwin,beat,20,0,19,186,0.446236559,0.059139785,0.564516129,1,0.307826125
9312,102,21553,10,6,0,0,0,16,2,1,10,2,9,24,nowin,win,dlbust,bust,20,0,16,192,0.338541667,0.046875,0.5625,0,0.003306118
9313,100,21553,3,10,0,0,0,13,2,1,10,2,9,24,nowin,win,dlbust,bust,20,0,13,190,0.452631579,0.036842105,0.594736842,3,0.888671154
9314,114,21553,11,10,0,0,0,21,2,1,10,2,9,24,win,win,dlbust,bust,25,0,21,198,0.47979798,0.025252525,0.611111111,3,0.937232995
9315,91,21553,10,8,0,0,0,18,2,1,10,2,9,24,nowin,win,dlbust,bust,20,0,18,194,0.417525773,0.046391753,0.515463918,1,0.266616552
9316,142,21553,3,10,0,0,0,13,2,1,10,2,9,24,nowin,win,dlbust,bust,20,0,13,211,0.417061611,0.047393365,0.526066351,1,0.271531309
9317,42,21553,11,10,0,0,0,21,2,1,10,2,9,24,win,win,dlbust,bust,25,0,21,212,0.443396226,0.051886792,0.570754717,1,0.309181312
9318,11,21554,9,6,0,0,0,15,6,11,0,0,0,17,nowin,loss,beat,dlwin,0,10,15,236,0.457627119,0.016949153,0.588983051,3,0.889015813
9319,110,21554,2,10,0,0,0,12,6,11,0,0,0,17,nowin,loss,beat,dlwin,0,10,12,192,0.416666667,0.046875,0.557291667,0,0.025413132
9320,5,21554,4,11,4,0,0,19,6,11,0,0,0,17,nowin,win,plwin,beat,20,0,15,203,0.42364532,0.02955665,0.596059113,2,0.582508076
9321,32,21554,1,6,10,0,0,17,6,11,0,0,0,17,nowin,push,push,push,10,0,7,189,0.391534392,0.037037037,0.53968254,0,0.013579086
9322,110,21554,4,8,0,0,0,12,6,11,0,0,0,17,nowin,loss,beat,dlwin,0,10,12,192,0.416666667,0.046875,0.557291667,0,0.025413132
9323,137,21554,9,8,0,0,0,17,6,11,0,0,0,17,nowin,push,push,push,10,0,17,194,0.417525773,0.046391753,0.536082474,1,0.276714602
9324,57,21555,7,9,0,0,0,16,2,9,10,0,0,21,nowin,loss,beat,dlwin,0,10,16,192,0.46875,0.052083333,0.59375,3,0.907001181
9325,42,21555,4,10,0,0,0,14,2,9,10,0,0,21,nowin,loss,beat,dlwin,0,10,14,212,0.443396226,0.051886792,0.570754717,1,0.309181312
9326,139,21555,10,4,0,0,0,14,2,9,10,0,0,21,nowin,loss,beat,dlwin,0,10,14,192,0.380208333,0.036458333,0.59375,0,0.023429169
9327,90,21555,5,8,0,0,0,13,2,9,10,0,0,21,nowin,loss,beat,dlwin,0,10,13,201,0.447761194,0.049751244,0.60199005,3,0.889945023
9328,30,21555,5,3,10,0,0,18,2,9,10,0,0,21,nowin,loss,beat,dlwin,0,10,8,206,0.393203883,0.033980583,0.601941748,0,0.029324648
9329,70,21555,5,9,0,0,0,14,2,9,10,0,0,21,nowin,loss,beat,dlwin,0,10,14,228,0.385964912,0.039473684,0.557017544,0,0.016157125
9330,65,21556,3,9,0,5,0,17,3,10,2,10,0,25,nowin,win,dlbust,bust,20,0,12,203,0.492610837,0.054187192,0.571428571,3,0.913702814
9331,47,21556,10,9,0,0,0,19,3,10,2,10,0,25,nowin,win,dlbust,bust,20,0,19,210,0.438095238,0.057142857,0.623809524,2,0.615868808
9332,76,21556,9,10,0,0,0,19,3,10,2,10,0,25,nowin,win,dlbust,bust,20,0,19,189,0.534391534,0.079365079,0.608465608,3,1
9333,52,21556,2,5,7,0,0,14,3,10,2,10,0,25,nowin,win,dlbust,bust,20,0,7,217,0.414746544,0.02764977,0.599078341,2,0.576736024
9334,28,21556,6,10,0,0,0,16,3,10,2,10,0,25,nowin,win,dlbust,bust,20,0,16,199,0.422110553,0.045226131,0.542713568,1,0.282706618
9335,138,21556,4,10,0,0,0,14,3,10,2,10,0,25,nowin,win,dlbust,bust,20,0,14,190,0.442105263,0.047368421,0.610526316,2,0.609711065
9336,107,21557,10,10,0,0,0,20,10,3,7,0,0,20,nowin,push,push,push,10,0,20,218,0.444954128,0.073394495,0.600917431,2,0.605210014
9337,51,21557,4,7,4,7,0,22,10,3,7,0,0,20,nowin,loss,bust,plbust,0,10,11,189,0.529100529,0.068783069,0.608465608,3,0.993665715
9338,109,21557,7,10,0,0,0,17,10,3,7,0,0,20,nowin,loss,beat,dlwin,0,10,17,221,0.461538462,0.058823529,0.597285068,3,0.901830309
9339,53,21557,10,6,0,9,0,25,10,3,7,0,0,20,nowin,loss,bust,plbust,0,10,16,250,0.372,0.064,0.564,0,0.013687345
9340,143,21557,5,10,0,10,0,25,10,3,7,0,0,20,nowin,loss,bust,plbust,0,10,15,203,0.463054187,0.044334975,0.57635468,3,0.883143365
9341,131,21557,6,10,0,5,0,21,10,3,7,0,0,20,nowin,win,plwin,beat,20,0,16,217,0.410138249,0.069124424,0.543778802,0,0.02015021
9342,111,21558,10,7,0,0,0,17,2,6,5,9,0,22,nowin,win,dlbust,bust,20,0,17,180,0.433333333,0.055555556,0.611111111,2,0.602264492
9343,18,21558,9,9,0,0,0,18,2,6,5,9,0,22,nowin,win,dlbust,bust,20,0,18,182,0.461538462,0.043956044,0.587912088,3,0.892649374
9344,68,21558,7,4,10,0,0,21,2,6,5,9,0,22,nowin,win,dlbust,bust,20,0,11,205,0.434146341,0.029268293,0.6,2,0.59483189
9345,21,21558,11,2,6,0,0,19,2,6,5,9,0,22,nowin,win,dlbust,bust,20,0,13,214,0.359813084,0.042056075,0.626168224,0,0.025263474
9346,39,21558,8,11,0,0,0,19,2,6,5,9,0,22,nowin,win,dlbust,bust,20,0,19,191,0.429319372,0.062827225,0.57591623,0,0.033760763
9347,83,21558,2,10,0,7,0,19,2,6,5,9,0,22,nowin,win,dlbust,bust,20,0,12,193,0.424870466,0.051813472,0.678756477,2,0.644360335
9348,132,21559,10,6,0,0,0,16,2,6,4,2,10,24,nowin,win,dlbust,bust,20,0,16,194,0.412371134,0.036082474,0.649484536,2,0.611633238
9349,82,21559,11,9,0,0,0,20,2,6,4,2,10,24,nowin,win,dlbust,bust,20,0,20,225,0.408888889,0.075555556,0.577777778,0,0.028101874
9350,112,21559,2,6,10,0,0,18,2,6,4,2,10,24,nowin,win,dlbust,bust,20,0,8,203,0.448275862,0.054187192,0.600985222,3,0.889576933
9351,63,21559,10,3,0,0,0,13,2,6,4,2,10,24,nowin,win,dlbust,bust,20,0,13,216,0.467592593,0.037037037,0.62037037,3,0.931690496
9352,46,21559,8,10,0,0,0,18,2,6,4,2,10,24,nowin,win,dlbust,bust,20,0,18,186,0.403225806,0.048387097,0.591397849,0,0.029742194
9353,14,21559,5,3,10,0,0,18,2,6,4,2,10,24,nowin,win,dlbust,bust,20,0,8,202,0.391089109,0.01980198,0.628712871,2,0.577264877
9354,101,21560,11,1,4,0,0,16,4,2,10,9,0,25,nowin,win,dlbust,bust,20,0,12,205,0.424390244,0.068292683,0.63902439,2,0.614740646
9355,123,21560,5,10,0,0,0,15,4,2,10,9,0,25,nowin,win,dlbust,bust,20,0,15,205,0.43902439,0.034146341,0.614634146,2,0.609962544
9356,54,21560,10,6,0,0,0,16,4,2,10,9,0,25,nowin,win,dlbust,bust,20,0,16,185,0.437837838,0.032432432,0.556756757,1,0.29899854
9357,67,21560,10,4,0,0,0,14,4,2,10,9,0,25,nowin,win,dlbust,bust,20,0,14,195,0.369230769,0.041025641,0.569230769,0,0.014139427
9358,42,21560,8,10,0,0,0,18,4,2,10,9,0,25,nowin,win,dlbust,bust,20,0,18,212,0.443396226,0.051886792,0.570754717,1,0.309181312
9359,4,21560,9,2,9,0,0,20,4,2,10,9,0,25,nowin,win,dlbust,bust,20,0,11,217,0.460829493,0.036866359,0.562211982,1,0.315432839
9360,150,21561,10,9,0,0,0,19,5,10,9,0,0,24,nowin,win,dlbust,bust,20,0,19,192,0.401041667,0.036458333,0.567708333,0,0.023287458
9361,135,21561,10,10,0,0,0,20,5,10,9,0,0,24,nowin,win,dlbust,bust,20,0,20,179,0.391061453,0.067039106,0.586592179,0,0.024924662
9362,59,21561,4,10,0,0,0,14,5,10,9,0,0,24,nowin,win,dlbust,bust,20,0,14,228,0.429824561,0.048245614,0.543859649,1,0.287885446
9363,93,21561,6,6,0,0,0,12,5,10,9,0,0,24,nowin,win,dlbust,bust,20,0,12,175,0.485714286,0.051428571,0.548571429,1,0.323648091
9364,28,21561,10,3,0,0,0,13,5,10,9,0,0,24,nowin,win,dlbust,bust,20,0,13,199,0.422110553,0.045226131,0.542713568,1,0.282706618
9365,32,21561,11,7,0,0,0,18,5,10,9,0,0,24,nowin,win,dlbust,bust,20,0,18,189,0.391534392,0.037037037,0.53968254,0,0.013579086
9366,114,21562,10,10,0,0,0,20,6,9,6,0,0,21,nowin,loss,beat,dlwin,0,10,20,198,0.47979798,0.025252525,0.611111111,3,0.937232995
9367,104,21562,10,11,0,0,0,21,6,9,6,0,0,21,win,push,push,push,10,0,21,209,0.363636364,0.052631579,0.593301435,0,0.018359419
9368,111,21562,10,6,0,0,0,16,6,9,6,0,0,21,nowin,loss,beat,dlwin,0,10,16,180,0.433333333,0.055555556,0.611111111,2,0.602264492
9369,121,21562,7,2,10,0,0,19,6,9,6,0,0,21,nowin,loss,beat,dlwin,0,10,9,195,0.456410256,0.025641026,0.512820513,1,0.288597791
9370,137,21562,11,3,5,0,0,19,6,9,6,0,0,21,nowin,loss,beat,dlwin,0,10,14,194,0.417525773,0.046391753,0.536082474,1,0.276714602
9371,121,21562,5,11,2,0,0,18,6,9,6,0,0,21,nowin,loss,beat,dlwin,0,10,16,195,0.456410256,0.025641026,0.512820513,1,0.288597791
9372,137,21563,3,10,0,9,0,22,10,4,8,0,0,22,nowin,loss,bust,plbust,0,10,13,194,0.417525773,0.046391753,0.536082474,1,0.276714602
9373,31,21563,4,7,4,7,0,22,10,4,8,0,0,22,nowin,loss,bust,plbust,0,10,11,188,0.473404255,0.058510638,0.515957447,1,0.300306557
9374,72,21563,2,10,0,10,0,22,10,4,8,0,0,22,nowin,loss,bust,plbust,0,10,12,185,0.394594595,0.032432432,0.508108108,0,0.006763115
9375,13,21563,10,4,0,2,4,20,10,4,8,0,0,22,nowin,win,dlbust,bust,20,0,14,206,0.417475728,0.063106796,0.621359223,2,0.59555479
9376,75,21563,10,5,0,4,0,19,10,4,8,0,0,22,nowin,win,dlbust,bust,20,0,15,191,0.418848168,0.052356021,0.570680628,0,0.029344702
9377,146,21563,8,11,0,0,0,19,10,4,8,0,0,22,nowin,win,dlbust,bust,20,0,19,221,0.43438914,0.040723982,0.542986425,1,0.290190091
9378,131,21564,11,10,0,0,0,21,8,10,0,0,0,18,win,win,plwin,beat,25,0,21,217,0.410138249,0.069124424,0.543778802,0,0.02015021
9379,137,21564,2,2,10,7,0,21,8,10,0,0,0,18,nowin,win,plwin,beat,20,0,4,194,0.417525773,0.046391753,0.536082474,1,0.276714602
9380,58,21564,10,2,0,1,3,16,8,10,0,0,0,18,nowin,loss,beat,dlwin,0,10,12,195,0.430769231,0.041025641,0.584615385,2,0.580497586
9381,146,21564,5,3,6,1,4,19,8,10,0,0,0,18,nowin,win,plwin,beat,20,0,8,221,0.43438914,0.040723982,0.542986425,1,0.290190091
9382,39,21564,10,10,0,0,0,20,8,10,0,0,0,18,nowin,win,plwin,beat,20,0,20,191,0.429319372,0.062827225,0.57591623,0,0.033760763
9383,147,21564,11,2,5,0,0,18,8,10,0,0,0,18,nowin,push,push,push,10,0,13,205,0.380487805,0.014634146,0.536585366,0,0.00951447
9384,136,21565,10,5,0,7,0,22,7,8,2,0,0,17,nowin,loss,bust,plbust,0,10,15,194,0.396907216,0.025773196,0.597938144,0,0.029452644
9385,62,21565,10,7,0,0,0,17,7,8,2,0,0,17,nowin,push,push,push,10,0,17,178,0.370786517,0.028089888,0.54494382,0,0.008657722
9386,82,21565,4,3,10,0,0,17,7,8,2,0,0,17,nowin,push,push,push,10,0,7,225,0.408888889,0.075555556,0.577777778,0,0.028101874
9387,73,21565,3,10,0,5,0,18,7,8,2,0,0,17,nowin,win,plwin,beat,20,0,13,181,0.375690608,0.011049724,0.596685083,0,0.022795773
9388,28,21565,10,4,0,3,0,17,7,8,2,0,0,17,nowin,push,push,push,10,0,14,199,0.422110553,0.045226131,0.542713568,1,0.282706618
9389,52,21565,6,10,0,6,0,22,7,8,2,0,0,17,nowin,loss,bust,plbust,0,10,16,217,0.414746544,0.02764977,0.599078341,2,0.576736024
9390,77,21566,4,9,0,6,0,19,10,3,6,0,0,19,nowin,push,push,push,10,0,13,200,0.455,0.04,0.62,3,0.916252116
9391,68,21566,1,1,10,4,10,26,10,3,6,0,0,19,nowin,loss,bust,plbust,0,10,2,205,0.434146341,0.029268293,0.6,2,0.59483189
9392,75,21566,5,1,7,8,0,21,10,3,6,0,0,19,nowin,win,plwin,beat,20,0,6,191,0.418848168,0.052356021,0.570680628,0,0.029344702
9393,43,21566,7,9,0,3,0,19,10,3,6,0,0,19,nowin,push,push,push,10,0,16,192,0.40625,0.041666667,0.609375,2,0.576671372
9394,88,21566,3,6,11,0,0,20,10,3,6,0,0,19,nowin,win,plwin,beat,20,0,9,206,0.466019417,0.033980583,0.54368932,1,0.309467903
9395,53,21566,10,9,0,0,0,19,10,3,6,0,0,19,nowin,push,push,push,10,0,19,250,0.372,0.064,0.564,0,0.013687345
9396,149,21567,7,10,0,0,0,17,5,3,10,0,0,18,nowin,loss,beat,dlwin,0,10,17,225,0.457777778,0.057777778,0.648888889,2,0.651965595
9397,129,21567,6,10,0,0,0,16,5,3,10,0,0,18,nowin,loss,beat,dlwin,0,10,16,201,0.422885572,0.064676617,0.55721393,0,0.027255383
9398,104,21567,3,1,8,0,0,12,5,3,10,0,0,18,nowin,loss,beat,dlwin,0,10,4,209,0.363636364,0.052631579,0.593301435,0,0.018359419
9399,110,21567,10,10,0,0,0,20,5,3,10,0,0,18,nowin,win,plwin,beat,20,0,20,192,0.416666667,0.046875,0.557291667,0,0.025413132
9400,147,21567,3,5,4,0,0,12,5,3,10,0,0,18,nowin,loss,beat,dlwin,0,10,8,205,0.380487805,0.014634146,0.536585366,0,0.00951447
9401,64,21567,9,4,0,0,0,13,5,3,10,0,0,18,nowin,loss,beat,dlwin,0,10,13,187,0.363636364,0.048128342,0.631016043,0,0.027594885
9402,108,21568,11,10,0,0,0,21,4,8,9,0,0,21,win,push,push,push,10,0,21,193,0.435233161,0.056994819,0.559585492,1,0.298824795
9403,17,21568,10,11,0,0,0,21,4,8,9,0,0,21,win,push,push,push,10,0,21,171,0.444444444,0.070175439,0.555555556,1,0.302364894
9404,140,21568,5,5,4,0,0,14,4,8,9,0,0,21,nowin,loss,beat,dlwin,0,10,10,210,0.466666667,0.023809524,0.604761905,3,0.915293335
9405,74,21568,7,9,0,0,0,16,4,8,9,0,0,21,nowin,loss,beat,dlwin,0,10,16,209,0.411483254,0.04784689,0.531100478,0,0.017448125
9406,73,21568,6,4,10,0,0,20,4,8,9,0,0,21,nowin,loss,beat,dlwin,0,10,10,181,0.375690608,0.011049724,0.596685083,0,0.022795773
9407,133,21568,5,7,0,0,0,12,4,8,9,0,0,21,nowin,loss,beat,dlwin,0,10,12,201,0.47761194,0.064676617,0.611940299,3,0.935428111
9408,8,21569,6,9,0,0,0,15,4,6,10,0,0,20,nowin,loss,beat,dlwin,0,10,15,181,0.44198895,0.071823204,0.596685083,2,0.599438402
9409,150,21569,8,11,0,0,0,19,4,6,10,0,0,20,nowin,loss,beat,dlwin,0,10,19,192,0.401041667,0.036458333,0.567708333,0,0.023287458
9410,111,21569,6,3,9,0,0,18,4,6,10,0,0,20,nowin,loss,beat,dlwin,0,10,9,180,0.433333333,0.055555556,0.611111111,2,0.602264492
9411,107,21569,10,6,0,0,0,16,4,6,10,0,0,20,nowin,loss,beat,dlwin,0,10,16,218,0.444954128,0.073394495,0.600917431,2,0.605210014
9412,32,21569,2,10,0,0,0,12,4,6,10,0,0,20,nowin,loss,beat,dlwin,0,10,12,189,0.391534392,0.037037037,0.53968254,0,0.013579086
9413,8,21569,10,9,0,0,0,19,4,6,10,0,0,20,nowin,loss,beat,dlwin,0,10,19,181,0.44198895,0.071823204,0.596685083,2,0.599438402
9414,105,21570,3,9,0,10,0,22,2,8,10,0,0,20,nowin,loss,bust,plbust,0,10,12,198,0.414141414,0.070707071,0.590909091,0,0.032889494
9415,47,21570,4,2,8,0,0,14,2,8,10,0,0,20,nowin,loss,beat,dlwin,0,10,6,210,0.438095238,0.057142857,0.623809524,2,0.615868808
9416,5,21570,2,10,0,7,0,19,2,8,10,0,0,20,nowin,loss,beat,dlwin,0,10,12,203,0.42364532,0.02955665,0.596059113,2,0.582508076
9417,8,21570,6,10,0,0,0,16,2,8,10,0,0,20,nowin,loss,beat,dlwin,0,10,16,181,0.44198895,0.071823204,0.596685083,2,0.599438402
9418,70,21570,2,3,7,3,0,15,2,8,10,0,0,20,nowin,loss,beat,dlwin,0,10,5,228,0.385964912,0.039473684,0.557017544,0,0.016157125
9419,140,21570,4,8,0,8,0,20,2,8,10,0,0,20,nowin,push,push,push,10,0,12,210,0.466666667,0.023809524,0.604761905,3,0.915293335
9420,60,21571,1,4,10,2,0,17,11,9,0,0,0,20,nowin,loss,beat,dlwin,0,10,5,227,0.418502203,0.022026432,0.559471366,0,0.026496258
9421,122,21571,10,6,0,4,0,20,11,9,0,0,0,20,nowin,push,push,push,10,0,16,210,0.347619048,0.052380952,0.59047619,0,0.012873677
9422,126,21571,5,8,0,10,0,23,11,9,0,0,0,20,nowin,loss,bust,plbust,0,10,13,188,0.457446809,0.074468085,0.60106383,3,0.900633203
9423,45,21571,3,9,0,6,0,18,11,9,0,0,0,20,nowin,loss,beat,dlwin,0,10,12,196,0.428571429,0.051020408,0.612244898,2,0.598821767
9424,144,21571,6,5,10,0,0,21,11,9,0,0,0,20,nowin,win,plwin,beat,20,0,11,202,0.386138614,0.054455446,0.564356436,0,0.018006244
9425,98,21571,10,5,0,10,0,25,11,9,0,0,0,20,nowin,loss,bust,plbust,0,10,15,220,0.422727273,0.054545455,0.55,1,0.28664435
9426,42,21572,3,5,10,0,0,18,6,11,0,0,0,17,nowin,win,plwin,beat,20,0,8,212,0.443396226,0.051886792,0.570754717,1,0.309181312
9427,127,21572,10,6,0,0,0,16,6,11,0,0,0,17,nowin,loss,beat,dlwin,0,10,16,201,0.402985075,0.029850746,0.60199005,0,0.032263937
9428,81,21572,10,10,0,0,0,20,6,11,0,0,0,17,nowin,win,plwin,beat,20,0,20,182,0.395604396,0.043956044,0.60989011,2,0.567491261
9429,39,21572,6,10,0,0,0,16,6,11,0,0,0,17,nowin,loss,beat,dlwin,0,10,16,191,0.429319372,0.062827225,0.57591623,0,0.033760763
9430,23,21572,2,7,10,0,0,19,6,11,0,0,0,17,nowin,win,plwin,beat,20,0,9,208,0.427884615,0.0625,0.552884615,1,0.29114424
9431,15,21572,10,9,0,0,0,19,6,11,0,0,0,17,nowin,win,plwin,beat,20,0,19,212,0.410377358,0.051886792,0.561320755,0,0.024517408
9432,58,21573,6,10,0,6,0,22,10,10,0,0,0,20,nowin,loss,bust,plbust,0,10,16,195,0.430769231,0.041025641,0.584615385,2,0.580497586
9433,58,21573,10,10,0,0,0,20,10,10,0,0,0,20,nowin,push,push,push,10,0,20,195,0.430769231,0.041025641,0.584615385,2,0.580497586
9434,130,21573,3,6,6,10,0,25,10,10,0,0,0,20,nowin,loss,bust,plbust,0,10,9,219,0.410958904,0.03652968,0.566210046,0,0.025888739
9435,75,21573,1,3,10,4,0,18,10,10,0,0,0,20,nowin,loss,beat,dlwin,0,10,4,191,0.418848168,0.052356021,0.570680628,0,0.029344702
9436,94,21573,9,9,0,0,0,18,10,10,0,0,0,20,nowin,loss,beat,dlwin,0,10,18,183,0.43715847,0.043715847,0.540983607,1,0.290866892
9437,75,21573,7,4,10,0,0,21,10,10,0,0,0,20,nowin,win,plwin,beat,20,0,11,191,0.418848168,0.052356021,0.570680628,0,0.029344702
9438,86,21574,10,10,0,0,0,20,10,10,0,0,0,20,nowin,push,push,push,10,0,20,196,0.454081633,0.040816327,0.591836735,3,0.887566443
9439,98,21574,2,9,9,0,0,20,10,10,0,0,0,20,nowin,push,push,push,10,0,11,220,0.422727273,0.054545455,0.55,1,0.28664435
9440,28,21574,3,10,0,8,0,21,10,10,0,0,0,20,nowin,win,plwin,beat,20,0,13,199,0.422110553,0.045226131,0.542713568,1,0.282706618
9441,63,21574,3,8,1,10,0,22,10,10,0,0,0,20,nowin,loss,bust,plbust,0,10,11,216,0.467592593,0.037037037,0.62037037,3,0.931690496
9442,26,21574,6,7,0,5,0,18,10,10,0,0,0,20,nowin,loss,beat,dlwin,0,10,13,203,0.463054187,0.0591133,0.541871921,1,0.306802864
9443,42,21574,11,10,0,0,0,21,10,10,0,0,0,20,win,win,plwin,beat,25,0,21,212,0.443396226,0.051886792,0.570754717,1,0.309181312
9444,60,21575,9,8,0,0,0,17,4,10,8,0,0,22,nowin,win,dlbust,bust,20,0,17,227,0.418502203,0.022026432,0.559471366,0,0.026496258
9445,56,21575,10,11,0,0,0,21,4,10,8,0,0,22,win,win,dlbust,bust,25,0,21,175,0.4,0.057142857,0.582857143,0,0.026685297
9446,2,21575,8,10,0,0,0,18,4,10,8,0,0,22,nowin,win,dlbust,bust,20,0,18,200,0.445,0.035,0.64,2,0.633962549
9447,119,21575,3,10,0,0,0,13,4,10,8,0,0,22,nowin,win,dlbust,bust,20,0,13,190,0.405263158,0.068421053,0.515789474,0,0.011837158
9448,20,21575,5,4,11,0,0,20,4,10,8,0,0,22,nowin,win,dlbust,bust,20,0,9,186,0.456989247,0.037634409,0.537634409,1,0.301097108
9449,62,21575,2,2,8,0,0,12,4,10,8,0,0,22,nowin,win,dlbust,bust,20,0,4,178,0.370786517,0.028089888,0.54494382,0,0.008657722
9450,138,21576,3,5,3,1,9,21,10,2,2,9,0,23,nowin,win,dlbust,bust,20,0,8,190,0.442105263,0.047368421,0.610526316,2,0.609711065
9451,26,21576,10,7,0,0,0,17,10,2,2,9,0,23,nowin,win,dlbust,bust,20,0,17,203,0.463054187,0.0591133,0.541871921,1,0.306802864
9452,147,21576,5,7,0,10,0,22,10,2,2,9,0,23,nowin,loss,bust,plbust,0,10,12,205,0.380487805,0.014634146,0.536585366,0,0.00951447
9453,62,21576,8,6,0,2,10,26,10,2,2,9,0,23,nowin,loss,bust,plbust,0,10,14,178,0.370786517,0.028089888,0.54494382,0,0.008657722
9454,62,21576,1,6,7,3,0,17,10,2,2,9,0,23,nowin,win,dlbust,bust,20,0,7,178,0.370786517,0.028089888,0.54494382,0,0.008657722
9455,3,21576,8,2,9,0,0,19,10,2,2,9,0,23,nowin,win,dlbust,bust,20,0,10,190,0.431578947,0.026315789,0.542105263,1,0.288076384
9456,144,21577,4,10,0,9,0,23,7,2,9,0,0,18,nowin,loss,bust,plbust,0,10,14,202,0.386138614,0.054455446,0.564356436,0,0.018006244
9457,57,21577,11,10,0,0,0,21,7,2,9,0,0,18,win,win,plwin,beat,25,0,21,192,0.46875,0.052083333,0.59375,3,0.907001181
9458,23,21577,5,10,0,10,0,25,7,2,9,0,0,18,nowin,loss,bust,plbust,0,10,15,208,0.427884615,0.0625,0.552884615,1,0.29114424
9459,27,21577,4,7,6,0,0,17,7,2,9,0,0,18,nowin,loss,beat,dlwin,0,10,11,178,0.370786517,0.016853933,0.573033708,0,0.015536309
9460,13,21577,8,7,0,6,0,21,7,2,9,0,0,18,nowin,win,plwin,beat,20,0,15,206,0.417475728,0.063106796,0.621359223,2,0.59555479
9461,144,21577,10,10,0,0,0,20,7,2,9,0,0,18,nowin,win,plwin,beat,20,0,20,202,0.386138614,0.054455446,0.564356436,0,0.018006244
9462,113,21578,9,9,0,0,0,18,3,7,10,0,0,20,nowin,loss,beat,dlwin,0,10,18,199,0.407035176,0.055276382,0.668341709,2,0.620695264
9463,18,21578,7,6,0,0,0,13,3,7,10,0,0,20,nowin,loss,beat,dlwin,0,10,13,182,0.461538462,0.043956044,0.587912088,3,0.892649374
9464,117,21578,4,10,0,0,0,14,3,7,10,0,0,20,nowin,loss,beat,dlwin,0,10,14,173,0.410404624,0.069364162,0.606936416,2,0.578610282
9465,125,21578,8,8,0,0,0,16,3,7,10,0,0,20,nowin,loss,beat,dlwin,0,10,16,219,0.438356164,0.050228311,0.575342466,1,0.308411257
9466,72,21578,9,9,0,0,0,18,3,7,10,0,0,20,nowin,loss,beat,dlwin,0,10,18,185,0.394594595,0.032432432,0.508108108,0,0.006763115
9467,58,21578,8,6,0,0,0,14,3,7,10,0,0,20,nowin,loss,beat,dlwin,0,10,14,195,0.430769231,0.041025641,0.584615385,2,0.580497586
9468,104,21579,10,10,0,0,0,20,10,4,7,0,0,21,nowin,loss,beat,dlwin,0,10,20,209,0.363636364,0.052631579,0.593301435,0,0.018359419
9469,17,21579,10,10,0,0,0,20,10,4,7,0,0,21,nowin,loss,beat,dlwin,0,10,20,171,0.444444444,0.070175439,0.555555556,1,0.302364894
9470,79,21579,2,6,11,0,0,19,10,4,7,0,0,21,nowin,loss,beat,dlwin,0,10,8,211,0.436018957,0.028436019,0.672985782,2,0.650131054
9471,19,21579,5,6,4,10,0,25,10,4,7,0,0,21,nowin,loss,bust,plbust,0,10,11,237,0.41350211,0.054852321,0.628691983,2,0.597373826
9472,89,21579,9,2,10,0,0,21,10,4,7,0,0,21,nowin,push,push,push,10,0,11,212,0.537735849,0.047169811,0.594339623,3,0.990167191
9473,96,21579,10,3,0,3,10,26,10,4,7,0,0,21,nowin,loss,bust,plbust,0,10,13,190,0.468421053,0.057894737,0.584210526,3,0.897263354
9474,114,21580,10,10,0,0,0,20,8,10,0,0,0,18,nowin,win,plwin,beat,20,0,20,198,0.47979798,0.025252525,0.611111111,3,0.937232995
9475,52,21580,4,10,0,4,0,18,8,10,0,0,0,18,nowin,push,push,push,10,0,14,217,0.414746544,0.02764977,0.599078341,2,0.576736024
9476,135,21580,2,10,0,9,0,21,8,10,0,0,0,18,nowin,win,plwin,beat,20,0,12,179,0.391061453,0.067039106,0.586592179,0,0.024924662
9477,95,21580,2,11,4,0,0,17,8,10,0,0,0,18,nowin,loss,beat,dlwin,0,10,13,218,0.412844037,0.04587156,0.559633028,0,0.024842385
9478,37,21580,10,6,0,7,0,23,8,10,0,0,0,18,nowin,loss,bust,plbust,0,10,16,208,0.394230769,0.038461538,0.581730769,0,0.024682772
9479,123,21580,10,7,0,0,0,17,8,10,0,0,0,18,nowin,loss,beat,dlwin,0,10,17,205,0.43902439,0.034146341,0.614634146,2,0.609962544
9480,47,21581,3,7,8,0,0,18,4,10,10,0,0,24,nowin,win,dlbust,bust,20,0,10,210,0.438095238,0.057142857,0.623809524,2,0.615868808
9481,36,21581,9,2,1,0,0,12,4,10,10,0,0,24,nowin,win,dlbust,bust,20,0,11,229,0.445414847,0.056768559,0.655021834,2,0.645370571
9482,73,21581,8,5,0,0,0,13,4,10,10,0,0,24,nowin,win,dlbust,bust,20,0,13,181,0.375690608,0.011049724,0.596685083,0,0.022795773
9483,121,21581,9,4,0,0,0,13,4,10,10,0,0,24,nowin,win,dlbust,bust,20,0,13,195,0.456410256,0.025641026,0.512820513,1,0.288597791
9484,130,21581,11,7,0,0,0,18,4,10,10,0,0,24,nowin,win,dlbust,bust,20,0,18,219,0.410958904,0.03652968,0.566210046,0,0.025888739
9485,56,21581,5,7,0,0,0,12,4,10,10,0,0,24,nowin,win,dlbust,bust,20,0,12,175,0.4,0.057142857,0.582857143,0,0.026685297
9486,70,21582,10,11,0,0,0,21,10,9,0,0,0,19,win,win,plwin,beat,25,0,21,228,0.385964912,0.039473684,0.557017544,0,0.016157125
9487,87,21582,8,10,0,0,0,18,10,9,0,0,0,19,nowin,loss,beat,dlwin,0,10,18,202,0.405940594,0.054455446,0.628712871,2,0.590599801
9488,51,21582,11,10,0,0,0,21,10,9,0,0,0,19,win,win,plwin,beat,25,0,21,189,0.529100529,0.068783069,0.608465608,3,0.993665715
9489,34,21582,10,10,0,0,0,20,10,9,0,0,0,19,nowin,win,plwin,beat,20,0,20,202,0.5,0.079207921,0.618811881,3,0.968961434
9490,5,21582,10,7,0,0,0,17,10,9,0,0,0,19,nowin,loss,beat,dlwin,0,10,17,203,0.42364532,0.02955665,0.596059113,2,0.582508076
9491,94,21582,10,8,0,0,0,18,10,9,0,0,0,19,nowin,loss,beat,dlwin,0,10,18,183,0.43715847,0.043715847,0.540983607,1,0.290866892
9492,111,21583,5,2,4,10,0,21,11,2,4,0,0,17,nowin,win,plwin,beat,20,0,7,180,0.433333333,0.055555556,0.611111111,2,0.602264492
9493,39,21583,7,9,0,10,0,26,11,2,4,0,0,17,nowin,loss,bust,plbust,0,10,16,191,0.429319372,0.062827225,0.57591623,0,0.033760763
9494,66,21583,3,9,0,10,0,22,11,2,4,0,0,17,nowin,loss,bust,plbust,0,10,12,217,0.456221198,0.064516129,0.626728111,3,0.924304367
9495,5,21583,4,4,7,10,0,25,11,2,4,0,0,17,nowin,loss,bust,plbust,0,10,8,203,0.42364532,0.02955665,0.596059113,2,0.582508076
9496,133,21583,10,10,0,0,0,20,11,2,4,0,0,17,nowin,win,plwin,beat,20,0,20,201,0.47761194,0.064676617,0.611940299,3,0.935428111
9497,68,21583,6,8,0,6,0,20,11,2,4,0,0,17,nowin,win,plwin,beat,20,0,14,205,0.434146341,0.029268293,0.6,2,0.59483189
9498,146,21584,3,10,0,10,0,23,9,6,10,0,0,25,nowin,loss,bust,plbust,0,10,13,221,0.43438914,0.040723982,0.542986425,1,0.290190091
9499,102,21584,3,7,10,0,0,20,9,6,10,0,0,25,nowin,win,dlbust,bust,20,0,10,192,0.338541667,0.046875,0.5625,0,0.003306118
9500,67,21584,1,3,8,7,0,19,9,6,10,0,0,25,nowin,win,dlbust,bust,20,0,4,195,0.369230769,0.041025641,0.569230769,0,0.014139427
9501,60,21584,3,4,6,10,0,23,9,6,10,0,0,25,nowin,loss,bust,plbust,0,10,7,227,0.418502203,0.022026432,0.559471366,0,0.026496258
9502,27,21584,8,2,4,10,0,24,9,6,10,0,0,25,nowin,loss,bust,plbust,0,10,10,178,0.370786517,0.016853933,0.573033708,0,0.015536309
9503,72,21584,9,2,5,2,0,18,9,6,10,0,0,25,nowin,win,dlbust,bust,20,0,11,185,0.394594595,0.032432432,0.508108108,0,0.006763115
9504,42,21585,6,10,0,6,0,22,10,4,5,0,0,19,nowin,loss,bust,plbust,0,10,16,212,0.443396226,0.051886792,0.570754717,1,0.309181312
9505,69,21585,5,10,0,7,0,22,10,4,5,0,0,19,nowin,loss,bust,plbust,0,10,15,194,0.365979381,0.030927835,0.515463918,0,0
9506,53,21585,8,11,0,0,0,19,10,4,5,0,0,19,nowin,push,push,push,10,0,19,250,0.372,0.064,0.564,0,0.013687345
9507,24,21585,5,11,4,0,0,20,10,4,5,0,0,19,nowin,win,plwin,beat,20,0,16,207,0.458937198,0.048309179,0.570048309,1,0.318138014
9508,108,21585,1,2,9,7,0,19,10,4,5,0,0,19,nowin,push,push,push,10,0,3,193,0.435233161,0.056994819,0.559585492,1,0.298824795
9509,147,21585,9,3,0,6,0,18,10,4,5,0,0,19,nowin,loss,beat,dlwin,0,10,12,205,0.380487805,0.014634146,0.536585366,0,0.00951447
9510,57,21586,11,8,0,0,0,19,3,6,2,6,0,17,nowin,win,plwin,beat,20,0,19,192,0.46875,0.052083333,0.59375,3,0.907001181
9511,76,21586,10,10,0,0,0,20,3,6,2,6,0,17,nowin,win,plwin,beat,20,0,20,189,0.534391534,0.079365079,0.608465608,3,1
9512,53,21586,10,10,0,0,0,20,3,6,2,6,0,17,nowin,win,plwin,beat,20,0,20,250,0.372,0.064,0.564,0,0.013687345
9513,40,21586,5,10,0,0,0,15,3,6,2,6,0,17,nowin,loss,beat,dlwin,0,10,15,196,0.367346939,0.030612245,0.617346939,0,0.025358183
9514,85,21586,11,7,0,0,0,18,3,6,2,6,0,17,nowin,win,plwin,beat,20,0,18,195,0.41025641,0.066666667,0.594871795,0,0.03269711
9515,130,21586,8,10,0,0,0,18,3,6,2,6,0,17,nowin,win,plwin,beat,20,0,18,219,0.410958904,0.03652968,0.566210046,0,0.025888739
9516,8,21587,10,10,0,0,0,20,6,4,9,0,0,19,nowin,win,plwin,beat,20,0,20,181,0.44198895,0.071823204,0.596685083,2,0.599438402
9517,57,21587,10,10,0,0,0,20,6,4,9,0,0,19,nowin,win,plwin,beat,20,0,20,192,0.46875,0.052083333,0.59375,3,0.907001181
9518,140,21587,11,2,8,0,0,21,6,4,9,0,0,19,nowin,win,plwin,beat,20,0,13,210,0.466666667,0.023809524,0.604761905,3,0.915293335
9519,40,21587,3,5,7,0,0,15,6,4,9,0,0,19,nowin,loss,beat,dlwin,0,10,8,196,0.367346939,0.030612245,0.617346939,0,0.025358183
9520,114,21587,10,10,0,0,0,20,6,4,9,0,0,19,nowin,win,plwin,beat,20,0,20,198,0.47979798,0.025252525,0.611111111,3,0.937232995
9521,23,21587,10,4,0,0,0,14,6,4,9,0,0,19,nowin,loss,beat,dlwin,0,10,14,208,0.427884615,0.0625,0.552884615,1,0.29114424
9522,45,21588,6,10,0,0,0,16,2,1,10,10,0,23,nowin,win,dlbust,bust,20,0,16,196,0.428571429,0.051020408,0.612244898,2,0.598821767
9523,6,21588,11,10,0,0,0,21,2,1,10,10,0,23,win,win,dlbust,bust,25,0,21,191,0.439790576,0.047120419,0.581151832,1,0.31211505
9524,146,21588,5,7,0,7,0,19,2,1,10,10,0,23,nowin,win,dlbust,bust,20,0,12,221,0.43438914,0.040723982,0.542986425,1,0.290190091
9525,8,21588,10,10,0,0,0,20,2,1,10,10,0,23,nowin,win,dlbust,bust,20,0,20,181,0.44198895,0.071823204,0.596685083,2,0.599438402
9526,9,21588,5,3,2,7,0,17,2,1,10,10,0,23,nowin,win,dlbust,bust,20,0,8,194,0.37628866,0.015463918,0.541237113,0,0.009396796
9527,1,21588,9,2,4,0,0,15,2,1,10,10,0,23,nowin,win,dlbust,bust,20,0,11,197,0.406091371,0.025380711,0.649746193,2,0.606186955
9528,123,21589,2,3,4,2,10,21,3,7,5,5,0,20,nowin,win,plwin,beat,20,0,5,205,0.43902439,0.034146341,0.614634146,2,0.609962544
9529,89,21589,10,2,0,10,0,22,3,7,5,5,0,20,nowin,loss,bust,plbust,0,10,12,212,0.537735849,0.047169811,0.594339623,3,0.990167191
9530,117,21589,9,5,0,0,0,14,3,7,5,5,0,20,nowin,loss,beat,dlwin,0,10,14,173,0.410404624,0.069364162,0.606936416,2,0.578610282
9531,106,21589,3,10,0,0,0,13,3,7,5,5,0,20,nowin,loss,beat,dlwin,0,10,13,192,0.411458333,0.026041667,0.557291667,0,0.023854304
9532,43,21589,10,8,0,0,0,18,3,7,5,5,0,20,nowin,loss,beat,dlwin,0,10,18,192,0.40625,0.041666667,0.609375,2,0.576671372
9533,38,21589,10,3,0,0,0,13,3,7,5,5,0,20,nowin,loss,beat,dlwin,0,10,13,202,0.361386139,0.03960396,0.564356436,0,0.010597953
9534,19,21590,3,7,2,5,0,17,10,5,6,0,0,21,nowin,loss,beat,dlwin,0,10,10,237,0.41350211,0.054852321,0.628691983,2,0.597373826
9535,47,21590,10,11,0,0,0,21,10,5,6,0,0,21,win,push,push,push,10,0,21,210,0.438095238,0.057142857,0.623809524,2,0.615868808
9536,101,21590,7,2,2,7,0,18,10,5,6,0,0,21,nowin,loss,beat,dlwin,0,10,9,205,0.424390244,0.068292683,0.63902439,2,0.614740646
9537,129,21590,6,2,7,9,0,24,10,5,6,0,0,21,nowin,loss,bust,plbust,0,10,8,201,0.422885572,0.064676617,0.55721393,0,0.027255383
9538,7,21590,6,10,0,10,0,26,10,5,6,0,0,21,nowin,loss,bust,plbust,0,10,16,183,0.442622951,0.06010929,0.62295082,2,0.619303341
9539,141,21590,10,9,0,0,0,19,10,5,6,0,0,21,nowin,loss,beat,dlwin,0,10,19,202,0.420792079,0.074257426,0.564356436,0,0.028377851
9540,86,21591,10,7,0,0,0,17,5,10,1,7,0,23,nowin,win,dlbust,bust,20,0,17,196,0.454081633,0.040816327,0.591836735,3,0.887566443
9541,72,21591,3,2,3,10,0,18,5,10,1,7,0,23,nowin,win,dlbust,bust,20,0,5,185,0.394594595,0.032432432,0.508108108,0,0.006763115
9542,36,21591,10,10,0,0,0,20,5,10,1,7,0,23,nowin,win,dlbust,bust,20,0,20,229,0.445414847,0.056768559,0.655021834,2,0.645370571
9543,76,21591,6,3,8,0,0,17,5,10,1,7,0,23,nowin,win,dlbust,bust,20,0,9,189,0.534391534,0.079365079,0.608465608,3,1
9544,114,21591,3,1,10,0,0,14,5,10,1,7,0,23,nowin,win,dlbust,bust,20,0,4,198,0.47979798,0.025252525,0.611111111,3,0.937232995
9545,62,21591,10,5,0,0,0,15,5,10,1,7,0,23,nowin,win,dlbust,bust,20,0,15,178,0.370786517,0.028089888,0.54494382,0,0.008657722
9546,116,21592,2,9,6,0,0,17,7,10,0,0,0,17,nowin,push,push,push,10,0,11,195,0.425641026,0.056410256,0.538461538,1,0.28273747
9547,86,21592,9,8,0,0,0,17,7,10,0,0,0,17,nowin,push,push,push,10,0,17,196,0.454081633,0.040816327,0.591836735,3,0.887566443
9548,50,21592,5,10,0,10,0,25,7,10,0,0,0,17,nowin,loss,bust,plbust,0,10,15,202,0.405940594,0.04950495,0.54950495,0,0.020296079
9549,114,21592,6,10,0,9,0,25,7,10,0,0,0,17,nowin,loss,bust,plbust,0,10,16,198,0.47979798,0.025252525,0.611111111,3,0.937232995
9550,7,21592,9,8,0,0,0,17,7,10,0,0,0,17,nowin,push,push,push,10,0,17,183,0.442622951,0.06010929,0.62295082,2,0.619303341
9551,13,21592,7,11,0,0,0,18,7,10,0,0,0,17,nowin,win,plwin,beat,20,0,18,206,0.417475728,0.063106796,0.621359223,2,0.59555479
9552,71,21593,4,10,0,7,0,21,11,10,0,0,0,21,nowin,push,push,push,10,0,14,193,0.352331606,0.046632124,0.585492228,0,0.013063661
9553,125,21593,10,7,0,0,0,17,11,10,0,0,0,21,nowin,loss,beat,dlwin,0,10,17,219,0.438356164,0.050228311,0.575342466,1,0.308411257
9554,137,21593,3,10,0,5,0,18,11,10,0,0,0,21,nowin,loss,beat,dlwin,0,10,13,194,0.417525773,0.046391753,0.536082474,1,0.276714602
9555,5,21593,4,7,4,10,0,25,11,10,0,0,0,21,nowin,loss,bust,plbust,0,10,11,203,0.42364532,0.02955665,0.596059113,2,0.582508076
9556,82,21593,4,5,7,9,0,25,11,10,0,0,0,21,nowin,loss,bust,plbust,0,10,9,225,0.408888889,0.075555556,0.577777778,0,0.028101874
9557,98,21593,11,10,0,0,0,21,11,10,0,0,0,21,win,push,push,push,10,0,21,220,0.422727273,0.054545455,0.55,1,0.28664435
9558,97,21594,1,2,10,7,0,20,7,4,10,0,0,21,nowin,loss,beat,dlwin,0,10,3,182,0.450549451,0.06043956,0.692307692,2,0.677372279
9559,35,21594,7,7,0,5,0,19,7,4,10,0,0,21,nowin,loss,beat,dlwin,0,10,14,202,0.410891089,0.044554455,0.633663366,2,0.598681573
9560,49,21594,10,10,0,0,0,20,7,4,10,0,0,21,nowin,loss,beat,dlwin,0,10,20,207,0.396135266,0.053140097,0.594202899,0,0.028306925
9561,144,21594,5,10,0,5,0,20,7,4,10,0,0,21,nowin,loss,beat,dlwin,0,10,15,202,0.386138614,0.054455446,0.564356436,0,0.018006244
9562,134,21594,2,1,10,10,0,23,7,4,10,0,0,21,nowin,loss,bust,plbust,0,10,3,185,0.443243243,0.021621622,0.545945946,1,0.296939509
9563,29,21594,10,8,0,0,0,18,7,4,10,0,0,21,nowin,loss,beat,dlwin,0,10,18,189,0.44973545,0.058201058,0.544973545,1,0.300349439
9564,127,21595,8,11,0,0,0,19,5,10,6,0,0,21,nowin,loss,beat,dlwin,0,10,19,201,0.402985075,0.029850746,0.60199005,0,0.032263937
9565,43,21595,10,10,0,0,0,20,5,10,6,0,0,21,nowin,loss,beat,dlwin,0,10,20,192,0.40625,0.041666667,0.609375,2,0.576671372
9566,86,21595,7,10,0,0,0,17,5,10,6,0,0,21,nowin,loss,beat,dlwin,0,10,17,196,0.454081633,0.040816327,0.591836735,3,0.887566443
9567,87,21595,4,1,10,0,0,15,5,10,6,0,0,21,nowin,loss,beat,dlwin,0,10,5,202,0.405940594,0.054455446,0.628712871,2,0.590599801
9568,103,21595,10,8,0,0,0,18,5,10,6,0,0,21,nowin,loss,beat,dlwin,0,10,18,203,0.379310345,0.064039409,0.551724138,0,0.012869209
9569,110,21595,3,11,4,0,0,18,5,10,6,0,0,21,nowin,loss,beat,dlwin,0,10,14,192,0.416666667,0.046875,0.557291667,0,0.025413132
9570,26,21596,4,8,0,8,0,20,10,5,2,0,0,17,nowin,win,plwin,beat,20,0,12,203,0.463054187,0.0591133,0.541871921,1,0.306802864
9571,65,21596,2,10,0,10,0,22,10,5,2,0,0,17,nowin,loss,bust,plbust,0,10,12,203,0.492610837,0.054187192,0.571428571,3,0.913702814
9572,40,21596,4,4,10,0,0,18,10,5,2,0,0,17,nowin,win,plwin,beat,20,0,8,196,0.367346939,0.030612245,0.617346939,0,0.025358183
9573,147,21596,10,7,0,0,0,17,10,5,2,0,0,17,nowin,push,push,push,10,0,17,205,0.380487805,0.014634146,0.536585366,0,0.00951447
9574,89,21596,1,6,10,0,0,17,10,5,2,0,0,17,nowin,push,push,push,10,0,7,212,0.537735849,0.047169811,0.594339623,3,0.990167191
9575,132,21596,6,8,0,8,0,22,10,5,2,0,0,17,nowin,loss,bust,plbust,0,10,14,194,0.412371134,0.036082474,0.649484536,2,0.611633238
9576,71,21597,3,11,1,0,0,15,5,10,10,0,0,25,nowin,win,dlbust,bust,20,0,14,193,0.352331606,0.046632124,0.585492228,0,0.013063661
9577,144,21597,10,9,0,0,0,19,5,10,10,0,0,25,nowin,win,dlbust,bust,20,0,19,202,0.386138614,0.054455446,0.564356436,0,0.018006244
9578,68,21597,10,2,0,0,0,12,5,10,10,0,0,25,nowin,win,dlbust,bust,20,0,12,205,0.434146341,0.029268293,0.6,2,0.59483189
9579,87,21597,10,5,0,0,0,15,5,10,10,0,0,25,nowin,win,dlbust,bust,20,0,15,202,0.405940594,0.054455446,0.628712871,2,0.590599801
9580,110,21597,9,5,0,0,0,14,5,10,10,0,0,25,nowin,win,dlbust,bust,20,0,14,192,0.416666667,0.046875,0.557291667,0,0.025413132
9581,68,21597,11,8,0,0,0,19,5,10,10,0,0,25,nowin,win,dlbust,bust,20,0,19,205,0.434146341,0.029268293,0.6,2,0.59483189
9582,18,21598,9,5,0,6,0,20,10,5,3,0,0,18,nowin,win,plwin,beat,20,0,14,182,0.461538462,0.043956044,0.587912088,3,0.892649374
9583,118,21598,10,7,0,0,0,17,10,5,3,0,0,18,nowin,loss,beat,dlwin,0,10,17,216,0.393518519,0.037037037,0.555555556,0,0.018059873
9584,128,21598,10,2,0,10,0,22,10,5,3,0,0,18,nowin,loss,bust,plbust,0,10,12,227,0.356828194,0.052863436,0.577092511,0,0.012352564
9585,49,21598,8,5,0,9,0,22,10,5,3,0,0,18,nowin,loss,bust,plbust,0,10,13,207,0.396135266,0.053140097,0.594202899,0,0.028306925
9586,26,21598,5,1,9,4,0,19,10,5,3,0,0,18,nowin,win,plwin,beat,20,0,6,203,0.463054187,0.0591133,0.541871921,1,0.306802864
9587,116,21598,2,6,2,10,0,20,10,5,3,0,0,18,nowin,win,plwin,beat,20,0,8,195,0.425641026,0.056410256,0.538461538,1,0.28273747
9588,106,21599,3,10,0,9,0,22,10,10,0,0,0,20,nowin,loss,bust,plbust,0,10,13,192,0.411458333,0.026041667,0.557291667,0,0.023854304
9589,83,21599,10,7,0,0,0,17,10,10,0,0,0,20,nowin,loss,beat,dlwin,0,10,17,193,0.424870466,0.051813472,0.678756477,2,0.644360335
9590,73,21599,6,9,0,7,0,22,10,10,0,0,0,20,nowin,loss,bust,plbust,0,10,15,181,0.375690608,0.011049724,0.596685083,0,0.022795773
9591,23,21599,7,6,0,10,0,23,10,10,0,0,0,20,nowin,loss,bust,plbust,0,10,13,208,0.427884615,0.0625,0.552884615,1,0.29114424
9592,118,21599,6,10,0,10,0,26,10,10,0,0,0,20,nowin,loss,bust,plbust,0,10,16,216,0.393518519,0.037037037,0.555555556,0,0.018059873
9593,14,21599,9,8,0,0,0,17,10,10,0,0,0,20,nowin,loss,beat,dlwin,0,10,17,202,0.391089109,0.01980198,0.628712871,2,0.577264877
9594,85,21600,10,4,0,2,9,25,7,10,0,0,0,17,nowin,loss,bust,plbust,0,10,14,195,0.41025641,0.066666667,0.594871795,0,0.03269711
9595,118,21600,10,6,0,3,0,19,7,10,0,0,0,17,nowin,win,plwin,beat,20,0,16,216,0.393518519,0.037037037,0.555555556,0,0.018059873
9596,20,21600,11,10,0,0,0,21,7,10,0,0,0,17,win,win,plwin,beat,25,0,21,186,0.456989247,0.037634409,0.537634409,1,0.301097108
9597,30,21600,2,9,1,3,4,19,7,10,0,0,0,17,nowin,win,plwin,beat,20,0,11,206,0.393203883,0.033980583,0.601941748,0,0.029324648
9598,118,21600,10,2,0,4,1,17,7,10,0,0,0,17,nowin,push,push,push,10,0,12,216,0.393518519,0.037037037,0.555555556,0,0.018059873
9599,126,21600,8,5,0,10,0,23,7,10,0,0,0,17,nowin,loss,bust,plbust,0,10,13,188,0.457446809,0.074468085,0.60106383,3,0.900633203
9600,52,21601,10,3,0,0,0,13,3,10,7,0,0,20,nowin,loss,beat,dlwin,0,10,13,217,0.414746544,0.02764977,0.599078341,2,0.576736024
9601,124,21601,9,10,0,0,0,19,3,10,7,0,0,20,nowin,loss,beat,dlwin,0,10,19,202,0.47029703,0.064356436,0.584158416,3,0.899458193
9602,106,21601,10,2,0,6,0,18,3,10,7,0,0,20,nowin,loss,beat,dlwin,0,10,12,192,0.411458333,0.026041667,0.557291667,0,0.023854304
9603,141,21601,4,6,6,0,0,16,3,10,7,0,0,20,nowin,loss,beat,dlwin,0,10,10,202,0.420792079,0.074257426,0.564356436,0,0.028377851
9604,49,21601,10,11,0,0,0,21,3,10,7,0,0,20,win,win,plwin,beat,25,0,21,207,0.396135266,0.053140097,0.594202899,0,0.028306925
9605,1,21601,10,10,0,0,0,20,3,10,7,0,0,20,nowin,push,push,push,10,0,20,197,0.406091371,0.025380711,0.649746193,2,0.606186955
9606,22,21602,4,1,10,0,0,15,4,3,4,7,0,18,nowin,loss,beat,dlwin,0,10,5,187,0.481283422,0.042780749,0.577540107,3,0.906128176
9607,50,21602,5,9,0,0,0,14,4,3,4,7,0,18,nowin,loss,beat,dlwin,0,10,14,202,0.405940594,0.04950495,0.54950495,0,0.020296079
9608,114,21602,3,10,0,0,0,13,4,3,4,7,0,18,nowin,loss,beat,dlwin,0,10,13,198,0.47979798,0.025252525,0.611111111,3,0.937232995
9609,45,21602,10,11,0,0,0,21,4,3,4,7,0,18,win,win,plwin,beat,25,0,21,196,0.428571429,0.051020408,0.612244898,2,0.598821767
9610,45,21602,3,9,0,0,0,12,4,3,4,7,0,18,nowin,loss,beat,dlwin,0,10,12,196,0.428571429,0.051020408,0.612244898,2,0.598821767
9611,5,21602,2,10,0,0,0,12,4,3,4,7,0,18,nowin,loss,beat,dlwin,0,10,12,203,0.42364532,0.02955665,0.596059113,2,0.582508076
9612,50,21603,10,4,0,0,0,14,5,5,4,10,0,24,nowin,win,dlbust,bust,20,0,14,202,0.405940594,0.04950495,0.54950495,0,0.020296079
9613,33,21603,3,5,5,0,0,13,5,5,4,10,0,24,nowin,win,dlbust,bust,20,0,8,192,0.4375,0.057291667,0.625,2,0.616208916
9614,85,21603,9,10,0,0,0,19,5,5,4,10,0,24,nowin,win,dlbust,bust,20,0,19,195,0.41025641,0.066666667,0.594871795,0,0.03269711
9615,63,21603,1,4,9,0,0,14,5,5,4,10,0,24,nowin,win,dlbust,bust,20,0,5,216,0.467592593,0.037037037,0.62037037,3,0.931690496
9616,31,21603,3,8,3,0,0,14,5,5,4,10,0,24,nowin,win,dlbust,bust,20,0,11,188,0.473404255,0.058510638,0.515957447,1,0.300306557
9617,15,21603,6,2,10,0,0,18,5,5,4,10,0,24,nowin,win,dlbust,bust,20,0,8,212,0.410377358,0.051886792,0.561320755,0,0.024517408
9618,118,21604,10,8,0,0,0,18,6,3,10,0,0,19,nowin,loss,beat,dlwin,0,10,18,216,0.393518519,0.037037037,0.555555556,0,0.018059873
9619,67,21604,7,11,0,0,0,18,6,3,10,0,0,19,nowin,loss,beat,dlwin,0,10,18,195,0.369230769,0.041025641,0.569230769,0,0.014139427
9620,11,21604,9,10,0,0,0,19,6,3,10,0,0,19,nowin,push,push,push,10,0,19,236,0.457627119,0.016949153,0.588983051,3,0.889015813
9621,71,21604,4,4,3,4,0,15,6,3,10,0,0,19,nowin,loss,beat,dlwin,0,10,8,193,0.352331606,0.046632124,0.585492228,0,0.013063661
9622,17,21604,8,10,0,0,0,18,6,3,10,0,0,19,nowin,loss,beat,dlwin,0,10,18,171,0.444444444,0.070175439,0.555555556,1,0.302364894
9623,71,21604,9,2,10,0,0,21,6,3,10,0,0,19,nowin,win,plwin,beat,20,0,11,193,0.352331606,0.046632124,0.585492228,0,0.013063661
9624,120,21605,10,7,0,0,0,17,7,6,2,10,0,25,nowin,win,dlbust,bust,20,0,17,202,0.440594059,0.034653465,0.618811881,2,0.614441029
9625,122,21605,10,10,0,0,0,20,7,6,2,10,0,25,nowin,win,dlbust,bust,20,0,20,210,0.347619048,0.052380952,0.59047619,0,0.012873677
9626,84,21605,5,10,0,1,10,26,7,6,2,10,0,25,nowin,loss,bust,plbust,0,10,15,195,0.379487179,0.056410256,0.569230769,0,0.017209119
9627,51,21605,11,7,0,0,0,18,7,6,2,10,0,25,nowin,win,dlbust,bust,20,0,18,189,0.529100529,0.068783069,0.608465608,3,0.993665715
9628,21,21605,10,10,0,0,0,20,7,6,2,10,0,25,nowin,win,dlbust,bust,20,0,20,214,0.359813084,0.042056075,0.626168224,0,0.025263474
9629,22,21605,4,5,3,10,0,22,7,6,2,10,0,25,nowin,loss,bust,plbust,0,10,9,187,0.481283422,0.042780749,0.577540107,3,0.906128176
9630,105,21606,10,6,0,0,0,16,3,10,10,0,0,23,nowin,win,dlbust,bust,20,0,16,198,0.414141414,0.070707071,0.590909091,0,0.032889494
9631,127,21606,10,10,0,0,0,20,3,10,10,0,0,23,nowin,win,dlbust,bust,20,0,20,201,0.402985075,0.029850746,0.60199005,0,0.032263937
9632,112,21606,2,7,7,0,0,16,3,10,10,0,0,23,nowin,win,dlbust,bust,20,0,9,203,0.448275862,0.054187192,0.600985222,3,0.889576933
9633,106,21606,5,7,0,7,0,19,3,10,10,0,0,23,nowin,win,dlbust,bust,20,0,12,192,0.411458333,0.026041667,0.557291667,0,0.023854304
9634,128,21606,2,2,5,10,0,19,3,10,10,0,0,23,nowin,win,dlbust,bust,20,0,4,227,0.356828194,0.052863436,0.577092511,0,0.012352564
9635,36,21606,10,7,0,0,0,17,3,10,10,0,0,23,nowin,win,dlbust,bust,20,0,17,229,0.445414847,0.056768559,0.655021834,2,0.645370571
9636,23,21607,6,9,0,0,0,15,2,10,10,0,0,22,nowin,win,dlbust,bust,20,0,15,208,0.427884615,0.0625,0.552884615,1,0.29114424
9637,16,21607,8,8,0,0,0,16,2,10,10,0,0,22,nowin,win,dlbust,bust,20,0,16,220,0.427272727,0.081818182,0.6,2,0.588660176
9638,117,21607,8,8,0,0,0,16,2,10,10,0,0,22,nowin,win,dlbust,bust,20,0,16,173,0.410404624,0.069364162,0.606936416,2,0.578610282
9639,132,21607,3,5,10,0,0,18,2,10,10,0,0,22,nowin,win,dlbust,bust,20,0,8,194,0.412371134,0.036082474,0.649484536,2,0.611633238
9640,98,21607,3,2,10,0,0,15,2,10,10,0,0,22,nowin,win,dlbust,bust,20,0,5,220,0.422727273,0.054545455,0.55,1,0.28664435
9641,142,21607,3,6,10,0,0,19,2,10,10,0,0,22,nowin,win,dlbust,bust,20,0,9,211,0.417061611,0.047393365,0.526066351,1,0.271531309
9642,134,21608,9,2,9,0,0,20,3,5,7,7,0,22,nowin,win,dlbust,bust,20,0,11,185,0.443243243,0.021621622,0.545945946,1,0.296939509
9643,146,21608,8,4,0,1,0,13,3,5,7,7,0,22,nowin,win,dlbust,bust,20,0,12,221,0.43438914,0.040723982,0.542986425,1,0.290190091
9644,32,21608,6,2,10,0,0,18,3,5,7,7,0,22,nowin,win,dlbust,bust,20,0,8,189,0.391534392,0.037037037,0.53968254,0,0.013579086
9645,74,21608,11,10,0,0,0,21,3,5,7,7,0,22,win,win,dlbust,bust,25,0,21,209,0.411483254,0.04784689,0.531100478,0,0.017448125
9646,63,21608,10,8,0,0,0,18,3,5,7,7,0,22,nowin,win,dlbust,bust,20,0,18,216,0.467592593,0.037037037,0.62037037,3,0.931690496
9647,127,21608,5,4,10,0,0,19,3,5,7,7,0,22,nowin,win,dlbust,bust,20,0,9,201,0.402985075,0.029850746,0.60199005,0,0.032263937
9648,8,21609,6,6,0,4,10,26,10,9,0,0,0,19,nowin,loss,bust,plbust,0,10,12,181,0.44198895,0.071823204,0.596685083,2,0.599438402
9649,99,21609,3,7,10,0,0,20,10,9,0,0,0,19,nowin,win,plwin,beat,20,0,10,207,0.47826087,0.062801932,0.637681159,3,0.961418446
9650,72,21609,5,10,0,10,0,25,10,9,0,0,0,19,nowin,loss,bust,plbust,0,10,15,185,0.394594595,0.032432432,0.508108108,0,0.006763115
9651,89,21609,6,7,0,7,0,20,10,9,0,0,0,19,nowin,win,plwin,beat,20,0,13,212,0.537735849,0.047169811,0.594339623,3,0.990167191
9652,7,21609,8,3,10,0,0,21,10,9,0,0,0,19,nowin,win,plwin,beat,20,0,11,183,0.442622951,0.06010929,0.62295082,2,0.619303341
9653,110,21609,9,9,0,0,0,18,10,9,0,0,0,19,nowin,loss,beat,dlwin,0,10,18,192,0.416666667,0.046875,0.557291667,0,0.025413132
9654,72,21610,9,7,0,10,0,26,10,4,2,2,0,18,nowin,loss,bust,plbust,0,10,16,185,0.394594595,0.032432432,0.508108108,0,0.006763115
9655,145,21610,6,4,3,7,0,20,10,4,2,2,0,18,nowin,win,plwin,beat,20,0,10,188,0.441489362,0.031914894,0.622340426,2,0.617837093
9656,39,21610,8,2,8,0,0,18,10,4,2,2,0,18,nowin,push,push,push,10,0,10,191,0.429319372,0.062827225,0.57591623,0,0.033760763
9657,39,21610,8,7,0,2,0,17,10,4,2,2,0,18,nowin,loss,beat,dlwin,0,10,15,191,0.429319372,0.062827225,0.57591623,0,0.033760763
9658,45,21610,3,6,11,0,0,20,10,4,2,2,0,18,nowin,win,plwin,beat,20,0,9,196,0.428571429,0.051020408,0.612244898,2,0.598821767
9659,52,21610,10,8,0,0,0,18,10,4,2,2,0,18,nowin,push,push,push,10,0,18,217,0.414746544,0.02764977,0.599078341,2,0.576736024
9660,32,21611,5,3,4,4,6,22,10,3,6,0,0,19,nowin,loss,bust,plbust,0,10,8,189,0.391534392,0.037037037,0.53968254,0,0.013579086
9661,27,21611,5,8,0,8,0,21,10,3,6,0,0,19,nowin,win,plwin,beat,20,0,13,178,0.370786517,0.016853933,0.573033708,0,0.015536309
9662,63,21611,9,10,0,0,0,19,10,3,6,0,0,19,nowin,push,push,push,10,0,19,216,0.467592593,0.037037037,0.62037037,3,0.931690496
9663,114,21611,6,6,0,1,10,23,10,3,6,0,0,19,nowin,loss,bust,plbust,0,10,12,198,0.47979798,0.025252525,0.611111111,3,0.937232995
9664,54,21611,9,10,0,0,0,19,10,3,6,0,0,19,nowin,push,push,push,10,0,19,185,0.437837838,0.032432432,0.556756757,1,0.29899854
9665,150,21611,9,3,0,10,0,22,10,3,6,0,0,19,nowin,loss,bust,plbust,0,10,12,192,0.401041667,0.036458333,0.567708333,0,0.023287458
9666,103,21612,4,10,0,0,0,14,4,3,6,8,0,21,nowin,loss,beat,dlwin,0,10,14,203,0.379310345,0.064039409,0.551724138,0,0.012869209
9667,34,21612,10,3,0,0,0,13,4,3,6,8,0,21,nowin,loss,beat,dlwin,0,10,13,202,0.5,0.079207921,0.618811881,3,0.968961434
9668,15,21612,9,3,0,0,0,12,4,3,6,8,0,21,nowin,loss,beat,dlwin,0,10,12,212,0.410377358,0.051886792,0.561320755,0,0.024517408
9669,115,21612,4,6,6,0,0,16,4,3,6,8,0,21,nowin,loss,beat,dlwin,0,10,10,194,0.427835052,0.041237113,0.592783505,2,0.583863602
9670,129,21612,10,10,0,0,0,20,4,3,6,8,0,21,nowin,loss,beat,dlwin,0,10,20,201,0.422885572,0.064676617,0.55721393,0,0.027255383
9671,94,21612,8,10,0,0,0,18,4,3,6,8,0,21,nowin,loss,beat,dlwin,0,10,18,183,0.43715847,0.043715847,0.540983607,1,0.290866892
9672,34,21613,10,10,0,0,0,20,5,1,10,6,0,22,nowin,win,dlbust,bust,20,0,20,202,0.5,0.079207921,0.618811881,3,0.968961434
9673,74,21613,11,9,0,0,0,20,5,1,10,6,0,22,nowin,win,dlbust,bust,20,0,20,209,0.411483254,0.04784689,0.531100478,0,0.017448125
9674,11,21613,9,10,0,0,0,19,5,1,10,6,0,22,nowin,win,dlbust,bust,20,0,19,236,0.457627119,0.016949153,0.588983051,3,0.889015813
9675,41,21613,8,3,6,0,0,17,5,1,10,6,0,22,nowin,win,dlbust,bust,20,0,11,192,0.364583333,0.036458333,0.520833333,0,0.00089702
9676,17,21613,10,11,0,0,0,21,5,1,10,6,0,22,win,win,dlbust,bust,25,0,21,171,0.444444444,0.070175439,0.555555556,1,0.302364894
9677,60,21613,10,2,0,0,0,12,5,1,10,6,0,22,nowin,win,dlbust,bust,20,0,12,227,0.418502203,0.022026432,0.559471366,0,0.026496258
9678,6,21614,4,10,0,10,0,24,10,10,0,0,0,20,nowin,loss,bust,plbust,0,10,14,191,0.439790576,0.047120419,0.581151832,1,0.31211505
9679,112,21614,11,5,5,0,0,21,10,10,0,0,0,20,nowin,win,plwin,beat,20,0,16,203,0.448275862,0.054187192,0.600985222,3,0.889576933
9680,116,21614,4,9,0,6,0,19,10,10,0,0,0,20,nowin,loss,beat,dlwin,0,10,13,195,0.425641026,0.056410256,0.538461538,1,0.28273747
9681,69,21614,4,2,9,10,0,25,10,10,0,0,0,20,nowin,loss,bust,plbust,0,10,6,194,0.365979381,0.030927835,0.515463918,0,0
9682,20,21614,3,7,4,1,1,16,10,10,0,0,0,20,nowin,loss,beat,dlwin,0,10,10,186,0.456989247,0.037634409,0.537634409,1,0.301097108
9683,6,21614,10,11,0,0,0,21,10,10,0,0,0,20,win,win,plwin,beat,25,0,21,191,0.439790576,0.047120419,0.581151832,1,0.31211505
9684,69,21615,7,3,10,0,0,20,5,3,10,0,0,18,nowin,win,plwin,beat,20,0,10,194,0.365979381,0.030927835,0.515463918,0,0
9685,23,21615,7,8,0,0,0,15,5,3,10,0,0,18,nowin,loss,beat,dlwin,0,10,15,208,0.427884615,0.0625,0.552884615,1,0.29114424
9686,30,21615,3,4,7,0,0,14,5,3,10,0,0,18,nowin,loss,beat,dlwin,0,10,7,206,0.393203883,0.033980583,0.601941748,0,0.029324648
9687,126,21615,10,10,0,0,0,20,5,3,10,0,0,18,nowin,win,plwin,beat,20,0,20,188,0.457446809,0.074468085,0.60106383,3,0.900633203
9688,86,21615,9,6,0,0,0,15,5,3,10,0,0,18,nowin,loss,beat,dlwin,0,10,15,196,0.454081633,0.040816327,0.591836735,3,0.887566443
9689,84,21615,8,4,0,0,0,12,5,3,10,0,0,18,nowin,loss,beat,dlwin,0,10,12,195,0.379487179,0.056410256,0.569230769,0,0.017209119
9690,147,21616,4,9,0,7,0,20,10,10,0,0,0,20,nowin,push,push,push,10,0,13,205,0.380487805,0.014634146,0.536585366,0,0.00951447
9691,149,21616,10,10,0,0,0,20,10,10,0,0,0,20,nowin,push,push,push,10,0,20,225,0.457777778,0.057777778,0.648888889,2,0.651965595
9692,114,21616,6,1,5,9,0,21,10,10,0,0,0,20,nowin,win,plwin,beat,20,0,7,198,0.47979798,0.025252525,0.611111111,3,0.937232995
9693,59,21616,10,9,0,0,0,19,10,10,0,0,0,20,nowin,loss,beat,dlwin,0,10,19,228,0.429824561,0.048245614,0.543859649,1,0.287885446
9694,136,21616,9,9,0,0,0,18,10,10,0,0,0,20,nowin,loss,beat,dlwin,0,10,18,194,0.396907216,0.025773196,0.597938144,0,0.029452644
9695,7,21616,4,4,4,5,0,17,10,10,0,0,0,20,nowin,loss,beat,dlwin,0,10,8,183,0.442622951,0.06010929,0.62295082,2,0.619303341
9696,30,21617,9,7,0,0,0,16,4,10,10,0,0,24,nowin,win,dlbust,bust,20,0,16,206,0.393203883,0.033980583,0.601941748,0,0.029324648
9697,90,21617,10,11,0,0,0,21,4,10,10,0,0,24,win,win,dlbust,bust,25,0,21,201,0.447761194,0.049751244,0.60199005,3,0.889945023
9698,86,21617,8,10,0,0,0,18,4,10,10,0,0,24,nowin,win,dlbust,bust,20,0,18,196,0.454081633,0.040816327,0.591836735,3,0.887566443
9699,80,21617,4,5,7,0,0,16,4,10,10,0,0,24,nowin,win,dlbust,bust,20,0,9,186,0.419354839,0.059139785,0.623655914,2,0.59892924
9700,57,21617,11,10,0,0,0,21,4,10,10,0,0,24,win,win,dlbust,bust,25,0,21,192,0.46875,0.052083333,0.59375,3,0.907001181
9701,41,21617,4,3,5,0,0,12,4,10,10,0,0,24,nowin,win,dlbust,bust,20,0,7,192,0.364583333,0.036458333,0.520833333,0,0.00089702
9702,45,21618,10,5,0,0,0,15,3,6,8,0,0,17,nowin,loss,beat,dlwin,0,10,15,196,0.428571429,0.051020408,0.612244898,2,0.598821767
9703,103,21618,7,6,0,0,0,13,3,6,8,0,0,17,nowin,loss,beat,dlwin,0,10,13,203,0.379310345,0.064039409,0.551724138,0,0.012869209
9704,149,21618,8,5,0,0,0,13,3,6,8,0,0,17,nowin,loss,beat,dlwin,0,10,13,225,0.457777778,0.057777778,0.648888889,2,0.651965595
9705,37,21618,3,11,6,0,0,20,3,6,8,0,0,17,nowin,win,plwin,beat,20,0,14,208,0.394230769,0.038461538,0.581730769,0,0.024682772
9706,84,21618,10,5,0,0,0,15,3,6,8,0,0,17,nowin,loss,beat,dlwin,0,10,15,195,0.379487179,0.056410256,0.569230769,0,0.017209119
9707,71,21618,11,6,3,0,0,20,3,6,8,0,0,17,nowin,win,plwin,beat,20,0,17,193,0.352331606,0.046632124,0.585492228,0,0.013063661
9708,147,21619,11,7,0,0,0,18,4,7,9,0,0,20,nowin,loss,beat,dlwin,0,10,18,205,0.380487805,0.014634146,0.536585366,0,0.00951447
9709,60,21619,10,6,0,0,0,16,4,7,9,0,0,20,nowin,loss,beat,dlwin,0,10,16,227,0.418502203,0.022026432,0.559471366,0,0.026496258
9710,134,21619,10,4,0,0,0,14,4,7,9,0,0,20,nowin,loss,beat,dlwin,0,10,14,185,0.443243243,0.021621622,0.545945946,1,0.296939509
9711,70,21619,4,2,6,0,0,12,4,7,9,0,0,20,nowin,loss,beat,dlwin,0,10,6,228,0.385964912,0.039473684,0.557017544,0,0.016157125
9712,74,21619,2,10,0,0,0,12,4,7,9,0,0,20,nowin,loss,beat,dlwin,0,10,12,209,0.411483254,0.04784689,0.531100478,0,0.017448125
9713,126,21619,3,5,4,0,0,12,4,7,9,0,0,20,nowin,loss,beat,dlwin,0,10,8,188,0.457446809,0.074468085,0.60106383,3,0.900633203
9714,128,21620,9,11,0,0,0,20,9,9,0,0,0,18,nowin,win,plwin,beat,20,0,20,227,0.356828194,0.052863436,0.577092511,0,0.012352564
9715,133,21620,10,8,0,0,0,18,9,9,0,0,0,18,nowin,push,push,push,10,0,18,201,0.47761194,0.064676617,0.611940299,3,0.935428111
9716,107,21620,11,10,0,0,0,21,9,9,0,0,0,18,win,win,plwin,beat,25,0,21,218,0.444954128,0.073394495,0.600917431,2,0.605210014
9717,17,21620,7,4,1,10,0,22,9,9,0,0,0,18,nowin,loss,bust,plbust,0,10,11,171,0.444444444,0.070175439,0.555555556,1,0.302364894
9718,61,21620,11,10,0,0,0,21,9,9,0,0,0,18,win,win,plwin,beat,25,0,21,194,0.427835052,0.077319588,0.603092784,2,0.591437139
9719,114,21620,2,10,0,8,0,20,9,9,0,0,0,18,nowin,win,plwin,beat,20,0,12,198,0.47979798,0.025252525,0.611111111,3,0.937232995
9720,127,21621,10,11,0,0,0,21,10,8,0,0,0,18,win,win,plwin,beat,25,0,21,201,0.402985075,0.029850746,0.60199005,0,0.032263937
9721,48,21621,6,7,0,9,0,22,10,8,0,0,0,18,nowin,loss,bust,plbust,0,10,13,203,0.413793103,0.019704433,0.600985222,2,0.577280801
9722,148,21621,8,10,0,0,0,18,10,8,0,0,0,18,nowin,push,push,push,10,0,18,204,0.401960784,0.078431373,0.593137255,0,0.029789521
9723,111,21621,2,5,7,4,0,18,10,8,0,0,0,18,nowin,push,push,push,10,0,7,180,0.433333333,0.055555556,0.611111111,2,0.602264492
9724,75,21621,11,1,2,10,0,24,10,8,0,0,0,18,nowin,loss,bust,plbust,0,10,12,191,0.418848168,0.052356021,0.570680628,0,0.029344702
9725,17,21621,10,11,0,0,0,21,10,8,0,0,0,18,win,win,plwin,beat,25,0,21,171,0.444444444,0.070175439,0.555555556,1,0.302364894
9726,118,21622,9,6,0,7,0,22,1,2,9,3,3,18,nowin,loss,bust,plbust,0,10,15,216,0.393518519,0.037037037,0.555555556,0,0.018059873
9727,95,21622,10,8,0,0,0,18,1,2,9,3,3,18,nowin,push,push,push,10,0,18,218,0.412844037,0.04587156,0.559633028,0,0.024842385
9728,50,21622,2,7,7,10,0,26,1,2,9,3,3,18,nowin,loss,bust,plbust,0,10,9,202,0.405940594,0.04950495,0.54950495,0,0.020296079
9729,18,21622,4,9,0,7,0,20,1,2,9,3,3,18,nowin,win,plwin,beat,20,0,13,182,0.461538462,0.043956044,0.587912088,3,0.892649374
9730,94,21622,1,5,10,8,0,24,1,2,9,3,3,18,nowin,loss,bust,plbust,0,10,6,183,0.43715847,0.043715847,0.540983607,1,0.290866892
9731,79,21622,1,3,10,10,0,24,1,2,9,3,3,18,nowin,loss,bust,plbust,0,10,4,211,0.436018957,0.028436019,0.672985782,2,0.650131054
9732,26,21623,8,5,0,4,0,17,9,10,0,0,0,19,nowin,loss,beat,dlwin,0,10,13,203,0.463054187,0.0591133,0.541871921,1,0.306802864
9733,99,21623,3,10,0,10,0,23,9,10,0,0,0,19,nowin,loss,bust,plbust,0,10,13,207,0.47826087,0.062801932,0.637681159,3,0.961418446
9734,73,21623,9,8,0,0,0,17,9,10,0,0,0,19,nowin,loss,beat,dlwin,0,10,17,181,0.375690608,0.011049724,0.596685083,0,0.022795773
9735,135,21623,6,6,0,10,0,22,9,10,0,0,0,19,nowin,loss,bust,plbust,0,10,12,179,0.391061453,0.067039106,0.586592179,0,0.024924662
9736,2,21623,2,10,0,1,10,23,9,10,0,0,0,19,nowin,loss,bust,plbust,0,10,12,200,0.445,0.035,0.64,2,0.633962549
9737,145,21623,10,7,0,0,0,17,9,10,0,0,0,19,nowin,loss,beat,dlwin,0,10,17,188,0.441489362,0.031914894,0.622340426,2,0.617837093
9738,7,21624,10,7,0,0,0,17,11,10,0,0,0,21,nowin,loss,beat,dlwin,0,10,17,183,0.442622951,0.06010929,0.62295082,2,0.619303341
9739,88,21624,1,2,10,7,0,20,11,10,0,0,0,21,nowin,loss,beat,dlwin,0,10,3,206,0.466019417,0.033980583,0.54368932,1,0.309467903
9740,87,21624,8,10,0,0,0,18,11,10,0,0,0,21,nowin,loss,beat,dlwin,0,10,18,202,0.405940594,0.054455446,0.628712871,2,0.590599801
9741,75,21624,10,6,0,3,0,19,11,10,0,0,0,21,nowin,loss,beat,dlwin,0,10,16,191,0.418848168,0.052356021,0.570680628,0,0.029344702
9742,95,21624,4,1,8,10,0,23,11,10,0,0,0,21,nowin,loss,bust,plbust,0,10,5,218,0.412844037,0.04587156,0.559633028,0,0.024842385
9743,91,21624,3,9,0,10,0,22,11,10,0,0,0,21,nowin,loss,bust,plbust,0,10,12,194,0.417525773,0.046391753,0.515463918,1,0.266616552
9744,57,21625,4,9,0,7,0,20,11,9,0,0,0,20,nowin,push,push,push,10,0,13,192,0.46875,0.052083333,0.59375,3,0.907001181
9745,147,21625,2,3,8,2,9,24,11,9,0,0,0,20,nowin,loss,bust,plbust,0,10,5,205,0.380487805,0.014634146,0.536585366,0,0.00951447
9746,18,21625,10,11,0,0,0,21,11,9,0,0,0,20,win,win,plwin,beat,25,0,21,182,0.461538462,0.043956044,0.587912088,3,0.892649374
9747,68,21625,10,10,0,0,0,20,11,9,0,0,0,20,nowin,push,push,push,10,0,20,205,0.434146341,0.029268293,0.6,2,0.59483189
9748,98,21625,5,6,2,8,0,21,11,9,0,0,0,20,nowin,win,plwin,beat,20,0,11,220,0.422727273,0.054545455,0.55,1,0.28664435
9749,120,21625,5,7,0,10,0,22,11,9,0,0,0,20,nowin,loss,bust,plbust,0,10,12,202,0.440594059,0.034653465,0.618811881,2,0.614441029
9750,124,21626,2,5,5,7,0,19,3,4,11,0,0,18,nowin,win,plwin,beat,20,0,7,202,0.47029703,0.064356436,0.584158416,3,0.899458193
9751,119,21626,5,10,0,0,0,15,3,4,11,0,0,18,nowin,loss,beat,dlwin,0,10,15,190,0.405263158,0.068421053,0.515789474,0,0.011837158
9752,99,21626,2,10,0,6,0,18,3,4,11,0,0,18,nowin,push,push,push,10,0,12,207,0.47826087,0.062801932,0.637681159,3,0.961418446
9753,27,21626,8,10,0,0,0,18,3,4,11,0,0,18,nowin,push,push,push,10,0,18,178,0.370786517,0.016853933,0.573033708,0,0.015536309
9754,146,21626,8,3,10,0,0,21,3,4,11,0,0,18,nowin,win,plwin,beat,20,0,11,221,0.43438914,0.040723982,0.542986425,1,0.290190091
9755,90,21626,9,10,0,0,0,19,3,4,11,0,0,18,nowin,win,plwin,beat,20,0,19,201,0.447761194,0.049751244,0.60199005,3,0.889945023
9756,54,21627,7,10,0,0,0,17,11,6,0,0,0,17,nowin,push,push,push,10,0,17,185,0.437837838,0.032432432,0.556756757,1,0.29899854
9757,95,21627,4,2,10,7,0,23,11,6,0,0,0,17,nowin,loss,bust,plbust,0,10,6,218,0.412844037,0.04587156,0.559633028,0,0.024842385
9758,43,21627,4,9,0,5,0,18,11,6,0,0,0,17,nowin,win,plwin,beat,20,0,13,192,0.40625,0.041666667,0.609375,2,0.576671372
9759,103,21627,9,2,6,0,0,17,11,6,0,0,0,17,nowin,push,push,push,10,0,11,203,0.379310345,0.064039409,0.551724138,0,0.012869209
9760,59,21627,4,3,10,0,0,17,11,6,0,0,0,17,nowin,push,push,push,10,0,7,228,0.429824561,0.048245614,0.543859649,1,0.287885446
9761,100,21627,9,2,6,0,0,17,11,6,0,0,0,17,nowin,push,push,push,10,0,11,190,0.452631579,0.036842105,0.594736842,3,0.888671154
9762,137,21628,4,2,3,10,0,19,10,8,0,0,0,18,nowin,win,plwin,beat,20,0,6,194,0.417525773,0.046391753,0.536082474,1,0.276714602
9763,36,21628,10,11,0,0,0,21,10,8,0,0,0,18,win,win,plwin,beat,25,0,21,229,0.445414847,0.056768559,0.655021834,2,0.645370571
9764,19,21628,10,10,0,0,0,20,10,8,0,0,0,18,nowin,win,plwin,beat,20,0,20,237,0.41350211,0.054852321,0.628691983,2,0.597373826
9765,97,21628,10,6,0,10,0,26,10,8,0,0,0,18,nowin,loss,bust,plbust,0,10,16,182,0.450549451,0.06043956,0.692307692,2,0.677372279
9766,118,21628,4,2,8,9,0,23,10,8,0,0,0,18,nowin,loss,bust,plbust,0,10,6,216,0.393518519,0.037037037,0.555555556,0,0.018059873
9767,2,21628,10,10,0,0,0,20,10,8,0,0,0,18,nowin,win,plwin,beat,20,0,20,200,0.445,0.035,0.64,2,0.633962549
9768,6,21629,10,8,0,0,0,18,10,5,4,0,0,19,nowin,loss,beat,dlwin,0,10,18,191,0.439790576,0.047120419,0.581151832,1,0.31211505
9769,124,21629,10,10,0,0,0,20,10,5,4,0,0,19,nowin,win,plwin,beat,20,0,20,202,0.47029703,0.064356436,0.584158416,3,0.899458193
9770,55,21629,3,3,7,10,0,23,10,5,4,0,0,19,nowin,loss,bust,plbust,0,10,6,191,0.371727749,0.057591623,0.54973822,0,0.01011347
9771,118,21629,4,8,0,10,0,22,10,5,4,0,0,19,nowin,loss,bust,plbust,0,10,12,216,0.393518519,0.037037037,0.555555556,0,0.018059873
9772,35,21629,10,10,0,0,0,20,10,5,4,0,0,19,nowin,win,plwin,beat,20,0,20,202,0.410891089,0.044554455,0.633663366,2,0.598681573
9773,60,21629,10,10,0,0,0,20,10,5,4,0,0,19,nowin,win,plwin,beat,20,0,20,227,0.418502203,0.022026432,0.559471366,0,0.026496258
9774,131,21630,10,9,0,0,0,19,8,7,10,0,0,25,nowin,win,dlbust,bust,20,0,19,217,0.410138249,0.069124424,0.543778802,0,0.02015021
9775,71,21630,4,9,0,6,0,19,8,7,10,0,0,25,nowin,win,dlbust,bust,20,0,13,193,0.352331606,0.046632124,0.585492228,0,0.013063661
9776,87,21630,9,9,0,0,0,18,8,7,10,0,0,25,nowin,win,dlbust,bust,20,0,18,202,0.405940594,0.054455446,0.628712871,2,0.590599801
9777,94,21630,6,10,0,10,0,26,8,7,10,0,0,25,nowin,loss,bust,plbust,0,10,16,183,0.43715847,0.043715847,0.540983607,1,0.290866892
9778,97,21630,9,3,0,8,0,20,8,7,10,0,0,25,nowin,win,dlbust,bust,20,0,12,182,0.450549451,0.06043956,0.692307692,2,0.677372279
9779,77,21630,8,5,0,10,0,23,8,7,10,0,0,25,nowin,loss,bust,plbust,0,10,13,200,0.455,0.04,0.62,3,0.916252116
9780,143,21631,6,11,1,0,0,18,6,10,6,0,0,22,nowin,win,dlbust,bust,20,0,17,203,0.463054187,0.044334975,0.57635468,3,0.883143365
9781,126,21631,7,10,0,0,0,17,6,10,6,0,0,22,nowin,win,dlbust,bust,20,0,17,188,0.457446809,0.074468085,0.60106383,3,0.900633203
9782,34,21631,7,10,0,0,0,17,6,10,6,0,0,22,nowin,win,dlbust,bust,20,0,17,202,0.5,0.079207921,0.618811881,3,0.968961434
9783,61,21631,8,6,0,0,0,14,6,10,6,0,0,22,nowin,win,dlbust,bust,20,0,14,194,0.427835052,0.077319588,0.603092784,2,0.591437139
9784,143,21631,8,10,0,0,0,18,6,10,6,0,0,22,nowin,win,dlbust,bust,20,0,18,203,0.463054187,0.044334975,0.57635468,3,0.883143365
9785,102,21631,8,7,0,0,0,15,6,10,6,0,0,22,nowin,win,dlbust,bust,20,0,15,192,0.338541667,0.046875,0.5625,0,0.003306118
9786,110,21632,2,9,9,0,0,20,10,3,6,0,0,19,nowin,win,plwin,beat,20,0,11,192,0.416666667,0.046875,0.557291667,0,0.025413132
9787,106,21632,7,11,0,0,0,18,10,3,6,0,0,19,nowin,loss,beat,dlwin,0,10,18,192,0.411458333,0.026041667,0.557291667,0,0.023854304
9788,81,21632,9,10,0,0,0,19,10,3,6,0,0,19,nowin,push,push,push,10,0,19,182,0.395604396,0.043956044,0.60989011,2,0.567491261
9789,116,21632,6,9,0,10,0,25,10,3,6,0,0,19,nowin,loss,bust,plbust,0,10,15,195,0.425641026,0.056410256,0.538461538,1,0.28273747
9790,113,21632,7,10,0,0,0,17,10,3,6,0,0,19,nowin,loss,beat,dlwin,0,10,17,199,0.407035176,0.055276382,0.668341709,2,0.620695264
9791,50,21632,10,5,0,5,0,20,10,3,6,0,0,19,nowin,win,plwin,beat,20,0,15,202,0.405940594,0.04950495,0.54950495,0,0.020296079
9792,100,21633,6,10,0,7,0,23,9,10,0,0,0,19,nowin,loss,bust,plbust,0,10,16,190,0.452631579,0.036842105,0.594736842,3,0.888671154
9793,6,21633,3,3,6,3,5,20,9,10,0,0,0,19,nowin,win,plwin,beat,20,0,6,191,0.439790576,0.047120419,0.581151832,1,0.31211505
9794,149,21633,5,1,7,6,0,19,9,10,0,0,0,19,nowin,push,push,push,10,0,6,225,0.457777778,0.057777778,0.648888889,2,0.651965595
9795,95,21633,5,2,11,0,0,18,9,10,0,0,0,19,nowin,loss,beat,dlwin,0,10,7,218,0.412844037,0.04587156,0.559633028,0,0.024842385
9796,131,21633,4,10,0,10,0,24,9,10,0,0,0,19,nowin,loss,bust,plbust,0,10,14,217,0.410138249,0.069124424,0.543778802,0,0.02015021
9797,57,21633,7,5,0,1,1,14,9,10,0,0,0,19,nowin,loss,beat,dlwin,0,10,12,192,0.46875,0.052083333,0.59375,3,0.907001181
9798,72,21634,2,10,0,3,0,15,2,4,7,4,0,17,nowin,loss,beat,dlwin,0,10,12,185,0.394594595,0.032432432,0.508108108,0,0.006763115
9799,114,21634,2,7,10,0,0,19,2,4,7,4,0,17,nowin,win,plwin,beat,20,0,9,198,0.47979798,0.025252525,0.611111111,3,0.937232995
9800,98,21634,11,10,0,0,0,21,2,4,7,4,0,17,win,win,plwin,beat,25,0,21,220,0.422727273,0.054545455,0.55,1,0.28664435
9801,109,21634,5,10,0,0,0,15,2,4,7,4,0,17,nowin,loss,beat,dlwin,0,10,15,221,0.461538462,0.058823529,0.597285068,3,0.901830309
9802,138,21634,3,2,8,0,0,13,2,4,7,4,0,17,nowin,loss,beat,dlwin,0,10,5,190,0.442105263,0.047368421,0.610526316,2,0.609711065
9803,132,21634,10,10,0,0,0,20,2,4,7,4,0,17,nowin,win,plwin,beat,20,0,20,194,0.412371134,0.036082474,0.649484536,2,0.611633238
9804,114,21635,4,10,0,0,0,14,3,3,2,1,2,11,nowin,win,plwin,beat,20,0,14,198,0.47979798,0.025252525,0.611111111,3,0.937232995
9805,11,21635,5,8,0,0,0,13,3,3,2,1,2,11,nowin,win,plwin,beat,20,0,13,236,0.457627119,0.016949153,0.588983051,3,0.889015813
9806,148,21635,5,5,3,0,0,13,3,3,2,1,2,11,nowin,win,plwin,beat,20,0,10,204,0.401960784,0.078431373,0.593137255,0,0.029789521
9807,4,21635,8,10,0,0,0,18,3,3,2,1,2,11,nowin,win,plwin,beat,20,0,18,217,0.460829493,0.036866359,0.562211982,1,0.315432839
9808,77,21635,10,2,0,2,0,14,3,3,2,1,2,11,nowin,win,plwin,beat,20,0,12,200,0.455,0.04,0.62,3,0.916252116
9809,112,21635,4,10,0,0,0,14,3,3,2,1,2,11,nowin,win,plwin,beat,20,0,14,203,0.448275862,0.054187192,0.600985222,3,0.889576933
9810,46,21636,8,10,0,0,0,18,8,9,0,0,0,17,nowin,win,plwin,beat,20,0,18,186,0.403225806,0.048387097,0.591397849,0,0.029742194
9811,110,21636,10,7,0,0,0,17,8,9,0,0,0,17,nowin,push,push,push,10,0,17,192,0.416666667,0.046875,0.557291667,0,0.025413132
9812,65,21636,7,5,0,9,0,21,8,9,0,0,0,17,nowin,win,plwin,beat,20,0,12,203,0.492610837,0.054187192,0.571428571,3,0.913702814
9813,89,21636,8,10,0,0,0,18,8,9,0,0,0,17,nowin,win,plwin,beat,20,0,18,212,0.537735849,0.047169811,0.594339623,3,0.990167191
9814,82,21636,10,5,0,2,0,17,8,9,0,0,0,17,nowin,push,push,push,10,0,15,225,0.408888889,0.075555556,0.577777778,0,0.028101874
9815,147,21636,2,8,10,0,0,20,8,9,0,0,0,17,nowin,win,plwin,beat,20,0,10,205,0.380487805,0.014634146,0.536585366,0,0.00951447
9816,95,21637,10,4,0,5,0,19,10,10,0,0,0,20,nowin,loss,beat,dlwin,0,10,14,218,0.412844037,0.04587156,0.559633028,0,0.024842385
9817,44,21637,11,1,6,0,0,18,10,10,0,0,0,20,nowin,loss,beat,dlwin,0,10,12,219,0.433789954,0.050228311,0.534246575,1,0.285551035
9818,65,21637,9,10,0,0,0,19,10,10,0,0,0,20,nowin,loss,beat,dlwin,0,10,19,203,0.492610837,0.054187192,0.571428571,3,0.913702814
9819,17,21637,10,4,0,9,0,23,10,10,0,0,0,20,nowin,loss,bust,plbust,0,10,14,171,0.444444444,0.070175439,0.555555556,1,0.302364894
9820,101,21637,8,10,0,0,0,18,10,10,0,0,0,20,nowin,loss,beat,dlwin,0,10,18,205,0.424390244,0.068292683,0.63902439,2,0.614740646
9821,85,21637,4,10,0,4,0,18,10,10,0,0,0,20,nowin,loss,beat,dlwin,0,10,14,195,0.41025641,0.066666667,0.594871795,0,0.03269711
9822,27,21638,6,10,0,0,0,16,6,11,0,0,0,17,nowin,loss,beat,dlwin,0,10,16,178,0.370786517,0.016853933,0.573033708,0,0.015536309
9823,106,21638,10,11,0,0,0,21,6,11,0,0,0,17,win,win,plwin,beat,25,0,21,192,0.411458333,0.026041667,0.557291667,0,0.023854304
9824,38,21638,10,10,0,0,0,20,6,11,0,0,0,17,nowin,win,plwin,beat,20,0,20,202,0.361386139,0.03960396,0.564356436,0,0.010597953
9825,64,21638,8,6,0,0,0,14,6,11,0,0,0,17,nowin,loss,beat,dlwin,0,10,14,187,0.363636364,0.048128342,0.631016043,0,0.027594885
9826,85,21638,6,9,0,0,0,15,6,11,0,0,0,17,nowin,loss,beat,dlwin,0,10,15,195,0.41025641,0.066666667,0.594871795,0,0.03269711
9827,28,21638,11,6,4,0,0,21,6,11,0,0,0,17,nowin,win,plwin,beat,20,0,17,199,0.422110553,0.045226131,0.542713568,1,0.282706618
9828,143,21639,10,6,0,8,0,24,7,9,7,0,0,23,nowin,loss,bust,plbust,0,10,16,203,0.463054187,0.044334975,0.57635468,3,0.883143365
9829,50,21639,5,2,10,0,0,17,7,9,7,0,0,23,nowin,win,dlbust,bust,20,0,7,202,0.405940594,0.04950495,0.54950495,0,0.020296079
9830,29,21639,5,10,0,7,0,22,7,9,7,0,0,23,nowin,loss,bust,plbust,0,10,15,189,0.44973545,0.058201058,0.544973545,1,0.300349439
9831,11,21639,10,10,0,0,0,20,7,9,7,0,0,23,nowin,win,dlbust,bust,20,0,20,236,0.457627119,0.016949153,0.588983051,3,0.889015813
9832,109,21639,11,10,0,0,0,21,7,9,7,0,0,23,win,win,dlbust,bust,25,0,21,221,0.461538462,0.058823529,0.597285068,3,0.901830309
9833,3,21639,7,5,0,10,0,22,7,9,7,0,0,23,nowin,loss,bust,plbust,0,10,12,190,0.431578947,0.026315789,0.542105263,1,0.288076384
9834,5,21640,9,3,0,3,7,22,10,10,0,0,0,20,nowin,loss,bust,plbust,0,10,12,203,0.42364532,0.02955665,0.596059113,2,0.582508076
9835,118,21640,11,7,0,0,0,18,10,10,0,0,0,20,nowin,loss,beat,dlwin,0,10,18,216,0.393518519,0.037037037,0.555555556,0,0.018059873
9836,7,21640,1,6,10,0,0,17,10,10,0,0,0,20,nowin,loss,beat,dlwin,0,10,7,183,0.442622951,0.06010929,0.62295082,2,0.619303341
9837,132,21640,5,11,3,0,0,19,10,10,0,0,0,20,nowin,loss,beat,dlwin,0,10,16,194,0.412371134,0.036082474,0.649484536,2,0.611633238
9838,87,21640,2,10,0,9,0,21,10,10,0,0,0,20,nowin,win,plwin,beat,20,0,12,202,0.405940594,0.054455446,0.628712871,2,0.590599801
9839,84,21640,7,10,0,0,0,17,10,10,0,0,0,20,nowin,loss,beat,dlwin,0,10,17,195,0.379487179,0.056410256,0.569230769,0,0.017209119
9840,100,21641,7,2,10,0,0,19,10,10,0,0,0,20,nowin,loss,beat,dlwin,0,10,9,190,0.452631579,0.036842105,0.594736842,3,0.888671154
9841,20,21641,6,8,0,10,0,24,10,10,0,0,0,20,nowin,loss,bust,plbust,0,10,14,186,0.456989247,0.037634409,0.537634409,1,0.301097108
9842,54,21641,4,4,10,0,0,18,10,10,0,0,0,20,nowin,loss,beat,dlwin,0,10,8,185,0.437837838,0.032432432,0.556756757,1,0.29899854
9843,119,21641,9,11,0,0,0,20,10,10,0,0,0,20,nowin,push,push,push,10,0,20,190,0.405263158,0.068421053,0.515789474,0,0.011837158
9844,6,21641,8,8,0,8,0,24,10,10,0,0,0,20,nowin,loss,bust,plbust,0,10,16,191,0.439790576,0.047120419,0.581151832,1,0.31211505
9845,10,21641,9,11,0,0,0,20,10,10,0,0,0,20,nowin,push,push,push,10,0,20,191,0.413612565,0.057591623,0.596858639,2,0.574087175
9846,28,21642,5,7,0,9,0,21,2,10,7,0,0,19,nowin,win,plwin,beat,20,0,12,199,0.422110553,0.045226131,0.542713568,1,0.282706618
9847,47,21642,8,10,0,0,0,18,2,10,7,0,0,19,nowin,loss,beat,dlwin,0,10,18,210,0.438095238,0.057142857,0.623809524,2,0.615868808
9848,90,21642,10,5,0,0,0,15,2,10,7,0,0,19,nowin,loss,beat,dlwin,0,10,15,201,0.447761194,0.049751244,0.60199005,3,0.889945023
9849,110,21642,3,9,0,9,0,21,2,10,7,0,0,19,nowin,win,plwin,beat,20,0,12,192,0.416666667,0.046875,0.557291667,0,0.025413132
9850,137,21642,5,10,0,0,0,15,2,10,7,0,0,19,nowin,loss,beat,dlwin,0,10,15,194,0.417525773,0.046391753,0.536082474,1,0.276714602
9851,142,21642,10,10,0,0,0,20,2,10,7,0,0,19,nowin,win,plwin,beat,20,0,20,211,0.417061611,0.047393365,0.526066351,1,0.271531309
9852,131,21643,3,10,0,4,0,17,11,10,0,0,0,21,nowin,loss,beat,dlwin,0,10,13,217,0.410138249,0.069124424,0.543778802,0,0.02015021
9853,23,21643,6,10,0,2,0,18,11,10,0,0,0,21,nowin,loss,beat,dlwin,0,10,16,208,0.427884615,0.0625,0.552884615,1,0.29114424
9854,76,21643,11,10,0,0,0,21,11,10,0,0,0,21,win,push,push,push,10,0,21,189,0.534391534,0.079365079,0.608465608,3,1
9855,40,21643,10,10,0,0,0,20,11,10,0,0,0,21,nowin,loss,beat,dlwin,0,10,20,196,0.367346939,0.030612245,0.617346939,0,0.025358183
9856,48,21643,6,9,0,10,0,25,11,10,0,0,0,21,nowin,loss,bust,plbust,0,10,15,203,0.413793103,0.019704433,0.600985222,2,0.577280801
9857,47,21643,6,3,10,0,0,19,11,10,0,0,0,21,nowin,loss,beat,dlwin,0,10,9,210,0.438095238,0.057142857,0.623809524,2,0.615868808
9858,100,21644,3,9,0,10,0,22,10,9,0,0,0,19,nowin,loss,bust,plbust,0,10,12,190,0.452631579,0.036842105,0.594736842,3,0.888671154
9859,61,21644,9,10,0,0,0,19,10,9,0,0,0,19,nowin,push,push,push,10,0,19,194,0.427835052,0.077319588,0.603092784,2,0.591437139
9860,22,21644,7,7,0,10,0,24,10,9,0,0,0,19,nowin,loss,bust,plbust,0,10,14,187,0.481283422,0.042780749,0.577540107,3,0.906128176
9861,80,21644,11,6,4,0,0,21,10,9,0,0,0,19,nowin,win,plwin,beat,20,0,17,186,0.419354839,0.059139785,0.623655914,2,0.59892924
9862,76,21644,8,10,0,0,0,18,10,9,0,0,0,19,nowin,loss,beat,dlwin,0,10,18,189,0.534391534,0.079365079,0.608465608,3,1
9863,79,21644,8,7,0,5,0,20,10,9,0,0,0,19,nowin,win,plwin,beat,20,0,15,211,0.436018957,0.028436019,0.672985782,2,0.650131054
9864,143,21645,5,3,2,10,0,20,7,5,3,3,0,18,nowin,win,plwin,beat,20,0,8,203,0.463054187,0.044334975,0.57635468,3,0.883143365
9865,128,21645,10,8,0,0,0,18,7,5,3,3,0,18,nowin,push,push,push,10,0,18,227,0.356828194,0.052863436,0.577092511,0,0.012352564
9866,97,21645,10,9,0,0,0,19,7,5,3,3,0,18,nowin,win,plwin,beat,20,0,19,182,0.450549451,0.06043956,0.692307692,2,0.677372279
9867,101,21645,10,9,0,0,0,19,7,5,3,3,0,18,nowin,win,plwin,beat,20,0,19,205,0.424390244,0.068292683,0.63902439,2,0.614740646
9868,2,21645,10,10,0,0,0,20,7,5,3,3,0,18,nowin,win,plwin,beat,20,0,20,200,0.445,0.035,0.64,2,0.633962549
9869,55,21645,4,5,3,4,6,22,7,5,3,3,0,18,nowin,loss,bust,plbust,0,10,9,191,0.371727749,0.057591623,0.54973822,0,0.01011347
9870,38,21646,10,5,0,4,0,19,10,10,0,0,0,20,nowin,loss,beat,dlwin,0,10,15,202,0.361386139,0.03960396,0.564356436,0,0.010597953
9871,25,21646,10,8,0,0,0,18,10,10,0,0,0,20,nowin,loss,beat,dlwin,0,10,18,190,0.463157895,0.063157895,0.536842105,1,0.304401563
9872,82,21646,3,9,0,5,0,17,10,10,0,0,0,20,nowin,loss,beat,dlwin,0,10,12,225,0.408888889,0.075555556,0.577777778,0,0.028101874
9873,42,21646,9,10,0,0,0,19,10,10,0,0,0,20,nowin,loss,beat,dlwin,0,10,19,212,0.443396226,0.051886792,0.570754717,1,0.309181312
9874,122,21646,3,3,8,3,0,17,10,10,0,0,0,20,nowin,loss,beat,dlwin,0,10,6,210,0.347619048,0.052380952,0.59047619,0,0.012873677
9875,6,21646,11,8,0,0,0,19,10,10,0,0,0,20,nowin,loss,beat,dlwin,0,10,19,191,0.439790576,0.047120419,0.581151832,1,0.31211505
9876,67,21647,3,9,0,0,0,12,5,10,10,0,0,25,nowin,win,dlbust,bust,20,0,12,195,0.369230769,0.041025641,0.569230769,0,0.014139427
9877,70,21647,10,5,0,0,0,15,5,10,10,0,0,25,nowin,win,dlbust,bust,20,0,15,228,0.385964912,0.039473684,0.557017544,0,0.016157125
9878,91,21647,10,10,0,0,0,20,5,10,10,0,0,25,nowin,win,dlbust,bust,20,0,20,194,0.417525773,0.046391753,0.515463918,1,0.266616552
9879,72,21647,9,6,0,0,0,15,5,10,10,0,0,25,nowin,win,dlbust,bust,20,0,15,185,0.394594595,0.032432432,0.508108108,0,0.006763115
9880,73,21647,10,6,0,0,0,16,5,10,10,0,0,25,nowin,win,dlbust,bust,20,0,16,181,0.375690608,0.011049724,0.596685083,0,0.022795773
9881,42,21647,8,10,0,0,0,18,5,10,10,0,0,25,nowin,win,dlbust,bust,20,0,18,212,0.443396226,0.051886792,0.570754717,1,0.309181312
9882,89,21648,3,6,2,3,6,20,11,5,1,0,0,17,nowin,win,plwin,beat,20,0,9,212,0.537735849,0.047169811,0.594339623,3,0.990167191
9883,54,21648,10,5,0,4,0,19,11,5,1,0,0,17,nowin,win,plwin,beat,20,0,15,185,0.437837838,0.032432432,0.556756757,1,0.29899854
9884,12,21648,5,9,0,10,0,24,11,5,1,0,0,17,nowin,loss,bust,plbust,0,10,14,189,0.470899471,0.015873016,0.613756614,3,0.929171178
9885,23,21648,7,11,0,0,0,18,11,5,1,0,0,17,nowin,win,plwin,beat,20,0,18,208,0.427884615,0.0625,0.552884615,1,0.29114424
9886,86,21648,2,10,0,1,9,22,11,5,1,0,0,17,nowin,loss,bust,plbust,0,10,12,196,0.454081633,0.040816327,0.591836735,3,0.887566443
9887,13,21648,7,3,10,0,0,20,11,5,1,0,0,17,nowin,win,plwin,beat,20,0,10,206,0.417475728,0.063106796,0.621359223,2,0.59555479
9888,27,21649,10,9,0,0,0,19,2,10,10,0,0,22,nowin,win,dlbust,bust,20,0,19,178,0.370786517,0.016853933,0.573033708,0,0.015536309
9889,39,21649,10,9,0,0,0,19,2,10,10,0,0,22,nowin,win,dlbust,bust,20,0,19,191,0.429319372,0.062827225,0.57591623,0,0.033760763
9890,5,21649,1,1,10,10,0,22,2,10,10,0,0,22,nowin,loss,bust,plbust,0,10,2,203,0.42364532,0.02955665,0.596059113,2,0.582508076
9891,150,21649,4,8,0,10,0,22,2,10,10,0,0,22,nowin,loss,bust,plbust,0,10,12,192,0.401041667,0.036458333,0.567708333,0,0.023287458
9892,9,21649,10,10,0,0,0,20,2,10,10,0,0,22,nowin,win,dlbust,bust,20,0,20,194,0.37628866,0.015463918,0.541237113,0,0.009396796
9893,67,21649,11,3,2,0,0,16,2,10,10,0,0,22,nowin,win,dlbust,bust,20,0,14,195,0.369230769,0.041025641,0.569230769,0,0.014139427
9894,101,21650,2,3,9,1,6,21,8,6,4,0,0,18,nowin,win,plwin,beat,20,0,5,205,0.424390244,0.068292683,0.63902439,2,0.614740646
9895,96,21650,7,10,0,0,0,17,8,6,4,0,0,18,nowin,loss,beat,dlwin,0,10,17,190,0.468421053,0.057894737,0.584210526,3,0.897263354
9896,45,21650,7,6,0,6,0,19,8,6,4,0,0,18,nowin,win,plwin,beat,20,0,13,196,0.428571429,0.051020408,0.612244898,2,0.598821767
9897,90,21650,8,5,0,5,0,18,8,6,4,0,0,18,nowin,push,push,push,10,0,13,201,0.447761194,0.049751244,0.60199005,3,0.889945023
9898,104,21650,10,10,0,0,0,20,8,6,4,0,0,18,nowin,win,plwin,beat,20,0,20,209,0.363636364,0.052631579,0.593301435,0,0.018359419
9899,3,21650,9,6,0,9,0,24,8,6,4,0,0,18,nowin,loss,bust,plbust,0,10,15,190,0.431578947,0.026315789,0.542105263,1,0.288076384
9900,16,21651,5,4,5,6,0,20,8,10,0,0,0,18,nowin,win,plwin,beat,20,0,9,220,0.427272727,0.081818182,0.6,2,0.588660176
9901,137,21651,8,11,0,0,0,19,8,10,0,0,0,18,nowin,win,plwin,beat,20,0,19,194,0.417525773,0.046391753,0.536082474,1,0.276714602
9902,87,21651,11,4,5,0,0,20,8,10,0,0,0,18,nowin,win,plwin,beat,20,0,15,202,0.405940594,0.054455446,0.628712871,2,0.590599801
9903,113,21651,10,7,0,0,0,17,8,10,0,0,0,18,nowin,loss,beat,dlwin,0,10,17,199,0.407035176,0.055276382,0.668341709,2,0.620695264
9904,34,21651,4,10,0,1,3,18,8,10,0,0,0,18,nowin,push,push,push,10,0,14,202,0.5,0.079207921,0.618811881,3,0.968961434
9905,93,21651,4,10,0,7,0,21,8,10,0,0,0,18,nowin,win,plwin,beat,20,0,14,175,0.485714286,0.051428571,0.548571429,1,0.323648091
9906,21,21652,2,10,0,10,0,22,9,4,5,0,0,18,nowin,loss,bust,plbust,0,10,12,214,0.359813084,0.042056075,0.626168224,0,0.025263474
9907,16,21652,8,2,10,0,0,20,9,4,5,0,0,18,nowin,win,plwin,beat,20,0,10,220,0.427272727,0.081818182,0.6,2,0.588660176
9908,103,21652,10,5,0,9,0,24,9,4,5,0,0,18,nowin,loss,bust,plbust,0,10,15,203,0.379310345,0.064039409,0.551724138,0,0.012869209
9909,15,21652,2,10,0,10,0,22,9,4,5,0,0,18,nowin,loss,bust,plbust,0,10,12,212,0.410377358,0.051886792,0.561320755,0,0.024517408
9910,113,21652,7,10,0,0,0,17,9,4,5,0,0,18,nowin,loss,beat,dlwin,0,10,17,199,0.407035176,0.055276382,0.668341709,2,0.620695264
9911,15,21652,9,3,0,10,0,22,9,4,5,0,0,18,nowin,loss,bust,plbust,0,10,12,212,0.410377358,0.051886792,0.561320755,0,0.024517408
9912,62,21653,8,4,0,6,0,18,3,10,5,0,0,18,nowin,push,push,push,10,0,12,178,0.370786517,0.028089888,0.54494382,0,0.008657722
9913,16,21653,6,10,0,0,0,16,3,10,5,0,0,18,nowin,loss,beat,dlwin,0,10,16,220,0.427272727,0.081818182,0.6,2,0.588660176
9914,54,21653,8,8,0,0,0,16,3,10,5,0,0,18,nowin,loss,beat,dlwin,0,10,16,185,0.437837838,0.032432432,0.556756757,1,0.29899854
9915,74,21653,10,10,0,0,0,20,3,10,5,0,0,18,nowin,win,plwin,beat,20,0,20,209,0.411483254,0.04784689,0.531100478,0,0.017448125
9916,52,21653,7,10,0,0,0,17,3,10,5,0,0,18,nowin,loss,beat,dlwin,0,10,17,217,0.414746544,0.02764977,0.599078341,2,0.576736024
9917,45,21653,4,6,10,0,0,20,3,10,5,0,0,18,nowin,win,plwin,beat,20,0,10,196,0.428571429,0.051020408,0.612244898,2,0.598821767
9918,65,21654,10,3,0,0,0,13,5,10,10,0,0,25,nowin,win,dlbust,bust,20,0,13,203,0.492610837,0.054187192,0.571428571,3,0.913702814
9919,108,21654,5,8,0,0,0,13,5,10,10,0,0,25,nowin,win,dlbust,bust,20,0,13,193,0.435233161,0.056994819,0.559585492,1,0.298824795
9920,136,21654,6,6,0,0,0,12,5,10,10,0,0,25,nowin,win,dlbust,bust,20,0,12,194,0.396907216,0.025773196,0.597938144,0,0.029452644
9921,30,21654,7,3,11,0,0,21,5,10,10,0,0,25,nowin,win,dlbust,bust,20,0,10,206,0.393203883,0.033980583,0.601941748,0,0.029324648
9922,49,21654,10,10,0,0,0,20,5,10,10,0,0,25,nowin,win,dlbust,bust,20,0,20,207,0.396135266,0.053140097,0.594202899,0,0.028306925
9923,9,21654,8,6,0,0,0,14,5,10,10,0,0,25,nowin,win,dlbust,bust,20,0,14,194,0.37628866,0.015463918,0.541237113,0,0.009396796
9924,128,21655,10,4,0,0,0,14,6,4,3,3,10,26,nowin,win,dlbust,bust,20,0,14,227,0.356828194,0.052863436,0.577092511,0,0.012352564
9925,133,21655,2,10,0,0,0,12,6,4,3,3,10,26,nowin,win,dlbust,bust,20,0,12,201,0.47761194,0.064676617,0.611940299,3,0.935428111
9926,93,21655,10,10,0,0,0,20,6,4,3,3,10,26,nowin,win,dlbust,bust,20,0,20,175,0.485714286,0.051428571,0.548571429,1,0.323648091
9927,79,21655,3,2,10,0,0,15,6,4,3,3,10,26,nowin,win,dlbust,bust,20,0,5,211,0.436018957,0.028436019,0.672985782,2,0.650131054
9928,97,21655,8,4,0,0,0,12,6,4,3,3,10,26,nowin,win,dlbust,bust,20,0,12,182,0.450549451,0.06043956,0.692307692,2,0.677372279
9929,111,21655,10,3,0,0,0,13,6,4,3,3,10,26,nowin,win,dlbust,bust,20,0,13,180,0.433333333,0.055555556,0.611111111,2,0.602264492
9930,102,21656,10,8,0,0,0,18,10,8,0,0,0,18,nowin,push,push,push,10,0,18,192,0.338541667,0.046875,0.5625,0,0.003306118
9931,37,21656,7,11,0,0,0,18,10,8,0,0,0,18,nowin,push,push,push,10,0,18,208,0.394230769,0.038461538,0.581730769,0,0.024682772
9932,37,21656,4,3,7,3,0,17,10,8,0,0,0,18,nowin,loss,beat,dlwin,0,10,7,208,0.394230769,0.038461538,0.581730769,0,0.024682772
9933,131,21656,10,8,0,0,0,18,10,8,0,0,0,18,nowin,push,push,push,10,0,18,217,0.410138249,0.069124424,0.543778802,0,0.02015021
9934,27,21656,9,11,0,0,0,20,10,8,0,0,0,18,nowin,win,plwin,beat,20,0,20,178,0.370786517,0.016853933,0.573033708,0,0.015536309
9935,61,21656,10,10,0,0,0,20,10,8,0,0,0,18,nowin,win,plwin,beat,20,0,20,194,0.427835052,0.077319588,0.603092784,2,0.591437139
9936,104,21657,10,8,0,0,0,18,8,7,3,0,0,18,nowin,push,push,push,10,0,18,209,0.363636364,0.052631579,0.593301435,0,0.018359419
9937,110,21657,10,4,0,5,0,19,8,7,3,0,0,18,nowin,win,plwin,beat,20,0,14,192,0.416666667,0.046875,0.557291667,0,0.025413132
9938,118,21657,2,3,10,7,0,22,8,7,3,0,0,18,nowin,loss,bust,plbust,0,10,5,216,0.393518519,0.037037037,0.555555556,0,0.018059873
9939,50,21657,1,5,7,10,0,23,8,7,3,0,0,18,nowin,loss,bust,plbust,0,10,6,202,0.405940594,0.04950495,0.54950495,0,0.020296079
9940,27,21657,1,3,10,8,0,22,8,7,3,0,0,18,nowin,loss,bust,plbust,0,10,4,178,0.370786517,0.016853933,0.573033708,0,0.015536309
9941,26,21657,7,11,0,0,0,18,8,7,3,0,0,18,nowin,push,push,push,10,0,18,203,0.463054187,0.0591133,0.541871921,1,0.306802864
9942,137,21658,2,10,0,10,0,22,3,9,2,9,0,23,nowin,loss,bust,plbust,0,10,12,194,0.417525773,0.046391753,0.536082474,1,0.276714602
9943,54,21658,3,8,3,0,0,14,3,9,2,9,0,23,nowin,win,dlbust,bust,20,0,11,185,0.437837838,0.032432432,0.556756757,1,0.29899854
9944,123,21658,5,3,10,0,0,18,3,9,2,9,0,23,nowin,win,dlbust,bust,20,0,8,205,0.43902439,0.034146341,0.614634146,2,0.609962544
9945,90,21658,10,8,0,0,0,18,3,9,2,9,0,23,nowin,win,dlbust,bust,20,0,18,201,0.447761194,0.049751244,0.60199005,3,0.889945023
9946,63,21658,6,5,1,10,0,22,3,9,2,9,0,23,nowin,loss,bust,plbust,0,10,11,216,0.467592593,0.037037037,0.62037037,3,0.931690496
9947,22,21658,6,10,0,0,0,16,3,9,2,9,0,23,nowin,win,dlbust,bust,20,0,16,187,0.481283422,0.042780749,0.577540107,3,0.906128176
9948,39,21659,10,9,0,0,0,19,10,10,0,0,0,20,nowin,loss,beat,dlwin,0,10,19,191,0.429319372,0.062827225,0.57591623,0,0.033760763
9949,118,21659,10,6,0,4,0,20,10,10,0,0,0,20,nowin,push,push,push,10,0,16,216,0.393518519,0.037037037,0.555555556,0,0.018059873
9950,77,21659,10,9,0,0,0,19,10,10,0,0,0,20,nowin,loss,beat,dlwin,0,10,19,200,0.455,0.04,0.62,3,0.916252116
9951,1,21659,2,4,3,1,9,19,10,10,0,0,0,20,nowin,loss,beat,dlwin,0,10,6,197,0.406091371,0.025380711,0.649746193,2,0.606186955
9952,51,21659,10,10,0,0,0,20,10,10,0,0,0,20,nowin,push,push,push,10,0,20,189,0.529100529,0.068783069,0.608465608,3,0.993665715
9953,130,21659,6,6,0,7,0,19,10,10,0,0,0,20,nowin,loss,beat,dlwin,0,10,12,219,0.410958904,0.03652968,0.566210046,0,0.025888739
9954,127,21660,7,10,0,0,0,17,10,10,0,0,0,20,nowin,loss,beat,dlwin,0,10,17,201,0.402985075,0.029850746,0.60199005,0,0.032263937
9955,104,21660,6,7,0,4,0,17,10,10,0,0,0,20,nowin,loss,beat,dlwin,0,10,13,209,0.363636364,0.052631579,0.593301435,0,0.018359419
9956,25,21660,2,10,0,10,0,22,10,10,0,0,0,20,nowin,loss,bust,plbust,0,10,12,190,0.463157895,0.063157895,0.536842105,1,0.304401563
9957,138,21660,2,3,2,5,8,20,10,10,0,0,0,20,nowin,push,push,push,10,0,5,190,0.442105263,0.047368421,0.610526316,2,0.609711065
9958,85,21660,1,2,10,10,0,23,10,10,0,0,0,20,nowin,loss,bust,plbust,0,10,3,195,0.41025641,0.066666667,0.594871795,0,0.03269711
9959,34,21660,6,10,0,10,0,26,10,10,0,0,0,20,nowin,loss,bust,plbust,0,10,16,202,0.5,0.079207921,0.618811881,3,0.968961434
9960,18,21661,6,1,10,0,0,17,5,7,4,9,0,25,nowin,win,dlbust,bust,20,0,7,182,0.461538462,0.043956044,0.587912088,3,0.892649374
9961,133,21661,9,4,0,0,0,13,5,7,4,9,0,25,nowin,win,dlbust,bust,20,0,13,201,0.47761194,0.064676617,0.611940299,3,0.935428111
9962,90,21661,2,2,9,0,0,13,5,7,4,9,0,25,nowin,win,dlbust,bust,20,0,4,201,0.447761194,0.049751244,0.60199005,3,0.889945023
9963,148,21661,4,10,0,0,0,14,5,7,4,9,0,25,nowin,win,dlbust,bust,20,0,14,204,0.401960784,0.078431373,0.593137255,0,0.029789521
9964,91,21661,10,6,0,0,0,16,5,7,4,9,0,25,nowin,win,dlbust,bust,20,0,16,194,0.417525773,0.046391753,0.515463918,1,0.266616552
9965,80,21661,3,9,0,0,0,12,5,7,4,9,0,25,nowin,win,dlbust,bust,20,0,12,186,0.419354839,0.059139785,0.623655914,2,0.59892924
9966,37,21662,3,4,9,10,0,26,7,10,0,0,0,17,nowin,loss,bust,plbust,0,10,7,208,0.394230769,0.038461538,0.581730769,0,0.024682772
9967,100,21662,10,10,0,0,0,20,7,10,0,0,0,17,nowin,win,plwin,beat,20,0,20,190,0.452631579,0.036842105,0.594736842,3,0.888671154
9968,19,21662,8,11,0,0,0,19,7,10,0,0,0,17,nowin,win,plwin,beat,20,0,19,237,0.41350211,0.054852321,0.628691983,2,0.597373826
9969,23,21662,11,3,3,0,0,17,7,10,0,0,0,17,nowin,push,push,push,10,0,14,208,0.427884615,0.0625,0.552884615,1,0.29114424
9970,15,21662,2,2,2,1,5,12,7,10,0,0,0,17,nowin,loss,beat,dlwin,0,10,4,212,0.410377358,0.051886792,0.561320755,0,0.024517408
9971,138,21662,11,10,0,0,0,21,7,10,0,0,0,17,win,win,plwin,beat,25,0,21,190,0.442105263,0.047368421,0.610526316,2,0.609711065
9972,33,21663,9,5,0,3,0,17,10,7,0,0,0,17,nowin,push,push,push,10,0,14,192,0.4375,0.057291667,0.625,2,0.616208916
9973,65,21663,10,2,0,9,0,21,10,7,0,0,0,17,nowin,win,plwin,beat,20,0,12,203,0.492610837,0.054187192,0.571428571,3,0.913702814
9974,129,21663,6,10,0,9,0,25,10,7,0,0,0,17,nowin,loss,bust,plbust,0,10,16,201,0.422885572,0.064676617,0.55721393,0,0.027255383
9975,63,21663,9,10,0,0,0,19,10,7,0,0,0,17,nowin,win,plwin,beat,20,0,19,216,0.467592593,0.037037037,0.62037037,3,0.931690496
9976,44,21663,9,7,0,1,0,17,10,7,0,0,0,17,nowin,push,push,push,10,0,16,219,0.433789954,0.050228311,0.534246575,1,0.285551035
9977,93,21663,4,8,0,10,0,22,10,7,0,0,0,17,nowin,loss,bust,plbust,0,10,12,175,0.485714286,0.051428571,0.548571429,1,0.323648091
9978,127,21664,4,8,0,1,9,22,10,10,0,0,0,20,nowin,loss,bust,plbust,0,10,12,201,0.402985075,0.029850746,0.60199005,0,0.032263937
9979,78,21664,5,2,10,0,0,17,10,10,0,0,0,20,nowin,loss,beat,dlwin,0,10,7,201,0.517412935,0.034825871,0.587064677,3,0.95871112
9980,46,21664,10,9,0,0,0,19,10,10,0,0,0,20,nowin,loss,beat,dlwin,0,10,19,186,0.403225806,0.048387097,0.591397849,0,0.029742194
9981,54,21664,11,10,0,0,0,21,10,10,0,0,0,20,win,win,plwin,beat,25,0,21,185,0.437837838,0.032432432,0.556756757,1,0.29899854
9982,2,21664,10,3,0,10,0,23,10,10,0,0,0,20,nowin,loss,bust,plbust,0,10,13,200,0.445,0.035,0.64,2,0.633962549
9983,135,21664,2,2,10,10,0,24,10,10,0,0,0,20,nowin,loss,bust,plbust,0,10,4,179,0.391061453,0.067039106,0.586592179,0,0.024924662
9984,4,21665,6,4,11,0,0,21,10,6,1,0,0,17,nowin,win,plwin,beat,20,0,10,217,0.460829493,0.036866359,0.562211982,1,0.315432839
9985,6,21665,9,2,10,0,0,21,10,6,1,0,0,17,nowin,win,plwin,beat,20,0,11,191,0.439790576,0.047120419,0.581151832,1,0.31211505
9986,89,21665,9,9,0,0,0,18,10,6,1,0,0,17,nowin,win,plwin,beat,20,0,18,212,0.537735849,0.047169811,0.594339623,3,0.990167191
9987,43,21665,8,4,0,8,0,20,10,6,1,0,0,17,nowin,win,plwin,beat,20,0,12,192,0.40625,0.041666667,0.609375,2,0.576671372
9988,82,21665,3,10,0,9,0,22,10,6,1,0,0,17,nowin,loss,bust,plbust,0,10,13,225,0.408888889,0.075555556,0.577777778,0,0.028101874
9989,59,21665,6,9,0,7,0,22,10,6,1,0,0,17,nowin,loss,bust,plbust,0,10,15,228,0.429824561,0.048245614,0.543859649,1,0.287885446
9990,4,21666,10,10,0,0,0,20,10,6,2,0,0,18,nowin,win,plwin,beat,20,0,20,217,0.460829493,0.036866359,0.562211982,1,0.315432839
9991,29,21666,10,10,0,0,0,20,10,6,2,0,0,18,nowin,win,plwin,beat,20,0,20,189,0.44973545,0.058201058,0.544973545,1,0.300349439
9992,147,21666,1,6,9,1,0,17,10,6,2,0,0,18,nowin,loss,beat,dlwin,0,10,7,205,0.380487805,0.014634146,0.536585366,0,0.00951447
9993,73,21666,3,2,10,9,0,24,10,6,2,0,0,18,nowin,loss,bust,plbust,0,10,5,181,0.375690608,0.011049724,0.596685083,0,0.022795773
9994,48,21666,2,2,2,5,3,14,10,6,2,0,0,18,nowin,loss,beat,dlwin,0,10,4,203,0.413793103,0.019704433,0.600985222,2,0.577280801
9995,113,21666,10,10,0,0,0,20,10,6,2,0,0,18,nowin,win,plwin,beat,20,0,20,199,0.407035176,0.055276382,0.668341709,2,0.620695264
9996,7,21667,10,7,0,0,0,17,9,3,10,0,0,22,nowin,win,dlbust,bust,20,0,17,183,0.442622951,0.06010929,0.62295082,2,0.619303341
9997,12,21667,6,8,0,3,0,17,9,3,10,0,0,22,nowin,win,dlbust,bust,20,0,14,189,0.470899471,0.015873016,0.613756614,3,0.929171178
9998,89,21667,5,3,10,0,0,18,9,3,10,0,0,22,nowin,win,dlbust,bust,20,0,8,212,0.537735849,0.047169811,0.594339623,3,0.990167191
9999,121,21667,10,10,0,0,0,20,9,3,10,0,0,22,nowin,win,dlbust,bust,20,0,20,195,0.456410256,0.025641026,0.512820513,1,0.288597791
10000,55,21667,10,11,0,0,0,21,9,3,10,0,0,22,win,win,dlbust,bust,25,0,21,191,0.371727749,0.057591623,0.54973822,0,0.01011347
10001,63,21667,10,10,0,0,0,20,9,3,10,0,0,22,nowin,win,dlbust,bust,20,0,20,216,0.467592593,0.037037037,0.62037037,3,0.931690496
10002,2,21668,9,10,0,0,0,19,5,11,1,0,0,17,nowin,win,plwin,beat,20,0,19,200,0.445,0.035,0.64,2,0.633962549
10003,98,21668,11,10,0,0,0,21,5,11,1,0,0,17,win,win,plwin,beat,25,0,21,220,0.422727273,0.054545455,0.55,1,0.28664435
10004,46,21668,9,8,0,0,0,17,5,11,1,0,0,17,nowin,push,push,push,10,0,17,186,0.403225806,0.048387097,0.591397849,0,0.029742194
10005,19,21668,10,5,0,0,0,15,5,11,1,0,0,17,nowin,loss,beat,dlwin,0,10,15,237,0.41350211,0.054852321,0.628691983,2,0.597373826
10006,133,21668,10,11,0,0,0,21,5,11,1,0,0,17,win,win,plwin,beat,25,0,21,201,0.47761194,0.064676617,0.611940299,3,0.935428111
10007,2,21668,10,4,0,0,0,14,5,11,1,0,0,17,nowin,loss,beat,dlwin,0,10,14,200,0.445,0.035,0.64,2,0.633962549
10008,143,21669,10,5,0,0,0,15,3,2,10,2,0,17,nowin,loss,beat,dlwin,0,10,15,203,0.463054187,0.044334975,0.57635468,3,0.883143365
10009,83,21669,2,4,2,4,3,15,3,2,10,2,0,17,nowin,loss,beat,dlwin,0,10,6,193,0.424870466,0.051813472,0.678756477,2,0.644360335
10010,4,21669,8,5,0,0,0,13,3,2,10,2,0,17,nowin,loss,beat,dlwin,0,10,13,217,0.460829493,0.036866359,0.562211982,1,0.315432839
10011,99,21669,2,7,3,7,0,19,3,2,10,2,0,17,nowin,win,plwin,beat,20,0,9,207,0.47826087,0.062801932,0.637681159,3,0.961418446
10012,143,21669,10,2,0,10,0,22,3,2,10,2,0,17,nowin,loss,bust,plbust,0,10,12,203,0.463054187,0.044334975,0.57635468,3,0.883143365
10013,134,21669,3,10,0,0,0,13,3,2,10,2,0,17,nowin,loss,beat,dlwin,0,10,13,185,0.443243243,0.021621622,0.545945946,1,0.296939509
10014,133,21670,5,7,0,0,0,12,4,10,1,10,0,25,nowin,win,dlbust,bust,20,0,12,201,0.47761194,0.064676617,0.611940299,3,0.935428111
10015,3,21670,11,5,2,0,0,18,4,10,1,10,0,25,nowin,win,dlbust,bust,20,0,16,190,0.431578947,0.026315789,0.542105263,1,0.288076384
10016,141,21670,8,8,0,0,0,16,4,10,1,10,0,25,nowin,win,dlbust,bust,20,0,16,202,0.420792079,0.074257426,0.564356436,0,0.028377851
10017,79,21670,10,10,0,0,0,20,4,10,1,10,0,25,nowin,win,dlbust,bust,20,0,20,211,0.436018957,0.028436019,0.672985782,2,0.650131054
10018,29,21670,11,10,0,0,0,21,4,10,1,10,0,25,win,win,dlbust,bust,25,0,21,189,0.44973545,0.058201058,0.544973545,1,0.300349439
10019,135,21670,7,10,0,0,0,17,4,10,1,10,0,25,nowin,win,dlbust,bust,20,0,17,179,0.391061453,0.067039106,0.586592179,0,0.024924662
10020,99,21671,2,10,0,6,0,18,11,9,0,0,0,20,nowin,loss,beat,dlwin,0,10,12,207,0.47826087,0.062801932,0.637681159,3,0.961418446
10021,97,21671,6,8,0,10,0,24,11,9,0,0,0,20,nowin,loss,bust,plbust,0,10,14,182,0.450549451,0.06043956,0.692307692,2,0.677372279
10022,33,21671,10,7,0,0,0,17,11,9,0,0,0,20,nowin,loss,beat,dlwin,0,10,17,192,0.4375,0.057291667,0.625,2,0.616208916
10023,145,21671,10,8,0,0,0,18,11,9,0,0,0,20,nowin,loss,beat,dlwin,0,10,18,188,0.441489362,0.031914894,0.622340426,2,0.617837093
10024,104,21671,10,11,0,0,0,21,11,9,0,0,0,20,win,win,plwin,beat,25,0,21,209,0.363636364,0.052631579,0.593301435,0,0.018359419
10025,104,21671,10,5,0,1,9,25,11,9,0,0,0,20,nowin,loss,bust,plbust,0,10,15,209,0.363636364,0.052631579,0.593301435,0,0.018359419
10026,61,21672,11,10,0,0,0,21,4,8,10,0,0,22,win,win,dlbust,bust,25,0,21,194,0.427835052,0.077319588,0.603092784,2,0.591437139
10027,4,21672,7,10,0,0,0,17,4,8,10,0,0,22,nowin,win,dlbust,bust,20,0,17,217,0.460829493,0.036866359,0.562211982,1,0.315432839
10028,118,21672,10,7,0,0,0,17,4,8,10,0,0,22,nowin,win,dlbust,bust,20,0,17,216,0.393518519,0.037037037,0.555555556,0,0.018059873
10029,68,21672,10,4,0,0,0,14,4,8,10,0,0,22,nowin,win,dlbust,bust,20,0,14,205,0.434146341,0.029268293,0.6,2,0.59483189
10030,102,21672,11,3,5,0,0,19,4,8,10,0,0,22,nowin,win,dlbust,bust,20,0,14,192,0.338541667,0.046875,0.5625,0,0.003306118
10031,3,21672,5,9,0,0,0,14,4,8,10,0,0,22,nowin,win,dlbust,bust,20,0,14,190,0.431578947,0.026315789,0.542105263,1,0.288076384
10032,108,21673,7,7,0,0,0,14,4,10,7,0,0,21,nowin,loss,beat,dlwin,0,10,14,193,0.435233161,0.056994819,0.559585492,1,0.298824795
10033,31,21673,9,2,4,0,0,15,4,10,7,0,0,21,nowin,loss,beat,dlwin,0,10,11,188,0.473404255,0.058510638,0.515957447,1,0.300306557
10034,86,21673,10,3,0,0,0,13,4,10,7,0,0,21,nowin,loss,beat,dlwin,0,10,13,196,0.454081633,0.040816327,0.591836735,3,0.887566443
10035,118,21673,10,9,0,0,0,19,4,10,7,0,0,21,nowin,loss,beat,dlwin,0,10,19,216,0.393518519,0.037037037,0.555555556,0,0.018059873
10036,124,21673,4,10,0,0,0,14,4,10,7,0,0,21,nowin,loss,beat,dlwin,0,10,14,202,0.47029703,0.064356436,0.584158416,3,0.899458193
10037,82,21673,2,7,8,0,0,17,4,10,7,0,0,21,nowin,loss,beat,dlwin,0,10,9,225,0.408888889,0.075555556,0.577777778,0,0.028101874
10038,93,21674,4,1,10,0,0,15,2,4,7,10,0,23,nowin,win,dlbust,bust,20,0,5,175,0.485714286,0.051428571,0.548571429,1,0.323648091
10039,9,21674,7,7,0,0,0,14,2,4,7,10,0,23,nowin,win,dlbust,bust,20,0,14,194,0.37628866,0.015463918,0.541237113,0,0.009396796
10040,31,21674,10,10,0,0,0,20,2,4,7,10,0,23,nowin,win,dlbust,bust,20,0,20,188,0.473404255,0.058510638,0.515957447,1,0.300306557
10041,6,21674,9,6,0,0,0,15,2,4,7,10,0,23,nowin,win,dlbust,bust,20,0,15,191,0.439790576,0.047120419,0.581151832,1,0.31211505
10042,48,21674,2,4,10,0,0,16,2,4,7,10,0,23,nowin,win,dlbust,bust,20,0,6,203,0.413793103,0.019704433,0.600985222,2,0.577280801
10043,134,21674,10,8,0,0,0,18,2,4,7,10,0,23,nowin,win,dlbust,bust,20,0,18,185,0.443243243,0.021621622,0.545945946,1,0.296939509
10044,16,21675,7,10,0,0,0,17,6,10,10,0,0,26,nowin,win,dlbust,bust,20,0,17,220,0.427272727,0.081818182,0.6,2,0.588660176
10045,66,21675,3,4,7,0,0,14,6,10,10,0,0,26,nowin,win,dlbust,bust,20,0,7,217,0.456221198,0.064516129,0.626728111,3,0.924304367
10046,47,21675,11,10,0,0,0,21,6,10,10,0,0,26,win,win,dlbust,bust,25,0,21,210,0.438095238,0.057142857,0.623809524,2,0.615868808
10047,69,21675,9,6,0,0,0,15,6,10,10,0,0,26,nowin,win,dlbust,bust,20,0,15,194,0.365979381,0.030927835,0.515463918,0,0
10048,119,21675,10,5,0,0,0,15,6,10,10,0,0,26,nowin,win,dlbust,bust,20,0,15,190,0.405263158,0.068421053,0.515789474,0,0.011837158
10049,10,21675,10,7,0,0,0,17,6,10,10,0,0,26,nowin,win,dlbust,bust,20,0,17,191,0.413612565,0.057591623,0.596858639,2,0.574087175
10050,36,21676,11,10,0,0,0,21,10,11,0,0,0,21,win,push,push,push,10,0,21,229,0.445414847,0.056768559,0.655021834,2,0.645370571
10051,117,21676,7,10,0,0,0,17,10,11,0,0,0,21,nowin,loss,beat,dlwin,0,10,17,173,0.410404624,0.069364162,0.606936416,2,0.578610282
10052,142,21676,10,11,0,0,0,21,10,11,0,0,0,21,win,push,push,push,10,0,21,211,0.417061611,0.047393365,0.526066351,1,0.271531309
10053,56,21676,2,1,10,3,10,26,10,11,0,0,0,21,nowin,loss,bust,plbust,0,10,3,175,0.4,0.057142857,0.582857143,0,0.026685297
10054,110,21676,10,2,0,10,0,22,10,11,0,0,0,21,nowin,loss,bust,plbust,0,10,12,192,0.416666667,0.046875,0.557291667,0,0.025413132
10055,30,21676,11,10,0,0,0,21,10,11,0,0,0,21,win,push,push,push,10,0,21,206,0.393203883,0.033980583,0.601941748,0,0.029324648
10056,84,21677,11,10,0,0,0,21,6,2,4,10,0,22,win,win,dlbust,bust,25,0,21,195,0.379487179,0.056410256,0.569230769,0,0.017209119
10057,78,21677,8,9,0,0,0,17,6,2,4,10,0,22,nowin,win,dlbust,bust,20,0,17,201,0.517412935,0.034825871,0.587064677,3,0.95871112
10058,131,21677,6,10,0,0,0,16,6,2,4,10,0,22,nowin,win,dlbust,bust,20,0,16,217,0.410138249,0.069124424,0.543778802,0,0.02015021
10059,114,21677,8,9,0,0,0,17,6,2,4,10,0,22,nowin,win,dlbust,bust,20,0,17,198,0.47979798,0.025252525,0.611111111,3,0.937232995
10060,88,21677,3,10,0,0,0,13,6,2,4,10,0,22,nowin,win,dlbust,bust,20,0,13,206,0.466019417,0.033980583,0.54368932,1,0.309467903
10061,24,21677,10,2,0,0,0,12,6,2,4,10,0,22,nowin,win,dlbust,bust,20,0,12,207,0.458937198,0.048309179,0.570048309,1,0.318138014
10062,29,21678,10,3,0,10,0,23,8,10,0,0,0,18,nowin,loss,bust,plbust,0,10,13,189,0.44973545,0.058201058,0.544973545,1,0.300349439
10063,81,21678,6,6,0,10,0,22,8,10,0,0,0,18,nowin,loss,bust,plbust,0,10,12,182,0.395604396,0.043956044,0.60989011,2,0.567491261
10064,109,21678,10,6,0,10,0,26,8,10,0,0,0,18,nowin,loss,bust,plbust,0,10,16,221,0.461538462,0.058823529,0.597285068,3,0.901830309
10065,25,21678,10,2,0,7,0,19,8,10,0,0,0,18,nowin,win,plwin,beat,20,0,12,190,0.463157895,0.063157895,0.536842105,1,0.304401563
10066,70,21678,3,9,0,8,0,20,8,10,0,0,0,18,nowin,win,plwin,beat,20,0,12,228,0.385964912,0.039473684,0.557017544,0,0.016157125
10067,64,21678,8,7,0,7,0,22,8,10,0,0,0,18,nowin,loss,bust,plbust,0,10,15,187,0.363636364,0.048128342,0.631016043,0,0.027594885
10068,50,21679,10,9,0,0,0,19,2,10,3,10,0,25,nowin,win,dlbust,bust,20,0,19,202,0.405940594,0.04950495,0.54950495,0,0.020296079
10069,59,21679,7,10,0,0,0,17,2,10,3,10,0,25,nowin,win,dlbust,bust,20,0,17,228,0.429824561,0.048245614,0.543859649,1,0.287885446
10070,112,21679,2,7,11,0,0,20,2,10,3,10,0,25,nowin,win,dlbust,bust,20,0,9,203,0.448275862,0.054187192,0.600985222,3,0.889576933
10071,6,21679,6,8,0,0,0,14,2,10,3,10,0,25,nowin,win,dlbust,bust,20,0,14,191,0.439790576,0.047120419,0.581151832,1,0.31211505
10072,17,21679,10,10,0,0,0,20,2,10,3,10,0,25,nowin,win,dlbust,bust,20,0,20,171,0.444444444,0.070175439,0.555555556,1,0.302364894
10073,96,21679,3,10,0,0,0,13,2,10,3,10,0,25,nowin,win,dlbust,bust,20,0,13,190,0.468421053,0.057894737,0.584210526,3,0.897263354
10074,81,21680,4,8,0,8,0,20,7,3,9,0,0,19,nowin,win,plwin,beat,20,0,12,182,0.395604396,0.043956044,0.60989011,2,0.567491261
10075,142,21680,5,7,0,6,0,18,7,3,9,0,0,19,nowin,loss,beat,dlwin,0,10,12,211,0.417061611,0.047393365,0.526066351,1,0.271531309
10076,87,21680,10,10,0,0,0,20,7,3,9,0,0,19,nowin,win,plwin,beat,20,0,20,202,0.405940594,0.054455446,0.628712871,2,0.590599801
10077,45,21680,2,10,0,1,10,23,7,3,9,0,0,19,nowin,loss,bust,plbust,0,10,12,196,0.428571429,0.051020408,0.612244898,2,0.598821767
10078,98,21680,8,4,0,8,0,20,7,3,9,0,0,19,nowin,win,plwin,beat,20,0,12,220,0.422727273,0.054545455,0.55,1,0.28664435
10079,97,21680,3,4,8,1,8,24,7,3,9,0,0,19,nowin,loss,bust,plbust,0,10,7,182,0.450549451,0.06043956,0.692307692,2,0.677372279
10080,42,21681,10,3,0,10,0,23,8,3,8,0,0,19,nowin,loss,bust,plbust,0,10,13,212,0.443396226,0.051886792,0.570754717,1,0.309181312
10081,132,21681,3,10,0,6,0,19,8,3,8,0,0,19,nowin,push,push,push,10,0,13,194,0.412371134,0.036082474,0.649484536,2,0.611633238
10082,44,21681,2,1,10,4,0,17,8,3,8,0,0,19,nowin,loss,beat,dlwin,0,10,3,219,0.433789954,0.050228311,0.534246575,1,0.285551035
10083,67,21681,10,11,0,0,0,21,8,3,8,0,0,19,win,win,plwin,beat,25,0,21,195,0.369230769,0.041025641,0.569230769,0,0.014139427
10084,146,21681,10,10,0,0,0,20,8,3,8,0,0,19,nowin,win,plwin,beat,20,0,20,221,0.43438914,0.040723982,0.542986425,1,0.290190091
10085,120,21681,10,9,0,0,0,19,8,3,8,0,0,19,nowin,push,push,push,10,0,19,202,0.440594059,0.034653465,0.618811881,2,0.614441029
10086,116,21682,2,8,3,0,0,13,6,8,2,6,0,22,nowin,win,dlbust,bust,20,0,10,195,0.425641026,0.056410256,0.538461538,1,0.28273747
10087,131,21682,9,10,0,0,0,19,6,8,2,6,0,22,nowin,win,dlbust,bust,20,0,19,217,0.410138249,0.069124424,0.543778802,0,0.02015021
10088,60,21682,10,5,0,0,0,15,6,8,2,6,0,22,nowin,win,dlbust,bust,20,0,15,227,0.418502203,0.022026432,0.559471366,0,0.026496258
10089,123,21682,10,10,0,0,0,20,6,8,2,6,0,22,nowin,win,dlbust,bust,20,0,20,205,0.43902439,0.034146341,0.614634146,2,0.609962544
10090,59,21682,7,10,0,0,0,17,6,8,2,6,0,22,nowin,win,dlbust,bust,20,0,17,228,0.429824561,0.048245614,0.543859649,1,0.287885446
10091,51,21682,8,9,0,0,0,17,6,8,2,6,0,22,nowin,win,dlbust,bust,20,0,17,189,0.529100529,0.068783069,0.608465608,3,0.993665715
10092,121,21683,10,10,0,0,0,20,6,8,10,0,0,24,nowin,win,dlbust,bust,20,0,20,195,0.456410256,0.025641026,0.512820513,1,0.288597791
10093,113,21683,6,7,0,0,0,13,6,8,10,0,0,24,nowin,win,dlbust,bust,20,0,13,199,0.407035176,0.055276382,0.668341709,2,0.620695264
10094,123,21683,8,10,0,0,0,18,6,8,10,0,0,24,nowin,win,dlbust,bust,20,0,18,205,0.43902439,0.034146341,0.614634146,2,0.609962544
10095,86,21683,2,4,10,0,0,16,6,8,10,0,0,24,nowin,win,dlbust,bust,20,0,6,196,0.454081633,0.040816327,0.591836735,3,0.887566443
10096,82,21683,10,10,0,0,0,20,6,8,10,0,0,24,nowin,win,dlbust,bust,20,0,20,225,0.408888889,0.075555556,0.577777778,0,0.028101874
10097,129,21683,7,7,0,0,0,14,6,8,10,0,0,24,nowin,win,dlbust,bust,20,0,14,201,0.422885572,0.064676617,0.55721393,0,0.027255383
10098,41,21684,4,10,0,0,0,14,2,7,10,0,0,19,nowin,loss,beat,dlwin,0,10,14,192,0.364583333,0.036458333,0.520833333,0,0.00089702
10099,63,21684,10,6,0,0,0,16,2,7,10,0,0,19,nowin,loss,beat,dlwin,0,10,16,216,0.467592593,0.037037037,0.62037037,3,0.931690496
10100,23,21684,10,10,0,0,0,20,2,7,10,0,0,19,nowin,win,plwin,beat,20,0,20,208,0.427884615,0.0625,0.552884615,1,0.29114424
10101,40,21684,2,4,3,6,0,15,2,7,10,0,0,19,nowin,loss,beat,dlwin,0,10,6,196,0.367346939,0.030612245,0.617346939,0,0.025358183
10102,31,21684,9,10,0,0,0,19,2,7,10,0,0,19,nowin,push,push,push,10,0,19,188,0.473404255,0.058510638,0.515957447,1,0.300306557
10103,93,21684,6,9,0,0,0,15,2,7,10,0,0,19,nowin,loss,beat,dlwin,0,10,15,175,0.485714286,0.051428571,0.548571429,1,0.323648091
10104,24,21685,2,6,11,0,0,19,10,5,7,0,0,22,nowin,win,dlbust,bust,20,0,8,207,0.458937198,0.048309179,0.570048309,1,0.318138014
10105,37,21685,7,4,5,1,0,17,10,5,7,0,0,22,nowin,win,dlbust,bust,20,0,11,208,0.394230769,0.038461538,0.581730769,0,0.024682772
10106,61,21685,2,10,0,4,8,24,10,5,7,0,0,22,nowin,loss,bust,plbust,0,10,12,194,0.427835052,0.077319588,0.603092784,2,0.591437139
10107,71,21685,10,5,0,10,0,25,10,5,7,0,0,22,nowin,loss,bust,plbust,0,10,15,193,0.352331606,0.046632124,0.585492228,0,0.013063661
10108,65,21685,10,3,0,9,0,22,10,5,7,0,0,22,nowin,loss,bust,plbust,0,10,13,203,0.492610837,0.054187192,0.571428571,3,0.913702814
10109,27,21685,9,10,0,0,0,19,10,5,7,0,0,22,nowin,win,dlbust,bust,20,0,19,178,0.370786517,0.016853933,0.573033708,0,0.015536309
10110,6,21686,11,10,0,0,0,21,7,10,0,0,0,17,win,win,plwin,beat,25,0,21,191,0.439790576,0.047120419,0.581151832,1,0.31211505
10111,96,21686,8,8,0,4,0,20,7,10,0,0,0,17,nowin,win,plwin,beat,20,0,16,190,0.468421053,0.057894737,0.584210526,3,0.897263354
10112,78,21686,11,8,0,0,0,19,7,10,0,0,0,17,nowin,win,plwin,beat,20,0,19,201,0.517412935,0.034825871,0.587064677,3,0.95871112
10113,64,21686,10,6,0,10,0,26,7,10,0,0,0,17,nowin,loss,bust,plbust,0,10,16,187,0.363636364,0.048128342,0.631016043,0,0.027594885
10114,2,21686,10,2,0,8,0,20,7,10,0,0,0,17,nowin,win,plwin,beat,20,0,12,200,0.445,0.035,0.64,2,0.633962549
10115,111,21686,9,10,0,0,0,19,7,10,0,0,0,17,nowin,win,plwin,beat,20,0,19,180,0.433333333,0.055555556,0.611111111,2,0.602264492
10116,101,21687,5,4,10,0,0,19,9,10,0,0,0,19,nowin,push,push,push,10,0,9,205,0.424390244,0.068292683,0.63902439,2,0.614740646
10117,29,21687,10,11,0,0,0,21,9,10,0,0,0,19,win,win,plwin,beat,25,0,21,189,0.44973545,0.058201058,0.544973545,1,0.300349439
10118,70,21687,2,6,4,10,0,22,9,10,0,0,0,19,nowin,loss,bust,plbust,0,10,8,228,0.385964912,0.039473684,0.557017544,0,0.016157125
10119,93,21687,7,10,0,0,0,17,9,10,0,0,0,19,nowin,loss,beat,dlwin,0,10,17,175,0.485714286,0.051428571,0.548571429,1,0.323648091
10120,87,21687,6,8,0,4,0,18,9,10,0,0,0,19,nowin,loss,beat,dlwin,0,10,14,202,0.405940594,0.054455446,0.628712871,2,0.590599801
10121,59,21687,6,10,0,3,0,19,9,10,0,0,0,19,nowin,push,push,push,10,0,16,228,0.429824561,0.048245614,0.543859649,1,0.287885446
10122,58,21688,3,10,0,6,0,19,10,8,0,0,0,18,nowin,win,plwin,beat,20,0,13,195,0.430769231,0.041025641,0.584615385,2,0.580497586
10123,90,21688,11,10,0,0,0,21,10,8,0,0,0,18,win,win,plwin,beat,25,0,21,201,0.447761194,0.049751244,0.60199005,3,0.889945023
10124,52,21688,9,4,0,10,0,23,10,8,0,0,0,18,nowin,loss,bust,plbust,0,10,13,217,0.414746544,0.02764977,0.599078341,2,0.576736024
10125,72,21688,5,1,10,5,0,21,10,8,0,0,0,18,nowin,win,plwin,beat,20,0,6,185,0.394594595,0.032432432,0.508108108,0,0.006763115
10126,115,21688,5,10,0,10,0,25,10,8,0,0,0,18,nowin,loss,bust,plbust,0,10,15,194,0.427835052,0.041237113,0.592783505,2,0.583863602
10127,91,21688,10,8,0,0,0,18,10,8,0,0,0,18,nowin,push,push,push,10,0,18,194,0.417525773,0.046391753,0.515463918,1,0.266616552
10128,71,21689,10,8,0,0,0,18,11,8,0,0,0,19,nowin,loss,beat,dlwin,0,10,18,193,0.352331606,0.046632124,0.585492228,0,0.013063661
10129,148,21689,3,4,10,0,0,17,11,8,0,0,0,19,nowin,loss,beat,dlwin,0,10,7,204,0.401960784,0.078431373,0.593137255,0,0.029789521
10130,106,21689,10,3,0,8,0,21,11,8,0,0,0,19,nowin,win,plwin,beat,20,0,13,192,0.411458333,0.026041667,0.557291667,0,0.023854304
10131,20,21689,10,9,0,0,0,19,11,8,0,0,0,19,nowin,push,push,push,10,0,19,186,0.456989247,0.037634409,0.537634409,1,0.301097108
10132,53,21689,8,11,0,0,0,19,11,8,0,0,0,19,nowin,push,push,push,10,0,19,250,0.372,0.064,0.564,0,0.013687345
10133,1,21689,1,5,8,4,0,18,11,8,0,0,0,19,nowin,loss,beat,dlwin,0,10,6,197,0.406091371,0.025380711,0.649746193,2,0.606186955
10134,25,21690,3,9,0,10,0,22,11,10,0,0,0,21,nowin,loss,bust,plbust,0,10,12,190,0.463157895,0.063157895,0.536842105,1,0.304401563
10135,103,21690,8,10,0,0,0,18,11,10,0,0,0,21,nowin,loss,beat,dlwin,0,10,18,203,0.379310345,0.064039409,0.551724138,0,0.012869209
10136,116,21690,10,5,0,9,0,24,11,10,0,0,0,21,nowin,loss,bust,plbust,0,10,15,195,0.425641026,0.056410256,0.538461538,1,0.28273747
10137,12,21690,2,10,0,4,6,22,11,10,0,0,0,21,nowin,loss,bust,plbust,0,10,12,189,0.470899471,0.015873016,0.613756614,3,0.929171178
10138,81,21690,10,4,0,7,0,21,11,10,0,0,0,21,nowin,push,push,push,10,0,14,182,0.395604396,0.043956044,0.60989011,2,0.567491261
10139,72,21690,7,10,0,0,0,17,11,10,0,0,0,21,nowin,loss,beat,dlwin,0,10,17,185,0.394594595,0.032432432,0.508108108,0,0.006763115
10140,7,21691,4,10,0,10,0,24,11,10,0,0,0,21,nowin,loss,bust,plbust,0,10,14,183,0.442622951,0.06010929,0.62295082,2,0.619303341
10141,146,21691,3,9,0,8,0,20,11,10,0,0,0,21,nowin,loss,beat,dlwin,0,10,12,221,0.43438914,0.040723982,0.542986425,1,0.290190091
10142,71,21691,11,10,0,0,0,21,11,10,0,0,0,21,win,push,push,push,10,0,21,193,0.352331606,0.046632124,0.585492228,0,0.013063661
10143,107,21691,7,5,0,3,9,24,11,10,0,0,0,21,nowin,loss,bust,plbust,0,10,12,218,0.444954128,0.073394495,0.600917431,2,0.605210014
10144,9,21691,9,6,0,5,0,20,11,10,0,0,0,21,nowin,loss,beat,dlwin,0,10,15,194,0.37628866,0.015463918,0.541237113,0,0.009396796
10145,148,21691,4,9,0,6,0,19,11,10,0,0,0,21,nowin,loss,beat,dlwin,0,10,13,204,0.401960784,0.078431373,0.593137255,0,0.029789521
10146,80,21692,5,8,0,0,0,13,2,6,3,7,0,18,nowin,loss,beat,dlwin,0,10,13,186,0.419354839,0.059139785,0.623655914,2,0.59892924
10147,19,21692,11,7,0,0,0,18,2,6,3,7,0,18,nowin,push,push,push,10,0,18,237,0.41350211,0.054852321,0.628691983,2,0.597373826
10148,93,21692,6,10,0,0,0,16,2,6,3,7,0,18,nowin,loss,beat,dlwin,0,10,16,175,0.485714286,0.051428571,0.548571429,1,0.323648091
10149,24,21692,5,8,0,0,0,13,2,6,3,7,0,18,nowin,loss,beat,dlwin,0,10,13,207,0.458937198,0.048309179,0.570048309,1,0.318138014
10150,84,21692,6,10,0,0,0,16,2,6,3,7,0,18,nowin,loss,beat,dlwin,0,10,16,195,0.379487179,0.056410256,0.569230769,0,0.017209119
10151,75,21692,4,2,11,0,0,17,2,6,3,7,0,18,nowin,loss,beat,dlwin,0,10,6,191,0.418848168,0.052356021,0.570680628,0,0.029344702
10152,37,21693,4,10,0,4,0,18,7,8,2,0,0,17,nowin,win,plwin,beat,20,0,14,208,0.394230769,0.038461538,0.581730769,0,0.024682772
10153,38,21693,10,7,0,0,0,17,7,8,2,0,0,17,nowin,push,push,push,10,0,17,202,0.361386139,0.03960396,0.564356436,0,0.010597953
10154,78,21693,10,8,0,0,0,18,7,8,2,0,0,17,nowin,win,plwin,beat,20,0,18,201,0.517412935,0.034825871,0.587064677,3,0.95871112
10155,142,21693,10,10,0,0,0,20,7,8,2,0,0,17,nowin,win,plwin,beat,20,0,20,211,0.417061611,0.047393365,0.526066351,1,0.271531309
10156,92,21693,6,9,0,4,0,19,7,8,2,0,0,17,nowin,win,plwin,beat,20,0,15,186,0.446236559,0.059139785,0.564516129,1,0.307826125
10157,145,21693,10,10,0,0,0,20,7,8,2,0,0,17,nowin,win,plwin,beat,20,0,20,188,0.441489362,0.031914894,0.622340426,2,0.617837093
10158,95,21694,10,11,0,0,0,21,4,10,10,0,0,24,win,win,dlbust,bust,25,0,21,218,0.412844037,0.04587156,0.559633028,0,0.024842385
10159,38,21694,9,7,0,0,0,16,4,10,10,0,0,24,nowin,win,dlbust,bust,20,0,16,202,0.361386139,0.03960396,0.564356436,0,0.010597953
10160,30,21694,3,1,8,0,0,12,4,10,10,0,0,24,nowin,win,dlbust,bust,20,0,4,206,0.393203883,0.033980583,0.601941748,0,0.029324648
10161,72,21694,10,7,0,0,0,17,4,10,10,0,0,24,nowin,win,dlbust,bust,20,0,17,185,0.394594595,0.032432432,0.508108108,0,0.006763115
10162,128,21694,10,7,0,0,0,17,4,10,10,0,0,24,nowin,win,dlbust,bust,20,0,17,227,0.356828194,0.052863436,0.577092511,0,0.012352564
10163,8,21694,2,10,0,0,0,12,4,10,10,0,0,24,nowin,win,dlbust,bust,20,0,12,181,0.44198895,0.071823204,0.596685083,2,0.599438402
10164,26,21695,2,10,0,9,0,21,10,7,0,0,0,17,nowin,win,plwin,beat,20,0,12,203,0.463054187,0.0591133,0.541871921,1,0.306802864
10165,30,21695,2,8,5,10,0,25,10,7,0,0,0,17,nowin,loss,bust,plbust,0,10,10,206,0.393203883,0.033980583,0.601941748,0,0.029324648
10166,51,21695,9,3,0,8,0,20,10,7,0,0,0,17,nowin,win,plwin,beat,20,0,12,189,0.529100529,0.068783069,0.608465608,3,0.993665715
10167,45,21695,10,7,0,0,0,17,10,7,0,0,0,17,nowin,push,push,push,10,0,17,196,0.428571429,0.051020408,0.612244898,2,0.598821767
10168,35,21695,11,8,0,0,0,19,10,7,0,0,0,17,nowin,win,plwin,beat,20,0,19,202,0.410891089,0.044554455,0.633663366,2,0.598681573
10169,115,21695,10,10,0,0,0,20,10,7,0,0,0,17,nowin,win,plwin,beat,20,0,20,194,0.427835052,0.041237113,0.592783505,2,0.583863602
10170,70,21696,11,2,7,0,0,20,9,10,0,0,0,19,nowin,win,plwin,beat,20,0,13,228,0.385964912,0.039473684,0.557017544,0,0.016157125
10171,81,21696,10,10,0,0,0,20,9,10,0,0,0,19,nowin,win,plwin,beat,20,0,20,182,0.395604396,0.043956044,0.60989011,2,0.567491261
10172,52,21696,10,10,0,0,0,20,9,10,0,0,0,19,nowin,win,plwin,beat,20,0,20,217,0.414746544,0.02764977,0.599078341,2,0.576736024
10173,136,21696,2,6,6,8,0,22,9,10,0,0,0,19,nowin,loss,bust,plbust,0,10,8,194,0.396907216,0.025773196,0.597938144,0,0.029452644
10174,46,21696,8,6,0,10,0,24,9,10,0,0,0,19,nowin,loss,bust,plbust,0,10,14,186,0.403225806,0.048387097,0.591397849,0,0.029742194
10175,119,21696,10,9,0,0,0,19,9,10,0,0,0,19,nowin,push,push,push,10,0,19,190,0.405263158,0.068421053,0.515789474,0,0.011837158
10176,102,21697,3,7,10,0,0,20,4,9,8,0,0,21,nowin,loss,beat,dlwin,0,10,10,192,0.338541667,0.046875,0.5625,0,0.003306118
10177,127,21697,9,6,0,0,0,15,4,9,8,0,0,21,nowin,loss,beat,dlwin,0,10,15,201,0.402985075,0.029850746,0.60199005,0,0.032263937
10178,82,21697,4,10,0,0,0,14,4,9,8,0,0,21,nowin,loss,beat,dlwin,0,10,14,225,0.408888889,0.075555556,0.577777778,0,0.028101874
10179,16,21697,10,10,0,0,0,20,4,9,8,0,0,21,nowin,loss,beat,dlwin,0,10,20,220,0.427272727,0.081818182,0.6,2,0.588660176
10180,95,21697,10,10,0,0,0,20,4,9,8,0,0,21,nowin,loss,beat,dlwin,0,10,20,218,0.412844037,0.04587156,0.559633028,0,0.024842385
10181,146,21697,10,5,0,0,0,15,4,9,8,0,0,21,nowin,loss,beat,dlwin,0,10,15,221,0.43438914,0.040723982,0.542986425,1,0.290190091
10182,90,21698,9,10,0,0,0,19,6,10,1,0,0,17,nowin,win,plwin,beat,20,0,19,201,0.447761194,0.049751244,0.60199005,3,0.889945023
10183,130,21698,5,2,6,0,0,13,6,10,1,0,0,17,nowin,loss,beat,dlwin,0,10,7,219,0.410958904,0.03652968,0.566210046,0,0.025888739
10184,29,21698,6,5,9,0,0,20,6,10,1,0,0,17,nowin,win,plwin,beat,20,0,11,189,0.44973545,0.058201058,0.544973545,1,0.300349439
10185,60,21698,4,4,2,5,0,15,6,10,1,0,0,17,nowin,loss,beat,dlwin,0,10,8,227,0.418502203,0.022026432,0.559471366,0,0.026496258
10186,82,21698,6,8,0,0,0,14,6,10,1,0,0,17,nowin,loss,beat,dlwin,0,10,14,225,0.408888889,0.075555556,0.577777778,0,0.028101874
10187,9,21698,2,2,7,2,0,13,6,10,1,0,0,17,nowin,loss,beat,dlwin,0,10,4,194,0.37628866,0.015463918,0.541237113,0,0.009396796
10188,30,21699,10,5,0,3,0,18,10,3,10,0,0,23,nowin,win,dlbust,bust,20,0,15,206,0.393203883,0.033980583,0.601941748,0,0.029324648
10189,56,21699,8,4,0,5,0,17,10,3,10,0,0,23,nowin,win,dlbust,bust,20,0,12,175,0.4,0.057142857,0.582857143,0,0.026685297
10190,139,21699,8,6,0,2,6,22,10,3,10,0,0,23,nowin,loss,bust,plbust,0,10,14,192,0.380208333,0.036458333,0.59375,0,0.023429169
10191,79,21699,2,9,9,0,0,20,10,3,10,0,0,23,nowin,win,dlbust,bust,20,0,11,211,0.436018957,0.028436019,0.672985782,2,0.650131054
10192,124,21699,2,9,5,10,0,26,10,3,10,0,0,23,nowin,loss,bust,plbust,0,10,11,202,0.47029703,0.064356436,0.584158416,3,0.899458193
10193,101,21699,7,10,0,0,0,17,10,3,10,0,0,23,nowin,win,dlbust,bust,20,0,17,205,0.424390244,0.068292683,0.63902439,2,0.614740646
10194,34,21700,11,3,4,0,0,18,7,10,0,0,0,17,nowin,win,plwin,beat,20,0,14,202,0.5,0.079207921,0.618811881,3,0.968961434
10195,11,21700,1,4,8,2,9,24,7,10,0,0,0,17,nowin,loss,bust,plbust,0,10,5,236,0.457627119,0.016949153,0.588983051,3,0.889015813
10196,40,21700,10,10,0,0,0,20,7,10,0,0,0,17,nowin,win,plwin,beat,20,0,20,196,0.367346939,0.030612245,0.617346939,0,0.025358183
10197,43,21700,10,5,0,3,0,18,7,10,0,0,0,17,nowin,win,plwin,beat,20,0,15,192,0.40625,0.041666667,0.609375,2,0.576671372
10198,53,21700,9,9,0,0,0,18,7,10,0,0,0,17,nowin,win,plwin,beat,20,0,18,250,0.372,0.064,0.564,0,0.013687345
10199,150,21700,10,6,0,3,0,19,7,10,0,0,0,17,nowin,win,plwin,beat,20,0,16,192,0.401041667,0.036458333,0.567708333,0,0.023287458
10200,61,21701,10,10,0,0,0,20,3,9,4,8,0,24,nowin,win,dlbust,bust,20,0,20,194,0.427835052,0.077319588,0.603092784,2,0.591437139
10201,52,21701,10,11,0,0,0,21,3,9,4,8,0,24,win,win,dlbust,bust,25,0,21,217,0.414746544,0.02764977,0.599078341,2,0.576736024
10202,91,21701,8,7,0,0,0,15,3,9,4,8,0,24,nowin,win,dlbust,bust,20,0,15,194,0.417525773,0.046391753,0.515463918,1,0.266616552
10203,5,21701,3,10,0,0,0,13,3,9,4,8,0,24,nowin,win,dlbust,bust,20,0,13,203,0.42364532,0.02955665,0.596059113,2,0.582508076
10204,29,21701,10,10,0,0,0,20,3,9,4,8,0,24,nowin,win,dlbust,bust,20,0,20,189,0.44973545,0.058201058,0.544973545,1,0.300349439
10205,32,21701,2,7,2,10,0,21,3,9,4,8,0,24,nowin,win,dlbust,bust,20,0,9,189,0.391534392,0.037037037,0.53968254,0,0.013579086
10206,73,21702,4,5,10,0,0,19,3,9,9,0,0,21,nowin,loss,beat,dlwin,0,10,9,181,0.375690608,0.011049724,0.596685083,0,0.022795773
10207,1,21702,9,8,0,0,0,17,3,9,9,0,0,21,nowin,loss,beat,dlwin,0,10,17,197,0.406091371,0.025380711,0.649746193,2,0.606186955
10208,120,21702,9,10,0,0,0,19,3,9,9,0,0,21,nowin,loss,beat,dlwin,0,10,19,202,0.440594059,0.034653465,0.618811881,2,0.614441029
10209,43,21702,4,2,6,9,0,21,3,9,9,0,0,21,nowin,push,push,push,10,0,6,192,0.40625,0.041666667,0.609375,2,0.576671372
10210,18,21702,8,5,0,0,0,13,3,9,9,0,0,21,nowin,loss,beat,dlwin,0,10,13,182,0.461538462,0.043956044,0.587912088,3,0.892649374
10211,35,21702,10,4,0,0,0,14,3,9,9,0,0,21,nowin,loss,beat,dlwin,0,10,14,202,0.410891089,0.044554455,0.633663366,2,0.598681573
10212,47,21703,2,11,1,4,0,18,10,6,10,0,0,26,nowin,win,dlbust,bust,20,0,13,210,0.438095238,0.057142857,0.623809524,2,0.615868808
10213,139,21703,5,2,9,1,0,17,10,6,10,0,0,26,nowin,win,dlbust,bust,20,0,7,192,0.380208333,0.036458333,0.59375,0,0.023429169
10214,34,21703,10,3,0,2,3,18,10,6,10,0,0,26,nowin,win,dlbust,bust,20,0,13,202,0.5,0.079207921,0.618811881,3,0.968961434
10215,35,21703,4,10,0,10,0,24,10,6,10,0,0,26,nowin,loss,bust,plbust,0,10,14,202,0.410891089,0.044554455,0.633663366,2,0.598681573
10216,93,21703,11,10,0,0,0,21,10,6,10,0,0,26,win,win,dlbust,bust,25,0,21,175,0.485714286,0.051428571,0.548571429,1,0.323648091
10217,39,21703,6,10,0,4,0,20,10,6,10,0,0,26,nowin,win,dlbust,bust,20,0,16,191,0.429319372,0.062827225,0.57591623,0,0.033760763
10218,59,21704,9,2,7,0,0,18,5,11,3,0,0,19,nowin,loss,beat,dlwin,0,10,11,228,0.429824561,0.048245614,0.543859649,1,0.287885446
10219,28,21704,5,10,0,0,0,15,5,11,3,0,0,19,nowin,loss,beat,dlwin,0,10,15,199,0.422110553,0.045226131,0.542713568,1,0.282706618
10220,22,21704,9,7,0,0,0,16,5,11,3,0,0,19,nowin,loss,beat,dlwin,0,10,16,187,0.481283422,0.042780749,0.577540107,3,0.906128176
10221,132,21704,2,8,5,0,0,15,5,11,3,0,0,19,nowin,loss,beat,dlwin,0,10,10,194,0.412371134,0.036082474,0.649484536,2,0.611633238
10222,103,21704,9,4,0,0,0,13,5,11,3,0,0,19,nowin,loss,beat,dlwin,0,10,13,203,0.379310345,0.064039409,0.551724138,0,0.012869209
10223,137,21704,6,7,0,0,0,13,5,11,3,0,0,19,nowin,loss,beat,dlwin,0,10,13,194,0.417525773,0.046391753,0.536082474,1,0.276714602
10224,147,21705,7,6,0,0,0,13,6,3,2,5,5,21,nowin,loss,beat,dlwin,0,10,13,205,0.380487805,0.014634146,0.536585366,0,0.00951447
10225,24,21705,11,10,0,0,0,21,6,3,2,5,5,21,win,push,push,push,10,0,21,207,0.458937198,0.048309179,0.570048309,1,0.318138014
10226,129,21705,10,3,0,0,0,13,6,3,2,5,5,21,nowin,loss,beat,dlwin,0,10,13,201,0.422885572,0.064676617,0.55721393,0,0.027255383
10227,18,21705,10,7,0,0,0,17,6,3,2,5,5,21,nowin,loss,beat,dlwin,0,10,17,182,0.461538462,0.043956044,0.587912088,3,0.892649374
10228,54,21705,2,8,10,0,0,20,6,3,2,5,5,21,nowin,loss,beat,dlwin,0,10,10,185,0.437837838,0.032432432,0.556756757,1,0.29899854
10229,43,21705,10,4,0,0,0,14,6,3,2,5,5,21,nowin,loss,beat,dlwin,0,10,14,192,0.40625,0.041666667,0.609375,2,0.576671372
10230,148,21706,10,10,0,0,0,20,5,2,6,1,4,18,nowin,win,plwin,beat,20,0,20,204,0.401960784,0.078431373,0.593137255,0,0.029789521
10231,110,21706,6,3,11,0,0,20,5,2,6,1,4,18,nowin,win,plwin,beat,20,0,9,192,0.416666667,0.046875,0.557291667,0,0.025413132
10232,11,21706,7,3,6,0,0,16,5,2,6,1,4,18,nowin,loss,beat,dlwin,0,10,10,236,0.457627119,0.016949153,0.588983051,3,0.889015813
10233,67,21706,4,2,11,0,0,17,5,2,6,1,4,18,nowin,loss,beat,dlwin,0,10,6,195,0.369230769,0.041025641,0.569230769,0,0.014139427
10234,135,21706,3,4,4,6,0,17,5,2,6,1,4,18,nowin,loss,beat,dlwin,0,10,7,179,0.391061453,0.067039106,0.586592179,0,0.024924662
10235,35,21706,10,10,0,0,0,20,5,2,6,1,4,18,nowin,win,plwin,beat,20,0,20,202,0.410891089,0.044554455,0.633663366,2,0.598681573
10236,128,21707,8,10,0,0,0,18,10,10,0,0,0,20,nowin,loss,beat,dlwin,0,10,18,227,0.356828194,0.052863436,0.577092511,0,0.012352564
10237,28,21707,5,1,10,6,0,22,10,10,0,0,0,20,nowin,loss,bust,plbust,0,10,6,199,0.422110553,0.045226131,0.542713568,1,0.282706618
10238,84,21707,9,9,0,0,0,18,10,10,0,0,0,20,nowin,loss,beat,dlwin,0,10,18,195,0.379487179,0.056410256,0.569230769,0,0.017209119
10239,95,21707,2,2,10,10,0,24,10,10,0,0,0,20,nowin,loss,bust,plbust,0,10,4,218,0.412844037,0.04587156,0.559633028,0,0.024842385
10240,87,21707,5,3,6,10,0,24,10,10,0,0,0,20,nowin,loss,bust,plbust,0,10,8,202,0.405940594,0.054455446,0.628712871,2,0.590599801
10241,40,21707,4,9,0,10,0,23,10,10,0,0,0,20,nowin,loss,bust,plbust,0,10,13,196,0.367346939,0.030612245,0.617346939,0,0.025358183
10242,9,21708,7,10,0,0,0,17,11,1,5,0,0,17,nowin,push,push,push,10,0,17,194,0.37628866,0.015463918,0.541237113,0,0.009396796
10243,10,21708,7,10,0,0,0,17,11,1,5,0,0,17,nowin,push,push,push,10,0,17,191,0.413612565,0.057591623,0.596858639,2,0.574087175
10244,70,21708,2,3,6,9,0,20,11,1,5,0,0,17,nowin,win,plwin,beat,20,0,5,228,0.385964912,0.039473684,0.557017544,0,0.016157125
10245,103,21708,8,11,0,0,0,19,11,1,5,0,0,17,nowin,win,plwin,beat,20,0,19,203,0.379310345,0.064039409,0.551724138,0,0.012869209
10246,43,21708,5,6,2,10,0,23,11,1,5,0,0,17,nowin,loss,bust,plbust,0,10,11,192,0.40625,0.041666667,0.609375,2,0.576671372
10247,9,21708,10,2,0,10,0,22,11,1,5,0,0,17,nowin,loss,bust,plbust,0,10,12,194,0.37628866,0.015463918,0.541237113,0,0.009396796
10248,9,21709,9,3,0,10,0,22,10,4,1,10,0,25,nowin,loss,bust,plbust,0,10,12,194,0.37628866,0.015463918,0.541237113,0,0.009396796
10249,37,21709,3,3,3,3,10,22,10,4,1,10,0,25,nowin,loss,bust,plbust,0,10,6,208,0.394230769,0.038461538,0.581730769,0,0.024682772
10250,109,21709,10,9,0,0,0,19,10,4,1,10,0,25,nowin,win,dlbust,bust,20,0,19,221,0.461538462,0.058823529,0.597285068,3,0.901830309
10251,131,21709,5,10,0,10,0,25,10,4,1,10,0,25,nowin,loss,bust,plbust,0,10,15,217,0.410138249,0.069124424,0.543778802,0,0.02015021
10252,18,21709,6,6,0,10,0,22,10,4,1,10,0,25,nowin,loss,bust,plbust,0,10,12,182,0.461538462,0.043956044,0.587912088,3,0.892649374
10253,44,21709,10,5,0,10,0,25,10,4,1,10,0,25,nowin,loss,bust,plbust,0,10,15,219,0.433789954,0.050228311,0.534246575,1,0.285551035
10254,74,21710,11,10,0,0,0,21,4,5,3,6,0,18,win,win,plwin,beat,25,0,21,209,0.411483254,0.04784689,0.531100478,0,0.017448125
10255,21,21710,9,8,0,0,0,17,4,5,3,6,0,18,nowin,loss,beat,dlwin,0,10,17,214,0.359813084,0.042056075,0.626168224,0,0.025263474
10256,46,21710,8,2,5,0,0,15,4,5,3,6,0,18,nowin,loss,beat,dlwin,0,10,10,186,0.403225806,0.048387097,0.591397849,0,0.029742194
10257,144,21710,4,9,0,0,0,13,4,5,3,6,0,18,nowin,loss,beat,dlwin,0,10,13,202,0.386138614,0.054455446,0.564356436,0,0.018006244
10258,126,21710,11,10,0,0,0,21,4,5,3,6,0,18,win,win,plwin,beat,25,0,21,188,0.457446809,0.074468085,0.60106383,3,0.900633203
10259,124,21710,10,4,0,0,0,14,4,5,3,6,0,18,nowin,loss,beat,dlwin,0,10,14,202,0.47029703,0.064356436,0.584158416,3,0.899458193
10260,13,21711,10,6,0,2,0,18,10,10,0,0,0,20,nowin,loss,beat,dlwin,0,10,16,206,0.417475728,0.063106796,0.621359223,2,0.59555479
10261,41,21711,5,11,4,0,0,20,10,10,0,0,0,20,nowin,push,push,push,10,0,16,192,0.364583333,0.036458333,0.520833333,0,0.00089702
10262,149,21711,5,9,0,6,0,20,10,10,0,0,0,20,nowin,push,push,push,10,0,14,225,0.457777778,0.057777778,0.648888889,2,0.651965595
10263,132,21711,10,10,0,0,0,20,10,10,0,0,0,20,nowin,push,push,push,10,0,20,194,0.412371134,0.036082474,0.649484536,2,0.611633238
10264,14,21711,10,10,0,0,0,20,10,10,0,0,0,20,nowin,push,push,push,10,0,20,202,0.391089109,0.01980198,0.628712871,2,0.577264877
10265,22,21711,10,7,0,0,0,17,10,10,0,0,0,20,nowin,loss,beat,dlwin,0,10,17,187,0.481283422,0.042780749,0.577540107,3,0.906128176
10266,35,21712,10,10,0,0,0,20,9,6,4,0,0,19,nowin,win,plwin,beat,20,0,20,202,0.410891089,0.044554455,0.633663366,2,0.598681573
10267,129,21712,10,10,0,0,0,20,9,6,4,0,0,19,nowin,win,plwin,beat,20,0,20,201,0.422885572,0.064676617,0.55721393,0,0.027255383
10268,105,21712,8,7,0,10,0,25,9,6,4,0,0,19,nowin,loss,bust,plbust,0,10,15,198,0.414141414,0.070707071,0.590909091,0,0.032889494
10269,149,21712,5,6,7,0,0,18,9,6,4,0,0,19,nowin,loss,beat,dlwin,0,10,11,225,0.457777778,0.057777778,0.648888889,2,0.651965595
10270,135,21712,4,3,2,5,2,16,9,6,4,0,0,19,nowin,loss,beat,dlwin,0,10,7,179,0.391061453,0.067039106,0.586592179,0,0.024924662
10271,124,21712,4,3,4,2,10,23,9,6,4,0,0,19,nowin,loss,bust,plbust,0,10,7,202,0.47029703,0.064356436,0.584158416,3,0.899458193
10272,47,21713,10,11,0,0,0,21,10,5,6,0,0,21,win,push,push,push,10,0,21,210,0.438095238,0.057142857,0.623809524,2,0.615868808
10273,25,21713,11,10,0,0,0,21,10,5,6,0,0,21,win,push,push,push,10,0,21,190,0.463157895,0.063157895,0.536842105,1,0.304401563
10274,73,21713,10,7,0,0,0,17,10,5,6,0,0,21,nowin,loss,beat,dlwin,0,10,17,181,0.375690608,0.011049724,0.596685083,0,0.022795773
10275,100,21713,10,10,0,0,0,20,10,5,6,0,0,21,nowin,loss,beat,dlwin,0,10,20,190,0.452631579,0.036842105,0.594736842,3,0.888671154
10276,146,21713,7,6,0,4,0,17,10,5,6,0,0,21,nowin,loss,beat,dlwin,0,10,13,221,0.43438914,0.040723982,0.542986425,1,0.290190091
10277,36,21713,9,5,0,10,0,24,10,5,6,0,0,21,nowin,loss,bust,plbust,0,10,14,229,0.445414847,0.056768559,0.655021834,2,0.645370571
10278,111,21714,10,4,0,10,0,24,10,11,0,0,0,21,nowin,loss,bust,plbust,0,10,14,180,0.433333333,0.055555556,0.611111111,2,0.602264492
10279,131,21714,5,10,0,2,0,17,10,11,0,0,0,21,nowin,loss,beat,dlwin,0,10,15,217,0.410138249,0.069124424,0.543778802,0,0.02015021
10280,5,21714,4,9,0,3,7,23,10,11,0,0,0,21,nowin,loss,bust,plbust,0,10,13,203,0.42364532,0.02955665,0.596059113,2,0.582508076
10281,130,21714,10,2,0,4,4,20,10,11,0,0,0,21,nowin,loss,beat,dlwin,0,10,12,219,0.410958904,0.03652968,0.566210046,0,0.025888739
10282,93,21714,10,10,0,0,0,20,10,11,0,0,0,21,nowin,loss,beat,dlwin,0,10,20,175,0.485714286,0.051428571,0.548571429,1,0.323648091
10283,38,21714,8,5,0,4,0,17,10,11,0,0,0,21,nowin,loss,beat,dlwin,0,10,13,202,0.361386139,0.03960396,0.564356436,0,0.010597953
10284,59,21715,10,3,0,0,0,13,4,8,10,0,0,22,nowin,win,dlbust,bust,20,0,13,228,0.429824561,0.048245614,0.543859649,1,0.287885446
10285,150,21715,8,10,0,0,0,18,4,8,10,0,0,22,nowin,win,dlbust,bust,20,0,18,192,0.401041667,0.036458333,0.567708333,0,0.023287458
10286,106,21715,7,2,10,0,0,19,4,8,10,0,0,22,nowin,win,dlbust,bust,20,0,9,192,0.411458333,0.026041667,0.557291667,0,0.023854304
10287,8,21715,7,10,0,0,0,17,4,8,10,0,0,22,nowin,win,dlbust,bust,20,0,17,181,0.44198895,0.071823204,0.596685083,2,0.599438402
10288,148,21715,4,5,2,3,0,14,4,8,10,0,0,22,nowin,win,dlbust,bust,20,0,9,204,0.401960784,0.078431373,0.593137255,0,0.029789521
10289,39,21715,9,7,0,0,0,16,4,8,10,0,0,22,nowin,win,dlbust,bust,20,0,16,191,0.429319372,0.062827225,0.57591623,0,0.033760763
10290,26,21716,4,11,2,0,0,17,2,7,10,0,0,19,nowin,loss,beat,dlwin,0,10,15,203,0.463054187,0.0591133,0.541871921,1,0.306802864
10291,127,21716,8,8,0,0,0,16,2,7,10,0,0,19,nowin,loss,beat,dlwin,0,10,16,201,0.402985075,0.029850746,0.60199005,0,0.032263937
10292,31,21716,8,3,1,1,0,13,2,7,10,0,0,19,nowin,loss,beat,dlwin,0,10,11,188,0.473404255,0.058510638,0.515957447,1,0.300306557
10293,130,21716,10,10,0,0,0,20,2,7,10,0,0,19,nowin,win,plwin,beat,20,0,20,219,0.410958904,0.03652968,0.566210046,0,0.025888739
10294,4,21716,2,9,10,0,0,21,2,7,10,0,0,19,nowin,win,plwin,beat,20,0,11,217,0.460829493,0.036866359,0.562211982,1,0.315432839
10295,53,21716,6,1,5,7,0,19,2,7,10,0,0,19,nowin,push,push,push,10,0,7,250,0.372,0.064,0.564,0,0.013687345
10296,115,21717,5,5,10,0,0,20,7,10,0,0,0,17,nowin,win,plwin,beat,20,0,10,194,0.427835052,0.041237113,0.592783505,2,0.583863602
10297,115,21717,10,10,0,0,0,20,7,10,0,0,0,17,nowin,win,plwin,beat,20,0,20,194,0.427835052,0.041237113,0.592783505,2,0.583863602
10298,38,21717,10,10,0,0,0,20,7,10,0,0,0,17,nowin,win,plwin,beat,20,0,20,202,0.361386139,0.03960396,0.564356436,0,0.010597953
10299,25,21717,3,10,0,5,0,18,7,10,0,0,0,17,nowin,win,plwin,beat,20,0,13,190,0.463157895,0.063157895,0.536842105,1,0.304401563
10300,99,21717,10,8,0,0,0,18,7,10,0,0,0,17,nowin,win,plwin,beat,20,0,18,207,0.47826087,0.062801932,0.637681159,3,0.961418446
10301,35,21717,3,10,0,6,0,19,7,10,0,0,0,17,nowin,win,plwin,beat,20,0,13,202,0.410891089,0.044554455,0.633663366,2,0.598681573
10302,91,21718,2,4,10,0,0,16,5,3,8,3,0,19,nowin,loss,beat,dlwin,0,10,6,194,0.417525773,0.046391753,0.515463918,1,0.266616552
10303,86,21718,8,10,0,0,0,18,5,3,8,3,0,19,nowin,loss,beat,dlwin,0,10,18,196,0.454081633,0.040816327,0.591836735,3,0.887566443
10304,82,21718,6,9,0,0,0,15,5,3,8,3,0,19,nowin,loss,beat,dlwin,0,10,15,225,0.408888889,0.075555556,0.577777778,0,0.028101874
10305,30,21718,7,10,0,0,0,17,5,3,8,3,0,19,nowin,loss,beat,dlwin,0,10,17,206,0.393203883,0.033980583,0.601941748,0,0.029324648
10306,77,21718,10,4,0,0,0,14,5,3,8,3,0,19,nowin,loss,beat,dlwin,0,10,14,200,0.455,0.04,0.62,3,0.916252116
10307,110,21718,10,3,0,0,0,13,5,3,8,3,0,19,nowin,loss,beat,dlwin,0,10,13,192,0.416666667,0.046875,0.557291667,0,0.025413132
10308,107,21719,9,10,0,0,0,19,10,8,0,0,0,18,nowin,win,plwin,beat,20,0,19,218,0.444954128,0.073394495,0.600917431,2,0.605210014
10309,149,21719,5,10,0,5,0,20,10,8,0,0,0,18,nowin,win,plwin,beat,20,0,15,225,0.457777778,0.057777778,0.648888889,2,0.651965595
10310,104,21719,10,10,0,0,0,20,10,8,0,0,0,18,nowin,win,plwin,beat,20,0,20,209,0.363636364,0.052631579,0.593301435,0,0.018359419
10311,8,21719,10,7,0,0,0,17,10,8,0,0,0,18,nowin,loss,beat,dlwin,0,10,17,181,0.44198895,0.071823204,0.596685083,2,0.599438402
10312,118,21719,10,4,0,8,0,22,10,8,0,0,0,18,nowin,loss,bust,plbust,0,10,14,216,0.393518519,0.037037037,0.555555556,0,0.018059873
10313,110,21719,7,10,0,0,0,17,10,8,0,0,0,18,nowin,loss,beat,dlwin,0,10,17,192,0.416666667,0.046875,0.557291667,0,0.025413132
10314,148,21720,10,8,0,0,0,18,2,6,4,1,9,22,nowin,win,dlbust,bust,20,0,18,204,0.401960784,0.078431373,0.593137255,0,0.029789521
10315,121,21720,3,10,0,0,0,13,2,6,4,1,9,22,nowin,win,dlbust,bust,20,0,13,195,0.456410256,0.025641026,0.512820513,1,0.288597791
10316,109,21720,9,2,3,0,0,14,2,6,4,1,9,22,nowin,win,dlbust,bust,20,0,11,221,0.461538462,0.058823529,0.597285068,3,0.901830309
10317,144,21720,3,5,6,0,0,14,2,6,4,1,9,22,nowin,win,dlbust,bust,20,0,8,202,0.386138614,0.054455446,0.564356436,0,0.018006244
10318,23,21720,4,3,11,0,0,18,2,6,4,1,9,22,nowin,win,dlbust,bust,20,0,7,208,0.427884615,0.0625,0.552884615,1,0.29114424
10319,56,21720,10,3,0,0,0,13,2,6,4,1,9,22,nowin,win,dlbust,bust,20,0,13,175,0.4,0.057142857,0.582857143,0,0.026685297
10320,63,21721,5,3,10,0,0,18,7,10,0,0,0,17,nowin,win,plwin,beat,20,0,8,216,0.467592593,0.037037037,0.62037037,3,0.931690496
10321,50,21721,10,5,0,6,0,21,7,10,0,0,0,17,nowin,win,plwin,beat,20,0,15,202,0.405940594,0.04950495,0.54950495,0,0.020296079
10322,51,21721,3,4,9,10,0,26,7,10,0,0,0,17,nowin,loss,bust,plbust,0,10,7,189,0.529100529,0.068783069,0.608465608,3,0.993665715
10323,74,21721,2,10,0,9,0,21,7,10,0,0,0,17,nowin,win,plwin,beat,20,0,12,209,0.411483254,0.04784689,0.531100478,0,0.017448125
10324,60,21721,10,10,0,0,0,20,7,10,0,0,0,17,nowin,win,plwin,beat,20,0,20,227,0.418502203,0.022026432,0.559471366,0,0.026496258
10325,17,21721,9,10,0,0,0,19,7,10,0,0,0,17,nowin,win,plwin,beat,20,0,19,171,0.444444444,0.070175439,0.555555556,1,0.302364894
10326,8,21722,1,6,9,10,0,26,1,3,9,4,0,17,nowin,loss,bust,plbust,0,10,7,181,0.44198895,0.071823204,0.596685083,2,0.599438402
10327,23,21722,9,10,0,0,0,19,1,3,9,4,0,17,nowin,win,plwin,beat,20,0,19,208,0.427884615,0.0625,0.552884615,1,0.29114424
10328,2,21722,4,10,0,4,0,18,1,3,9,4,0,17,nowin,win,plwin,beat,20,0,14,200,0.445,0.035,0.64,2,0.633962549
10329,72,21722,3,9,0,10,0,22,1,3,9,4,0,17,nowin,loss,bust,plbust,0,10,12,185,0.394594595,0.032432432,0.508108108,0,0.006763115
10330,22,21722,3,10,0,7,0,20,1,3,9,4,0,17,nowin,win,plwin,beat,20,0,13,187,0.481283422,0.042780749,0.577540107,3,0.906128176
10331,88,21722,8,10,0,0,0,18,1,3,9,4,0,17,nowin,win,plwin,beat,20,0,18,206,0.466019417,0.033980583,0.54368932,1,0.309467903
10332,117,21723,10,10,0,0,0,20,3,1,8,6,0,18,nowin,win,plwin,beat,20,0,20,173,0.410404624,0.069364162,0.606936416,2,0.578610282
10333,84,21723,10,6,0,0,0,16,3,1,8,6,0,18,nowin,loss,beat,dlwin,0,10,16,195,0.379487179,0.056410256,0.569230769,0,0.017209119
10334,97,21723,6,4,10,0,0,20,3,1,8,6,0,18,nowin,win,plwin,beat,20,0,10,182,0.450549451,0.06043956,0.692307692,2,0.677372279
10335,108,21723,5,4,10,0,0,19,3,1,8,6,0,18,nowin,win,plwin,beat,20,0,9,193,0.435233161,0.056994819,0.559585492,1,0.298824795
10336,51,21723,6,7,0,0,0,13,3,1,8,6,0,18,nowin,loss,beat,dlwin,0,10,13,189,0.529100529,0.068783069,0.608465608,3,0.993665715
10337,128,21723,4,4,6,0,0,14,3,1,8,6,0,18,nowin,loss,beat,dlwin,0,10,8,227,0.356828194,0.052863436,0.577092511,0,0.012352564
10338,120,21724,10,2,0,0,0,12,6,3,9,0,0,18,nowin,loss,beat,dlwin,0,10,12,202,0.440594059,0.034653465,0.618811881,2,0.614441029
10339,87,21724,1,3,10,0,0,14,6,3,9,0,0,18,nowin,loss,beat,dlwin,0,10,4,202,0.405940594,0.054455446,0.628712871,2,0.590599801
10340,146,21724,6,7,0,0,0,13,6,3,9,0,0,18,nowin,loss,beat,dlwin,0,10,13,221,0.43438914,0.040723982,0.542986425,1,0.290190091
10341,47,21724,10,11,0,0,0,21,6,3,9,0,0,18,win,win,plwin,beat,25,0,21,210,0.438095238,0.057142857,0.623809524,2,0.615868808
10342,71,21724,2,5,10,0,0,17,6,3,9,0,0,18,nowin,loss,beat,dlwin,0,10,7,193,0.352331606,0.046632124,0.585492228,0,0.013063661
10343,53,21724,4,10,0,0,0,14,6,3,9,0,0,18,nowin,loss,beat,dlwin,0,10,14,250,0.372,0.064,0.564,0,0.013687345
10344,79,21725,5,8,0,8,0,21,7,2,10,0,0,19,nowin,win,plwin,beat,20,0,13,211,0.436018957,0.028436019,0.672985782,2,0.650131054
10345,37,21725,9,4,0,7,0,20,7,2,10,0,0,19,nowin,win,plwin,beat,20,0,13,208,0.394230769,0.038461538,0.581730769,0,0.024682772
10346,91,21725,10,8,0,0,0,18,7,2,10,0,0,19,nowin,loss,beat,dlwin,0,10,18,194,0.417525773,0.046391753,0.515463918,1,0.266616552
10347,1,21725,10,11,0,0,0,21,7,2,10,0,0,19,win,win,plwin,beat,25,0,21,197,0.406091371,0.025380711,0.649746193,2,0.606186955
10348,140,21725,10,10,0,0,0,20,7,2,10,0,0,19,nowin,win,plwin,beat,20,0,20,210,0.466666667,0.023809524,0.604761905,3,0.915293335
10349,86,21725,7,2,7,7,0,23,7,2,10,0,0,19,nowin,loss,bust,plbust,0,10,9,196,0.454081633,0.040816327,0.591836735,3,0.887566443
10350,36,21726,10,10,0,0,0,20,4,11,4,0,0,19,nowin,win,plwin,beat,20,0,20,229,0.445414847,0.056768559,0.655021834,2,0.645370571
10351,11,21726,10,9,0,0,0,19,4,11,4,0,0,19,nowin,push,push,push,10,0,19,236,0.457627119,0.016949153,0.588983051,3,0.889015813
10352,98,21726,9,9,0,0,0,18,4,11,4,0,0,19,nowin,loss,beat,dlwin,0,10,18,220,0.422727273,0.054545455,0.55,1,0.28664435
10353,113,21726,10,11,0,0,0,21,4,11,4,0,0,19,win,win,plwin,beat,25,0,21,199,0.407035176,0.055276382,0.668341709,2,0.620695264
10354,33,21726,7,10,0,0,0,17,4,11,4,0,0,19,nowin,loss,beat,dlwin,0,10,17,192,0.4375,0.057291667,0.625,2,0.616208916
10355,90,21726,11,10,0,0,0,21,4,11,4,0,0,19,win,win,plwin,beat,25,0,21,201,0.447761194,0.049751244,0.60199005,3,0.889945023
10356,60,21727,10,9,0,0,0,19,10,4,2,5,0,21,nowin,loss,beat,dlwin,0,10,19,227,0.418502203,0.022026432,0.559471366,0,0.026496258
10357,8,21727,5,7,0,3,9,24,10,4,2,5,0,21,nowin,loss,bust,plbust,0,10,12,181,0.44198895,0.071823204,0.596685083,2,0.599438402
10358,115,21727,9,8,0,0,0,17,10,4,2,5,0,21,nowin,loss,beat,dlwin,0,10,17,194,0.427835052,0.041237113,0.592783505,2,0.583863602
10359,104,21727,2,3,10,10,0,25,10,4,2,5,0,21,nowin,loss,bust,plbust,0,10,5,209,0.363636364,0.052631579,0.593301435,0,0.018359419
10360,62,21727,7,8,0,10,0,25,10,4,2,5,0,21,nowin,loss,bust,plbust,0,10,15,178,0.370786517,0.028089888,0.54494382,0,0.008657722
10361,40,21727,2,6,5,3,4,20,10,4,2,5,0,21,nowin,loss,beat,dlwin,0,10,8,196,0.367346939,0.030612245,0.617346939,0,0.025358183
10362,93,21728,4,11,3,0,0,18,2,3,4,2,10,21,nowin,loss,beat,dlwin,0,10,15,175,0.485714286,0.051428571,0.548571429,1,0.323648091
10363,40,21728,4,7,5,0,0,16,2,3,4,2,10,21,nowin,loss,beat,dlwin,0,10,11,196,0.367346939,0.030612245,0.617346939,0,0.025358183
10364,67,21728,6,4,10,0,0,20,2,3,4,2,10,21,nowin,loss,beat,dlwin,0,10,10,195,0.369230769,0.041025641,0.569230769,0,0.014139427
10365,98,21728,10,3,0,0,0,13,2,3,4,2,10,21,nowin,loss,beat,dlwin,0,10,13,220,0.422727273,0.054545455,0.55,1,0.28664435
10366,37,21728,7,2,9,0,0,18,2,3,4,2,10,21,nowin,loss,beat,dlwin,0,10,9,208,0.394230769,0.038461538,0.581730769,0,0.024682772
10367,29,21728,5,9,0,0,0,14,2,3,4,2,10,21,nowin,loss,beat,dlwin,0,10,14,189,0.44973545,0.058201058,0.544973545,1,0.300349439
10368,27,21729,3,10,0,10,0,23,10,2,10,0,0,22,nowin,loss,bust,plbust,0,10,13,178,0.370786517,0.016853933,0.573033708,0,0.015536309
10369,63,21729,10,8,0,0,0,18,10,2,10,0,0,22,nowin,win,dlbust,bust,20,0,18,216,0.467592593,0.037037037,0.62037037,3,0.931690496
10370,69,21729,10,2,0,10,0,22,10,2,10,0,0,22,nowin,loss,bust,plbust,0,10,12,194,0.365979381,0.030927835,0.515463918,0,0
10371,62,21729,10,7,0,0,0,17,10,2,10,0,0,22,nowin,win,dlbust,bust,20,0,17,178,0.370786517,0.028089888,0.54494382,0,0.008657722
10372,148,21729,4,10,0,10,0,24,10,2,10,0,0,22,nowin,loss,bust,plbust,0,10,14,204,0.401960784,0.078431373,0.593137255,0,0.029789521
10373,139,21729,10,7,0,0,0,17,10,2,10,0,0,22,nowin,win,dlbust,bust,20,0,17,192,0.380208333,0.036458333,0.59375,0,0.023429169
10374,5,21730,1,2,9,10,0,22,2,8,11,0,0,21,nowin,loss,bust,plbust,0,10,3,203,0.42364532,0.02955665,0.596059113,2,0.582508076
10375,84,21730,3,2,10,0,0,15,2,8,11,0,0,21,nowin,loss,beat,dlwin,0,10,5,195,0.379487179,0.056410256,0.569230769,0,0.017209119
10376,60,21730,6,10,0,0,0,16,2,8,11,0,0,21,nowin,loss,beat,dlwin,0,10,16,227,0.418502203,0.022026432,0.559471366,0,0.026496258
10377,61,21730,7,2,8,0,0,17,2,8,11,0,0,21,nowin,loss,beat,dlwin,0,10,9,194,0.427835052,0.077319588,0.603092784,2,0.591437139
10378,47,21730,3,2,10,0,0,15,2,8,11,0,0,21,nowin,loss,beat,dlwin,0,10,5,210,0.438095238,0.057142857,0.623809524,2,0.615868808
10379,98,21730,4,7,1,10,0,22,2,8,11,0,0,21,nowin,loss,bust,plbust,0,10,11,220,0.422727273,0.054545455,0.55,1,0.28664435
10380,58,21731,10,7,0,0,0,17,4,10,1,10,0,25,nowin,win,dlbust,bust,20,0,17,195,0.430769231,0.041025641,0.584615385,2,0.580497586
10381,117,21731,2,8,11,0,0,21,4,10,1,10,0,25,nowin,win,dlbust,bust,20,0,10,173,0.410404624,0.069364162,0.606936416,2,0.578610282
10382,9,21731,5,2,6,0,0,13,4,10,1,10,0,25,nowin,win,dlbust,bust,20,0,7,194,0.37628866,0.015463918,0.541237113,0,0.009396796
10383,44,21731,3,10,0,0,0,13,4,10,1,10,0,25,nowin,win,dlbust,bust,20,0,13,219,0.433789954,0.050228311,0.534246575,1,0.285551035
10384,4,21731,10,10,0,0,0,20,4,10,1,10,0,25,nowin,win,dlbust,bust,20,0,20,217,0.460829493,0.036866359,0.562211982,1,0.315432839
10385,49,21731,10,5,0,0,0,15,4,10,1,10,0,25,nowin,win,dlbust,bust,20,0,15,207,0.396135266,0.053140097,0.594202899,0,0.028306925
10386,10,21732,10,11,0,0,0,21,9,10,0,0,0,19,win,win,plwin,beat,25,0,21,191,0.413612565,0.057591623,0.596858639,2,0.574087175
10387,73,21732,10,9,0,0,0,19,9,10,0,0,0,19,nowin,push,push,push,10,0,19,181,0.375690608,0.011049724,0.596685083,0,0.022795773
10388,98,21732,3,4,3,5,10,25,9,10,0,0,0,19,nowin,loss,bust,plbust,0,10,7,220,0.422727273,0.054545455,0.55,1,0.28664435
10389,93,21732,8,7,0,1,1,17,9,10,0,0,0,19,nowin,loss,beat,dlwin,0,10,15,175,0.485714286,0.051428571,0.548571429,1,0.323648091
10390,78,21732,4,4,8,1,0,17,9,10,0,0,0,19,nowin,loss,beat,dlwin,0,10,8,201,0.517412935,0.034825871,0.587064677,3,0.95871112
10391,92,21732,8,10,0,0,0,18,9,10,0,0,0,19,nowin,loss,beat,dlwin,0,10,18,186,0.446236559,0.059139785,0.564516129,1,0.307826125
10392,138,21733,10,10,0,0,0,20,9,7,4,0,0,20,nowin,push,push,push,10,0,20,190,0.442105263,0.047368421,0.610526316,2,0.609711065
10393,67,21733,8,10,0,0,0,18,9,7,4,0,0,20,nowin,loss,beat,dlwin,0,10,18,195,0.369230769,0.041025641,0.569230769,0,0.014139427
10394,109,21733,3,4,7,6,0,20,9,7,4,0,0,20,nowin,push,push,push,10,0,7,221,0.461538462,0.058823529,0.597285068,3,0.901830309
10395,65,21733,10,10,0,0,0,20,9,7,4,0,0,20,nowin,push,push,push,10,0,20,203,0.492610837,0.054187192,0.571428571,3,0.913702814
10396,124,21733,10,11,0,0,0,21,9,7,4,0,0,20,win,win,plwin,beat,25,0,21,202,0.47029703,0.064356436,0.584158416,3,0.899458193
10397,129,21733,10,2,0,3,6,21,9,7,4,0,0,20,nowin,win,plwin,beat,20,0,12,201,0.422885572,0.064676617,0.55721393,0,0.027255383
10398,88,21734,7,10,0,0,0,17,10,11,0,0,0,21,nowin,loss,beat,dlwin,0,10,17,206,0.466019417,0.033980583,0.54368932,1,0.309467903
10399,117,21734,8,11,0,0,0,19,10,11,0,0,0,21,nowin,loss,beat,dlwin,0,10,19,173,0.410404624,0.069364162,0.606936416,2,0.578610282
10400,18,21734,10,6,0,8,0,24,10,11,0,0,0,21,nowin,loss,bust,plbust,0,10,16,182,0.461538462,0.043956044,0.587912088,3,0.892649374
10401,36,21734,6,1,10,0,0,17,10,11,0,0,0,21,nowin,loss,beat,dlwin,0,10,7,229,0.445414847,0.056768559,0.655021834,2,0.645370571
10402,18,21734,10,6,0,1,0,17,10,11,0,0,0,21,nowin,loss,beat,dlwin,0,10,16,182,0.461538462,0.043956044,0.587912088,3,0.892649374
10403,66,21734,2,3,6,10,0,21,10,11,0,0,0,21,nowin,push,push,push,10,0,5,217,0.456221198,0.064516129,0.626728111,3,0.924304367
10404,35,21735,6,8,0,9,0,23,10,2,10,0,0,22,nowin,loss,bust,plbust,0,10,14,202,0.410891089,0.044554455,0.633663366,2,0.598681573
10405,52,21735,4,5,10,0,0,19,10,2,10,0,0,22,nowin,win,dlbust,bust,20,0,9,217,0.414746544,0.02764977,0.599078341,2,0.576736024
10406,133,21735,5,10,0,5,0,20,10,2,10,0,0,22,nowin,win,dlbust,bust,20,0,15,201,0.47761194,0.064676617,0.611940299,3,0.935428111
10407,146,21735,11,7,0,0,0,18,10,2,10,0,0,22,nowin,win,dlbust,bust,20,0,18,221,0.43438914,0.040723982,0.542986425,1,0.290190091
10408,124,21735,8,7,0,5,0,20,10,2,10,0,0,22,nowin,win,dlbust,bust,20,0,15,202,0.47029703,0.064356436,0.584158416,3,0.899458193
10409,90,21735,10,8,0,0,0,18,10,2,10,0,0,22,nowin,win,dlbust,bust,20,0,18,201,0.447761194,0.049751244,0.60199005,3,0.889945023
10410,14,21736,5,5,10,0,0,20,2,4,6,10,0,22,nowin,win,dlbust,bust,20,0,10,202,0.391089109,0.01980198,0.628712871,2,0.577264877
10411,142,21736,3,1,9,0,0,13,2,4,6,10,0,22,nowin,win,dlbust,bust,20,0,4,211,0.417061611,0.047393365,0.526066351,1,0.271531309
10412,80,21736,11,10,0,0,0,21,2,4,6,10,0,22,win,win,dlbust,bust,25,0,21,186,0.419354839,0.059139785,0.623655914,2,0.59892924
10413,124,21736,6,10,0,0,0,16,2,4,6,10,0,22,nowin,win,dlbust,bust,20,0,16,202,0.47029703,0.064356436,0.584158416,3,0.899458193
10414,136,21736,7,10,0,0,0,17,2,4,6,10,0,22,nowin,win,dlbust,bust,20,0,17,194,0.396907216,0.025773196,0.597938144,0,0.029452644
10415,130,21736,10,11,0,0,0,21,2,4,6,10,0,22,win,win,dlbust,bust,25,0,21,219,0.410958904,0.03652968,0.566210046,0,0.025888739
10416,67,21737,1,3,10,4,0,18,10,5,4,0,0,19,nowin,loss,beat,dlwin,0,10,4,195,0.369230769,0.041025641,0.569230769,0,0.014139427
10417,82,21737,10,7,0,0,0,17,10,5,4,0,0,19,nowin,loss,beat,dlwin,0,10,17,225,0.408888889,0.075555556,0.577777778,0,0.028101874
10418,20,21737,3,5,8,6,0,22,10,5,4,0,0,19,nowin,loss,bust,plbust,0,10,8,186,0.456989247,0.037634409,0.537634409,1,0.301097108
10419,23,21737,10,7,0,0,0,17,10,5,4,0,0,19,nowin,loss,beat,dlwin,0,10,17,208,0.427884615,0.0625,0.552884615,1,0.29114424
10420,79,21737,10,10,0,0,0,20,10,5,4,0,0,19,nowin,win,plwin,beat,20,0,20,211,0.436018957,0.028436019,0.672985782,2,0.650131054
10421,47,21737,11,5,4,0,0,20,10,5,4,0,0,19,nowin,win,plwin,beat,20,0,16,210,0.438095238,0.057142857,0.623809524,2,0.615868808
10422,57,21738,9,9,0,0,0,18,11,2,6,0,0,19,nowin,loss,beat,dlwin,0,10,18,192,0.46875,0.052083333,0.59375,3,0.907001181
10423,91,21738,6,8,0,5,0,19,11,2,6,0,0,19,nowin,push,push,push,10,0,14,194,0.417525773,0.046391753,0.515463918,1,0.266616552
10424,47,21738,5,8,0,7,0,20,11,2,6,0,0,19,nowin,win,plwin,beat,20,0,13,210,0.438095238,0.057142857,0.623809524,2,0.615868808
10425,47,21738,11,10,0,0,0,21,11,2,6,0,0,19,win,win,plwin,beat,25,0,21,210,0.438095238,0.057142857,0.623809524,2,0.615868808
10426,19,21738,10,3,0,7,0,20,11,2,6,0,0,19,nowin,win,plwin,beat,20,0,13,237,0.41350211,0.054852321,0.628691983,2,0.597373826
10427,19,21738,4,5,5,1,9,24,11,2,6,0,0,19,nowin,loss,bust,plbust,0,10,9,237,0.41350211,0.054852321,0.628691983,2,0.597373826
10428,92,21739,11,6,2,0,0,19,8,11,0,0,0,19,nowin,push,push,push,10,0,17,186,0.446236559,0.059139785,0.564516129,1,0.307826125
10429,78,21739,7,9,0,9,0,25,8,11,0,0,0,19,nowin,loss,bust,plbust,0,10,16,201,0.517412935,0.034825871,0.587064677,3,0.95871112
10430,64,21739,8,10,0,0,0,18,8,11,0,0,0,19,nowin,loss,beat,dlwin,0,10,18,187,0.363636364,0.048128342,0.631016043,0,0.027594885
10431,54,21739,1,5,8,7,0,21,8,11,0,0,0,19,nowin,win,plwin,beat,20,0,6,185,0.437837838,0.032432432,0.556756757,1,0.29899854
10432,4,21739,9,10,0,0,0,19,8,11,0,0,0,19,nowin,push,push,push,10,0,19,217,0.460829493,0.036866359,0.562211982,1,0.315432839
10433,56,21739,3,7,10,0,0,20,8,11,0,0,0,19,nowin,win,plwin,beat,20,0,10,175,0.4,0.057142857,0.582857143,0,0.026685297
10434,14,21740,8,4,0,4,5,21,10,8,0,0,0,18,nowin,win,plwin,beat,20,0,12,202,0.391089109,0.01980198,0.628712871,2,0.577264877
10435,149,21740,5,4,8,0,0,17,10,8,0,0,0,18,nowin,loss,beat,dlwin,0,10,9,225,0.457777778,0.057777778,0.648888889,2,0.651965595
10436,128,21740,2,10,0,10,0,22,10,8,0,0,0,18,nowin,loss,bust,plbust,0,10,12,227,0.356828194,0.052863436,0.577092511,0,0.012352564
10437,14,21740,9,8,0,0,0,17,10,8,0,0,0,18,nowin,loss,beat,dlwin,0,10,17,202,0.391089109,0.01980198,0.628712871,2,0.577264877
10438,148,21740,2,8,8,0,0,18,10,8,0,0,0,18,nowin,push,push,push,10,0,10,204,0.401960784,0.078431373,0.593137255,0,0.029789521
10439,62,21740,2,8,6,4,0,20,10,8,0,0,0,18,nowin,win,plwin,beat,20,0,10,178,0.370786517,0.028089888,0.54494382,0,0.008657722
10440,40,21741,4,10,0,2,10,26,10,8,0,0,0,18,nowin,loss,bust,plbust,0,10,14,196,0.367346939,0.030612245,0.617346939,0,0.025358183
10441,62,21741,7,8,0,5,0,20,10,8,0,0,0,18,nowin,win,plwin,beat,20,0,15,178,0.370786517,0.028089888,0.54494382,0,0.008657722
10442,124,21741,10,10,0,0,0,20,10,8,0,0,0,18,nowin,win,plwin,beat,20,0,20,202,0.47029703,0.064356436,0.584158416,3,0.899458193
10443,21,21741,2,10,0,5,0,17,10,8,0,0,0,18,nowin,loss,beat,dlwin,0,10,12,214,0.359813084,0.042056075,0.626168224,0,0.025263474
10444,120,21741,10,10,0,0,0,20,10,8,0,0,0,18,nowin,win,plwin,beat,20,0,20,202,0.440594059,0.034653465,0.618811881,2,0.614441029
10445,2,21741,7,9,0,10,0,26,10,8,0,0,0,18,nowin,loss,bust,plbust,0,10,16,200,0.445,0.035,0.64,2,0.633962549
10446,29,21742,2,10,0,4,0,16,3,3,2,5,6,19,nowin,loss,beat,dlwin,0,10,12,189,0.44973545,0.058201058,0.544973545,1,0.300349439
10447,129,21742,5,7,0,10,0,22,3,3,2,5,6,19,nowin,loss,bust,plbust,0,10,12,201,0.422885572,0.064676617,0.55721393,0,0.027255383
10448,115,21742,9,9,0,0,0,18,3,3,2,5,6,19,nowin,loss,beat,dlwin,0,10,18,194,0.427835052,0.041237113,0.592783505,2,0.583863602
10449,26,21742,10,2,0,10,0,22,3,3,2,5,6,19,nowin,loss,bust,plbust,0,10,12,203,0.463054187,0.0591133,0.541871921,1,0.306802864
10450,76,21742,2,7,3,3,0,15,3,3,2,5,6,19,nowin,loss,beat,dlwin,0,10,9,189,0.534391534,0.079365079,0.608465608,3,1
10451,119,21742,9,7,0,0,0,16,3,3,2,5,6,19,nowin,loss,beat,dlwin,0,10,16,190,0.405263158,0.068421053,0.515789474,0,0.011837158
10452,61,21743,2,7,9,0,0,18,10,2,10,0,0,22,nowin,win,dlbust,bust,20,0,9,194,0.427835052,0.077319588,0.603092784,2,0.591437139
10453,108,21743,10,9,0,0,0,19,10,2,10,0,0,22,nowin,win,dlbust,bust,20,0,19,193,0.435233161,0.056994819,0.559585492,1,0.298824795
10454,148,21743,10,8,0,0,0,18,10,2,10,0,0,22,nowin,win,dlbust,bust,20,0,18,204,0.401960784,0.078431373,0.593137255,0,0.029789521
10455,50,21743,11,10,0,0,0,21,10,2,10,0,0,22,win,win,dlbust,bust,25,0,21,202,0.405940594,0.04950495,0.54950495,0,0.020296079
10456,90,21743,6,10,0,2,0,18,10,2,10,0,0,22,nowin,win,dlbust,bust,20,0,16,201,0.447761194,0.049751244,0.60199005,3,0.889945023
10457,64,21743,9,6,0,5,0,20,10,2,10,0,0,22,nowin,win,dlbust,bust,20,0,15,187,0.363636364,0.048128342,0.631016043,0,0.027594885
10458,140,21744,10,3,0,0,0,13,4,10,2,6,0,22,nowin,win,dlbust,bust,20,0,13,210,0.466666667,0.023809524,0.604761905,3,0.915293335
10459,28,21744,2,10,0,0,0,12,4,10,2,6,0,22,nowin,win,dlbust,bust,20,0,12,199,0.422110553,0.045226131,0.542713568,1,0.282706618
10460,51,21744,10,10,0,0,0,20,4,10,2,6,0,22,nowin,win,dlbust,bust,20,0,20,189,0.529100529,0.068783069,0.608465608,3,0.993665715
10461,84,21744,6,7,0,0,0,13,4,10,2,6,0,22,nowin,win,dlbust,bust,20,0,13,195,0.379487179,0.056410256,0.569230769,0,0.017209119
10462,81,21744,10,9,0,0,0,19,4,10,2,6,0,22,nowin,win,dlbust,bust,20,0,19,182,0.395604396,0.043956044,0.60989011,2,0.567491261
10463,108,21744,10,4,0,0,0,14,4,10,2,6,0,22,nowin,win,dlbust,bust,20,0,14,193,0.435233161,0.056994819,0.559585492,1,0.298824795
10464,73,21745,10,8,0,0,0,18,10,6,10,0,0,26,nowin,win,dlbust,bust,20,0,18,181,0.375690608,0.011049724,0.596685083,0,0.022795773
10465,118,21745,11,10,0,0,0,21,10,6,10,0,0,26,win,win,dlbust,bust,25,0,21,216,0.393518519,0.037037037,0.555555556,0,0.018059873
10466,86,21745,6,9,0,5,0,20,10,6,10,0,0,26,nowin,win,dlbust,bust,20,0,15,196,0.454081633,0.040816327,0.591836735,3,0.887566443
10467,7,21745,6,5,10,0,0,21,10,6,10,0,0,26,nowin,win,dlbust,bust,20,0,11,183,0.442622951,0.06010929,0.62295082,2,0.619303341
10468,66,21745,10,8,0,0,0,18,10,6,10,0,0,26,nowin,win,dlbust,bust,20,0,18,217,0.456221198,0.064516129,0.626728111,3,0.924304367
10469,138,21745,5,11,2,0,0,18,10,6,10,0,0,26,nowin,win,dlbust,bust,20,0,16,190,0.442105263,0.047368421,0.610526316,2,0.609711065
10470,55,21746,5,10,0,0,0,15,3,6,10,0,0,19,nowin,loss,beat,dlwin,0,10,15,191,0.371727749,0.057591623,0.54973822,0,0.01011347
10471,113,21746,2,10,0,3,0,15,3,6,10,0,0,19,nowin,loss,beat,dlwin,0,10,12,199,0.407035176,0.055276382,0.668341709,2,0.620695264
10472,5,21746,4,10,0,0,0,14,3,6,10,0,0,19,nowin,loss,beat,dlwin,0,10,14,203,0.42364532,0.02955665,0.596059113,2,0.582508076
10473,28,21746,7,10,0,0,0,17,3,6,10,0,0,19,nowin,loss,beat,dlwin,0,10,17,199,0.422110553,0.045226131,0.542713568,1,0.282706618
10474,3,21746,10,10,0,0,0,20,3,6,10,0,0,19,nowin,win,plwin,beat,20,0,20,190,0.431578947,0.026315789,0.542105263,1,0.288076384
10475,13,21746,10,10,0,0,0,20,3,6,10,0,0,19,nowin,win,plwin,beat,20,0,20,206,0.417475728,0.063106796,0.621359223,2,0.59555479
10476,81,21747,1,4,10,0,0,15,3,10,3,10,0,26,nowin,win,dlbust,bust,20,0,5,182,0.395604396,0.043956044,0.60989011,2,0.567491261
10477,99,21747,2,3,5,6,0,16,3,10,3,10,0,26,nowin,win,dlbust,bust,20,0,5,207,0.47826087,0.062801932,0.637681159,3,0.961418446
10478,20,21747,6,7,0,0,0,13,3,10,3,10,0,26,nowin,win,dlbust,bust,20,0,13,186,0.456989247,0.037634409,0.537634409,1,0.301097108
10479,130,21747,5,6,10,0,0,21,3,10,3,10,0,26,nowin,win,dlbust,bust,20,0,11,219,0.410958904,0.03652968,0.566210046,0,0.025888739
10480,128,21747,3,9,0,2,0,14,3,10,3,10,0,26,nowin,win,dlbust,bust,20,0,12,227,0.356828194,0.052863436,0.577092511,0,0.012352564
10481,86,21747,6,6,0,2,0,14,3,10,3,10,0,26,nowin,win,dlbust,bust,20,0,12,196,0.454081633,0.040816327,0.591836735,3,0.887566443
10482,68,21748,3,2,10,4,0,19,10,2,7,0,0,19,nowin,push,push,push,10,0,5,205,0.434146341,0.029268293,0.6,2,0.59483189
10483,112,21748,4,10,0,5,0,19,10,2,7,0,0,19,nowin,push,push,push,10,0,14,203,0.448275862,0.054187192,0.600985222,3,0.889576933
10484,68,21748,5,3,2,10,0,20,10,2,7,0,0,19,nowin,win,plwin,beat,20,0,8,205,0.434146341,0.029268293,0.6,2,0.59483189
10485,81,21748,10,8,0,0,0,18,10,2,7,0,0,19,nowin,loss,beat,dlwin,0,10,18,182,0.395604396,0.043956044,0.60989011,2,0.567491261
10486,78,21748,4,3,8,6,0,21,10,2,7,0,0,19,nowin,win,plwin,beat,20,0,7,201,0.517412935,0.034825871,0.587064677,3,0.95871112
10487,50,21748,3,1,9,9,0,22,10,2,7,0,0,19,nowin,loss,bust,plbust,0,10,4,202,0.405940594,0.04950495,0.54950495,0,0.020296079
10488,78,21749,9,8,0,0,0,17,4,9,10,0,0,23,nowin,win,dlbust,bust,20,0,17,201,0.517412935,0.034825871,0.587064677,3,0.95871112
10489,78,21749,10,3,0,0,0,13,4,9,10,0,0,23,nowin,win,dlbust,bust,20,0,13,201,0.517412935,0.034825871,0.587064677,3,0.95871112
10490,127,21749,10,7,0,0,0,17,4,9,10,0,0,23,nowin,win,dlbust,bust,20,0,17,201,0.402985075,0.029850746,0.60199005,0,0.032263937
10491,138,21749,11,6,4,0,0,21,4,9,10,0,0,23,nowin,win,dlbust,bust,20,0,17,190,0.442105263,0.047368421,0.610526316,2,0.609711065
10492,3,21749,10,10,0,0,0,20,4,9,10,0,0,23,nowin,win,dlbust,bust,20,0,20,190,0.431578947,0.026315789,0.542105263,1,0.288076384
10493,87,21749,10,2,0,0,0,12,4,9,10,0,0,23,nowin,win,dlbust,bust,20,0,12,202,0.405940594,0.054455446,0.628712871,2,0.590599801
10494,50,21750,5,10,0,0,0,15,2,2,9,3,4,20,nowin,loss,beat,dlwin,0,10,15,202,0.405940594,0.04950495,0.54950495,0,0.020296079
10495,106,21750,1,1,10,10,0,22,2,2,9,3,4,20,nowin,loss,bust,plbust,0,10,2,192,0.411458333,0.026041667,0.557291667,0,0.023854304
10496,138,21750,2,9,6,0,0,17,2,2,9,3,4,20,nowin,loss,beat,dlwin,0,10,11,190,0.442105263,0.047368421,0.610526316,2,0.609711065
10497,149,21750,6,10,0,0,0,16,2,2,9,3,4,20,nowin,loss,beat,dlwin,0,10,16,225,0.457777778,0.057777778,0.648888889,2,0.651965595
10498,113,21750,9,6,0,0,0,15,2,2,9,3,4,20,nowin,loss,beat,dlwin,0,10,15,199,0.407035176,0.055276382,0.668341709,2,0.620695264
10499,127,21750,3,10,0,0,0,13,2,2,9,3,4,20,nowin,loss,beat,dlwin,0,10,13,201,0.402985075,0.029850746,0.60199005,0,0.032263937
10500,99,21751,11,6,1,0,0,18,5,3,4,10,0,22,nowin,win,dlbust,bust,20,0,17,207,0.47826087,0.062801932,0.637681159,3,0.961418446
10501,11,21751,3,6,3,0,0,12,5,3,4,10,0,22,nowin,win,dlbust,bust,20,0,9,236,0.457627119,0.016949153,0.588983051,3,0.889015813
10502,113,21751,9,8,0,0,0,17,5,3,4,10,0,22,nowin,win,dlbust,bust,20,0,17,199,0.407035176,0.055276382,0.668341709,2,0.620695264
10503,83,21751,3,2,11,0,0,16,5,3,4,10,0,22,nowin,win,dlbust,bust,20,0,5,193,0.424870466,0.051813472,0.678756477,2,0.644360335
10504,110,21751,11,10,0,0,0,21,5,3,4,10,0,22,win,win,dlbust,bust,25,0,21,192,0.416666667,0.046875,0.557291667,0,0.025413132
10505,139,21751,2,2,2,10,0,16,5,3,4,10,0,22,nowin,win,dlbust,bust,20,0,4,192,0.380208333,0.036458333,0.59375,0,0.023429169
10506,101,21752,10,11,0,0,0,21,11,10,0,0,0,21,win,push,push,push,10,0,21,205,0.424390244,0.068292683,0.63902439,2,0.614740646
10507,29,21752,11,8,0,0,0,19,11,10,0,0,0,21,nowin,loss,beat,dlwin,0,10,19,189,0.44973545,0.058201058,0.544973545,1,0.300349439
10508,49,21752,10,11,0,0,0,21,11,10,0,0,0,21,win,push,push,push,10,0,21,207,0.396135266,0.053140097,0.594202899,0,0.028306925
10509,29,21752,2,5,8,3,0,18,11,10,0,0,0,21,nowin,loss,beat,dlwin,0,10,7,189,0.44973545,0.058201058,0.544973545,1,0.300349439
10510,90,21752,7,7,0,6,0,20,11,10,0,0,0,21,nowin,loss,beat,dlwin,0,10,14,201,0.447761194,0.049751244,0.60199005,3,0.889945023
10511,102,21752,7,7,0,5,0,19,11,10,0,0,0,21,nowin,loss,beat,dlwin,0,10,14,192,0.338541667,0.046875,0.5625,0,0.003306118
10512,40,21753,3,11,1,0,0,15,6,5,10,0,0,21,nowin,loss,beat,dlwin,0,10,14,196,0.367346939,0.030612245,0.617346939,0,0.025358183
10513,109,21753,6,3,7,0,0,16,6,5,10,0,0,21,nowin,loss,beat,dlwin,0,10,9,221,0.461538462,0.058823529,0.597285068,3,0.901830309
10514,16,21753,7,2,2,1,0,12,6,5,10,0,0,21,nowin,loss,beat,dlwin,0,10,9,220,0.427272727,0.081818182,0.6,2,0.588660176
10515,100,21753,3,10,0,0,0,13,6,5,10,0,0,21,nowin,loss,beat,dlwin,0,10,13,190,0.452631579,0.036842105,0.594736842,3,0.888671154
10516,147,21753,6,4,11,0,0,21,6,5,10,0,0,21,nowin,push,push,push,10,0,10,205,0.380487805,0.014634146,0.536585366,0,0.00951447
10517,71,21753,9,2,10,0,0,21,6,5,10,0,0,21,nowin,push,push,push,10,0,11,193,0.352331606,0.046632124,0.585492228,0,0.013063661
10518,97,21754,6,5,4,10,0,25,10,2,9,0,0,21,nowin,loss,bust,plbust,0,10,11,182,0.450549451,0.06043956,0.692307692,2,0.677372279
10519,68,21754,9,10,0,0,0,19,10,2,9,0,0,21,nowin,loss,beat,dlwin,0,10,19,205,0.434146341,0.029268293,0.6,2,0.59483189
10520,84,21754,6,2,3,10,0,21,10,2,9,0,0,21,nowin,push,push,push,10,0,8,195,0.379487179,0.056410256,0.569230769,0,0.017209119
10521,13,21754,8,4,0,7,0,19,10,2,9,0,0,21,nowin,loss,beat,dlwin,0,10,12,206,0.417475728,0.063106796,0.621359223,2,0.59555479
10522,9,21754,10,6,0,1,0,17,10,2,9,0,0,21,nowin,loss,beat,dlwin,0,10,16,194,0.37628866,0.015463918,0.541237113,0,0.009396796
10523,143,21754,6,10,0,10,0,26,10,2,9,0,0,21,nowin,loss,bust,plbust,0,10,16,203,0.463054187,0.044334975,0.57635468,3,0.883143365
10524,127,21755,4,10,0,10,0,24,10,11,0,0,0,21,nowin,loss,bust,plbust,0,10,14,201,0.402985075,0.029850746,0.60199005,0,0.032263937
10525,61,21755,7,10,0,0,0,17,10,11,0,0,0,21,nowin,loss,beat,dlwin,0,10,17,194,0.427835052,0.077319588,0.603092784,2,0.591437139
10526,48,21755,10,10,0,0,0,20,10,11,0,0,0,21,nowin,loss,beat,dlwin,0,10,20,203,0.413793103,0.019704433,0.600985222,2,0.577280801
10527,86,21755,3,9,0,7,0,19,10,11,0,0,0,21,nowin,loss,beat,dlwin,0,10,12,196,0.454081633,0.040816327,0.591836735,3,0.887566443
10528,24,21755,7,10,0,0,0,17,10,11,0,0,0,21,nowin,loss,beat,dlwin,0,10,17,207,0.458937198,0.048309179,0.570048309,1,0.318138014
10529,52,21755,9,10,0,0,0,19,10,11,0,0,0,21,nowin,loss,beat,dlwin,0,10,19,217,0.414746544,0.02764977,0.599078341,2,0.576736024
10530,58,21756,2,8,7,0,0,17,2,10,3,4,0,19,nowin,loss,beat,dlwin,0,10,10,195,0.430769231,0.041025641,0.584615385,2,0.580497586
10531,99,21756,5,2,3,2,3,15,2,10,3,4,0,19,nowin,loss,beat,dlwin,0,10,7,207,0.47826087,0.062801932,0.637681159,3,0.961418446
10532,48,21756,8,10,0,0,0,18,2,10,3,4,0,19,nowin,loss,beat,dlwin,0,10,18,203,0.413793103,0.019704433,0.600985222,2,0.577280801
10533,37,21756,3,10,0,0,0,13,2,10,3,4,0,19,nowin,loss,beat,dlwin,0,10,13,208,0.394230769,0.038461538,0.581730769,0,0.024682772
10534,133,21756,10,5,0,0,0,15,2,10,3,4,0,19,nowin,loss,beat,dlwin,0,10,15,201,0.47761194,0.064676617,0.611940299,3,0.935428111
10535,100,21756,8,7,0,0,0,15,2,10,3,4,0,19,nowin,loss,beat,dlwin,0,10,15,190,0.452631579,0.036842105,0.594736842,3,0.888671154
10536,68,21757,2,10,0,3,3,18,10,8,0,0,0,18,nowin,push,push,push,10,0,12,205,0.434146341,0.029268293,0.6,2,0.59483189
10537,146,21757,10,10,0,0,0,20,10,8,0,0,0,18,nowin,win,plwin,beat,20,0,20,221,0.43438914,0.040723982,0.542986425,1,0.290190091
10538,52,21757,10,4,0,7,0,21,10,8,0,0,0,18,nowin,win,plwin,beat,20,0,14,217,0.414746544,0.02764977,0.599078341,2,0.576736024
10539,78,21757,2,3,5,2,2,14,10,8,0,0,0,18,nowin,loss,beat,dlwin,0,10,5,201,0.517412935,0.034825871,0.587064677,3,0.95871112
10540,80,21757,4,8,0,7,0,19,10,8,0,0,0,18,nowin,win,plwin,beat,20,0,12,186,0.419354839,0.059139785,0.623655914,2,0.59892924
10541,147,21757,10,9,0,0,0,19,10,8,0,0,0,18,nowin,win,plwin,beat,20,0,19,205,0.380487805,0.014634146,0.536585366,0,0.00951447
10542,38,21758,10,10,0,0,0,20,11,8,0,0,0,19,nowin,win,plwin,beat,20,0,20,202,0.361386139,0.03960396,0.564356436,0,0.010597953
10543,11,21758,10,7,0,0,0,17,11,8,0,0,0,19,nowin,loss,beat,dlwin,0,10,17,236,0.457627119,0.016949153,0.588983051,3,0.889015813
10544,71,21758,10,3,0,2,8,23,11,8,0,0,0,19,nowin,loss,bust,plbust,0,10,13,193,0.352331606,0.046632124,0.585492228,0,0.013063661
10545,30,21758,5,4,9,0,0,18,11,8,0,0,0,19,nowin,loss,beat,dlwin,0,10,9,206,0.393203883,0.033980583,0.601941748,0,0.029324648
10546,50,21758,10,6,0,6,0,22,11,8,0,0,0,19,nowin,loss,bust,plbust,0,10,16,202,0.405940594,0.04950495,0.54950495,0,0.020296079
10547,126,21758,10,10,0,0,0,20,11,8,0,0,0,19,nowin,win,plwin,beat,20,0,20,188,0.457446809,0.074468085,0.60106383,3,0.900633203
10548,64,21759,2,10,0,2,0,14,3,9,10,0,0,22,nowin,win,dlbust,bust,20,0,12,187,0.363636364,0.048128342,0.631016043,0,0.027594885
10549,74,21759,3,9,0,7,0,19,3,9,10,0,0,22,nowin,win,dlbust,bust,20,0,12,209,0.411483254,0.04784689,0.531100478,0,0.017448125
10550,136,21759,3,6,10,0,0,19,3,9,10,0,0,22,nowin,win,dlbust,bust,20,0,9,194,0.396907216,0.025773196,0.597938144,0,0.029452644
10551,88,21759,10,7,0,0,0,17,3,9,10,0,0,22,nowin,win,dlbust,bust,20,0,17,206,0.466019417,0.033980583,0.54368932,1,0.309467903
10552,94,21759,10,6,0,0,0,16,3,9,10,0,0,22,nowin,win,dlbust,bust,20,0,16,183,0.43715847,0.043715847,0.540983607,1,0.290866892
10553,76,21759,9,10,0,0,0,19,3,9,10,0,0,22,nowin,win,dlbust,bust,20,0,19,189,0.534391534,0.079365079,0.608465608,3,1
10554,27,21760,10,10,0,0,0,20,5,5,2,9,0,21,nowin,loss,beat,dlwin,0,10,20,178,0.370786517,0.016853933,0.573033708,0,0.015536309
10555,56,21760,3,2,6,10,0,21,5,5,2,9,0,21,nowin,push,push,push,10,0,5,175,0.4,0.057142857,0.582857143,0,0.026685297
10556,51,21760,10,10,0,0,0,20,5,5,2,9,0,21,nowin,loss,beat,dlwin,0,10,20,189,0.529100529,0.068783069,0.608465608,3,0.993665715
10557,39,21760,7,11,0,0,0,18,5,5,2,9,0,21,nowin,loss,beat,dlwin,0,10,18,191,0.429319372,0.062827225,0.57591623,0,0.033760763
10558,149,21760,10,10,0,0,0,20,5,5,2,9,0,21,nowin,loss,beat,dlwin,0,10,20,225,0.457777778,0.057777778,0.648888889,2,0.651965595
10559,141,21760,4,8,0,0,0,12,5,5,2,9,0,21,nowin,loss,beat,dlwin,0,10,12,202,0.420792079,0.074257426,0.564356436,0,0.028377851
10560,43,21761,10,4,0,0,0,14,5,7,9,0,0,21,nowin,loss,beat,dlwin,0,10,14,192,0.40625,0.041666667,0.609375,2,0.576671372
10561,41,21761,9,6,0,0,0,15,5,7,9,0,0,21,nowin,loss,beat,dlwin,0,10,15,192,0.364583333,0.036458333,0.520833333,0,0.00089702
10562,142,21761,6,6,0,0,0,12,5,7,9,0,0,21,nowin,loss,beat,dlwin,0,10,12,211,0.417061611,0.047393365,0.526066351,1,0.271531309
10563,120,21761,10,6,0,0,0,16,5,7,9,0,0,21,nowin,loss,beat,dlwin,0,10,16,202,0.440594059,0.034653465,0.618811881,2,0.614441029
10564,35,21761,5,5,2,0,0,12,5,7,9,0,0,21,nowin,loss,beat,dlwin,0,10,10,202,0.410891089,0.044554455,0.633663366,2,0.598681573
10565,22,21761,7,9,0,0,0,16,5,7,9,0,0,21,nowin,loss,beat,dlwin,0,10,16,187,0.481283422,0.042780749,0.577540107,3,0.906128176
10566,33,21762,6,9,0,1,7,23,10,7,0,0,0,17,nowin,loss,bust,plbust,0,10,15,192,0.4375,0.057291667,0.625,2,0.616208916
10567,56,21762,1,3,10,5,0,19,10,7,0,0,0,17,nowin,win,plwin,beat,20,0,4,175,0.4,0.057142857,0.582857143,0,0.026685297
10568,140,21762,10,2,0,8,0,20,10,7,0,0,0,17,nowin,win,plwin,beat,20,0,12,210,0.466666667,0.023809524,0.604761905,3,0.915293335
10569,67,21762,10,10,0,0,0,20,10,7,0,0,0,17,nowin,win,plwin,beat,20,0,20,195,0.369230769,0.041025641,0.569230769,0,0.014139427
10570,127,21762,10,10,0,0,0,20,10,7,0,0,0,17,nowin,win,plwin,beat,20,0,20,201,0.402985075,0.029850746,0.60199005,0,0.032263937
10571,40,21762,2,10,0,6,0,18,10,7,0,0,0,17,nowin,win,plwin,beat,20,0,12,196,0.367346939,0.030612245,0.617346939,0,0.025358183
10572,51,21763,8,5,0,5,0,18,9,10,0,0,0,19,nowin,loss,beat,dlwin,0,10,13,189,0.529100529,0.068783069,0.608465608,3,0.993665715
10573,122,21763,6,11,3,0,0,20,9,10,0,0,0,19,nowin,win,plwin,beat,20,0,17,210,0.347619048,0.052380952,0.59047619,0,0.012873677
10574,90,21763,5,10,0,10,0,25,9,10,0,0,0,19,nowin,loss,bust,plbust,0,10,15,201,0.447761194,0.049751244,0.60199005,3,0.889945023
10575,51,21763,10,11,0,0,0,21,9,10,0,0,0,19,win,win,plwin,beat,25,0,21,189,0.529100529,0.068783069,0.608465608,3,0.993665715
10576,24,21763,10,3,0,5,0,18,9,10,0,0,0,19,nowin,loss,beat,dlwin,0,10,13,207,0.458937198,0.048309179,0.570048309,1,0.318138014
10577,142,21763,5,3,5,5,0,18,9,10,0,0,0,19,nowin,loss,beat,dlwin,0,10,8,211,0.417061611,0.047393365,0.526066351,1,0.271531309
10578,59,21764,10,5,0,0,0,15,3,3,10,7,0,23,nowin,win,dlbust,bust,20,0,15,228,0.429824561,0.048245614,0.543859649,1,0.287885446
10579,22,21764,3,8,3,0,0,14,3,3,10,7,0,23,nowin,win,dlbust,bust,20,0,11,187,0.481283422,0.042780749,0.577540107,3,0.906128176
10580,133,21764,4,4,7,0,0,15,3,3,10,7,0,23,nowin,win,dlbust,bust,20,0,8,201,0.47761194,0.064676617,0.611940299,3,0.935428111
10581,145,21764,8,10,0,0,0,18,3,3,10,7,0,23,nowin,win,dlbust,bust,20,0,18,188,0.441489362,0.031914894,0.622340426,2,0.617837093
10582,90,21764,5,6,10,0,0,21,3,3,10,7,0,23,nowin,win,dlbust,bust,20,0,11,201,0.447761194,0.049751244,0.60199005,3,0.889945023
10583,141,21764,2,9,3,0,0,14,3,3,10,7,0,23,nowin,win,dlbust,bust,20,0,11,202,0.420792079,0.074257426,0.564356436,0,0.028377851
10584,118,21765,8,7,0,0,0,15,3,10,6,0,0,19,nowin,loss,beat,dlwin,0,10,15,216,0.393518519,0.037037037,0.555555556,0,0.018059873
10585,141,21765,6,10,0,0,0,16,3,10,6,0,0,19,nowin,loss,beat,dlwin,0,10,16,202,0.420792079,0.074257426,0.564356436,0,0.028377851
10586,150,21765,5,3,4,10,0,22,3,10,6,0,0,19,nowin,loss,bust,plbust,0,10,8,192,0.401041667,0.036458333,0.567708333,0,0.023287458
10587,92,21765,11,10,0,0,0,21,3,10,6,0,0,19,win,win,plwin,beat,25,0,21,186,0.446236559,0.059139785,0.564516129,1,0.307826125
10588,140,21765,4,3,10,0,0,17,3,10,6,0,0,19,nowin,loss,beat,dlwin,0,10,7,210,0.466666667,0.023809524,0.604761905,3,0.915293335
10589,30,21765,11,10,0,0,0,21,3,10,6,0,0,19,win,win,plwin,beat,25,0,21,206,0.393203883,0.033980583,0.601941748,0,0.029324648
10590,85,21766,10,11,0,0,0,21,7,5,10,0,0,22,win,win,dlbust,bust,25,0,21,195,0.41025641,0.066666667,0.594871795,0,0.03269711
10591,149,21766,3,10,0,8,0,21,7,5,10,0,0,22,nowin,win,dlbust,bust,20,0,13,225,0.457777778,0.057777778,0.648888889,2,0.651965595
10592,12,21766,4,9,0,7,0,20,7,5,10,0,0,22,nowin,win,dlbust,bust,20,0,13,189,0.470899471,0.015873016,0.613756614,3,0.929171178
10593,117,21766,10,3,0,1,10,24,7,5,10,0,0,22,nowin,loss,bust,plbust,0,10,13,173,0.410404624,0.069364162,0.606936416,2,0.578610282
10594,67,21766,4,2,10,7,0,23,7,5,10,0,0,22,nowin,loss,bust,plbust,0,10,6,195,0.369230769,0.041025641,0.569230769,0,0.014139427
10595,26,21766,10,6,0,2,0,18,7,5,10,0,0,22,nowin,win,dlbust,bust,20,0,16,203,0.463054187,0.0591133,0.541871921,1,0.306802864
10596,28,21767,7,10,0,0,0,17,10,6,8,0,0,24,nowin,win,dlbust,bust,20,0,17,199,0.422110553,0.045226131,0.542713568,1,0.282706618
10597,139,21767,7,9,0,7,0,23,10,6,8,0,0,24,nowin,loss,bust,plbust,0,10,16,192,0.380208333,0.036458333,0.59375,0,0.023429169
10598,39,21767,4,8,0,5,0,17,10,6,8,0,0,24,nowin,win,dlbust,bust,20,0,12,191,0.429319372,0.062827225,0.57591623,0,0.033760763
10599,34,21767,1,2,10,10,0,23,10,6,8,0,0,24,nowin,loss,bust,plbust,0,10,3,202,0.5,0.079207921,0.618811881,3,0.968961434
10600,34,21767,2,7,11,0,0,20,10,6,8,0,0,24,nowin,win,dlbust,bust,20,0,9,202,0.5,0.079207921,0.618811881,3,0.968961434
10601,19,21767,3,6,9,0,0,18,10,6,8,0,0,24,nowin,win,dlbust,bust,20,0,9,237,0.41350211,0.054852321,0.628691983,2,0.597373826
10602,12,21768,5,1,9,0,0,15,6,8,3,0,0,17,nowin,loss,beat,dlwin,0,10,6,189,0.470899471,0.015873016,0.613756614,3,0.929171178
10603,43,21768,10,10,0,0,0,20,6,8,3,0,0,17,nowin,win,plwin,beat,20,0,20,192,0.40625,0.041666667,0.609375,2,0.576671372
10604,55,21768,8,3,1,0,0,12,6,8,3,0,0,17,nowin,loss,beat,dlwin,0,10,11,191,0.371727749,0.057591623,0.54973822,0,0.01011347
10605,142,21768,7,7,0,0,0,14,6,8,3,0,0,17,nowin,loss,beat,dlwin,0,10,14,211,0.417061611,0.047393365,0.526066351,1,0.271531309
10606,118,21768,10,3,0,0,0,13,6,8,3,0,0,17,nowin,loss,beat,dlwin,0,10,13,216,0.393518519,0.037037037,0.555555556,0,0.018059873
10607,55,21768,7,3,5,0,0,15,6,8,3,0,0,17,nowin,loss,beat,dlwin,0,10,10,191,0.371727749,0.057591623,0.54973822,0,0.01011347
10608,62,21769,9,4,0,10,0,23,1,4,10,10,0,25,nowin,loss,bust,plbust,0,10,13,178,0.370786517,0.028089888,0.54494382,0,0.008657722
10609,133,21769,10,2,0,8,0,20,1,4,10,10,0,25,nowin,win,dlbust,bust,20,0,12,201,0.47761194,0.064676617,0.611940299,3,0.935428111
10610,124,21769,11,7,0,0,0,18,1,4,10,10,0,25,nowin,win,dlbust,bust,20,0,18,202,0.47029703,0.064356436,0.584158416,3,0.899458193
10611,65,21769,10,7,0,0,0,17,1,4,10,10,0,25,nowin,win,dlbust,bust,20,0,17,203,0.492610837,0.054187192,0.571428571,3,0.913702814
10612,82,21769,4,4,4,5,0,17,1,4,10,10,0,25,nowin,win,dlbust,bust,20,0,8,225,0.408888889,0.075555556,0.577777778,0,0.028101874
10613,53,21769,1,3,9,1,9,23,1,4,10,10,0,25,nowin,loss,bust,plbust,0,10,4,250,0.372,0.064,0.564,0,0.013687345
10614,68,21770,7,8,0,0,0,15,4,1,10,10,0,25,nowin,win,dlbust,bust,20,0,15,205,0.434146341,0.029268293,0.6,2,0.59483189
10615,105,21770,10,4,0,0,0,14,4,1,10,10,0,25,nowin,win,dlbust,bust,20,0,14,198,0.414141414,0.070707071,0.590909091,0,0.032889494
10616,15,21770,5,11,5,0,0,21,4,1,10,10,0,25,nowin,win,dlbust,bust,20,0,16,212,0.410377358,0.051886792,0.561320755,0,0.024517408
10617,29,21770,5,10,0,0,0,15,4,1,10,10,0,25,nowin,win,dlbust,bust,20,0,15,189,0.44973545,0.058201058,0.544973545,1,0.300349439
10618,124,21770,10,5,0,0,0,15,4,1,10,10,0,25,nowin,win,dlbust,bust,20,0,15,202,0.47029703,0.064356436,0.584158416,3,0.899458193
10619,41,21770,10,10,0,0,0,20,4,1,10,10,0,25,nowin,win,dlbust,bust,20,0,20,192,0.364583333,0.036458333,0.520833333,0,0.00089702
10620,83,21771,6,10,0,0,0,16,4,10,8,0,0,22,nowin,win,dlbust,bust,20,0,16,193,0.424870466,0.051813472,0.678756477,2,0.644360335
10621,63,21771,10,6,0,0,0,16,4,10,8,0,0,22,nowin,win,dlbust,bust,20,0,16,216,0.467592593,0.037037037,0.62037037,3,0.931690496
10622,2,21771,11,10,0,0,0,21,4,10,8,0,0,22,win,win,dlbust,bust,25,0,21,200,0.445,0.035,0.64,2,0.633962549
10623,77,21771,11,10,0,0,0,21,4,10,8,0,0,22,win,win,dlbust,bust,25,0,21,200,0.455,0.04,0.62,3,0.916252116
10624,103,21771,10,11,0,0,0,21,4,10,8,0,0,22,win,win,dlbust,bust,25,0,21,203,0.379310345,0.064039409,0.551724138,0,0.012869209
10625,23,21771,10,11,0,0,0,21,4,10,8,0,0,22,win,win,dlbust,bust,25,0,21,208,0.427884615,0.0625,0.552884615,1,0.29114424
10626,85,21772,10,4,0,3,0,17,10,6,8,0,0,24,nowin,win,dlbust,bust,20,0,14,195,0.41025641,0.066666667,0.594871795,0,0.03269711
10627,62,21772,10,10,0,0,0,20,10,6,8,0,0,24,nowin,win,dlbust,bust,20,0,20,178,0.370786517,0.028089888,0.54494382,0,0.008657722
10628,17,21772,10,8,0,0,0,18,10,6,8,0,0,24,nowin,win,dlbust,bust,20,0,18,171,0.444444444,0.070175439,0.555555556,1,0.302364894
10629,105,21772,3,4,10,0,0,17,10,6,8,0,0,24,nowin,win,dlbust,bust,20,0,7,198,0.414141414,0.070707071,0.590909091,0,0.032889494
10630,127,21772,6,10,0,10,0,26,10,6,8,0,0,24,nowin,loss,bust,plbust,0,10,16,201,0.402985075,0.029850746,0.60199005,0,0.032263937
10631,131,21772,8,10,0,0,0,18,10,6,8,0,0,24,nowin,win,dlbust,bust,20,0,18,217,0.410138249,0.069124424,0.543778802,0,0.02015021
10632,144,21773,6,4,11,0,0,21,6,4,10,0,0,20,nowin,win,plwin,beat,20,0,10,202,0.386138614,0.054455446,0.564356436,0,0.018006244
10633,100,21773,10,7,0,0,0,17,6,4,10,0,0,20,nowin,loss,beat,dlwin,0,10,17,190,0.452631579,0.036842105,0.594736842,3,0.888671154
10634,11,21773,10,10,0,0,0,20,6,4,10,0,0,20,nowin,push,push,push,10,0,20,236,0.457627119,0.016949153,0.588983051,3,0.889015813
10635,106,21773,10,8,0,0,0,18,6,4,10,0,0,20,nowin,loss,beat,dlwin,0,10,18,192,0.411458333,0.026041667,0.557291667,0,0.023854304
10636,149,21773,3,5,3,2,0,13,6,4,10,0,0,20,nowin,loss,beat,dlwin,0,10,8,225,0.457777778,0.057777778,0.648888889,2,0.651965595
10637,56,21773,5,6,8,0,0,19,6,4,10,0,0,20,nowin,loss,beat,dlwin,0,10,11,175,0.4,0.057142857,0.582857143,0,0.026685297
10638,81,21774,4,5,2,9,0,20,6,10,5,0,0,21,nowin,loss,beat,dlwin,0,10,9,182,0.395604396,0.043956044,0.60989011,2,0.567491261
10639,12,21774,3,5,6,0,0,14,6,10,5,0,0,21,nowin,loss,beat,dlwin,0,10,8,189,0.470899471,0.015873016,0.613756614,3,0.929171178
10640,96,21774,2,10,0,0,0,12,6,10,5,0,0,21,nowin,loss,beat,dlwin,0,10,12,190,0.468421053,0.057894737,0.584210526,3,0.897263354
10641,25,21774,9,10,0,0,0,19,6,10,5,0,0,21,nowin,loss,beat,dlwin,0,10,19,190,0.463157895,0.063157895,0.536842105,1,0.304401563
10642,114,21774,11,9,0,0,0,20,6,10,5,0,0,21,nowin,loss,beat,dlwin,0,10,20,198,0.47979798,0.025252525,0.611111111,3,0.937232995
10643,43,21774,5,10,0,0,0,15,6,10,5,0,0,21,nowin,loss,beat,dlwin,0,10,15,192,0.40625,0.041666667,0.609375,2,0.576671372
10644,137,21775,10,10,0,0,0,20,10,8,0,0,0,18,nowin,win,plwin,beat,20,0,20,194,0.417525773,0.046391753,0.536082474,1,0.276714602
10645,16,21775,5,4,10,0,0,19,10,8,0,0,0,18,nowin,win,plwin,beat,20,0,9,220,0.427272727,0.081818182,0.6,2,0.588660176
10646,34,21775,3,4,10,0,0,17,10,8,0,0,0,18,nowin,loss,beat,dlwin,0,10,7,202,0.5,0.079207921,0.618811881,3,0.968961434
10647,34,21775,3,9,0,2,4,18,10,8,0,0,0,18,nowin,push,push,push,10,0,12,202,0.5,0.079207921,0.618811881,3,0.968961434
10648,130,21775,8,7,0,3,0,18,10,8,0,0,0,18,nowin,push,push,push,10,0,15,219,0.410958904,0.03652968,0.566210046,0,0.025888739
10649,107,21775,10,11,0,0,0,21,10,8,0,0,0,18,win,win,plwin,beat,25,0,21,218,0.444954128,0.073394495,0.600917431,2,0.605210014
10650,123,21776,2,9,9,0,0,20,4,10,1,5,0,20,nowin,push,push,push,10,0,11,205,0.43902439,0.034146341,0.614634146,2,0.609962544
10651,43,21776,3,7,5,0,0,15,4,10,1,5,0,20,nowin,loss,beat,dlwin,0,10,10,192,0.40625,0.041666667,0.609375,2,0.576671372
10652,98,21776,11,10,0,0,0,21,4,10,1,5,0,20,win,win,plwin,beat,25,0,21,220,0.422727273,0.054545455,0.55,1,0.28664435
10653,25,21776,10,6,0,0,0,16,4,10,1,5,0,20,nowin,loss,beat,dlwin,0,10,16,190,0.463157895,0.063157895,0.536842105,1,0.304401563
10654,62,21776,9,10,0,0,0,19,4,10,1,5,0,20,nowin,loss,beat,dlwin,0,10,19,178,0.370786517,0.028089888,0.54494382,0,0.008657722
10655,4,21776,5,5,6,0,0,16,4,10,1,5,0,20,nowin,loss,beat,dlwin,0,10,10,217,0.460829493,0.036866359,0.562211982,1,0.315432839
10656,59,21777,10,6,0,7,0,23,8,10,0,0,0,18,nowin,loss,bust,plbust,0,10,16,228,0.429824561,0.048245614,0.543859649,1,0.287885446
10657,126,21777,10,2,0,2,10,24,8,10,0,0,0,18,nowin,loss,bust,plbust,0,10,12,188,0.457446809,0.074468085,0.60106383,3,0.900633203
10658,74,21777,7,10,0,0,0,17,8,10,0,0,0,18,nowin,loss,beat,dlwin,0,10,17,209,0.411483254,0.04784689,0.531100478,0,0.017448125
10659,41,21777,8,10,0,0,0,18,8,10,0,0,0,18,nowin,push,push,push,10,0,18,192,0.364583333,0.036458333,0.520833333,0,0.00089702
10660,113,21777,3,1,10,9,0,23,8,10,0,0,0,18,nowin,loss,bust,plbust,0,10,4,199,0.407035176,0.055276382,0.668341709,2,0.620695264
10661,26,21777,10,3,0,7,0,20,8,10,0,0,0,18,nowin,win,plwin,beat,20,0,13,203,0.463054187,0.0591133,0.541871921,1,0.306802864
10662,124,21778,11,8,0,0,0,19,2,10,8,0,0,20,nowin,loss,beat,dlwin,0,10,19,202,0.47029703,0.064356436,0.584158416,3,0.899458193
10663,69,21778,2,4,10,0,0,16,2,10,8,0,0,20,nowin,loss,beat,dlwin,0,10,6,194,0.365979381,0.030927835,0.515463918,0,0
10664,126,21778,11,3,6,0,0,20,2,10,8,0,0,20,nowin,push,push,push,10,0,14,188,0.457446809,0.074468085,0.60106383,3,0.900633203
10665,136,21778,10,6,0,0,0,16,2,10,8,0,0,20,nowin,loss,beat,dlwin,0,10,16,194,0.396907216,0.025773196,0.597938144,0,0.029452644
10666,111,21778,11,10,0,0,0,21,2,10,8,0,0,20,win,win,plwin,beat,25,0,21,180,0.433333333,0.055555556,0.611111111,2,0.602264492
10667,132,21778,10,9,0,0,0,19,2,10,8,0,0,20,nowin,loss,beat,dlwin,0,10,19,194,0.412371134,0.036082474,0.649484536,2,0.611633238
10668,125,21779,3,9,0,0,0,12,4,1,10,10,0,25,nowin,win,dlbust,bust,20,0,12,219,0.438356164,0.050228311,0.575342466,1,0.308411257
10669,7,21779,8,6,0,0,0,14,4,1,10,10,0,25,nowin,win,dlbust,bust,20,0,14,183,0.442622951,0.06010929,0.62295082,2,0.619303341
10670,26,21779,10,3,0,0,0,13,4,1,10,10,0,25,nowin,win,dlbust,bust,20,0,13,203,0.463054187,0.0591133,0.541871921,1,0.306802864
10671,36,21779,2,10,0,0,0,12,4,1,10,10,0,25,nowin,win,dlbust,bust,20,0,12,229,0.445414847,0.056768559,0.655021834,2,0.645370571
10672,101,21779,7,5,0,0,0,12,4,1,10,10,0,25,nowin,win,dlbust,bust,20,0,12,205,0.424390244,0.068292683,0.63902439,2,0.614740646
10673,28,21779,3,10,0,0,0,13,4,1,10,10,0,25,nowin,win,dlbust,bust,20,0,13,199,0.422110553,0.045226131,0.542713568,1,0.282706618
10674,128,21780,8,11,0,0,0,19,6,11,0,0,0,17,nowin,win,plwin,beat,20,0,19,227,0.356828194,0.052863436,0.577092511,0,0.012352564
10675,95,21780,11,5,5,0,0,21,6,11,0,0,0,17,nowin,win,plwin,beat,20,0,16,218,0.412844037,0.04587156,0.559633028,0,0.024842385
10676,65,21780,10,6,0,0,0,16,6,11,0,0,0,17,nowin,loss,beat,dlwin,0,10,16,203,0.492610837,0.054187192,0.571428571,3,0.913702814
10677,41,21780,6,11,3,0,0,20,6,11,0,0,0,17,nowin,win,plwin,beat,20,0,17,192,0.364583333,0.036458333,0.520833333,0,0.00089702
10678,79,21780,5,6,9,0,0,20,6,11,0,0,0,17,nowin,win,plwin,beat,20,0,11,211,0.436018957,0.028436019,0.672985782,2,0.650131054
10679,82,21780,6,7,0,0,0,13,6,11,0,0,0,17,nowin,loss,beat,dlwin,0,10,13,225,0.408888889,0.075555556,0.577777778,0,0.028101874
10680,65,21781,2,9,4,0,0,15,3,2,10,6,0,21,nowin,loss,beat,dlwin,0,10,11,203,0.492610837,0.054187192,0.571428571,3,0.913702814
10681,143,21781,7,3,2,10,0,22,3,2,10,6,0,21,nowin,loss,bust,plbust,0,10,10,203,0.463054187,0.044334975,0.57635468,3,0.883143365
10682,80,21781,1,6,10,0,0,17,3,2,10,6,0,21,nowin,loss,beat,dlwin,0,10,7,186,0.419354839,0.059139785,0.623655914,2,0.59892924
10683,109,21781,4,9,0,0,0,13,3,2,10,6,0,21,nowin,loss,beat,dlwin,0,10,13,221,0.461538462,0.058823529,0.597285068,3,0.901830309
10684,133,21781,5,6,7,0,0,18,3,2,10,6,0,21,nowin,loss,beat,dlwin,0,10,11,201,0.47761194,0.064676617,0.611940299,3,0.935428111
10685,115,21781,8,10,0,0,0,18,3,2,10,6,0,21,nowin,loss,beat,dlwin,0,10,18,194,0.427835052,0.041237113,0.592783505,2,0.583863602
10686,148,21782,8,10,0,0,0,18,10,10,0,0,0,20,nowin,loss,beat,dlwin,0,10,18,204,0.401960784,0.078431373,0.593137255,0,0.029789521
10687,36,21782,11,5,4,0,0,20,10,10,0,0,0,20,nowin,push,push,push,10,0,16,229,0.445414847,0.056768559,0.655021834,2,0.645370571
10688,90,21782,10,4,0,9,0,23,10,10,0,0,0,20,nowin,loss,bust,plbust,0,10,14,201,0.447761194,0.049751244,0.60199005,3,0.889945023
10689,61,21782,7,2,9,0,0,18,10,10,0,0,0,20,nowin,loss,beat,dlwin,0,10,9,194,0.427835052,0.077319588,0.603092784,2,0.591437139
10690,60,21782,10,4,0,2,10,26,10,10,0,0,0,20,nowin,loss,bust,plbust,0,10,14,227,0.418502203,0.022026432,0.559471366,0,0.026496258
10691,149,21782,4,9,0,6,0,19,10,10,0,0,0,20,nowin,loss,beat,dlwin,0,10,13,225,0.457777778,0.057777778,0.648888889,2,0.651965595
10692,133,21783,10,9,0,0,0,19,10,4,1,5,0,20,nowin,loss,beat,dlwin,0,10,19,201,0.47761194,0.064676617,0.611940299,3,0.935428111
10693,93,21783,5,4,10,0,0,19,10,4,1,5,0,20,nowin,loss,beat,dlwin,0,10,9,175,0.485714286,0.051428571,0.548571429,1,0.323648091
10694,103,21783,6,5,10,0,0,21,10,4,1,5,0,20,nowin,win,plwin,beat,20,0,11,203,0.379310345,0.064039409,0.551724138,0,0.012869209
10695,44,21783,11,5,4,0,0,20,10,4,1,5,0,20,nowin,push,push,push,10,0,16,219,0.433789954,0.050228311,0.534246575,1,0.285551035
10696,68,21783,4,2,5,6,0,17,10,4,1,5,0,20,nowin,loss,beat,dlwin,0,10,6,205,0.434146341,0.029268293,0.6,2,0.59483189
10697,126,21783,9,3,0,10,0,22,10,4,1,5,0,20,nowin,loss,bust,plbust,0,10,12,188,0.457446809,0.074468085,0.60106383,3,0.900633203
10698,104,21784,10,10,0,0,0,20,11,10,0,0,0,21,nowin,loss,beat,dlwin,0,10,20,209,0.363636364,0.052631579,0.593301435,0,0.018359419
10699,132,21784,7,10,0,0,0,17,11,10,0,0,0,21,nowin,loss,beat,dlwin,0,10,17,194,0.412371134,0.036082474,0.649484536,2,0.611633238
10700,142,21784,5,9,0,4,0,18,11,10,0,0,0,21,nowin,loss,beat,dlwin,0,10,14,211,0.417061611,0.047393365,0.526066351,1,0.271531309
10701,80,21784,10,11,0,0,0,21,11,10,0,0,0,21,win,push,push,push,10,0,21,186,0.419354839,0.059139785,0.623655914,2,0.59892924
10702,68,21784,8,10,0,0,0,18,11,10,0,0,0,21,nowin,loss,beat,dlwin,0,10,18,205,0.434146341,0.029268293,0.6,2,0.59483189
10703,102,21784,10,4,0,10,0,24,11,10,0,0,0,21,nowin,loss,bust,plbust,0,10,14,192,0.338541667,0.046875,0.5625,0,0.003306118
10704,91,21785,8,7,0,10,0,25,10,6,5,0,0,21,nowin,loss,bust,plbust,0,10,15,194,0.417525773,0.046391753,0.515463918,1,0.266616552
10705,25,21785,11,4,3,0,0,18,10,6,5,0,0,21,nowin,loss,beat,dlwin,0,10,15,190,0.463157895,0.063157895,0.536842105,1,0.304401563
10706,91,21785,2,2,11,4,0,19,10,6,5,0,0,21,nowin,loss,beat,dlwin,0,10,4,194,0.417525773,0.046391753,0.515463918,1,0.266616552
10707,75,21785,5,3,10,0,0,18,10,6,5,0,0,21,nowin,loss,beat,dlwin,0,10,8,191,0.418848168,0.052356021,0.570680628,0,0.029344702
10708,101,21785,10,2,0,1,10,23,10,6,5,0,0,21,nowin,loss,bust,plbust,0,10,12,205,0.424390244,0.068292683,0.63902439,2,0.614740646
10709,65,21785,9,6,0,1,3,19,10,6,5,0,0,21,nowin,loss,beat,dlwin,0,10,15,203,0.492610837,0.054187192,0.571428571,3,0.913702814
10710,8,21786,6,2,5,0,0,13,2,10,2,3,0,17,nowin,loss,beat,dlwin,0,10,8,181,0.44198895,0.071823204,0.596685083,2,0.599438402
10711,49,21786,9,9,0,0,0,18,2,10,2,3,0,17,nowin,win,plwin,beat,20,0,18,207,0.396135266,0.053140097,0.594202899,0,0.028306925
10712,126,21786,9,7,0,0,0,16,2,10,2,3,0,17,nowin,loss,beat,dlwin,0,10,16,188,0.457446809,0.074468085,0.60106383,3,0.900633203
10713,23,21786,10,3,0,0,0,13,2,10,2,3,0,17,nowin,loss,beat,dlwin,0,10,13,208,0.427884615,0.0625,0.552884615,1,0.29114424
10714,67,21786,10,10,0,0,0,20,2,10,2,3,0,17,nowin,win,plwin,beat,20,0,20,195,0.369230769,0.041025641,0.569230769,0,0.014139427
10715,1,21786,8,10,0,0,0,18,2,10,2,3,0,17,nowin,win,plwin,beat,20,0,18,197,0.406091371,0.025380711,0.649746193,2,0.606186955
10716,65,21787,3,5,10,0,0,18,3,11,6,0,0,20,nowin,loss,beat,dlwin,0,10,8,203,0.492610837,0.054187192,0.571428571,3,0.913702814
10717,84,21787,10,10,0,0,0,20,3,11,6,0,0,20,nowin,push,push,push,10,0,20,195,0.379487179,0.056410256,0.569230769,0,0.017209119
10718,8,21787,9,9,0,0,0,18,3,11,6,0,0,20,nowin,loss,beat,dlwin,0,10,18,181,0.44198895,0.071823204,0.596685083,2,0.599438402
10719,39,21787,6,5,3,0,0,14,3,11,6,0,0,20,nowin,loss,beat,dlwin,0,10,11,191,0.429319372,0.062827225,0.57591623,0,0.033760763
10720,122,21787,10,10,0,0,0,20,3,11,6,0,0,20,nowin,push,push,push,10,0,20,210,0.347619048,0.052380952,0.59047619,0,0.012873677
10721,102,21787,11,10,0,0,0,21,3,11,6,0,0,20,win,win,plwin,beat,25,0,21,192,0.338541667,0.046875,0.5625,0,0.003306118
10722,34,21788,6,7,0,10,0,23,10,6,10,0,0,26,nowin,loss,bust,plbust,0,10,13,202,0.5,0.079207921,0.618811881,3,0.968961434
10723,120,21788,7,10,0,0,0,17,10,6,10,0,0,26,nowin,win,dlbust,bust,20,0,17,202,0.440594059,0.034653465,0.618811881,2,0.614441029
10724,31,21788,9,3,0,5,0,17,10,6,10,0,0,26,nowin,win,dlbust,bust,20,0,12,188,0.473404255,0.058510638,0.515957447,1,0.300306557
10725,23,21788,11,10,0,0,0,21,10,6,10,0,0,26,win,win,dlbust,bust,25,0,21,208,0.427884615,0.0625,0.552884615,1,0.29114424
10726,98,21788,2,7,10,0,0,19,10,6,10,0,0,26,nowin,win,dlbust,bust,20,0,9,220,0.422727273,0.054545455,0.55,1,0.28664435
10727,20,21788,6,9,0,4,0,19,10,6,10,0,0,26,nowin,win,dlbust,bust,20,0,15,186,0.456989247,0.037634409,0.537634409,1,0.301097108
10728,134,21789,10,4,0,10,0,24,11,2,1,1,10,25,nowin,loss,bust,plbust,0,10,14,185,0.443243243,0.021621622,0.545945946,1,0.296939509
10729,39,21789,11,10,0,0,0,21,11,2,1,1,10,25,win,win,dlbust,bust,25,0,21,191,0.429319372,0.062827225,0.57591623,0,0.033760763
10730,93,21789,5,9,0,7,0,21,11,2,1,1,10,25,nowin,win,dlbust,bust,20,0,14,175,0.485714286,0.051428571,0.548571429,1,0.323648091
10731,130,21789,10,9,0,0,0,19,11,2,1,1,10,25,nowin,win,dlbust,bust,20,0,19,219,0.410958904,0.03652968,0.566210046,0,0.025888739
10732,2,21789,10,8,0,0,0,18,11,2,1,1,10,25,nowin,win,dlbust,bust,20,0,18,200,0.445,0.035,0.64,2,0.633962549
10733,13,21789,2,5,7,10,0,24,11,2,1,1,10,25,nowin,loss,bust,plbust,0,10,7,206,0.417475728,0.063106796,0.621359223,2,0.59555479
10734,20,21790,10,3,0,7,0,20,10,10,0,0,0,20,nowin,push,push,push,10,0,13,186,0.456989247,0.037634409,0.537634409,1,0.301097108
10735,44,21790,6,10,0,10,0,26,10,10,0,0,0,20,nowin,loss,bust,plbust,0,10,16,219,0.433789954,0.050228311,0.534246575,1,0.285551035
10736,52,21790,10,11,0,0,0,21,10,10,0,0,0,20,win,win,plwin,beat,25,0,21,217,0.414746544,0.02764977,0.599078341,2,0.576736024
10737,89,21790,6,2,11,0,0,19,10,10,0,0,0,20,nowin,loss,beat,dlwin,0,10,8,212,0.537735849,0.047169811,0.594339623,3,0.990167191
10738,145,21790,7,6,0,10,0,23,10,10,0,0,0,20,nowin,loss,bust,plbust,0,10,13,188,0.441489362,0.031914894,0.622340426,2,0.617837093
10739,71,21790,5,10,0,10,0,25,10,10,0,0,0,20,nowin,loss,bust,plbust,0,10,15,193,0.352331606,0.046632124,0.585492228,0,0.013063661
10740,90,21791,9,5,0,8,0,22,8,7,9,0,0,24,nowin,loss,bust,plbust,0,10,14,201,0.447761194,0.049751244,0.60199005,3,0.889945023
10741,135,21791,2,11,8,0,0,21,8,7,9,0,0,24,nowin,win,dlbust,bust,20,0,13,179,0.391061453,0.067039106,0.586592179,0,0.024924662
10742,137,21791,10,11,0,0,0,21,8,7,9,0,0,24,win,win,dlbust,bust,25,0,21,194,0.417525773,0.046391753,0.536082474,1,0.276714602
10743,115,21791,10,10,0,0,0,20,8,7,9,0,0,24,nowin,win,dlbust,bust,20,0,20,194,0.427835052,0.041237113,0.592783505,2,0.583863602
10744,14,21791,3,2,10,10,0,25,8,7,9,0,0,24,nowin,loss,bust,plbust,0,10,5,202,0.391089109,0.01980198,0.628712871,2,0.577264877
10745,75,21791,10,8,0,0,0,18,8,7,9,0,0,24,nowin,win,dlbust,bust,20,0,18,191,0.418848168,0.052356021,0.570680628,0,0.029344702
10746,143,21792,3,10,0,9,0,22,10,2,4,3,0,19,nowin,loss,bust,plbust,0,10,13,203,0.463054187,0.044334975,0.57635468,3,0.883143365
10747,112,21792,8,9,0,0,0,17,10,2,4,3,0,19,nowin,loss,beat,dlwin,0,10,17,203,0.448275862,0.054187192,0.600985222,3,0.889576933
10748,104,21792,10,7,0,0,0,17,10,2,4,3,0,19,nowin,loss,beat,dlwin,0,10,17,209,0.363636364,0.052631579,0.593301435,0,0.018359419
10749,74,21792,10,8,0,0,0,18,10,2,4,3,0,19,nowin,loss,beat,dlwin,0,10,18,209,0.411483254,0.04784689,0.531100478,0,0.017448125
10750,109,21792,11,2,7,0,0,20,10,2,4,3,0,19,nowin,win,plwin,beat,20,0,13,221,0.461538462,0.058823529,0.597285068,3,0.901830309
10751,29,21792,11,9,0,0,0,20,10,2,4,3,0,19,nowin,win,plwin,beat,20,0,20,189,0.44973545,0.058201058,0.544973545,1,0.300349439
10752,78,21793,3,5,3,10,0,21,9,8,0,0,0,17,nowin,win,plwin,beat,20,0,8,201,0.517412935,0.034825871,0.587064677,3,0.95871112
10753,85,21793,2,10,0,8,0,20,9,8,0,0,0,17,nowin,win,plwin,beat,20,0,12,195,0.41025641,0.066666667,0.594871795,0,0.03269711
10754,99,21793,4,6,7,0,0,17,9,8,0,0,0,17,nowin,push,push,push,10,0,10,207,0.47826087,0.062801932,0.637681159,3,0.961418446
10755,107,21793,10,10,0,0,0,20,9,8,0,0,0,17,nowin,win,plwin,beat,20,0,20,218,0.444954128,0.073394495,0.600917431,2,0.605210014
10756,4,21793,10,9,0,0,0,19,9,8,0,0,0,17,nowin,win,plwin,beat,20,0,19,217,0.460829493,0.036866359,0.562211982,1,0.315432839
10757,55,21793,6,10,0,3,0,19,9,8,0,0,0,17,nowin,win,plwin,beat,20,0,16,191,0.371727749,0.057591623,0.54973822,0,0.01011347
10758,90,21794,3,1,8,10,0,22,3,10,4,0,0,17,nowin,loss,bust,plbust,0,10,4,201,0.447761194,0.049751244,0.60199005,3,0.889945023
10759,118,21794,3,8,6,0,0,17,3,10,4,0,0,17,nowin,push,push,push,10,0,11,216,0.393518519,0.037037037,0.555555556,0,0.018059873
10760,104,21794,5,9,0,0,0,14,3,10,4,0,0,17,nowin,loss,beat,dlwin,0,10,14,209,0.363636364,0.052631579,0.593301435,0,0.018359419
10761,116,21794,4,10,0,0,0,14,3,10,4,0,0,17,nowin,loss,beat,dlwin,0,10,14,195,0.425641026,0.056410256,0.538461538,1,0.28273747
10762,16,21794,2,8,9,0,0,19,3,10,4,0,0,17,nowin,win,plwin,beat,20,0,10,220,0.427272727,0.081818182,0.6,2,0.588660176
10763,27,21794,10,7,0,0,0,17,3,10,4,0,0,17,nowin,push,push,push,10,0,17,178,0.370786517,0.016853933,0.573033708,0,0.015536309
10764,15,21795,11,10,0,0,0,21,3,10,4,0,0,17,win,win,plwin,beat,25,0,21,212,0.410377358,0.051886792,0.561320755,0,0.024517408
10765,13,21795,10,10,0,0,0,20,3,10,4,0,0,17,nowin,win,plwin,beat,20,0,20,206,0.417475728,0.063106796,0.621359223,2,0.59555479
10766,96,21795,4,6,8,0,0,18,3,10,4,0,0,17,nowin,win,plwin,beat,20,0,10,190,0.468421053,0.057894737,0.584210526,3,0.897263354
10767,116,21795,10,5,0,0,0,15,3,10,4,0,0,17,nowin,loss,beat,dlwin,0,10,15,195,0.425641026,0.056410256,0.538461538,1,0.28273747
10768,116,21795,10,4,0,0,0,14,3,10,4,0,0,17,nowin,loss,beat,dlwin,0,10,14,195,0.425641026,0.056410256,0.538461538,1,0.28273747
10769,3,21795,2,11,4,0,0,17,3,10,4,0,0,17,nowin,push,push,push,10,0,13,190,0.431578947,0.026315789,0.542105263,1,0.288076384
10770,59,21796,11,8,0,0,0,19,10,10,0,0,0,20,nowin,loss,beat,dlwin,0,10,19,228,0.429824561,0.048245614,0.543859649,1,0.287885446
10771,107,21796,10,10,0,0,0,20,10,10,0,0,0,20,nowin,push,push,push,10,0,20,218,0.444954128,0.073394495,0.600917431,2,0.605210014
10772,77,21796,4,3,9,8,0,24,10,10,0,0,0,20,nowin,loss,bust,plbust,0,10,7,200,0.455,0.04,0.62,3,0.916252116
10773,122,21796,9,10,0,0,0,19,10,10,0,0,0,20,nowin,loss,beat,dlwin,0,10,19,210,0.347619048,0.052380952,0.59047619,0,0.012873677
10774,75,21796,3,6,6,10,0,25,10,10,0,0,0,20,nowin,loss,bust,plbust,0,10,9,191,0.418848168,0.052356021,0.570680628,0,0.029344702
10775,120,21796,10,8,0,0,0,18,10,10,0,0,0,20,nowin,loss,beat,dlwin,0,10,18,202,0.440594059,0.034653465,0.618811881,2,0.614441029
10776,97,21797,3,1,10,4,0,18,10,2,10,0,0,22,nowin,win,dlbust,bust,20,0,4,182,0.450549451,0.06043956,0.692307692,2,0.677372279
10777,66,21797,10,2,0,9,0,21,10,2,10,0,0,22,nowin,win,dlbust,bust,20,0,12,217,0.456221198,0.064516129,0.626728111,3,0.924304367
10778,106,21797,5,4,7,10,0,26,10,2,10,0,0,22,nowin,loss,bust,plbust,0,10,9,192,0.411458333,0.026041667,0.557291667,0,0.023854304
10779,129,21797,10,10,0,0,0,20,10,2,10,0,0,22,nowin,win,dlbust,bust,20,0,20,201,0.422885572,0.064676617,0.55721393,0,0.027255383
10780,49,21797,4,8,0,10,0,22,10,2,10,0,0,22,nowin,loss,bust,plbust,0,10,12,207,0.396135266,0.053140097,0.594202899,0,0.028306925
10781,61,21797,10,10,0,0,0,20,10,2,10,0,0,22,nowin,win,dlbust,bust,20,0,20,194,0.427835052,0.077319588,0.603092784,2,0.591437139
10782,127,21798,10,10,0,0,0,20,10,10,0,0,0,20,nowin,push,push,push,10,0,20,201,0.402985075,0.029850746,0.60199005,0,0.032263937
10783,105,21798,9,11,0,0,0,20,10,10,0,0,0,20,nowin,push,push,push,10,0,20,198,0.414141414,0.070707071,0.590909091,0,0.032889494
10784,76,21798,10,11,0,0,0,21,10,10,0,0,0,20,win,win,plwin,beat,25,0,21,189,0.534391534,0.079365079,0.608465608,3,1
10785,124,21798,10,11,0,0,0,21,10,10,0,0,0,20,win,win,plwin,beat,25,0,21,202,0.47029703,0.064356436,0.584158416,3,0.899458193
10786,107,21798,11,10,0,0,0,21,10,10,0,0,0,20,win,win,plwin,beat,25,0,21,218,0.444954128,0.073394495,0.600917431,2,0.605210014
10787,25,21798,4,11,2,0,0,17,10,10,0,0,0,20,nowin,loss,beat,dlwin,0,10,15,190,0.463157895,0.063157895,0.536842105,1,0.304401563
10788,133,21799,3,6,10,0,0,19,9,10,0,0,0,19,nowin,push,push,push,10,0,9,201,0.47761194,0.064676617,0.611940299,3,0.935428111
10789,145,21799,5,8,0,1,9,23,9,10,0,0,0,19,nowin,loss,bust,plbust,0,10,13,188,0.441489362,0.031914894,0.622340426,2,0.617837093
10790,119,21799,10,11,0,0,0,21,9,10,0,0,0,19,win,win,plwin,beat,25,0,21,190,0.405263158,0.068421053,0.515789474,0,0.011837158
10791,20,21799,9,4,0,10,0,23,9,10,0,0,0,19,nowin,loss,bust,plbust,0,10,13,186,0.456989247,0.037634409,0.537634409,1,0.301097108
10792,85,21799,10,5,0,7,0,22,9,10,0,0,0,19,nowin,loss,bust,plbust,0,10,15,195,0.41025641,0.066666667,0.594871795,0,0.03269711
10793,115,21799,5,10,0,4,0,19,9,10,0,0,0,19,nowin,push,push,push,10,0,15,194,0.427835052,0.041237113,0.592783505,2,0.583863602
10794,101,21800,7,6,0,0,0,13,4,4,6,9,0,23,nowin,win,dlbust,bust,20,0,13,205,0.424390244,0.068292683,0.63902439,2,0.614740646
10795,145,21800,8,2,4,0,0,14,4,4,6,9,0,23,nowin,win,dlbust,bust,20,0,10,188,0.441489362,0.031914894,0.622340426,2,0.617837093
10796,15,21800,10,4,0,0,0,14,4,4,6,9,0,23,nowin,win,dlbust,bust,20,0,14,212,0.410377358,0.051886792,0.561320755,0,0.024517408
10797,128,21800,10,10,0,0,0,20,4,4,6,9,0,23,nowin,win,dlbust,bust,20,0,20,227,0.356828194,0.052863436,0.577092511,0,0.012352564
10798,77,21800,10,10,0,0,0,20,4,4,6,9,0,23,nowin,win,dlbust,bust,20,0,20,200,0.455,0.04,0.62,3,0.916252116
10799,110,21800,1,6,9,0,0,16,4,4,6,9,0,23,nowin,win,dlbust,bust,20,0,7,192,0.416666667,0.046875,0.557291667,0,0.025413132
10800,7,21801,6,10,0,0,0,16,6,3,9,0,0,18,nowin,loss,beat,dlwin,0,10,16,183,0.442622951,0.06010929,0.62295082,2,0.619303341
10801,112,21801,10,6,0,0,0,16,6,3,9,0,0,18,nowin,loss,beat,dlwin,0,10,16,203,0.448275862,0.054187192,0.600985222,3,0.889576933
10802,37,21801,2,8,5,0,0,15,6,3,9,0,0,18,nowin,loss,beat,dlwin,0,10,10,208,0.394230769,0.038461538,0.581730769,0,0.024682772
10803,116,21801,10,10,0,0,0,20,6,3,9,0,0,18,nowin,win,plwin,beat,20,0,20,195,0.425641026,0.056410256,0.538461538,1,0.28273747
10804,12,21801,10,10,0,0,0,20,6,3,9,0,0,18,nowin,win,plwin,beat,20,0,20,189,0.470899471,0.015873016,0.613756614,3,0.929171178
10805,129,21801,11,10,0,0,0,21,6,3,9,0,0,18,win,win,plwin,beat,25,0,21,201,0.422885572,0.064676617,0.55721393,0,0.027255383
10806,36,21802,2,6,9,0,0,17,7,8,1,3,0,19,nowin,loss,beat,dlwin,0,10,8,229,0.445414847,0.056768559,0.655021834,2,0.645370571
10807,102,21802,10,10,0,0,0,20,7,8,1,3,0,19,nowin,win,plwin,beat,20,0,20,192,0.338541667,0.046875,0.5625,0,0.003306118
10808,79,21802,9,9,0,0,0,18,7,8,1,3,0,19,nowin,loss,beat,dlwin,0,10,18,211,0.436018957,0.028436019,0.672985782,2,0.650131054
10809,98,21802,11,6,3,0,0,20,7,8,1,3,0,19,nowin,win,plwin,beat,20,0,17,220,0.422727273,0.054545455,0.55,1,0.28664435
10810,102,21802,8,10,0,0,0,18,7,8,1,3,0,19,nowin,loss,beat,dlwin,0,10,18,192,0.338541667,0.046875,0.5625,0,0.003306118
10811,127,21802,5,6,10,0,0,21,7,8,1,3,0,19,nowin,win,plwin,beat,20,0,11,201,0.402985075,0.029850746,0.60199005,0,0.032263937
10812,84,21803,6,4,2,9,0,21,10,10,0,0,0,20,nowin,win,plwin,beat,20,0,10,195,0.379487179,0.056410256,0.569230769,0,0.017209119
10813,91,21803,3,3,10,9,0,25,10,10,0,0,0,20,nowin,loss,bust,plbust,0,10,6,194,0.417525773,0.046391753,0.515463918,1,0.266616552
10814,121,21803,10,11,0,0,0,21,10,10,0,0,0,20,win,win,plwin,beat,25,0,21,195,0.456410256,0.025641026,0.512820513,1,0.288597791
10815,138,21803,11,10,0,0,0,21,10,10,0,0,0,20,win,win,plwin,beat,25,0,21,190,0.442105263,0.047368421,0.610526316,2,0.609711065
10816,102,21803,3,10,0,2,2,17,10,10,0,0,0,20,nowin,loss,beat,dlwin,0,10,13,192,0.338541667,0.046875,0.5625,0,0.003306118
10817,125,21803,2,7,10,0,0,19,10,10,0,0,0,20,nowin,loss,beat,dlwin,0,10,9,219,0.438356164,0.050228311,0.575342466,1,0.308411257
10818,144,21804,10,3,0,7,0,20,9,10,0,0,0,19,nowin,win,plwin,beat,20,0,13,202,0.386138614,0.054455446,0.564356436,0,0.018006244
10819,142,21804,10,10,0,0,0,20,9,10,0,0,0,19,nowin,win,plwin,beat,20,0,20,211,0.417061611,0.047393365,0.526066351,1,0.271531309
10820,71,21804,7,10,0,0,0,17,9,10,0,0,0,19,nowin,loss,beat,dlwin,0,10,17,193,0.352331606,0.046632124,0.585492228,0,0.013063661
10821,4,21804,10,10,0,0,0,20,9,10,0,0,0,19,nowin,win,plwin,beat,20,0,20,217,0.460829493,0.036866359,0.562211982,1,0.315432839
10822,105,21804,10,8,0,0,0,18,9,10,0,0,0,19,nowin,loss,beat,dlwin,0,10,18,198,0.414141414,0.070707071,0.590909091,0,0.032889494
10823,83,21804,10,3,0,6,0,19,9,10,0,0,0,19,nowin,push,push,push,10,0,13,193,0.424870466,0.051813472,0.678756477,2,0.644360335
10824,82,21805,10,6,0,9,0,25,11,10,0,0,0,21,nowin,loss,bust,plbust,0,10,16,225,0.408888889,0.075555556,0.577777778,0,0.028101874
10825,83,21805,10,4,0,5,0,19,11,10,0,0,0,21,nowin,loss,beat,dlwin,0,10,14,193,0.424870466,0.051813472,0.678756477,2,0.644360335
10826,87,21805,10,6,0,9,0,25,11,10,0,0,0,21,nowin,loss,bust,plbust,0,10,16,202,0.405940594,0.054455446,0.628712871,2,0.590599801
10827,5,21805,6,2,6,9,0,23,11,10,0,0,0,21,nowin,loss,bust,plbust,0,10,8,203,0.42364532,0.02955665,0.596059113,2,0.582508076
10828,58,21805,9,11,0,0,0,20,11,10,0,0,0,21,nowin,loss,beat,dlwin,0,10,20,195,0.430769231,0.041025641,0.584615385,2,0.580497586
10829,38,21805,7,7,0,8,0,22,11,10,0,0,0,21,nowin,loss,bust,plbust,0,10,14,202,0.361386139,0.03960396,0.564356436,0,0.010597953
10830,145,21806,4,5,2,10,0,21,4,3,3,9,0,19,nowin,win,plwin,beat,20,0,9,188,0.441489362,0.031914894,0.622340426,2,0.617837093
10831,83,21806,3,10,0,0,0,13,4,3,3,9,0,19,nowin,loss,beat,dlwin,0,10,13,193,0.424870466,0.051813472,0.678756477,2,0.644360335
10832,100,21806,10,9,0,0,0,19,4,3,3,9,0,19,nowin,push,push,push,10,0,19,190,0.452631579,0.036842105,0.594736842,3,0.888671154
10833,16,21806,3,5,10,0,0,18,4,3,3,9,0,19,nowin,loss,beat,dlwin,0,10,8,220,0.427272727,0.081818182,0.6,2,0.588660176
10834,28,21806,10,5,0,0,0,15,4,3,3,9,0,19,nowin,loss,beat,dlwin,0,10,15,199,0.422110553,0.045226131,0.542713568,1,0.282706618
10835,59,21806,9,11,0,0,0,20,4,3,3,9,0,19,nowin,win,plwin,beat,20,0,20,228,0.429824561,0.048245614,0.543859649,1,0.287885446
10836,64,21807,10,6,0,0,0,16,3,8,7,0,0,18,nowin,loss,beat,dlwin,0,10,16,187,0.363636364,0.048128342,0.631016043,0,0.027594885
10837,145,21807,10,2,0,4,0,16,3,8,7,0,0,18,nowin,loss,beat,dlwin,0,10,12,188,0.441489362,0.031914894,0.622340426,2,0.617837093
10838,18,21807,1,5,8,0,0,14,3,8,7,0,0,18,nowin,loss,beat,dlwin,0,10,6,182,0.461538462,0.043956044,0.587912088,3,0.892649374
10839,40,21807,9,7,0,0,0,16,3,8,7,0,0,18,nowin,loss,beat,dlwin,0,10,16,196,0.367346939,0.030612245,0.617346939,0,0.025358183
10840,57,21807,3,5,9,0,0,17,3,8,7,0,0,18,nowin,loss,beat,dlwin,0,10,8,192,0.46875,0.052083333,0.59375,3,0.907001181
10841,32,21807,10,10,0,0,0,20,3,8,7,0,0,18,nowin,win,plwin,beat,20,0,20,189,0.391534392,0.037037037,0.53968254,0,0.013579086
10842,86,21808,11,5,4,0,0,20,3,9,5,0,0,17,nowin,win,plwin,beat,20,0,16,196,0.454081633,0.040816327,0.591836735,3,0.887566443
10843,3,21808,9,5,0,0,0,14,3,9,5,0,0,17,nowin,loss,beat,dlwin,0,10,14,190,0.431578947,0.026315789,0.542105263,1,0.288076384
10844,41,21808,8,6,0,0,0,14,3,9,5,0,0,17,nowin,loss,beat,dlwin,0,10,14,192,0.364583333,0.036458333,0.520833333,0,0.00089702
10845,35,21808,5,10,0,0,0,15,3,9,5,0,0,17,nowin,loss,beat,dlwin,0,10,15,202,0.410891089,0.044554455,0.633663366,2,0.598681573
10846,94,21808,10,9,0,0,0,19,3,9,5,0,0,17,nowin,win,plwin,beat,20,0,19,183,0.43715847,0.043715847,0.540983607,1,0.290866892
10847,85,21808,10,7,0,0,0,17,3,9,5,0,0,17,nowin,push,push,push,10,0,17,195,0.41025641,0.066666667,0.594871795,0,0.03269711
10848,125,21809,6,7,0,0,0,13,5,4,11,0,0,20,nowin,loss,beat,dlwin,0,10,13,219,0.438356164,0.050228311,0.575342466,1,0.308411257
10849,8,21809,1,4,7,0,0,12,5,4,11,0,0,20,nowin,loss,beat,dlwin,0,10,5,181,0.44198895,0.071823204,0.596685083,2,0.599438402
10850,29,21809,4,1,8,0,0,13,5,4,11,0,0,20,nowin,loss,beat,dlwin,0,10,5,189,0.44973545,0.058201058,0.544973545,1,0.300349439
10851,98,21809,10,4,0,0,0,14,5,4,11,0,0,20,nowin,loss,beat,dlwin,0,10,14,220,0.422727273,0.054545455,0.55,1,0.28664435
10852,85,21809,10,3,0,0,0,13,5,4,11,0,0,20,nowin,loss,beat,dlwin,0,10,13,195,0.41025641,0.066666667,0.594871795,0,0.03269711
10853,56,21809,9,9,0,0,0,18,5,4,11,0,0,20,nowin,loss,beat,dlwin,0,10,18,175,0.4,0.057142857,0.582857143,0,0.026685297
10854,4,21810,11,10,0,0,0,21,2,8,4,2,3,19,win,win,plwin,beat,25,0,21,217,0.460829493,0.036866359,0.562211982,1,0.315432839
10855,44,21810,5,9,0,0,0,14,2,8,4,2,3,19,nowin,loss,beat,dlwin,0,10,14,219,0.433789954,0.050228311,0.534246575,1,0.285551035
10856,6,21810,7,5,0,8,0,20,2,8,4,2,3,19,nowin,win,plwin,beat,20,0,12,191,0.439790576,0.047120419,0.581151832,1,0.31211505
10857,9,21810,4,10,0,0,0,14,2,8,4,2,3,19,nowin,loss,beat,dlwin,0,10,14,194,0.37628866,0.015463918,0.541237113,0,0.009396796
10858,83,21810,6,2,8,0,0,16,2,8,4,2,3,19,nowin,loss,beat,dlwin,0,10,8,193,0.424870466,0.051813472,0.678756477,2,0.644360335
10859,87,21810,6,9,0,0,0,15,2,8,4,2,3,19,nowin,loss,beat,dlwin,0,10,15,202,0.405940594,0.054455446,0.628712871,2,0.590599801
10860,124,21811,3,8,8,0,0,19,10,6,4,0,0,20,nowin,loss,beat,dlwin,0,10,11,202,0.47029703,0.064356436,0.584158416,3,0.899458193
10861,82,21811,10,10,0,0,0,20,10,6,4,0,0,20,nowin,push,push,push,10,0,20,225,0.408888889,0.075555556,0.577777778,0,0.028101874
10862,40,21811,10,7,0,0,0,17,10,6,4,0,0,20,nowin,loss,beat,dlwin,0,10,17,196,0.367346939,0.030612245,0.617346939,0,0.025358183
10863,45,21811,2,8,8,0,0,18,10,6,4,0,0,20,nowin,loss,beat,dlwin,0,10,10,196,0.428571429,0.051020408,0.612244898,2,0.598821767
10864,50,21811,10,6,0,9,0,25,10,6,4,0,0,20,nowin,loss,bust,plbust,0,10,16,202,0.405940594,0.04950495,0.54950495,0,0.020296079
10865,105,21811,11,9,0,0,0,20,10,6,4,0,0,20,nowin,push,push,push,10,0,20,198,0.414141414,0.070707071,0.590909091,0,0.032889494
10866,79,21812,3,3,10,6,0,22,10,5,4,0,0,19,nowin,loss,bust,plbust,0,10,6,211,0.436018957,0.028436019,0.672985782,2,0.650131054
10867,144,21812,2,11,8,0,0,21,10,5,4,0,0,19,nowin,win,plwin,beat,20,0,13,202,0.386138614,0.054455446,0.564356436,0,0.018006244
10868,147,21812,7,11,0,0,0,18,10,5,4,0,0,19,nowin,loss,beat,dlwin,0,10,18,205,0.380487805,0.014634146,0.536585366,0,0.00951447
10869,111,21812,5,7,0,1,4,17,10,5,4,0,0,19,nowin,loss,beat,dlwin,0,10,12,180,0.433333333,0.055555556,0.611111111,2,0.602264492
10870,110,21812,1,2,10,10,0,23,10,5,4,0,0,19,nowin,loss,bust,plbust,0,10,3,192,0.416666667,0.046875,0.557291667,0,0.025413132
10871,143,21812,7,6,0,10,0,23,10,5,4,0,0,19,nowin,loss,bust,plbust,0,10,13,203,0.463054187,0.044334975,0.57635468,3,0.883143365
10872,56,21813,10,11,0,0,0,21,3,10,10,0,0,23,win,win,dlbust,bust,25,0,21,175,0.4,0.057142857,0.582857143,0,0.026685297
10873,143,21813,10,7,0,0,0,17,3,10,10,0,0,23,nowin,win,dlbust,bust,20,0,17,203,0.463054187,0.044334975,0.57635468,3,0.883143365
10874,105,21813,8,11,0,0,0,19,3,10,10,0,0,23,nowin,win,dlbust,bust,20,0,19,198,0.414141414,0.070707071,0.590909091,0,0.032889494
10875,6,21813,5,8,0,0,0,13,3,10,10,0,0,23,nowin,win,dlbust,bust,20,0,13,191,0.439790576,0.047120419,0.581151832,1,0.31211505
10876,60,21813,3,6,6,0,0,15,3,10,10,0,0,23,nowin,win,dlbust,bust,20,0,9,227,0.418502203,0.022026432,0.559471366,0,0.026496258
10877,47,21813,5,4,4,0,0,13,3,10,10,0,0,23,nowin,win,dlbust,bust,20,0,9,210,0.438095238,0.057142857,0.623809524,2,0.615868808
10878,60,21814,10,2,0,10,0,22,10,8,0,0,0,18,nowin,loss,bust,plbust,0,10,12,227,0.418502203,0.022026432,0.559471366,0,0.026496258
10879,52,21814,3,7,11,0,0,21,10,8,0,0,0,18,nowin,win,plwin,beat,20,0,10,217,0.414746544,0.02764977,0.599078341,2,0.576736024
10880,118,21814,9,4,0,10,0,23,10,8,0,0,0,18,nowin,loss,bust,plbust,0,10,13,216,0.393518519,0.037037037,0.555555556,0,0.018059873
10881,52,21814,8,10,0,0,0,18,10,8,0,0,0,18,nowin,push,push,push,10,0,18,217,0.414746544,0.02764977,0.599078341,2,0.576736024
10882,5,21814,9,10,0,0,0,19,10,8,0,0,0,18,nowin,win,plwin,beat,20,0,19,203,0.42364532,0.02955665,0.596059113,2,0.582508076
10883,22,21814,6,4,7,0,0,17,10,8,0,0,0,18,nowin,loss,beat,dlwin,0,10,10,187,0.481283422,0.042780749,0.577540107,3,0.906128176
10884,106,21815,10,2,0,10,0,22,9,3,5,0,0,17,nowin,loss,bust,plbust,0,10,12,192,0.411458333,0.026041667,0.557291667,0,0.023854304
10885,37,21815,3,9,0,8,0,20,9,3,5,0,0,17,nowin,win,plwin,beat,20,0,12,208,0.394230769,0.038461538,0.581730769,0,0.024682772
10886,66,21815,5,10,0,10,0,25,9,3,5,0,0,17,nowin,loss,bust,plbust,0,10,15,217,0.456221198,0.064516129,0.626728111,3,0.924304367
10887,27,21815,10,5,0,8,0,23,9,3,5,0,0,17,nowin,loss,bust,plbust,0,10,15,178,0.370786517,0.016853933,0.573033708,0,0.015536309
10888,93,21815,10,6,0,2,0,18,9,3,5,0,0,17,nowin,win,plwin,beat,20,0,16,175,0.485714286,0.051428571,0.548571429,1,0.323648091
10889,37,21815,4,2,5,10,0,21,9,3,5,0,0,17,nowin,win,plwin,beat,20,0,6,208,0.394230769,0.038461538,0.581730769,0,0.024682772
10890,107,21816,3,8,8,0,0,19,7,2,10,0,0,19,nowin,push,push,push,10,0,11,218,0.444954128,0.073394495,0.600917431,2,0.605210014
10891,60,21816,7,2,8,0,0,17,7,2,10,0,0,19,nowin,loss,beat,dlwin,0,10,9,227,0.418502203,0.022026432,0.559471366,0,0.026496258
10892,112,21816,9,10,0,0,0,19,7,2,10,0,0,19,nowin,push,push,push,10,0,19,203,0.448275862,0.054187192,0.600985222,3,0.889576933
10893,96,21816,4,8,0,5,0,17,7,2,10,0,0,19,nowin,loss,beat,dlwin,0,10,12,190,0.468421053,0.057894737,0.584210526,3,0.897263354
10894,59,21816,10,5,0,8,0,23,7,2,10,0,0,19,nowin,loss,bust,plbust,0,10,15,228,0.429824561,0.048245614,0.543859649,1,0.287885446
10895,24,21816,10,2,0,2,10,24,7,2,10,0,0,19,nowin,loss,bust,plbust,0,10,12,207,0.458937198,0.048309179,0.570048309,1,0.318138014
10896,146,21817,3,11,6,0,0,20,9,10,0,0,0,19,nowin,win,plwin,beat,20,0,14,221,0.43438914,0.040723982,0.542986425,1,0.290190091
10897,122,21817,9,3,0,9,0,21,9,10,0,0,0,19,nowin,win,plwin,beat,20,0,12,210,0.347619048,0.052380952,0.59047619,0,0.012873677
10898,75,21817,9,8,0,0,0,17,9,10,0,0,0,19,nowin,loss,beat,dlwin,0,10,17,191,0.418848168,0.052356021,0.570680628,0,0.029344702
10899,93,21817,10,4,0,6,0,20,9,10,0,0,0,19,nowin,win,plwin,beat,20,0,14,175,0.485714286,0.051428571,0.548571429,1,0.323648091
10900,150,21817,6,9,0,7,0,22,9,10,0,0,0,19,nowin,loss,bust,plbust,0,10,15,192,0.401041667,0.036458333,0.567708333,0,0.023287458
10901,147,21817,7,10,0,0,0,17,9,10,0,0,0,19,nowin,loss,beat,dlwin,0,10,17,205,0.380487805,0.014634146,0.536585366,0,0.00951447
10902,78,21818,11,8,0,0,0,19,9,7,7,0,0,23,nowin,win,dlbust,bust,20,0,19,201,0.517412935,0.034825871,0.587064677,3,0.95871112
10903,4,21818,7,5,0,9,0,21,9,7,7,0,0,23,nowin,win,dlbust,bust,20,0,12,217,0.460829493,0.036866359,0.562211982,1,0.315432839
10904,34,21818,10,3,0,3,10,26,9,7,7,0,0,23,nowin,loss,bust,plbust,0,10,13,202,0.5,0.079207921,0.618811881,3,0.968961434
10905,78,21818,10,10,0,0,0,20,9,7,7,0,0,23,nowin,win,dlbust,bust,20,0,20,201,0.517412935,0.034825871,0.587064677,3,0.95871112
10906,101,21818,10,7,0,0,0,17,9,7,7,0,0,23,nowin,win,dlbust,bust,20,0,17,205,0.424390244,0.068292683,0.63902439,2,0.614740646
10907,35,21818,10,6,0,10,0,26,9,7,7,0,0,23,nowin,loss,bust,plbust,0,10,16,202,0.410891089,0.044554455,0.633663366,2,0.598681573
10908,73,21819,2,2,10,10,0,24,11,8,0,0,0,19,nowin,loss,bust,plbust,0,10,4,181,0.375690608,0.011049724,0.596685083,0,0.022795773
10909,9,21819,5,8,0,10,0,23,11,8,0,0,0,19,nowin,loss,bust,plbust,0,10,13,194,0.37628866,0.015463918,0.541237113,0,0.009396796
10910,92,21819,1,4,10,5,0,20,11,8,0,0,0,19,nowin,win,plwin,beat,20,0,5,186,0.446236559,0.059139785,0.564516129,1,0.307826125
10911,83,21819,10,2,0,1,3,16,11,8,0,0,0,19,nowin,loss,beat,dlwin,0,10,12,193,0.424870466,0.051813472,0.678756477,2,0.644360335
10912,62,21819,7,7,0,8,0,22,11,8,0,0,0,19,nowin,loss,bust,plbust,0,10,14,178,0.370786517,0.028089888,0.54494382,0,0.008657722
10913,105,21819,11,6,1,0,0,18,11,8,0,0,0,19,nowin,loss,beat,dlwin,0,10,17,198,0.414141414,0.070707071,0.590909091,0,0.032889494
10914,129,21820,4,7,2,0,0,13,3,7,8,0,0,18,nowin,loss,beat,dlwin,0,10,11,201,0.422885572,0.064676617,0.55721393,0,0.027255383
10915,71,21820,6,10,0,0,0,16,3,7,8,0,0,18,nowin,loss,beat,dlwin,0,10,16,193,0.352331606,0.046632124,0.585492228,0,0.013063661
10916,80,21820,6,10,0,0,0,16,3,7,8,0,0,18,nowin,loss,beat,dlwin,0,10,16,186,0.419354839,0.059139785,0.623655914,2,0.59892924
10917,29,21820,10,11,0,0,0,21,3,7,8,0,0,18,win,win,plwin,beat,25,0,21,189,0.44973545,0.058201058,0.544973545,1,0.300349439
10918,122,21820,6,4,3,0,0,13,3,7,8,0,0,18,nowin,loss,beat,dlwin,0,10,10,210,0.347619048,0.052380952,0.59047619,0,0.012873677
10919,117,21820,7,6,0,0,0,13,3,7,8,0,0,18,nowin,loss,beat,dlwin,0,10,13,173,0.410404624,0.069364162,0.606936416,2,0.578610282
10920,101,21821,7,11,0,0,0,18,10,3,1,7,0,21,nowin,loss,beat,dlwin,0,10,18,205,0.424390244,0.068292683,0.63902439,2,0.614740646
10921,120,21821,4,1,8,1,4,18,10,3,1,7,0,21,nowin,loss,beat,dlwin,0,10,5,202,0.440594059,0.034653465,0.618811881,2,0.614441029
10922,55,21821,10,7,0,0,0,17,10,3,1,7,0,21,nowin,loss,beat,dlwin,0,10,17,191,0.371727749,0.057591623,0.54973822,0,0.01011347
10923,83,21821,8,10,0,0,0,18,10,3,1,7,0,21,nowin,loss,beat,dlwin,0,10,18,193,0.424870466,0.051813472,0.678756477,2,0.644360335
10924,11,21821,2,5,5,10,0,22,10,3,1,7,0,21,nowin,loss,bust,plbust,0,10,7,236,0.457627119,0.016949153,0.588983051,3,0.889015813
10925,58,21821,10,10,0,0,0,20,10,3,1,7,0,21,nowin,loss,beat,dlwin,0,10,20,195,0.430769231,0.041025641,0.584615385,2,0.580497586
10926,123,21822,2,5,3,5,0,15,3,2,10,10,0,25,nowin,win,dlbust,bust,20,0,7,205,0.43902439,0.034146341,0.614634146,2,0.609962544
10927,29,21822,1,3,8,7,0,19,3,2,10,10,0,25,nowin,win,dlbust,bust,20,0,4,189,0.44973545,0.058201058,0.544973545,1,0.300349439
10928,147,21822,9,11,0,0,0,20,3,2,10,10,0,25,nowin,win,dlbust,bust,20,0,20,205,0.380487805,0.014634146,0.536585366,0,0.00951447
10929,136,21822,3,4,10,0,0,17,3,2,10,10,0,25,nowin,win,dlbust,bust,20,0,7,194,0.396907216,0.025773196,0.597938144,0,0.029452644
10930,103,21822,8,4,0,10,0,22,3,2,10,10,0,25,nowin,loss,bust,plbust,0,10,12,203,0.379310345,0.064039409,0.551724138,0,0.012869209
10931,102,21822,10,2,0,10,0,22,3,2,10,10,0,25,nowin,loss,bust,plbust,0,10,12,192,0.338541667,0.046875,0.5625,0,0.003306118
10932,133,21823,10,6,0,8,0,24,7,2,3,10,0,22,nowin,loss,bust,plbust,0,10,16,201,0.47761194,0.064676617,0.611940299,3,0.935428111
10933,57,21823,3,3,6,8,0,20,7,2,3,10,0,22,nowin,win,dlbust,bust,20,0,6,192,0.46875,0.052083333,0.59375,3,0.907001181
10934,24,21823,3,8,8,0,0,19,7,2,3,10,0,22,nowin,win,dlbust,bust,20,0,11,207,0.458937198,0.048309179,0.570048309,1,0.318138014
10935,55,21823,9,6,0,6,0,21,7,2,3,10,0,22,nowin,win,dlbust,bust,20,0,15,191,0.371727749,0.057591623,0.54973822,0,0.01011347
10936,135,21823,4,10,0,10,0,24,7,2,3,10,0,22,nowin,loss,bust,plbust,0,10,14,179,0.391061453,0.067039106,0.586592179,0,0.024924662
10937,60,21823,8,2,10,0,0,20,7,2,3,10,0,22,nowin,win,dlbust,bust,20,0,10,227,0.418502203,0.022026432,0.559471366,0,0.026496258
10938,145,21824,10,8,0,0,0,18,10,7,0,0,0,17,nowin,win,plwin,beat,20,0,18,188,0.441489362,0.031914894,0.622340426,2,0.617837093
10939,20,21824,10,11,0,0,0,21,10,7,0,0,0,17,win,win,plwin,beat,25,0,21,186,0.456989247,0.037634409,0.537634409,1,0.301097108
10940,85,21824,4,3,9,10,0,26,10,7,0,0,0,17,nowin,loss,bust,plbust,0,10,7,195,0.41025641,0.066666667,0.594871795,0,0.03269711
10941,107,21824,6,4,7,0,0,17,10,7,0,0,0,17,nowin,push,push,push,10,0,10,218,0.444954128,0.073394495,0.600917431,2,0.605210014
10942,49,21824,7,9,0,7,0,23,10,7,0,0,0,17,nowin,loss,bust,plbust,0,10,16,207,0.396135266,0.053140097,0.594202899,0,0.028306925
10943,28,21824,3,2,8,5,0,18,10,7,0,0,0,17,nowin,win,plwin,beat,20,0,5,199,0.422110553,0.045226131,0.542713568,1,0.282706618
10944,5,21825,2,9,4,10,0,25,10,10,0,0,0,20,nowin,loss,bust,plbust,0,10,11,203,0.42364532,0.02955665,0.596059113,2,0.582508076
10945,5,21825,10,7,0,0,0,17,10,10,0,0,0,20,nowin,loss,beat,dlwin,0,10,17,203,0.42364532,0.02955665,0.596059113,2,0.582508076
10946,109,21825,10,5,0,4,0,19,10,10,0,0,0,20,nowin,loss,beat,dlwin,0,10,15,221,0.461538462,0.058823529,0.597285068,3,0.901830309
10947,112,21825,9,5,0,6,0,20,10,10,0,0,0,20,nowin,push,push,push,10,0,14,203,0.448275862,0.054187192,0.600985222,3,0.889576933
10948,133,21825,10,6,0,10,0,26,10,10,0,0,0,20,nowin,loss,bust,plbust,0,10,16,201,0.47761194,0.064676617,0.611940299,3,0.935428111
10949,136,21825,5,10,0,7,0,22,10,10,0,0,0,20,nowin,loss,bust,plbust,0,10,15,194,0.396907216,0.025773196,0.597938144,0,0.029452644
10950,32,21826,11,3,1,0,0,15,4,10,2,5,0,21,nowin,loss,beat,dlwin,0,10,14,189,0.391534392,0.037037037,0.53968254,0,0.013579086
10951,71,21826,6,8,0,0,0,14,4,10,2,5,0,21,nowin,loss,beat,dlwin,0,10,14,193,0.352331606,0.046632124,0.585492228,0,0.013063661
10952,79,21826,5,8,0,0,0,13,4,10,2,5,0,21,nowin,loss,beat,dlwin,0,10,13,211,0.436018957,0.028436019,0.672985782,2,0.650131054
10953,13,21826,7,10,0,0,0,17,4,10,2,5,0,21,nowin,loss,beat,dlwin,0,10,17,206,0.417475728,0.063106796,0.621359223,2,0.59555479
10954,13,21826,10,5,0,0,0,15,4,10,2,5,0,21,nowin,loss,beat,dlwin,0,10,15,206,0.417475728,0.063106796,0.621359223,2,0.59555479
10955,126,21826,10,11,0,0,0,21,4,10,2,5,0,21,win,push,push,push,10,0,21,188,0.457446809,0.074468085,0.60106383,3,0.900633203
10956,139,21827,3,10,0,10,0,23,10,6,3,0,0,19,nowin,loss,bust,plbust,0,10,13,192,0.380208333,0.036458333,0.59375,0,0.023429169
10957,126,21827,10,8,0,0,0,18,10,6,3,0,0,19,nowin,loss,beat,dlwin,0,10,18,188,0.457446809,0.074468085,0.60106383,3,0.900633203
10958,66,21827,7,4,7,0,0,18,10,6,3,0,0,19,nowin,loss,beat,dlwin,0,10,11,217,0.456221198,0.064516129,0.626728111,3,0.924304367
10959,136,21827,2,6,6,4,0,18,10,6,3,0,0,19,nowin,loss,beat,dlwin,0,10,8,194,0.396907216,0.025773196,0.597938144,0,0.029452644
10960,128,21827,7,8,0,5,0,20,10,6,3,0,0,19,nowin,win,plwin,beat,20,0,15,227,0.356828194,0.052863436,0.577092511,0,0.012352564
10961,51,21827,4,7,7,0,0,18,10,6,3,0,0,19,nowin,loss,beat,dlwin,0,10,11,189,0.529100529,0.068783069,0.608465608,3,0.993665715
10962,80,21828,6,4,10,0,0,20,6,2,10,0,0,18,nowin,win,plwin,beat,20,0,10,186,0.419354839,0.059139785,0.623655914,2,0.59892924
10963,139,21828,10,7,0,0,0,17,6,2,10,0,0,18,nowin,loss,beat,dlwin,0,10,17,192,0.380208333,0.036458333,0.59375,0,0.023429169
10964,104,21828,8,9,0,0,0,17,6,2,10,0,0,18,nowin,loss,beat,dlwin,0,10,17,209,0.363636364,0.052631579,0.593301435,0,0.018359419
10965,26,21828,8,9,0,0,0,17,6,2,10,0,0,18,nowin,loss,beat,dlwin,0,10,17,203,0.463054187,0.0591133,0.541871921,1,0.306802864
10966,27,21828,10,10,0,0,0,20,6,2,10,0,0,18,nowin,win,plwin,beat,20,0,20,178,0.370786517,0.016853933,0.573033708,0,0.015536309
10967,77,21828,10,2,0,0,0,12,6,2,10,0,0,18,nowin,loss,beat,dlwin,0,10,12,200,0.455,0.04,0.62,3,0.916252116
10968,111,21829,4,4,8,1,0,17,10,2,10,0,0,22,nowin,win,dlbust,bust,20,0,8,180,0.433333333,0.055555556,0.611111111,2,0.602264492
10969,73,21829,10,10,0,0,0,20,10,2,10,0,0,22,nowin,win,dlbust,bust,20,0,20,181,0.375690608,0.011049724,0.596685083,0,0.022795773
10970,22,21829,10,11,0,0,0,21,10,2,10,0,0,22,win,win,dlbust,bust,25,0,21,187,0.481283422,0.042780749,0.577540107,3,0.906128176
10971,61,21829,10,2,0,10,0,22,10,2,10,0,0,22,nowin,loss,bust,plbust,0,10,12,194,0.427835052,0.077319588,0.603092784,2,0.591437139
10972,133,21829,10,10,0,0,0,20,10,2,10,0,0,22,nowin,win,dlbust,bust,20,0,20,201,0.47761194,0.064676617,0.611940299,3,0.935428111
10973,4,21829,11,9,0,0,0,20,10,2,10,0,0,22,nowin,win,dlbust,bust,20,0,20,217,0.460829493,0.036866359,0.562211982,1,0.315432839
10974,54,21830,8,10,0,0,0,18,8,5,3,3,0,19,nowin,loss,beat,dlwin,0,10,18,185,0.437837838,0.032432432,0.556756757,1,0.29899854
10975,143,21830,5,10,0,8,0,23,8,5,3,3,0,19,nowin,loss,bust,plbust,0,10,15,203,0.463054187,0.044334975,0.57635468,3,0.883143365
10976,87,21830,4,10,0,10,0,24,8,5,3,3,0,19,nowin,loss,bust,plbust,0,10,14,202,0.405940594,0.054455446,0.628712871,2,0.590599801
10977,99,21830,10,10,0,0,0,20,8,5,3,3,0,19,nowin,win,plwin,beat,20,0,20,207,0.47826087,0.062801932,0.637681159,3,0.961418446
10978,54,21830,10,2,0,10,0,22,8,5,3,3,0,19,nowin,loss,bust,plbust,0,10,12,185,0.437837838,0.032432432,0.556756757,1,0.29899854
10979,38,21830,10,9,0,0,0,19,8,5,3,3,0,19,nowin,push,push,push,10,0,19,202,0.361386139,0.03960396,0.564356436,0,0.010597953
10980,55,21831,10,11,0,0,0,21,9,4,2,7,0,22,win,win,dlbust,bust,25,0,21,191,0.371727749,0.057591623,0.54973822,0,0.01011347
10981,124,21831,10,10,0,0,0,20,9,4,2,7,0,22,nowin,win,dlbust,bust,20,0,20,202,0.47029703,0.064356436,0.584158416,3,0.899458193
10982,17,21831,2,9,4,4,0,19,9,4,2,7,0,22,nowin,win,dlbust,bust,20,0,11,171,0.444444444,0.070175439,0.555555556,1,0.302364894
10983,81,21831,2,7,10,0,0,19,9,4,2,7,0,22,nowin,win,dlbust,bust,20,0,9,182,0.395604396,0.043956044,0.60989011,2,0.567491261
10984,65,21831,10,4,0,7,0,21,9,4,2,7,0,22,nowin,win,dlbust,bust,20,0,14,203,0.492610837,0.054187192,0.571428571,3,0.913702814
10985,136,21831,3,10,0,10,0,23,9,4,2,7,0,22,nowin,loss,bust,plbust,0,10,13,194,0.396907216,0.025773196,0.597938144,0,0.029452644
10986,115,21832,10,7,0,0,0,17,11,10,0,0,0,21,nowin,loss,beat,dlwin,0,10,17,194,0.427835052,0.041237113,0.592783505,2,0.583863602
10987,148,21832,10,10,0,0,0,20,11,10,0,0,0,21,nowin,loss,beat,dlwin,0,10,20,204,0.401960784,0.078431373,0.593137255,0,0.029789521
10988,136,21832,10,4,0,10,0,24,11,10,0,0,0,21,nowin,loss,bust,plbust,0,10,14,194,0.396907216,0.025773196,0.597938144,0,0.029452644
10989,36,21832,10,3,0,4,0,17,11,10,0,0,0,21,nowin,loss,beat,dlwin,0,10,13,229,0.445414847,0.056768559,0.655021834,2,0.645370571
10990,120,21832,10,10,0,0,0,20,11,10,0,0,0,21,nowin,loss,beat,dlwin,0,10,20,202,0.440594059,0.034653465,0.618811881,2,0.614441029
10991,149,21832,9,8,0,0,0,17,11,10,0,0,0,21,nowin,loss,beat,dlwin,0,10,17,225,0.457777778,0.057777778,0.648888889,2,0.651965595
10992,5,21833,9,4,0,8,0,21,9,8,0,0,0,17,nowin,win,plwin,beat,20,0,13,203,0.42364532,0.02955665,0.596059113,2,0.582508076
10993,11,21833,8,10,0,0,0,18,9,8,0,0,0,17,nowin,win,plwin,beat,20,0,18,236,0.457627119,0.016949153,0.588983051,3,0.889015813
10994,41,21833,7,7,0,6,0,20,9,8,0,0,0,17,nowin,win,plwin,beat,20,0,14,192,0.364583333,0.036458333,0.520833333,0,0.00089702
10995,92,21833,4,9,0,5,0,18,9,8,0,0,0,17,nowin,win,plwin,beat,20,0,13,186,0.446236559,0.059139785,0.564516129,1,0.307826125
10996,120,21833,5,10,0,5,0,20,9,8,0,0,0,17,nowin,win,plwin,beat,20,0,15,202,0.440594059,0.034653465,0.618811881,2,0.614441029
10997,9,21833,10,5,0,7,0,22,9,8,0,0,0,17,nowin,loss,bust,plbust,0,10,15,194,0.37628866,0.015463918,0.541237113,0,0.009396796
10998,137,21834,3,3,10,10,0,26,11,10,0,0,0,21,nowin,loss,bust,plbust,0,10,6,194,0.417525773,0.046391753,0.536082474,1,0.276714602
10999,149,21834,8,2,7,0,0,17,11,10,0,0,0,21,nowin,loss,beat,dlwin,0,10,10,225,0.457777778,0.057777778,0.648888889,2,0.651965595
11000,24,21834,9,10,0,0,0,19,11,10,0,0,0,21,nowin,loss,beat,dlwin,0,10,19,207,0.458937198,0.048309179,0.570048309,1,0.318138014
11001,50,21834,2,10,0,10,0,22,11,10,0,0,0,21,nowin,loss,bust,plbust,0,10,12,202,0.405940594,0.04950495,0.54950495,0,0.020296079
11002,83,21834,10,5,0,8,0,23,11,10,0,0,0,21,nowin,loss,bust,plbust,0,10,15,193,0.424870466,0.051813472,0.678756477,2,0.644360335
11003,36,21834,6,10,0,1,0,17,11,10,0,0,0,21,nowin,loss,beat,dlwin,0,10,16,229,0.445414847,0.056768559,0.655021834,2,0.645370571
11004,1,21835,2,7,5,8,0,22,8,10,0,0,0,18,nowin,loss,bust,plbust,0,10,9,197,0.406091371,0.025380711,0.649746193,2,0.606186955
11005,68,21835,7,10,0,0,0,17,8,10,0,0,0,18,nowin,loss,beat,dlwin,0,10,17,205,0.434146341,0.029268293,0.6,2,0.59483189
11006,41,21835,8,10,0,0,0,18,8,10,0,0,0,18,nowin,push,push,push,10,0,18,192,0.364583333,0.036458333,0.520833333,0,0.00089702
11007,22,21835,9,10,0,0,0,19,8,10,0,0,0,18,nowin,win,plwin,beat,20,0,19,187,0.481283422,0.042780749,0.577540107,3,0.906128176
11008,139,21835,8,10,0,0,0,18,8,10,0,0,0,18,nowin,push,push,push,10,0,18,192,0.380208333,0.036458333,0.59375,0,0.023429169
11009,59,21835,7,5,0,8,0,20,8,10,0,0,0,18,nowin,win,plwin,beat,20,0,12,228,0.429824561,0.048245614,0.543859649,1,0.287885446
11010,14,21836,2,6,10,0,0,18,11,9,0,0,0,20,nowin,loss,beat,dlwin,0,10,8,202,0.391089109,0.01980198,0.628712871,2,0.577264877
11011,69,21836,10,6,0,10,0,26,11,9,0,0,0,20,nowin,loss,bust,plbust,0,10,16,194,0.365979381,0.030927835,0.515463918,0,0
11012,78,21836,10,10,0,0,0,20,11,9,0,0,0,20,nowin,push,push,push,10,0,20,201,0.517412935,0.034825871,0.587064677,3,0.95871112
11013,99,21836,11,10,0,0,0,21,11,9,0,0,0,20,win,win,plwin,beat,25,0,21,207,0.47826087,0.062801932,0.637681159,3,0.961418446
11014,138,21836,7,10,0,0,0,17,11,9,0,0,0,20,nowin,loss,beat,dlwin,0,10,17,190,0.442105263,0.047368421,0.610526316,2,0.609711065
11015,107,21836,5,11,4,0,0,20,11,9,0,0,0,20,nowin,push,push,push,10,0,16,218,0.444954128,0.073394495,0.600917431,2,0.605210014
11016,47,21837,2,10,0,1,0,13,3,10,1,10,0,24,nowin,win,dlbust,bust,20,0,12,210,0.438095238,0.057142857,0.623809524,2,0.615868808
11017,145,21837,7,9,0,0,0,16,3,10,1,10,0,24,nowin,win,dlbust,bust,20,0,16,188,0.441489362,0.031914894,0.622340426,2,0.617837093
11018,102,21837,10,5,0,0,0,15,3,10,1,10,0,24,nowin,win,dlbust,bust,20,0,15,192,0.338541667,0.046875,0.5625,0,0.003306118
11019,134,21837,5,4,10,0,0,19,3,10,1,10,0,24,nowin,win,dlbust,bust,20,0,9,185,0.443243243,0.021621622,0.545945946,1,0.296939509
11020,52,21837,6,10,0,0,0,16,3,10,1,10,0,24,nowin,win,dlbust,bust,20,0,16,217,0.414746544,0.02764977,0.599078341,2,0.576736024
11021,107,21837,9,10,0,0,0,19,3,10,1,10,0,24,nowin,win,dlbust,bust,20,0,19,218,0.444954128,0.073394495,0.600917431,2,0.605210014
11022,87,21838,5,10,0,8,0,23,11,10,0,0,0,21,nowin,loss,bust,plbust,0,10,15,202,0.405940594,0.054455446,0.628712871,2,0.590599801
11023,104,21838,7,5,0,10,0,22,11,10,0,0,0,21,nowin,loss,bust,plbust,0,10,12,209,0.363636364,0.052631579,0.593301435,0,0.018359419
11024,115,21838,10,10,0,0,0,20,11,10,0,0,0,21,nowin,loss,beat,dlwin,0,10,20,194,0.427835052,0.041237113,0.592783505,2,0.583863602
11025,145,21838,4,9,0,7,0,20,11,10,0,0,0,21,nowin,loss,beat,dlwin,0,10,13,188,0.441489362,0.031914894,0.622340426,2,0.617837093
11026,68,21838,4,8,0,2,6,20,11,10,0,0,0,21,nowin,loss,beat,dlwin,0,10,12,205,0.434146341,0.029268293,0.6,2,0.59483189
11027,123,21838,3,6,6,2,0,17,11,10,0,0,0,21,nowin,loss,beat,dlwin,0,10,9,205,0.43902439,0.034146341,0.614634146,2,0.609962544
11028,57,21839,7,9,0,9,0,25,7,11,0,0,0,18,nowin,loss,bust,plbust,0,10,16,192,0.46875,0.052083333,0.59375,3,0.907001181
11029,54,21839,7,8,0,8,0,23,7,11,0,0,0,18,nowin,loss,bust,plbust,0,10,15,185,0.437837838,0.032432432,0.556756757,1,0.29899854
11030,54,21839,6,7,0,4,0,17,7,11,0,0,0,18,nowin,loss,beat,dlwin,0,10,13,185,0.437837838,0.032432432,0.556756757,1,0.29899854
11031,119,21839,10,2,0,10,0,22,7,11,0,0,0,18,nowin,loss,bust,plbust,0,10,12,190,0.405263158,0.068421053,0.515789474,0,0.011837158
11032,135,21839,2,4,10,10,0,26,7,11,0,0,0,18,nowin,loss,bust,plbust,0,10,6,179,0.391061453,0.067039106,0.586592179,0,0.024924662
11033,17,21839,2,3,10,10,0,25,7,11,0,0,0,18,nowin,loss,bust,plbust,0,10,5,171,0.444444444,0.070175439,0.555555556,1,0.302364894
11034,118,21840,2,6,10,0,0,18,9,8,0,0,0,17,nowin,win,plwin,beat,20,0,8,216,0.393518519,0.037037037,0.555555556,0,0.018059873
11035,58,21840,11,9,0,0,0,20,9,8,0,0,0,17,nowin,win,plwin,beat,20,0,20,195,0.430769231,0.041025641,0.584615385,2,0.580497586
11036,102,21840,2,11,2,10,0,25,9,8,0,0,0,17,nowin,loss,bust,plbust,0,10,13,192,0.338541667,0.046875,0.5625,0,0.003306118
11037,53,21840,10,10,0,0,0,20,9,8,0,0,0,17,nowin,win,plwin,beat,20,0,20,250,0.372,0.064,0.564,0,0.013687345
11038,39,21840,1,4,9,3,0,17,9,8,0,0,0,17,nowin,push,push,push,10,0,5,191,0.429319372,0.062827225,0.57591623,0,0.033760763
11039,93,21840,4,10,0,10,0,24,9,8,0,0,0,17,nowin,loss,bust,plbust,0,10,14,175,0.485714286,0.051428571,0.548571429,1,0.323648091
11040,105,21841,9,9,0,0,0,18,6,3,5,10,0,24,nowin,win,dlbust,bust,20,0,18,198,0.414141414,0.070707071,0.590909091,0,0.032889494
11041,73,21841,5,5,4,0,0,14,6,3,5,10,0,24,nowin,win,dlbust,bust,20,0,10,181,0.375690608,0.011049724,0.596685083,0,0.022795773
11042,26,21841,9,10,0,0,0,19,6,3,5,10,0,24,nowin,win,dlbust,bust,20,0,19,203,0.463054187,0.0591133,0.541871921,1,0.306802864
11043,27,21841,9,10,0,0,0,19,6,3,5,10,0,24,nowin,win,dlbust,bust,20,0,19,178,0.370786517,0.016853933,0.573033708,0,0.015536309
11044,79,21841,2,2,3,10,0,17,6,3,5,10,0,24,nowin,win,dlbust,bust,20,0,4,211,0.436018957,0.028436019,0.672985782,2,0.650131054
11045,84,21841,8,7,0,0,0,15,6,3,5,10,0,24,nowin,win,dlbust,bust,20,0,15,195,0.379487179,0.056410256,0.569230769,0,0.017209119
11046,112,21842,6,8,0,0,0,14,5,10,7,0,0,22,nowin,win,dlbust,bust,20,0,14,203,0.448275862,0.054187192,0.600985222,3,0.889576933
11047,66,21842,10,6,0,0,0,16,5,10,7,0,0,22,nowin,win,dlbust,bust,20,0,16,217,0.456221198,0.064516129,0.626728111,3,0.924304367
11048,86,21842,10,10,0,0,0,20,5,10,7,0,0,22,nowin,win,dlbust,bust,20,0,20,196,0.454081633,0.040816327,0.591836735,3,0.887566443
11049,119,21842,3,2,10,0,0,15,5,10,7,0,0,22,nowin,win,dlbust,bust,20,0,5,190,0.405263158,0.068421053,0.515789474,0,0.011837158
11050,145,21842,10,5,0,0,0,15,5,10,7,0,0,22,nowin,win,dlbust,bust,20,0,15,188,0.441489362,0.031914894,0.622340426,2,0.617837093
11051,87,21842,10,10,0,0,0,20,5,10,7,0,0,22,nowin,win,dlbust,bust,20,0,20,202,0.405940594,0.054455446,0.628712871,2,0.590599801
11052,94,21843,6,3,7,7,0,23,8,7,10,0,0,25,nowin,loss,bust,plbust,0,10,9,183,0.43715847,0.043715847,0.540983607,1,0.290866892
11053,27,21843,10,4,0,10,0,24,8,7,10,0,0,25,nowin,loss,bust,plbust,0,10,14,178,0.370786517,0.016853933,0.573033708,0,0.015536309
11054,51,21843,8,8,0,8,0,24,8,7,10,0,0,25,nowin,loss,bust,plbust,0,10,16,189,0.529100529,0.068783069,0.608465608,3,0.993665715
11055,108,21843,7,4,7,0,0,18,8,7,10,0,0,25,nowin,win,dlbust,bust,20,0,11,193,0.435233161,0.056994819,0.559585492,1,0.298824795
11056,39,21843,10,2,0,1,7,20,8,7,10,0,0,25,nowin,win,dlbust,bust,20,0,12,191,0.429319372,0.062827225,0.57591623,0,0.033760763
11057,5,21843,7,10,0,0,0,17,8,7,10,0,0,25,nowin,win,dlbust,bust,20,0,17,203,0.42364532,0.02955665,0.596059113,2,0.582508076
11058,61,21844,3,3,10,10,0,26,10,3,7,0,0,20,nowin,loss,bust,plbust,0,10,6,194,0.427835052,0.077319588,0.603092784,2,0.591437139
11059,16,21844,8,10,0,0,0,18,10,3,7,0,0,20,nowin,loss,beat,dlwin,0,10,18,220,0.427272727,0.081818182,0.6,2,0.588660176
11060,54,21844,9,10,0,0,0,19,10,3,7,0,0,20,nowin,loss,beat,dlwin,0,10,19,185,0.437837838,0.032432432,0.556756757,1,0.29899854
11061,30,21844,10,11,0,0,0,21,10,3,7,0,0,20,win,win,plwin,beat,25,0,21,206,0.393203883,0.033980583,0.601941748,0,0.029324648
11062,57,21844,10,8,0,0,0,18,10,3,7,0,0,20,nowin,loss,beat,dlwin,0,10,18,192,0.46875,0.052083333,0.59375,3,0.907001181
11063,96,21844,11,10,0,0,0,21,10,3,7,0,0,20,win,win,plwin,beat,25,0,21,190,0.468421053,0.057894737,0.584210526,3,0.897263354
11064,56,21845,7,10,0,0,0,17,10,10,0,0,0,20,nowin,loss,beat,dlwin,0,10,17,175,0.4,0.057142857,0.582857143,0,0.026685297
11065,47,21845,10,9,0,0,0,19,10,10,0,0,0,20,nowin,loss,beat,dlwin,0,10,19,210,0.438095238,0.057142857,0.623809524,2,0.615868808
11066,97,21845,5,1,10,5,0,21,10,10,0,0,0,20,nowin,win,plwin,beat,20,0,6,182,0.450549451,0.06043956,0.692307692,2,0.677372279
11067,55,21845,10,7,0,0,0,17,10,10,0,0,0,20,nowin,loss,beat,dlwin,0,10,17,191,0.371727749,0.057591623,0.54973822,0,0.01011347
11068,103,21845,9,10,0,0,0,19,10,10,0,0,0,20,nowin,loss,beat,dlwin,0,10,19,203,0.379310345,0.064039409,0.551724138,0,0.012869209
11069,84,21845,4,10,0,10,0,24,10,10,0,0,0,20,nowin,loss,bust,plbust,0,10,14,195,0.379487179,0.056410256,0.569230769,0,0.017209119
11070,135,21846,8,10,0,0,0,18,4,9,3,4,0,20,nowin,loss,beat,dlwin,0,10,18,179,0.391061453,0.067039106,0.586592179,0,0.024924662
11071,61,21846,4,10,0,0,0,14,4,9,3,4,0,20,nowin,loss,beat,dlwin,0,10,14,194,0.427835052,0.077319588,0.603092784,2,0.591437139
11072,103,21846,7,6,0,0,0,13,4,9,3,4,0,20,nowin,loss,beat,dlwin,0,10,13,203,0.379310345,0.064039409,0.551724138,0,0.012869209
11073,138,21846,3,2,10,0,0,15,4,9,3,4,0,20,nowin,loss,beat,dlwin,0,10,5,190,0.442105263,0.047368421,0.610526316,2,0.609711065
11074,98,21846,7,10,0,0,0,17,4,9,3,4,0,20,nowin,loss,beat,dlwin,0,10,17,220,0.422727273,0.054545455,0.55,1,0.28664435
11075,149,21846,10,10,0,0,0,20,4,9,3,4,0,20,nowin,push,push,push,10,0,20,225,0.457777778,0.057777778,0.648888889,2,0.651965595
11076,47,21847,5,9,0,10,0,24,7,4,10,0,0,21,nowin,loss,bust,plbust,0,10,14,210,0.438095238,0.057142857,0.623809524,2,0.615868808
11077,6,21847,5,10,0,8,0,23,7,4,10,0,0,21,nowin,loss,bust,plbust,0,10,15,191,0.439790576,0.047120419,0.581151832,1,0.31211505
11078,136,21847,11,10,0,0,0,21,7,4,10,0,0,21,win,push,push,push,10,0,21,194,0.396907216,0.025773196,0.597938144,0,0.029452644
11079,30,21847,10,9,0,0,0,19,7,4,10,0,0,21,nowin,loss,beat,dlwin,0,10,19,206,0.393203883,0.033980583,0.601941748,0,0.029324648
11080,71,21847,10,2,0,3,8,23,7,4,10,0,0,21,nowin,loss,bust,plbust,0,10,12,193,0.352331606,0.046632124,0.585492228,0,0.013063661
11081,104,21847,6,10,0,4,0,20,7,4,10,0,0,21,nowin,loss,beat,dlwin,0,10,16,209,0.363636364,0.052631579,0.593301435,0,0.018359419
11082,106,21848,8,8,0,0,0,16,4,6,10,0,0,20,nowin,loss,beat,dlwin,0,10,16,192,0.411458333,0.026041667,0.557291667,0,0.023854304
11083,66,21848,10,2,0,0,0,12,4,6,10,0,0,20,nowin,loss,beat,dlwin,0,10,12,217,0.456221198,0.064516129,0.626728111,3,0.924304367
11084,147,21848,10,10,0,0,0,20,4,6,10,0,0,20,nowin,push,push,push,10,0,20,205,0.380487805,0.014634146,0.536585366,0,0.00951447
11085,59,21848,5,8,0,0,0,13,4,6,10,0,0,20,nowin,loss,beat,dlwin,0,10,13,228,0.429824561,0.048245614,0.543859649,1,0.287885446
11086,107,21848,2,9,5,0,0,16,4,6,10,0,0,20,nowin,loss,beat,dlwin,0,10,11,218,0.444954128,0.073394495,0.600917431,2,0.605210014
11087,13,21848,10,11,0,0,0,21,4,6,10,0,0,20,win,win,plwin,beat,25,0,21,206,0.417475728,0.063106796,0.621359223,2,0.59555479
11088,11,21849,3,10,0,0,0,13,6,10,10,0,0,26,nowin,win,dlbust,bust,20,0,13,236,0.457627119,0.016949153,0.588983051,3,0.889015813
11089,32,21849,10,10,0,0,0,20,6,10,10,0,0,26,nowin,win,dlbust,bust,20,0,20,189,0.391534392,0.037037037,0.53968254,0,0.013579086
11090,68,21849,2,4,10,0,0,16,6,10,10,0,0,26,nowin,win,dlbust,bust,20,0,6,205,0.434146341,0.029268293,0.6,2,0.59483189
11091,131,21849,3,9,0,0,0,12,6,10,10,0,0,26,nowin,win,dlbust,bust,20,0,12,217,0.410138249,0.069124424,0.543778802,0,0.02015021
11092,42,21849,2,4,10,0,0,16,6,10,10,0,0,26,nowin,win,dlbust,bust,20,0,6,212,0.443396226,0.051886792,0.570754717,1,0.309181312
11093,147,21849,10,10,0,0,0,20,6,10,10,0,0,26,nowin,win,dlbust,bust,20,0,20,205,0.380487805,0.014634146,0.536585366,0,0.00951447
11094,52,21850,8,3,9,0,0,20,10,9,0,0,0,19,nowin,win,plwin,beat,20,0,11,217,0.414746544,0.02764977,0.599078341,2,0.576736024
11095,143,21850,10,7,0,0,0,17,10,9,0,0,0,19,nowin,loss,beat,dlwin,0,10,17,203,0.463054187,0.044334975,0.57635468,3,0.883143365
11096,19,21850,10,5,0,10,0,25,10,9,0,0,0,19,nowin,loss,bust,plbust,0,10,15,237,0.41350211,0.054852321,0.628691983,2,0.597373826
11097,146,21850,10,7,0,0,0,17,10,9,0,0,0,19,nowin,loss,beat,dlwin,0,10,17,221,0.43438914,0.040723982,0.542986425,1,0.290190091
11098,69,21850,7,7,0,2,10,26,10,9,0,0,0,19,nowin,loss,bust,plbust,0,10,14,194,0.365979381,0.030927835,0.515463918,0,0
11099,120,21850,11,10,0,0,0,21,10,9,0,0,0,19,win,win,plwin,beat,25,0,21,202,0.440594059,0.034653465,0.618811881,2,0.614441029
11100,9,21851,7,10,0,0,0,17,7,11,0,0,0,18,nowin,loss,beat,dlwin,0,10,17,194,0.37628866,0.015463918,0.541237113,0,0.009396796
11101,38,21851,8,10,0,0,0,18,7,11,0,0,0,18,nowin,push,push,push,10,0,18,202,0.361386139,0.03960396,0.564356436,0,0.010597953
11102,133,21851,10,7,0,0,0,17,7,11,0,0,0,18,nowin,loss,beat,dlwin,0,10,17,201,0.47761194,0.064676617,0.611940299,3,0.935428111
11103,6,21851,10,10,0,0,0,20,7,11,0,0,0,18,nowin,win,plwin,beat,20,0,20,191,0.439790576,0.047120419,0.581151832,1,0.31211505
11104,16,21851,11,10,0,0,0,21,7,11,0,0,0,18,win,win,plwin,beat,25,0,21,220,0.427272727,0.081818182,0.6,2,0.588660176
11105,13,21851,10,10,0,0,0,20,7,11,0,0,0,18,nowin,win,plwin,beat,20,0,20,206,0.417475728,0.063106796,0.621359223,2,0.59555479
11106,147,21852,1,4,8,9,0,22,10,6,6,0,0,22,nowin,loss,bust,plbust,0,10,5,205,0.380487805,0.014634146,0.536585366,0,0.00951447
11107,150,21852,5,5,5,5,0,20,10,6,6,0,0,22,nowin,win,dlbust,bust,20,0,10,192,0.401041667,0.036458333,0.567708333,0,0.023287458
11108,126,21852,8,10,0,0,0,18,10,6,6,0,0,22,nowin,win,dlbust,bust,20,0,18,188,0.457446809,0.074468085,0.60106383,3,0.900633203
11109,85,21852,11,8,0,0,0,19,10,6,6,0,0,22,nowin,win,dlbust,bust,20,0,19,195,0.41025641,0.066666667,0.594871795,0,0.03269711
11110,43,21852,4,3,4,10,0,21,10,6,6,0,0,22,nowin,win,dlbust,bust,20,0,7,192,0.40625,0.041666667,0.609375,2,0.576671372
11111,20,21852,9,4,0,3,10,26,10,6,6,0,0,22,nowin,loss,bust,plbust,0,10,13,186,0.456989247,0.037634409,0.537634409,1,0.301097108
11112,38,21853,4,10,0,0,0,14,3,10,10,0,0,23,nowin,win,dlbust,bust,20,0,14,202,0.361386139,0.03960396,0.564356436,0,0.010597953
11113,116,21853,5,2,10,0,0,17,3,10,10,0,0,23,nowin,win,dlbust,bust,20,0,7,195,0.425641026,0.056410256,0.538461538,1,0.28273747
11114,110,21853,4,3,10,0,0,17,3,10,10,0,0,23,nowin,win,dlbust,bust,20,0,7,192,0.416666667,0.046875,0.557291667,0,0.025413132
11115,52,21853,3,5,8,0,0,16,3,10,10,0,0,23,nowin,win,dlbust,bust,20,0,8,217,0.414746544,0.02764977,0.599078341,2,0.576736024
11116,77,21853,10,6,0,0,0,16,3,10,10,0,0,23,nowin,win,dlbust,bust,20,0,16,200,0.455,0.04,0.62,3,0.916252116
11117,121,21853,2,9,9,0,0,20,3,10,10,0,0,23,nowin,win,dlbust,bust,20,0,11,195,0.456410256,0.025641026,0.512820513,1,0.288597791
11118,4,21854,11,10,0,0,0,21,9,9,0,0,0,18,win,win,plwin,beat,25,0,21,217,0.460829493,0.036866359,0.562211982,1,0.315432839
11119,115,21854,10,2,0,6,0,18,9,9,0,0,0,18,nowin,push,push,push,10,0,12,194,0.427835052,0.041237113,0.592783505,2,0.583863602
11120,95,21854,10,5,0,10,0,25,9,9,0,0,0,18,nowin,loss,bust,plbust,0,10,15,218,0.412844037,0.04587156,0.559633028,0,0.024842385
11121,141,21854,4,6,8,0,0,18,9,9,0,0,0,18,nowin,push,push,push,10,0,10,202,0.420792079,0.074257426,0.564356436,0,0.028377851
11122,84,21854,2,2,9,9,0,22,9,9,0,0,0,18,nowin,loss,bust,plbust,0,10,4,195,0.379487179,0.056410256,0.569230769,0,0.017209119
11123,144,21854,2,5,3,10,0,20,9,9,0,0,0,18,nowin,win,plwin,beat,20,0,7,202,0.386138614,0.054455446,0.564356436,0,0.018006244
11124,52,21855,6,7,0,10,0,23,7,9,8,0,0,24,nowin,loss,bust,plbust,0,10,13,217,0.414746544,0.02764977,0.599078341,2,0.576736024
11125,21,21855,8,4,0,10,0,22,7,9,8,0,0,24,nowin,loss,bust,plbust,0,10,12,214,0.359813084,0.042056075,0.626168224,0,0.025263474
11126,121,21855,11,2,7,0,0,20,7,9,8,0,0,24,nowin,win,dlbust,bust,20,0,13,195,0.456410256,0.025641026,0.512820513,1,0.288597791
11127,91,21855,10,10,0,0,0,20,7,9,8,0,0,24,nowin,win,dlbust,bust,20,0,20,194,0.417525773,0.046391753,0.515463918,1,0.266616552
11128,47,21855,9,10,0,0,0,19,7,9,8,0,0,24,nowin,win,dlbust,bust,20,0,19,210,0.438095238,0.057142857,0.623809524,2,0.615868808
11129,77,21855,11,7,0,0,0,18,7,9,8,0,0,24,nowin,win,dlbust,bust,20,0,18,200,0.455,0.04,0.62,3,0.916252116
11130,111,21856,10,9,0,0,0,19,10,8,0,0,0,18,nowin,win,plwin,beat,20,0,19,180,0.433333333,0.055555556,0.611111111,2,0.602264492
11131,128,21856,10,3,0,10,0,23,10,8,0,0,0,18,nowin,loss,bust,plbust,0,10,13,227,0.356828194,0.052863436,0.577092511,0,0.012352564
11132,91,21856,5,3,7,10,0,25,10,8,0,0,0,18,nowin,loss,bust,plbust,0,10,8,194,0.417525773,0.046391753,0.515463918,1,0.266616552
11133,112,21856,5,9,0,4,0,18,10,8,0,0,0,18,nowin,push,push,push,10,0,14,203,0.448275862,0.054187192,0.600985222,3,0.889576933
11134,97,21856,5,4,6,8,0,23,10,8,0,0,0,18,nowin,loss,bust,plbust,0,10,9,182,0.450549451,0.06043956,0.692307692,2,0.677372279
11135,148,21856,9,5,0,1,2,17,10,8,0,0,0,18,nowin,loss,beat,dlwin,0,10,14,204,0.401960784,0.078431373,0.593137255,0,0.029789521
11136,116,21857,8,10,0,0,0,18,5,3,10,0,0,18,nowin,push,push,push,10,0,18,195,0.425641026,0.056410256,0.538461538,1,0.28273747
11137,149,21857,5,6,10,0,0,21,5,3,10,0,0,18,nowin,win,plwin,beat,20,0,11,225,0.457777778,0.057777778,0.648888889,2,0.651965595
11138,20,21857,10,9,0,0,0,19,5,3,10,0,0,18,nowin,win,plwin,beat,20,0,19,186,0.456989247,0.037634409,0.537634409,1,0.301097108
11139,73,21857,10,2,0,0,0,12,5,3,10,0,0,18,nowin,loss,beat,dlwin,0,10,12,181,0.375690608,0.011049724,0.596685083,0,0.022795773
11140,37,21857,10,7,0,0,0,17,5,3,10,0,0,18,nowin,loss,beat,dlwin,0,10,17,208,0.394230769,0.038461538,0.581730769,0,0.024682772
11141,15,21857,6,9,0,0,0,15,5,3,10,0,0,18,nowin,loss,beat,dlwin,0,10,15,212,0.410377358,0.051886792,0.561320755,0,0.024517408
11142,65,21858,10,5,0,3,0,18,11,6,0,0,0,17,nowin,win,plwin,beat,20,0,15,203,0.492610837,0.054187192,0.571428571,3,0.913702814
11143,8,21858,10,5,0,8,0,23,11,6,0,0,0,17,nowin,loss,bust,plbust,0,10,15,181,0.44198895,0.071823204,0.596685083,2,0.599438402
11144,31,21858,10,10,0,0,0,20,11,6,0,0,0,17,nowin,win,plwin,beat,20,0,20,188,0.473404255,0.058510638,0.515957447,1,0.300306557
11145,135,21858,2,6,10,0,0,18,11,6,0,0,0,17,nowin,win,plwin,beat,20,0,8,179,0.391061453,0.067039106,0.586592179,0,0.024924662
11146,53,21858,6,4,10,0,0,20,11,6,0,0,0,17,nowin,win,plwin,beat,20,0,10,250,0.372,0.064,0.564,0,0.013687345
11147,101,21858,2,8,10,0,0,20,11,6,0,0,0,17,nowin,win,plwin,beat,20,0,10,205,0.424390244,0.068292683,0.63902439,2,0.614740646
11148,48,21859,10,10,0,0,0,20,10,8,0,0,0,18,nowin,win,plwin,beat,20,0,20,203,0.413793103,0.019704433,0.600985222,2,0.577280801
11149,109,21859,3,7,9,0,0,19,10,8,0,0,0,18,nowin,win,plwin,beat,20,0,10,221,0.461538462,0.058823529,0.597285068,3,0.901830309
11150,108,21859,10,11,0,0,0,21,10,8,0,0,0,18,win,win,plwin,beat,25,0,21,193,0.435233161,0.056994819,0.559585492,1,0.298824795
11151,84,21859,10,10,0,0,0,20,10,8,0,0,0,18,nowin,win,plwin,beat,20,0,20,195,0.379487179,0.056410256,0.569230769,0,0.017209119
11152,96,21859,4,6,10,0,0,20,10,8,0,0,0,18,nowin,win,plwin,beat,20,0,10,190,0.468421053,0.057894737,0.584210526,3,0.897263354
11153,122,21859,9,6,0,9,0,24,10,8,0,0,0,18,nowin,loss,bust,plbust,0,10,15,210,0.347619048,0.052380952,0.59047619,0,0.012873677
11154,13,21860,10,8,0,0,0,18,4,11,1,5,0,21,nowin,loss,beat,dlwin,0,10,18,206,0.417475728,0.063106796,0.621359223,2,0.59555479
11155,102,21860,11,10,0,0,0,21,4,11,1,5,0,21,win,push,push,push,10,0,21,192,0.338541667,0.046875,0.5625,0,0.003306118
11156,31,21860,11,7,0,0,0,18,4,11,1,5,0,21,nowin,loss,beat,dlwin,0,10,18,188,0.473404255,0.058510638,0.515957447,1,0.300306557
11157,30,21860,7,10,0,0,0,17,4,11,1,5,0,21,nowin,loss,beat,dlwin,0,10,17,206,0.393203883,0.033980583,0.601941748,0,0.029324648
11158,63,21860,10,6,0,0,0,16,4,11,1,5,0,21,nowin,loss,beat,dlwin,0,10,16,216,0.467592593,0.037037037,0.62037037,3,0.931690496
11159,4,21860,7,7,0,0,0,14,4,11,1,5,0,21,nowin,loss,beat,dlwin,0,10,14,217,0.460829493,0.036866359,0.562211982,1,0.315432839
11160,140,21861,10,4,0,0,0,14,5,4,11,0,0,20,nowin,loss,beat,dlwin,0,10,14,210,0.466666667,0.023809524,0.604761905,3,0.915293335
11161,52,21861,4,1,10,0,0,15,5,4,11,0,0,20,nowin,loss,beat,dlwin,0,10,5,217,0.414746544,0.02764977,0.599078341,2,0.576736024
11162,51,21861,4,7,10,0,0,21,5,4,11,0,0,20,nowin,win,plwin,beat,20,0,11,189,0.529100529,0.068783069,0.608465608,3,0.993665715
11163,38,21861,10,10,0,0,0,20,5,4,11,0,0,20,nowin,push,push,push,10,0,20,202,0.361386139,0.03960396,0.564356436,0,0.010597953
11164,91,21861,3,9,0,0,0,12,5,4,11,0,0,20,nowin,loss,beat,dlwin,0,10,12,194,0.417525773,0.046391753,0.515463918,1,0.266616552
11165,110,21861,6,8,0,0,0,14,5,4,11,0,0,20,nowin,loss,beat,dlwin,0,10,14,192,0.416666667,0.046875,0.557291667,0,0.025413132
11166,78,21862,5,1,8,9,0,23,10,5,6,0,0,21,nowin,loss,bust,plbust,0,10,6,201,0.517412935,0.034825871,0.587064677,3,0.95871112
11167,100,21862,1,6,8,7,0,22,10,5,6,0,0,21,nowin,loss,bust,plbust,0,10,7,190,0.452631579,0.036842105,0.594736842,3,0.888671154
11168,91,21862,10,9,0,0,0,19,10,5,6,0,0,21,nowin,loss,beat,dlwin,0,10,19,194,0.417525773,0.046391753,0.515463918,1,0.266616552
11169,121,21862,10,2,0,5,0,17,10,5,6,0,0,21,nowin,loss,beat,dlwin,0,10,12,195,0.456410256,0.025641026,0.512820513,1,0.288597791
11170,2,21862,9,3,0,10,0,22,10,5,6,0,0,21,nowin,loss,bust,plbust,0,10,12,200,0.445,0.035,0.64,2,0.633962549
11171,70,21862,10,6,0,10,0,26,10,5,6,0,0,21,nowin,loss,bust,plbust,0,10,16,228,0.385964912,0.039473684,0.557017544,0,0.016157125
11172,144,21863,3,4,7,10,0,24,9,8,0,0,0,17,nowin,loss,bust,plbust,0,10,7,202,0.386138614,0.054455446,0.564356436,0,0.018006244
11173,26,21863,3,8,6,0,0,17,9,8,0,0,0,17,nowin,push,push,push,10,0,11,203,0.463054187,0.0591133,0.541871921,1,0.306802864
11174,147,21863,4,3,10,0,0,17,9,8,0,0,0,17,nowin,push,push,push,10,0,7,205,0.380487805,0.014634146,0.536585366,0,0.00951447
11175,1,21863,3,7,8,0,0,18,9,8,0,0,0,17,nowin,win,plwin,beat,20,0,10,197,0.406091371,0.025380711,0.649746193,2,0.606186955
11176,55,21863,7,5,0,5,0,17,9,8,0,0,0,17,nowin,push,push,push,10,0,12,191,0.371727749,0.057591623,0.54973822,0,0.01011347
11177,141,21863,6,8,0,3,0,17,9,8,0,0,0,17,nowin,push,push,push,10,0,14,202,0.420792079,0.074257426,0.564356436,0,0.028377851
11178,124,21864,4,8,0,6,0,18,10,4,6,0,0,20,nowin,loss,beat,dlwin,0,10,12,202,0.47029703,0.064356436,0.584158416,3,0.899458193
11179,128,21864,3,10,0,8,0,21,10,4,6,0,0,20,nowin,win,plwin,beat,20,0,13,227,0.356828194,0.052863436,0.577092511,0,0.012352564
11180,144,21864,9,2,9,0,0,20,10,4,6,0,0,20,nowin,push,push,push,10,0,11,202,0.386138614,0.054455446,0.564356436,0,0.018006244
11181,113,21864,8,3,9,0,0,20,10,4,6,0,0,20,nowin,push,push,push,10,0,11,199,0.407035176,0.055276382,0.668341709,2,0.620695264
11182,17,21864,10,2,0,10,0,22,10,4,6,0,0,20,nowin,loss,bust,plbust,0,10,12,171,0.444444444,0.070175439,0.555555556,1,0.302364894
11183,128,21864,8,5,0,4,0,17,10,4,6,0,0,20,nowin,loss,beat,dlwin,0,10,13,227,0.356828194,0.052863436,0.577092511,0,0.012352564
11184,35,21865,4,10,0,6,0,20,11,9,0,0,0,20,nowin,push,push,push,10,0,14,202,0.410891089,0.044554455,0.633663366,2,0.598681573
11185,52,21865,5,10,0,8,0,23,11,9,0,0,0,20,nowin,loss,bust,plbust,0,10,15,217,0.414746544,0.02764977,0.599078341,2,0.576736024
11186,124,21865,10,8,0,0,0,18,11,9,0,0,0,20,nowin,loss,beat,dlwin,0,10,18,202,0.47029703,0.064356436,0.584158416,3,0.899458193
11187,10,21865,5,3,2,3,7,20,11,9,0,0,0,20,nowin,push,push,push,10,0,8,191,0.413612565,0.057591623,0.596858639,2,0.574087175
11188,11,21865,3,2,7,10,0,22,11,9,0,0,0,20,nowin,loss,bust,plbust,0,10,5,236,0.457627119,0.016949153,0.588983051,3,0.889015813
11189,29,21865,6,3,6,1,6,22,11,9,0,0,0,20,nowin,loss,bust,plbust,0,10,9,189,0.44973545,0.058201058,0.544973545,1,0.300349439
11190,84,21866,9,10,0,0,0,19,8,6,10,0,0,24,nowin,win,dlbust,bust,20,0,19,195,0.379487179,0.056410256,0.569230769,0,0.017209119
11191,98,21866,10,5,0,2,0,17,8,6,10,0,0,24,nowin,win,dlbust,bust,20,0,15,220,0.422727273,0.054545455,0.55,1,0.28664435
11192,7,21866,7,6,0,2,10,25,8,6,10,0,0,24,nowin,loss,bust,plbust,0,10,13,183,0.442622951,0.06010929,0.62295082,2,0.619303341
11193,28,21866,2,5,8,10,0,25,8,6,10,0,0,24,nowin,loss,bust,plbust,0,10,7,199,0.422110553,0.045226131,0.542713568,1,0.282706618
11194,4,21866,10,7,0,0,0,17,8,6,10,0,0,24,nowin,win,dlbust,bust,20,0,17,217,0.460829493,0.036866359,0.562211982,1,0.315432839
11195,84,21866,8,8,0,1,0,17,8,6,10,0,0,24,nowin,win,dlbust,bust,20,0,16,195,0.379487179,0.056410256,0.569230769,0,0.017209119
11196,97,21867,11,8,0,0,0,19,9,4,5,0,0,18,nowin,win,plwin,beat,20,0,19,182,0.450549451,0.06043956,0.692307692,2,0.677372279
11197,30,21867,5,10,0,10,0,25,9,4,5,0,0,18,nowin,loss,bust,plbust,0,10,15,206,0.393203883,0.033980583,0.601941748,0,0.029324648
11198,31,21867,1,6,10,0,0,17,9,4,5,0,0,18,nowin,loss,beat,dlwin,0,10,7,188,0.473404255,0.058510638,0.515957447,1,0.300306557
11199,15,21867,3,11,5,0,0,19,9,4,5,0,0,18,nowin,win,plwin,beat,20,0,14,212,0.410377358,0.051886792,0.561320755,0,0.024517408
11200,100,21867,9,3,0,3,5,20,9,4,5,0,0,18,nowin,win,plwin,beat,20,0,12,190,0.452631579,0.036842105,0.594736842,3,0.888671154
11201,22,21867,3,10,0,1,4,18,9,4,5,0,0,18,nowin,push,push,push,10,0,13,187,0.481283422,0.042780749,0.577540107,3,0.906128176
11202,75,21868,8,8,0,0,0,16,2,10,9,0,0,21,nowin,loss,beat,dlwin,0,10,16,191,0.418848168,0.052356021,0.570680628,0,0.029344702
11203,47,21868,10,10,0,0,0,20,2,10,9,0,0,21,nowin,loss,beat,dlwin,0,10,20,210,0.438095238,0.057142857,0.623809524,2,0.615868808
11204,122,21868,10,6,0,0,0,16,2,10,9,0,0,21,nowin,loss,beat,dlwin,0,10,16,210,0.347619048,0.052380952,0.59047619,0,0.012873677
11205,148,21868,5,10,0,0,0,15,2,10,9,0,0,21,nowin,loss,beat,dlwin,0,10,15,204,0.401960784,0.078431373,0.593137255,0,0.029789521
11206,113,21868,10,10,0,0,0,20,2,10,9,0,0,21,nowin,loss,beat,dlwin,0,10,20,199,0.407035176,0.055276382,0.668341709,2,0.620695264
11207,146,21868,10,10,0,0,0,20,2,10,9,0,0,21,nowin,loss,beat,dlwin,0,10,20,221,0.43438914,0.040723982,0.542986425,1,0.290190091
11208,71,21869,6,10,0,7,0,23,9,10,0,0,0,19,nowin,loss,bust,plbust,0,10,16,193,0.352331606,0.046632124,0.585492228,0,0.013063661
11209,132,21869,5,8,0,7,0,20,9,10,0,0,0,19,nowin,win,plwin,beat,20,0,13,194,0.412371134,0.036082474,0.649484536,2,0.611633238
11210,26,21869,11,10,0,0,0,21,9,10,0,0,0,19,win,win,plwin,beat,25,0,21,203,0.463054187,0.0591133,0.541871921,1,0.306802864
11211,97,21869,10,2,0,6,0,18,9,10,0,0,0,19,nowin,loss,beat,dlwin,0,10,12,182,0.450549451,0.06043956,0.692307692,2,0.677372279
11212,142,21869,9,5,0,5,0,19,9,10,0,0,0,19,nowin,push,push,push,10,0,14,211,0.417061611,0.047393365,0.526066351,1,0.271531309
11213,150,21869,6,2,10,0,0,18,9,10,0,0,0,19,nowin,loss,beat,dlwin,0,10,8,192,0.401041667,0.036458333,0.567708333,0,0.023287458
11214,23,21870,8,10,0,0,0,18,8,3,10,0,0,21,nowin,loss,beat,dlwin,0,10,18,208,0.427884615,0.0625,0.552884615,1,0.29114424
11215,90,21870,9,10,0,0,0,19,8,3,10,0,0,21,nowin,loss,beat,dlwin,0,10,19,201,0.447761194,0.049751244,0.60199005,3,0.889945023
11216,42,21870,5,9,0,10,0,24,8,3,10,0,0,21,nowin,loss,bust,plbust,0,10,14,212,0.443396226,0.051886792,0.570754717,1,0.309181312
11217,3,21870,7,5,0,10,0,22,8,3,10,0,0,21,nowin,loss,bust,plbust,0,10,12,190,0.431578947,0.026315789,0.542105263,1,0.288076384
11218,84,21870,6,1,10,0,0,17,8,3,10,0,0,21,nowin,loss,beat,dlwin,0,10,7,195,0.379487179,0.056410256,0.569230769,0,0.017209119
11219,82,21870,7,10,0,0,0,17,8,3,10,0,0,21,nowin,loss,beat,dlwin,0,10,17,225,0.408888889,0.075555556,0.577777778,0,0.028101874
11220,114,21871,2,10,0,10,0,22,10,10,0,0,0,20,nowin,loss,bust,plbust,0,10,12,198,0.47979798,0.025252525,0.611111111,3,0.937232995
11221,38,21871,6,10,0,10,0,26,10,10,0,0,0,20,nowin,loss,bust,plbust,0,10,16,202,0.361386139,0.03960396,0.564356436,0,0.010597953
11222,107,21871,10,3,0,2,1,16,10,10,0,0,0,20,nowin,loss,beat,dlwin,0,10,13,218,0.444954128,0.073394495,0.600917431,2,0.605210014
11223,113,21871,11,1,3,10,0,25,10,10,0,0,0,20,nowin,loss,bust,plbust,0,10,12,199,0.407035176,0.055276382,0.668341709,2,0.620695264
11224,65,21871,2,6,10,0,0,18,10,10,0,0,0,20,nowin,loss,beat,dlwin,0,10,8,203,0.492610837,0.054187192,0.571428571,3,0.913702814
11225,94,21871,6,2,6,9,0,23,10,10,0,0,0,20,nowin,loss,bust,plbust,0,10,8,183,0.43715847,0.043715847,0.540983607,1,0.290866892
11226,103,21872,11,10,0,0,0,21,9,3,4,7,0,23,win,win,dlbust,bust,25,0,21,203,0.379310345,0.064039409,0.551724138,0,0.012869209
11227,145,21872,9,7,0,10,0,26,9,3,4,7,0,23,nowin,loss,bust,plbust,0,10,16,188,0.441489362,0.031914894,0.622340426,2,0.617837093
11228,95,21872,8,6,0,7,0,21,9,3,4,7,0,23,nowin,win,dlbust,bust,20,0,14,218,0.412844037,0.04587156,0.559633028,0,0.024842385
11229,149,21872,7,7,0,9,0,23,9,3,4,7,0,23,nowin,loss,bust,plbust,0,10,14,225,0.457777778,0.057777778,0.648888889,2,0.651965595
11230,81,21872,10,4,0,9,0,23,9,3,4,7,0,23,nowin,loss,bust,plbust,0,10,14,182,0.395604396,0.043956044,0.60989011,2,0.567491261
11231,7,21872,6,4,9,0,0,19,9,3,4,7,0,23,nowin,win,dlbust,bust,20,0,10,183,0.442622951,0.06010929,0.62295082,2,0.619303341
11232,35,21873,10,2,0,8,0,20,10,2,10,0,0,22,nowin,win,dlbust,bust,20,0,12,202,0.410891089,0.044554455,0.633663366,2,0.598681573
11233,122,21873,11,10,0,0,0,21,10,2,10,0,0,22,win,win,dlbust,bust,25,0,21,210,0.347619048,0.052380952,0.59047619,0,0.012873677
11234,111,21873,4,10,0,7,0,21,10,2,10,0,0,22,nowin,win,dlbust,bust,20,0,14,180,0.433333333,0.055555556,0.611111111,2,0.602264492
11235,142,21873,9,10,0,0,0,19,10,2,10,0,0,22,nowin,win,dlbust,bust,20,0,19,211,0.417061611,0.047393365,0.526066351,1,0.271531309
11236,65,21873,9,10,0,0,0,19,10,2,10,0,0,22,nowin,win,dlbust,bust,20,0,19,203,0.492610837,0.054187192,0.571428571,3,0.913702814
11237,43,21873,10,9,0,0,0,19,10,2,10,0,0,22,nowin,win,dlbust,bust,20,0,19,192,0.40625,0.041666667,0.609375,2,0.576671372
11238,144,21874,5,10,0,5,0,20,9,7,7,0,0,23,nowin,win,dlbust,bust,20,0,15,202,0.386138614,0.054455446,0.564356436,0,0.018006244
11239,131,21874,10,5,0,6,0,21,9,7,7,0,0,23,nowin,win,dlbust,bust,20,0,15,217,0.410138249,0.069124424,0.543778802,0,0.02015021
11240,132,21874,7,10,0,0,0,17,9,7,7,0,0,23,nowin,win,dlbust,bust,20,0,17,194,0.412371134,0.036082474,0.649484536,2,0.611633238
11241,108,21874,6,10,0,7,0,23,9,7,7,0,0,23,nowin,loss,bust,plbust,0,10,16,193,0.435233161,0.056994819,0.559585492,1,0.298824795
11242,138,21874,8,5,0,8,0,21,9,7,7,0,0,23,nowin,win,dlbust,bust,20,0,13,190,0.442105263,0.047368421,0.610526316,2,0.609711065
11243,81,21874,6,10,0,10,0,26,9,7,7,0,0,23,nowin,loss,bust,plbust,0,10,16,182,0.395604396,0.043956044,0.60989011,2,0.567491261
11244,104,21875,5,10,0,9,0,24,10,11,0,0,0,21,nowin,loss,bust,plbust,0,10,15,209,0.363636364,0.052631579,0.593301435,0,0.018359419
11245,1,21875,9,10,0,0,0,19,10,11,0,0,0,21,nowin,loss,beat,dlwin,0,10,19,197,0.406091371,0.025380711,0.649746193,2,0.606186955
11246,88,21875,8,10,0,0,0,18,10,11,0,0,0,21,nowin,loss,beat,dlwin,0,10,18,206,0.466019417,0.033980583,0.54368932,1,0.309467903
11247,59,21875,1,6,10,0,0,17,10,11,0,0,0,21,nowin,loss,beat,dlwin,0,10,7,228,0.429824561,0.048245614,0.543859649,1,0.287885446
11248,39,21875,10,7,0,0,0,17,10,11,0,0,0,21,nowin,loss,beat,dlwin,0,10,17,191,0.429319372,0.062827225,0.57591623,0,0.033760763
11249,129,21875,4,9,0,2,7,22,10,11,0,0,0,21,nowin,loss,bust,plbust,0,10,13,201,0.422885572,0.064676617,0.55721393,0,0.027255383
11250,43,21876,2,9,10,0,0,21,6,3,10,0,0,19,nowin,win,plwin,beat,20,0,11,192,0.40625,0.041666667,0.609375,2,0.576671372
11251,123,21876,10,10,0,0,0,20,6,3,10,0,0,19,nowin,win,plwin,beat,20,0,20,205,0.43902439,0.034146341,0.614634146,2,0.609962544
11252,41,21876,11,10,0,0,0,21,6,3,10,0,0,19,win,win,plwin,beat,25,0,21,192,0.364583333,0.036458333,0.520833333,0,0.00089702
11253,132,21876,10,2,0,0,0,12,6,3,10,0,0,19,nowin,loss,beat,dlwin,0,10,12,194,0.412371134,0.036082474,0.649484536,2,0.611633238
11254,102,21876,10,10,0,0,0,20,6,3,10,0,0,19,nowin,win,plwin,beat,20,0,20,192,0.338541667,0.046875,0.5625,0,0.003306118
11255,59,21876,5,6,2,0,0,13,6,3,10,0,0,19,nowin,loss,beat,dlwin,0,10,11,228,0.429824561,0.048245614,0.543859649,1,0.287885446
11256,96,21877,11,10,0,0,0,21,4,5,6,10,0,25,win,win,dlbust,bust,25,0,21,190,0.468421053,0.057894737,0.584210526,3,0.897263354
11257,130,21877,10,10,0,0,0,20,4,5,6,10,0,25,nowin,win,dlbust,bust,20,0,20,219,0.410958904,0.03652968,0.566210046,0,0.025888739
11258,10,21877,6,10,0,0,0,16,4,5,6,10,0,25,nowin,win,dlbust,bust,20,0,16,191,0.413612565,0.057591623,0.596858639,2,0.574087175
11259,135,21877,6,3,8,0,0,17,4,5,6,10,0,25,nowin,win,dlbust,bust,20,0,9,179,0.391061453,0.067039106,0.586592179,0,0.024924662
11260,96,21877,8,10,0,0,0,18,4,5,6,10,0,25,nowin,win,dlbust,bust,20,0,18,190,0.468421053,0.057894737,0.584210526,3,0.897263354
11261,107,21877,1,3,8,0,0,12,4,5,6,10,0,25,nowin,win,dlbust,bust,20,0,4,218,0.444954128,0.073394495,0.600917431,2,0.605210014
11262,105,21878,10,7,0,0,0,17,6,4,8,0,0,18,nowin,loss,beat,dlwin,0,10,17,198,0.414141414,0.070707071,0.590909091,0,0.032889494
11263,48,21878,4,4,9,0,0,17,6,4,8,0,0,18,nowin,loss,beat,dlwin,0,10,8,203,0.413793103,0.019704433,0.600985222,2,0.577280801
11264,134,21878,10,4,0,0,0,14,6,4,8,0,0,18,nowin,loss,beat,dlwin,0,10,14,185,0.443243243,0.021621622,0.545945946,1,0.296939509
11265,127,21878,2,7,2,3,0,14,6,4,8,0,0,18,nowin,loss,beat,dlwin,0,10,9,201,0.402985075,0.029850746,0.60199005,0,0.032263937
11266,65,21878,9,10,0,0,0,19,6,4,8,0,0,18,nowin,win,plwin,beat,20,0,19,203,0.492610837,0.054187192,0.571428571,3,0.913702814
11267,48,21878,1,6,10,0,0,17,6,4,8,0,0,18,nowin,loss,beat,dlwin,0,10,7,203,0.413793103,0.019704433,0.600985222,2,0.577280801
11268,11,21879,8,10,0,0,0,18,10,4,7,0,0,21,nowin,loss,beat,dlwin,0,10,18,236,0.457627119,0.016949153,0.588983051,3,0.889015813
11269,45,21879,8,7,0,9,0,24,10,4,7,0,0,21,nowin,loss,bust,plbust,0,10,15,196,0.428571429,0.051020408,0.612244898,2,0.598821767
11270,28,21879,10,11,0,0,0,21,10,4,7,0,0,21,win,push,push,push,10,0,21,199,0.422110553,0.045226131,0.542713568,1,0.282706618
11271,127,21879,8,9,0,0,0,17,10,4,7,0,0,21,nowin,loss,beat,dlwin,0,10,17,201,0.402985075,0.029850746,0.60199005,0,0.032263937
11272,25,21879,4,3,10,0,0,17,10,4,7,0,0,21,nowin,loss,beat,dlwin,0,10,7,190,0.463157895,0.063157895,0.536842105,1,0.304401563
11273,71,21879,5,6,9,0,0,20,10,4,7,0,0,21,nowin,loss,beat,dlwin,0,10,11,193,0.352331606,0.046632124,0.585492228,0,0.013063661
11274,102,21880,9,5,0,0,0,14,4,1,7,5,0,17,nowin,loss,beat,dlwin,0,10,14,192,0.338541667,0.046875,0.5625,0,0.003306118
11275,30,21880,5,9,0,0,0,14,4,1,7,5,0,17,nowin,loss,beat,dlwin,0,10,14,206,0.393203883,0.033980583,0.601941748,0,0.029324648
11276,101,21880,5,4,7,0,0,16,4,1,7,5,0,17,nowin,loss,beat,dlwin,0,10,9,205,0.424390244,0.068292683,0.63902439,2,0.614740646
11277,91,21880,3,10,0,0,0,13,4,1,7,5,0,17,nowin,loss,beat,dlwin,0,10,13,194,0.417525773,0.046391753,0.515463918,1,0.266616552
11278,123,21880,2,9,2,0,0,13,4,1,7,5,0,17,nowin,loss,beat,dlwin,0,10,11,205,0.43902439,0.034146341,0.614634146,2,0.609962544
11279,112,21880,10,10,0,0,0,20,4,1,7,5,0,17,nowin,win,plwin,beat,20,0,20,203,0.448275862,0.054187192,0.600985222,3,0.889576933
11280,49,21881,4,5,10,0,0,19,10,10,0,0,0,20,nowin,loss,beat,dlwin,0,10,9,207,0.396135266,0.053140097,0.594202899,0,0.028306925
11281,75,21881,3,10,0,4,0,17,10,10,0,0,0,20,nowin,loss,beat,dlwin,0,10,13,191,0.418848168,0.052356021,0.570680628,0,0.029344702
11282,109,21881,10,2,0,9,0,21,10,10,0,0,0,20,nowin,win,plwin,beat,20,0,12,221,0.461538462,0.058823529,0.597285068,3,0.901830309
11283,95,21881,10,5,0,10,0,25,10,10,0,0,0,20,nowin,loss,bust,plbust,0,10,15,218,0.412844037,0.04587156,0.559633028,0,0.024842385
11284,41,21881,10,6,0,10,0,26,10,10,0,0,0,20,nowin,loss,bust,plbust,0,10,16,192,0.364583333,0.036458333,0.520833333,0,0.00089702
11285,25,21881,3,2,9,10,0,24,10,10,0,0,0,20,nowin,loss,bust,plbust,0,10,5,190,0.463157895,0.063157895,0.536842105,1,0.304401563
11286,127,21882,8,10,0,0,0,18,7,2,5,4,0,18,nowin,push,push,push,10,0,18,201,0.402985075,0.029850746,0.60199005,0,0.032263937
11287,100,21882,6,5,10,0,0,21,7,2,5,4,0,18,nowin,win,plwin,beat,20,0,11,190,0.452631579,0.036842105,0.594736842,3,0.888671154
11288,128,21882,4,9,0,5,0,18,7,2,5,4,0,18,nowin,push,push,push,10,0,13,227,0.356828194,0.052863436,0.577092511,0,0.012352564
11289,146,21882,8,6,0,6,0,20,7,2,5,4,0,18,nowin,win,plwin,beat,20,0,14,221,0.43438914,0.040723982,0.542986425,1,0.290190091
11290,134,21882,5,5,11,0,0,21,7,2,5,4,0,18,nowin,win,plwin,beat,20,0,10,185,0.443243243,0.021621622,0.545945946,1,0.296939509
11291,47,21882,1,6,5,10,0,22,7,2,5,4,0,18,nowin,loss,bust,plbust,0,10,7,210,0.438095238,0.057142857,0.623809524,2,0.615868808
11292,18,21883,5,5,8,0,0,18,7,10,0,0,0,17,nowin,win,plwin,beat,20,0,10,182,0.461538462,0.043956044,0.587912088,3,0.892649374
11293,37,21883,10,7,0,0,0,17,7,10,0,0,0,17,nowin,push,push,push,10,0,17,208,0.394230769,0.038461538,0.581730769,0,0.024682772
11294,78,21883,10,10,0,0,0,20,7,10,0,0,0,17,nowin,win,plwin,beat,20,0,20,201,0.517412935,0.034825871,0.587064677,3,0.95871112
11295,11,21883,10,4,0,10,0,24,7,10,0,0,0,17,nowin,loss,bust,plbust,0,10,14,236,0.457627119,0.016949153,0.588983051,3,0.889015813
11296,30,21883,7,10,0,0,0,17,7,10,0,0,0,17,nowin,push,push,push,10,0,17,206,0.393203883,0.033980583,0.601941748,0,0.029324648
11297,122,21883,5,1,10,1,0,17,7,10,0,0,0,17,nowin,push,push,push,10,0,6,210,0.347619048,0.052380952,0.59047619,0,0.012873677
11298,103,21884,9,6,0,8,0,23,10,6,6,0,0,22,nowin,loss,bust,plbust,0,10,15,203,0.379310345,0.064039409,0.551724138,0,0.012869209
11299,104,21884,7,10,0,0,0,17,10,6,6,0,0,22,nowin,win,dlbust,bust,20,0,17,209,0.363636364,0.052631579,0.593301435,0,0.018359419
11300,7,21884,10,5,0,10,0,25,10,6,6,0,0,22,nowin,loss,bust,plbust,0,10,15,183,0.442622951,0.06010929,0.62295082,2,0.619303341
11301,37,21884,6,10,0,10,0,26,10,6,6,0,0,22,nowin,loss,bust,plbust,0,10,16,208,0.394230769,0.038461538,0.581730769,0,0.024682772
11302,47,21884,7,8,0,10,0,25,10,6,6,0,0,22,nowin,loss,bust,plbust,0,10,15,210,0.438095238,0.057142857,0.623809524,2,0.615868808
11303,84,21884,3,10,0,1,8,22,10,6,6,0,0,22,nowin,loss,bust,plbust,0,10,13,195,0.379487179,0.056410256,0.569230769,0,0.017209119
11304,1,21885,1,5,7,2,4,19,10,10,0,0,0,20,nowin,loss,beat,dlwin,0,10,6,197,0.406091371,0.025380711,0.649746193,2,0.606186955
11305,56,21885,2,9,10,0,0,21,10,10,0,0,0,20,nowin,win,plwin,beat,20,0,11,175,0.4,0.057142857,0.582857143,0,0.026685297
11306,9,21885,10,5,0,10,0,25,10,10,0,0,0,20,nowin,loss,bust,plbust,0,10,15,194,0.37628866,0.015463918,0.541237113,0,0.009396796
11307,13,21885,4,10,0,6,0,20,10,10,0,0,0,20,nowin,push,push,push,10,0,14,206,0.417475728,0.063106796,0.621359223,2,0.59555479
11308,69,21885,7,9,0,7,0,23,10,10,0,0,0,20,nowin,loss,bust,plbust,0,10,16,194,0.365979381,0.030927835,0.515463918,0,0
11309,121,21885,7,7,0,10,0,24,10,10,0,0,0,20,nowin,loss,bust,plbust,0,10,14,195,0.456410256,0.025641026,0.512820513,1,0.288597791
11310,57,21886,11,5,1,0,0,17,10,10,0,0,0,20,nowin,loss,beat,dlwin,0,10,16,192,0.46875,0.052083333,0.59375,3,0.907001181
11311,64,21886,10,4,0,1,2,17,10,10,0,0,0,20,nowin,loss,beat,dlwin,0,10,14,187,0.363636364,0.048128342,0.631016043,0,0.027594885
11312,131,21886,4,3,9,9,0,25,10,10,0,0,0,20,nowin,loss,bust,plbust,0,10,7,217,0.410138249,0.069124424,0.543778802,0,0.02015021
11313,122,21886,10,9,0,0,0,19,10,10,0,0,0,20,nowin,loss,beat,dlwin,0,10,19,210,0.347619048,0.052380952,0.59047619,0,0.012873677
11314,82,21886,6,2,10,0,0,18,10,10,0,0,0,20,nowin,loss,beat,dlwin,0,10,8,225,0.408888889,0.075555556,0.577777778,0,0.028101874
11315,94,21886,4,10,0,5,0,19,10,10,0,0,0,20,nowin,loss,beat,dlwin,0,10,14,183,0.43715847,0.043715847,0.540983607,1,0.290866892
11316,59,21887,10,10,0,0,0,20,4,9,3,6,0,22,nowin,win,dlbust,bust,20,0,20,228,0.429824561,0.048245614,0.543859649,1,0.287885446
11317,52,21887,2,4,11,0,0,17,4,9,3,6,0,22,nowin,win,dlbust,bust,20,0,6,217,0.414746544,0.02764977,0.599078341,2,0.576736024
11318,85,21887,6,8,0,0,0,14,4,9,3,6,0,22,nowin,win,dlbust,bust,20,0,14,195,0.41025641,0.066666667,0.594871795,0,0.03269711
11319,83,21887,10,9,0,0,0,19,4,9,3,6,0,22,nowin,win,dlbust,bust,20,0,19,193,0.424870466,0.051813472,0.678756477,2,0.644360335
11320,146,21887,9,5,0,0,0,14,4,9,3,6,0,22,nowin,win,dlbust,bust,20,0,14,221,0.43438914,0.040723982,0.542986425,1,0.290190091
11321,41,21887,8,10,0,0,0,18,4,9,3,6,0,22,nowin,win,dlbust,bust,20,0,18,192,0.364583333,0.036458333,0.520833333,0,0.00089702
11322,59,21888,6,6,0,4,10,26,7,9,1,0,0,17,nowin,loss,bust,plbust,0,10,12,228,0.429824561,0.048245614,0.543859649,1,0.287885446
11323,19,21888,11,8,0,0,0,19,7,9,1,0,0,17,nowin,win,plwin,beat,20,0,19,237,0.41350211,0.054852321,0.628691983,2,0.597373826
11324,149,21888,7,10,0,0,0,17,7,9,1,0,0,17,nowin,push,push,push,10,0,17,225,0.457777778,0.057777778,0.648888889,2,0.651965595
11325,123,21888,10,10,0,0,0,20,7,9,1,0,0,17,nowin,win,plwin,beat,20,0,20,205,0.43902439,0.034146341,0.614634146,2,0.609962544
11326,98,21888,10,5,0,5,0,20,7,9,1,0,0,17,nowin,win,plwin,beat,20,0,15,220,0.422727273,0.054545455,0.55,1,0.28664435
11327,61,21888,10,10,0,0,0,20,7,9,1,0,0,17,nowin,win,plwin,beat,20,0,20,194,0.427835052,0.077319588,0.603092784,2,0.591437139
11328,130,21889,7,8,0,9,0,24,9,6,5,0,0,20,nowin,loss,bust,plbust,0,10,15,219,0.410958904,0.03652968,0.566210046,0,0.025888739
11329,24,21889,5,10,0,10,0,25,9,6,5,0,0,20,nowin,loss,bust,plbust,0,10,15,207,0.458937198,0.048309179,0.570048309,1,0.318138014
11330,128,21889,7,10,0,0,0,17,9,6,5,0,0,20,nowin,loss,beat,dlwin,0,10,17,227,0.356828194,0.052863436,0.577092511,0,0.012352564
11331,120,21889,10,10,0,0,0,20,9,6,5,0,0,20,nowin,push,push,push,10,0,20,202,0.440594059,0.034653465,0.618811881,2,0.614441029
11332,85,21889,10,10,0,0,0,20,9,6,5,0,0,20,nowin,push,push,push,10,0,20,195,0.41025641,0.066666667,0.594871795,0,0.03269711
11333,111,21889,3,10,0,4,0,17,9,6,5,0,0,20,nowin,loss,beat,dlwin,0,10,13,180,0.433333333,0.055555556,0.611111111,2,0.602264492
11334,65,21890,5,10,0,9,0,24,10,3,6,0,0,19,nowin,loss,bust,plbust,0,10,15,203,0.492610837,0.054187192,0.571428571,3,0.913702814
11335,109,21890,4,5,6,10,0,25,10,3,6,0,0,19,nowin,loss,bust,plbust,0,10,9,221,0.461538462,0.058823529,0.597285068,3,0.901830309
11336,7,21890,10,11,0,0,0,21,10,3,6,0,0,19,win,win,plwin,beat,25,0,21,183,0.442622951,0.06010929,0.62295082,2,0.619303341
11337,66,21890,4,1,7,10,0,22,10,3,6,0,0,19,nowin,loss,bust,plbust,0,10,5,217,0.456221198,0.064516129,0.626728111,3,0.924304367
11338,40,21890,10,4,0,1,2,17,10,3,6,0,0,19,nowin,loss,beat,dlwin,0,10,14,196,0.367346939,0.030612245,0.617346939,0,0.025358183
11339,51,21890,7,10,0,0,0,17,10,3,6,0,0,19,nowin,loss,beat,dlwin,0,10,17,189,0.529100529,0.068783069,0.608465608,3,0.993665715
11340,24,21891,7,7,0,10,0,24,8,10,0,0,0,18,nowin,loss,bust,plbust,0,10,14,207,0.458937198,0.048309179,0.570048309,1,0.318138014
11341,138,21891,10,9,0,0,0,19,8,10,0,0,0,18,nowin,win,plwin,beat,20,0,19,190,0.442105263,0.047368421,0.610526316,2,0.609711065
11342,96,21891,10,11,0,0,0,21,8,10,0,0,0,18,win,win,plwin,beat,25,0,21,190,0.468421053,0.057894737,0.584210526,3,0.897263354
11343,100,21891,7,6,0,8,0,21,8,10,0,0,0,18,nowin,win,plwin,beat,20,0,13,190,0.452631579,0.036842105,0.594736842,3,0.888671154
11344,20,21891,9,10,0,0,0,19,8,10,0,0,0,18,nowin,win,plwin,beat,20,0,19,186,0.456989247,0.037634409,0.537634409,1,0.301097108
11345,147,21891,2,10,0,10,0,22,8,10,0,0,0,18,nowin,loss,bust,plbust,0,10,12,205,0.380487805,0.014634146,0.536585366,0,0.00951447
11346,60,21892,8,8,0,0,0,16,6,5,6,0,0,17,nowin,loss,beat,dlwin,0,10,16,227,0.418502203,0.022026432,0.559471366,0,0.026496258
11347,147,21892,10,8,0,0,0,18,6,5,6,0,0,17,nowin,win,plwin,beat,20,0,18,205,0.380487805,0.014634146,0.536585366,0,0.00951447
11348,126,21892,10,4,0,0,0,14,6,5,6,0,0,17,nowin,loss,beat,dlwin,0,10,14,188,0.457446809,0.074468085,0.60106383,3,0.900633203
11349,58,21892,6,7,0,0,0,13,6,5,6,0,0,17,nowin,loss,beat,dlwin,0,10,13,195,0.430769231,0.041025641,0.584615385,2,0.580497586
11350,143,21892,8,3,10,0,0,21,6,5,6,0,0,17,nowin,win,plwin,beat,20,0,11,203,0.463054187,0.044334975,0.57635468,3,0.883143365
11351,98,21892,5,10,0,0,0,15,6,5,6,0,0,17,nowin,loss,beat,dlwin,0,10,15,220,0.422727273,0.054545455,0.55,1,0.28664435
11352,60,21893,6,10,0,10,0,26,8,11,0,0,0,19,nowin,loss,bust,plbust,0,10,16,227,0.418502203,0.022026432,0.559471366,0,0.026496258
11353,60,21893,10,9,0,0,0,19,8,11,0,0,0,19,nowin,push,push,push,10,0,19,227,0.418502203,0.022026432,0.559471366,0,0.026496258
11354,111,21893,6,5,8,0,0,19,8,11,0,0,0,19,nowin,push,push,push,10,0,11,180,0.433333333,0.055555556,0.611111111,2,0.602264492
11355,74,21893,10,11,0,0,0,21,8,11,0,0,0,19,win,win,plwin,beat,25,0,21,209,0.411483254,0.04784689,0.531100478,0,0.017448125
11356,59,21893,11,9,0,0,0,20,8,11,0,0,0,19,nowin,win,plwin,beat,20,0,20,228,0.429824561,0.048245614,0.543859649,1,0.287885446
11357,109,21893,2,9,4,1,8,24,8,11,0,0,0,19,nowin,loss,bust,plbust,0,10,11,221,0.461538462,0.058823529,0.597285068,3,0.901830309
11358,133,21894,10,10,0,0,0,20,10,10,0,0,0,20,nowin,push,push,push,10,0,20,201,0.47761194,0.064676617,0.611940299,3,0.935428111
11359,2,21894,10,10,0,0,0,20,10,10,0,0,0,20,nowin,push,push,push,10,0,20,200,0.445,0.035,0.64,2,0.633962549
11360,72,21894,6,9,0,10,0,25,10,10,0,0,0,20,nowin,loss,bust,plbust,0,10,15,185,0.394594595,0.032432432,0.508108108,0,0.006763115
11361,134,21894,2,5,9,10,0,26,10,10,0,0,0,20,nowin,loss,bust,plbust,0,10,7,185,0.443243243,0.021621622,0.545945946,1,0.296939509
11362,133,21894,11,3,2,2,0,18,10,10,0,0,0,20,nowin,loss,beat,dlwin,0,10,14,201,0.47761194,0.064676617,0.611940299,3,0.935428111
11363,13,21894,10,9,0,0,0,19,10,10,0,0,0,20,nowin,loss,beat,dlwin,0,10,19,206,0.417475728,0.063106796,0.621359223,2,0.59555479
11364,100,21895,5,3,10,0,0,18,6,6,9,0,0,21,nowin,loss,beat,dlwin,0,10,8,190,0.452631579,0.036842105,0.594736842,3,0.888671154
11365,108,21895,4,5,10,0,0,19,6,6,9,0,0,21,nowin,loss,beat,dlwin,0,10,9,193,0.435233161,0.056994819,0.559585492,1,0.298824795
11366,140,21895,10,3,0,0,0,13,6,6,9,0,0,21,nowin,loss,beat,dlwin,0,10,13,210,0.466666667,0.023809524,0.604761905,3,0.915293335
11367,56,21895,11,3,2,0,0,16,6,6,9,0,0,21,nowin,loss,beat,dlwin,0,10,14,175,0.4,0.057142857,0.582857143,0,0.026685297
11368,30,21895,10,9,0,0,0,19,6,6,9,0,0,21,nowin,loss,beat,dlwin,0,10,19,206,0.393203883,0.033980583,0.601941748,0,0.029324648
11369,7,21895,2,2,10,0,0,14,6,6,9,0,0,21,nowin,loss,beat,dlwin,0,10,4,183,0.442622951,0.06010929,0.62295082,2,0.619303341
11370,68,21896,10,10,0,0,0,20,10,10,0,0,0,20,nowin,push,push,push,10,0,20,205,0.434146341,0.029268293,0.6,2,0.59483189
11371,109,21896,7,9,0,8,0,24,10,10,0,0,0,20,nowin,loss,bust,plbust,0,10,16,221,0.461538462,0.058823529,0.597285068,3,0.901830309
11372,79,21896,10,10,0,0,0,20,10,10,0,0,0,20,nowin,push,push,push,10,0,20,211,0.436018957,0.028436019,0.672985782,2,0.650131054
11373,36,21896,10,10,0,0,0,20,10,10,0,0,0,20,nowin,push,push,push,10,0,20,229,0.445414847,0.056768559,0.655021834,2,0.645370571
11374,66,21896,6,3,9,0,0,18,10,10,0,0,0,20,nowin,loss,beat,dlwin,0,10,9,217,0.456221198,0.064516129,0.626728111,3,0.924304367
11375,56,21896,6,3,10,0,0,19,10,10,0,0,0,20,nowin,loss,beat,dlwin,0,10,9,175,0.4,0.057142857,0.582857143,0,0.026685297
11376,82,21897,5,11,4,0,0,20,10,10,0,0,0,20,nowin,push,push,push,10,0,16,225,0.408888889,0.075555556,0.577777778,0,0.028101874
11377,91,21897,1,3,10,4,0,18,10,10,0,0,0,20,nowin,loss,beat,dlwin,0,10,4,194,0.417525773,0.046391753,0.515463918,1,0.266616552
11378,70,21897,9,4,0,3,9,25,10,10,0,0,0,20,nowin,loss,bust,plbust,0,10,13,228,0.385964912,0.039473684,0.557017544,0,0.016157125
11379,81,21897,8,8,0,9,0,25,10,10,0,0,0,20,nowin,loss,bust,plbust,0,10,16,182,0.395604396,0.043956044,0.60989011,2,0.567491261
11380,84,21897,7,9,0,1,0,17,10,10,0,0,0,20,nowin,loss,beat,dlwin,0,10,16,195,0.379487179,0.056410256,0.569230769,0,0.017209119
11381,145,21897,10,10,0,0,0,20,10,10,0,0,0,20,nowin,push,push,push,10,0,20,188,0.441489362,0.031914894,0.622340426,2,0.617837093
11382,86,21898,2,11,2,8,0,23,9,10,0,0,0,19,nowin,loss,bust,plbust,0,10,13,196,0.454081633,0.040816327,0.591836735,3,0.887566443
11383,147,21898,6,10,0,3,0,19,9,10,0,0,0,19,nowin,push,push,push,10,0,16,205,0.380487805,0.014634146,0.536585366,0,0.00951447
11384,146,21898,3,6,10,0,0,19,9,10,0,0,0,19,nowin,push,push,push,10,0,9,221,0.43438914,0.040723982,0.542986425,1,0.290190091
11385,66,21898,11,6,4,0,0,21,9,10,0,0,0,19,nowin,win,plwin,beat,20,0,17,217,0.456221198,0.064516129,0.626728111,3,0.924304367
11386,87,21898,10,10,0,0,0,20,9,10,0,0,0,19,nowin,win,plwin,beat,20,0,20,202,0.405940594,0.054455446,0.628712871,2,0.590599801
11387,105,21898,10,5,0,7,0,22,9,10,0,0,0,19,nowin,loss,bust,plbust,0,10,15,198,0.414141414,0.070707071,0.590909091,0,0.032889494
11388,45,21899,3,5,3,10,0,21,2,10,10,0,0,22,nowin,win,dlbust,bust,20,0,8,196,0.428571429,0.051020408,0.612244898,2,0.598821767
11389,19,21899,10,11,0,0,0,21,2,10,10,0,0,22,win,win,dlbust,bust,25,0,21,237,0.41350211,0.054852321,0.628691983,2,0.597373826
11390,120,21899,3,10,0,0,0,13,2,10,10,0,0,22,nowin,win,dlbust,bust,20,0,13,202,0.440594059,0.034653465,0.618811881,2,0.614441029
11391,134,21899,11,10,0,0,0,21,2,10,10,0,0,22,win,win,dlbust,bust,25,0,21,185,0.443243243,0.021621622,0.545945946,1,0.296939509
11392,25,21899,10,4,0,0,0,14,2,10,10,0,0,22,nowin,win,dlbust,bust,20,0,14,190,0.463157895,0.063157895,0.536842105,1,0.304401563
11393,69,21899,8,5,0,0,0,13,2,10,10,0,0,22,nowin,win,dlbust,bust,20,0,13,194,0.365979381,0.030927835,0.515463918,0,0
11394,6,21900,10,5,0,1,10,26,8,5,5,0,0,18,nowin,loss,bust,plbust,0,10,15,191,0.439790576,0.047120419,0.581151832,1,0.31211505
11395,96,21900,2,4,8,4,0,18,8,5,5,0,0,18,nowin,push,push,push,10,0,6,190,0.468421053,0.057894737,0.584210526,3,0.897263354
11396,35,21900,7,2,7,10,0,26,8,5,5,0,0,18,nowin,loss,bust,plbust,0,10,9,202,0.410891089,0.044554455,0.633663366,2,0.598681573
11397,110,21900,1,6,10,0,0,17,8,5,5,0,0,18,nowin,loss,beat,dlwin,0,10,7,192,0.416666667,0.046875,0.557291667,0,0.025413132
11398,1,21900,10,6,0,9,0,25,8,5,5,0,0,18,nowin,loss,bust,plbust,0,10,16,197,0.406091371,0.025380711,0.649746193,2,0.606186955
11399,121,21900,11,3,4,0,0,18,8,5,5,0,0,18,nowin,push,push,push,10,0,14,195,0.456410256,0.025641026,0.512820513,1,0.288597791
11400,118,21901,9,10,0,0,0,19,8,4,4,6,0,22,nowin,win,dlbust,bust,20,0,19,216,0.393518519,0.037037037,0.555555556,0,0.018059873
11401,56,21901,10,11,0,0,0,21,8,4,4,6,0,22,win,win,dlbust,bust,25,0,21,175,0.4,0.057142857,0.582857143,0,0.026685297
11402,147,21901,8,11,0,0,0,19,8,4,4,6,0,22,nowin,win,dlbust,bust,20,0,19,205,0.380487805,0.014634146,0.536585366,0,0.00951447
11403,147,21901,10,6,0,5,0,21,8,4,4,6,0,22,nowin,win,dlbust,bust,20,0,16,205,0.380487805,0.014634146,0.536585366,0,0.00951447
11404,20,21901,6,10,0,6,0,22,8,4,4,6,0,22,nowin,loss,bust,plbust,0,10,16,186,0.456989247,0.037634409,0.537634409,1,0.301097108
11405,70,21901,10,10,0,0,0,20,8,4,4,6,0,22,nowin,win,dlbust,bust,20,0,20,228,0.385964912,0.039473684,0.557017544,0,0.016157125
11406,25,21902,3,7,10,0,0,20,10,9,0,0,0,19,nowin,win,plwin,beat,20,0,10,190,0.463157895,0.063157895,0.536842105,1,0.304401563
11407,14,21902,3,10,0,4,0,17,10,9,0,0,0,19,nowin,loss,beat,dlwin,0,10,13,202,0.391089109,0.01980198,0.628712871,2,0.577264877
11408,78,21902,1,6,8,5,0,20,10,9,0,0,0,19,nowin,win,plwin,beat,20,0,7,201,0.517412935,0.034825871,0.587064677,3,0.95871112
11409,29,21902,6,7,0,6,0,19,10,9,0,0,0,19,nowin,push,push,push,10,0,13,189,0.44973545,0.058201058,0.544973545,1,0.300349439
11410,140,21902,9,6,0,4,0,19,10,9,0,0,0,19,nowin,push,push,push,10,0,15,210,0.466666667,0.023809524,0.604761905,3,0.915293335
11411,107,21902,2,2,2,10,10,26,10,9,0,0,0,19,nowin,loss,bust,plbust,0,10,4,218,0.444954128,0.073394495,0.600917431,2,0.605210014
11412,135,21903,11,10,0,0,0,21,11,7,0,0,0,18,win,win,plwin,beat,25,0,21,179,0.391061453,0.067039106,0.586592179,0,0.024924662
11413,87,21903,2,4,10,7,0,23,11,7,0,0,0,18,nowin,loss,bust,plbust,0,10,6,202,0.405940594,0.054455446,0.628712871,2,0.590599801
11414,76,21903,3,10,0,10,0,23,11,7,0,0,0,18,nowin,loss,bust,plbust,0,10,13,189,0.534391534,0.079365079,0.608465608,3,1
11415,33,21903,11,10,0,0,0,21,11,7,0,0,0,18,win,win,plwin,beat,25,0,21,192,0.4375,0.057291667,0.625,2,0.616208916
11416,77,21903,4,10,0,4,0,18,11,7,0,0,0,18,nowin,push,push,push,10,0,14,200,0.455,0.04,0.62,3,0.916252116
11417,148,21903,4,10,0,10,0,24,11,7,0,0,0,18,nowin,loss,bust,plbust,0,10,14,204,0.401960784,0.078431373,0.593137255,0,0.029789521
11418,11,21904,10,10,0,0,0,20,8,8,9,0,0,25,nowin,win,dlbust,bust,20,0,20,236,0.457627119,0.016949153,0.588983051,3,0.889015813
11419,109,21904,10,8,0,0,0,18,8,8,9,0,0,25,nowin,win,dlbust,bust,20,0,18,221,0.461538462,0.058823529,0.597285068,3,0.901830309
11420,29,21904,11,10,0,0,0,21,8,8,9,0,0,25,win,win,dlbust,bust,25,0,21,189,0.44973545,0.058201058,0.544973545,1,0.300349439
11421,21,21904,10,11,0,0,0,21,8,8,9,0,0,25,win,win,dlbust,bust,25,0,21,214,0.359813084,0.042056075,0.626168224,0,0.025263474
11422,81,21904,3,8,2,9,0,22,8,8,9,0,0,25,nowin,loss,bust,plbust,0,10,11,182,0.395604396,0.043956044,0.60989011,2,0.567491261
11423,22,21904,10,8,0,0,0,18,8,8,9,0,0,25,nowin,win,dlbust,bust,20,0,18,187,0.481283422,0.042780749,0.577540107,3,0.906128176
11424,103,21905,3,5,4,10,0,22,10,10,0,0,0,20,nowin,loss,bust,plbust,0,10,8,203,0.379310345,0.064039409,0.551724138,0,0.012869209
11425,127,21905,5,2,6,6,0,19,10,10,0,0,0,20,nowin,loss,beat,dlwin,0,10,7,201,0.402985075,0.029850746,0.60199005,0,0.032263937
11426,63,21905,10,3,0,9,0,22,10,10,0,0,0,20,nowin,loss,bust,plbust,0,10,13,216,0.467592593,0.037037037,0.62037037,3,0.931690496
11427,138,21905,3,5,8,10,0,26,10,10,0,0,0,20,nowin,loss,bust,plbust,0,10,8,190,0.442105263,0.047368421,0.610526316,2,0.609711065
11428,21,21905,8,10,0,0,0,18,10,10,0,0,0,20,nowin,loss,beat,dlwin,0,10,18,214,0.359813084,0.042056075,0.626168224,0,0.025263474
11429,67,21905,10,10,0,0,0,20,10,10,0,0,0,20,nowin,push,push,push,10,0,20,195,0.369230769,0.041025641,0.569230769,0,0.014139427
11430,68,21906,5,8,0,6,0,19,8,10,0,0,0,18,nowin,win,plwin,beat,20,0,13,205,0.434146341,0.029268293,0.6,2,0.59483189
11431,140,21906,6,10,0,10,0,26,8,10,0,0,0,18,nowin,loss,bust,plbust,0,10,16,210,0.466666667,0.023809524,0.604761905,3,0.915293335
11432,148,21906,10,10,0,0,0,20,8,10,0,0,0,18,nowin,win,plwin,beat,20,0,20,204,0.401960784,0.078431373,0.593137255,0,0.029789521
11433,103,21906,4,7,10,0,0,21,8,10,0,0,0,18,nowin,win,plwin,beat,20,0,11,203,0.379310345,0.064039409,0.551724138,0,0.012869209
11434,65,21906,9,2,8,0,0,19,8,10,0,0,0,18,nowin,win,plwin,beat,20,0,11,203,0.492610837,0.054187192,0.571428571,3,0.913702814
11435,116,21906,2,4,7,5,0,18,8,10,0,0,0,18,nowin,push,push,push,10,0,6,195,0.425641026,0.056410256,0.538461538,1,0.28273747
11436,125,21907,7,2,9,0,0,18,10,5,5,0,0,20,nowin,loss,beat,dlwin,0,10,9,219,0.438356164,0.050228311,0.575342466,1,0.308411257
11437,61,21907,5,7,0,10,0,22,10,5,5,0,0,20,nowin,loss,bust,plbust,0,10,12,194,0.427835052,0.077319588,0.603092784,2,0.591437139
11438,85,21907,6,9,0,9,0,24,10,5,5,0,0,20,nowin,loss,bust,plbust,0,10,15,195,0.41025641,0.066666667,0.594871795,0,0.03269711
11439,35,21907,9,10,0,0,0,19,10,5,5,0,0,20,nowin,loss,beat,dlwin,0,10,19,202,0.410891089,0.044554455,0.633663366,2,0.598681573
11440,11,21907,10,6,0,10,0,26,10,5,5,0,0,20,nowin,loss,bust,plbust,0,10,16,236,0.457627119,0.016949153,0.588983051,3,0.889015813
11441,148,21907,2,4,3,10,0,19,10,5,5,0,0,20,nowin,loss,beat,dlwin,0,10,6,204,0.401960784,0.078431373,0.593137255,0,0.029789521
11442,122,21908,10,2,0,0,0,12,6,10,1,0,0,17,nowin,loss,beat,dlwin,0,10,12,210,0.347619048,0.052380952,0.59047619,0,0.012873677
11443,67,21908,3,1,10,0,0,14,6,10,1,0,0,17,nowin,loss,beat,dlwin,0,10,4,195,0.369230769,0.041025641,0.569230769,0,0.014139427
11444,111,21908,3,10,0,0,0,13,6,10,1,0,0,17,nowin,loss,beat,dlwin,0,10,13,180,0.433333333,0.055555556,0.611111111,2,0.602264492
11445,135,21908,11,2,3,0,0,16,6,10,1,0,0,17,nowin,loss,beat,dlwin,0,10,13,179,0.391061453,0.067039106,0.586592179,0,0.024924662
11446,98,21908,2,3,7,0,0,12,6,10,1,0,0,17,nowin,loss,beat,dlwin,0,10,5,220,0.422727273,0.054545455,0.55,1,0.28664435
11447,125,21908,8,10,0,0,0,18,6,10,1,0,0,17,nowin,win,plwin,beat,20,0,18,219,0.438356164,0.050228311,0.575342466,1,0.308411257
11448,58,21909,10,4,0,0,0,14,6,5,10,0,0,21,nowin,loss,beat,dlwin,0,10,14,195,0.430769231,0.041025641,0.584615385,2,0.580497586
11449,26,21909,4,3,7,0,0,14,6,5,10,0,0,21,nowin,loss,beat,dlwin,0,10,7,203,0.463054187,0.0591133,0.541871921,1,0.306802864
11450,82,21909,4,11,6,0,0,21,6,5,10,0,0,21,nowin,push,push,push,10,0,15,225,0.408888889,0.075555556,0.577777778,0,0.028101874
11451,80,21909,7,8,0,0,0,15,6,5,10,0,0,21,nowin,loss,beat,dlwin,0,10,15,186,0.419354839,0.059139785,0.623655914,2,0.59892924
11452,8,21909,2,7,11,0,0,20,6,5,10,0,0,21,nowin,loss,beat,dlwin,0,10,9,181,0.44198895,0.071823204,0.596685083,2,0.599438402
11453,147,21909,11,2,7,0,0,20,6,5,10,0,0,21,nowin,loss,beat,dlwin,0,10,13,205,0.380487805,0.014634146,0.536585366,0,0.00951447
11454,57,21910,2,1,10,0,0,13,2,2,10,10,0,24,nowin,win,dlbust,bust,20,0,3,192,0.46875,0.052083333,0.59375,3,0.907001181
11455,64,21910,10,10,0,0,0,20,2,2,10,10,0,24,nowin,win,dlbust,bust,20,0,20,187,0.363636364,0.048128342,0.631016043,0,0.027594885
11456,121,21910,5,10,0,0,0,15,2,2,10,10,0,24,nowin,win,dlbust,bust,20,0,15,195,0.456410256,0.025641026,0.512820513,1,0.288597791
11457,136,21910,5,5,3,0,0,13,2,2,10,10,0,24,nowin,win,dlbust,bust,20,0,10,194,0.396907216,0.025773196,0.597938144,0,0.029452644
11458,91,21910,3,5,9,0,0,17,2,2,10,10,0,24,nowin,win,dlbust,bust,20,0,8,194,0.417525773,0.046391753,0.515463918,1,0.266616552
11459,110,21910,6,6,0,5,0,17,2,2,10,10,0,24,nowin,win,dlbust,bust,20,0,12,192,0.416666667,0.046875,0.557291667,0,0.025413132
11460,47,21911,10,3,0,1,5,19,10,2,9,0,0,21,nowin,loss,beat,dlwin,0,10,13,210,0.438095238,0.057142857,0.623809524,2,0.615868808
11461,92,21911,5,9,0,10,0,24,10,2,9,0,0,21,nowin,loss,bust,plbust,0,10,14,186,0.446236559,0.059139785,0.564516129,1,0.307826125
11462,113,21911,10,10,0,0,0,20,10,2,9,0,0,21,nowin,loss,beat,dlwin,0,10,20,199,0.407035176,0.055276382,0.668341709,2,0.620695264
11463,70,21911,6,3,11,0,0,20,10,2,9,0,0,21,nowin,loss,beat,dlwin,0,10,9,228,0.385964912,0.039473684,0.557017544,0,0.016157125
11464,54,21911,5,8,0,2,7,22,10,2,9,0,0,21,nowin,loss,bust,plbust,0,10,13,185,0.437837838,0.032432432,0.556756757,1,0.29899854
11465,79,21911,2,5,10,0,0,17,10,2,9,0,0,21,nowin,loss,beat,dlwin,0,10,7,211,0.436018957,0.028436019,0.672985782,2,0.650131054
11466,68,21912,9,10,0,0,0,19,10,10,0,0,0,20,nowin,loss,beat,dlwin,0,10,19,205,0.434146341,0.029268293,0.6,2,0.59483189
11467,112,21912,4,10,0,10,0,24,10,10,0,0,0,20,nowin,loss,bust,plbust,0,10,14,203,0.448275862,0.054187192,0.600985222,3,0.889576933
11468,27,21912,6,4,6,3,0,19,10,10,0,0,0,20,nowin,loss,beat,dlwin,0,10,10,178,0.370786517,0.016853933,0.573033708,0,0.015536309
11469,88,21912,3,2,9,10,0,24,10,10,0,0,0,20,nowin,loss,bust,plbust,0,10,5,206,0.466019417,0.033980583,0.54368932,1,0.309467903
11470,76,21912,2,9,10,0,0,21,10,10,0,0,0,20,nowin,win,plwin,beat,20,0,11,189,0.534391534,0.079365079,0.608465608,3,1
11471,17,21912,11,7,0,0,0,18,10,10,0,0,0,20,nowin,loss,beat,dlwin,0,10,18,171,0.444444444,0.070175439,0.555555556,1,0.302364894
11472,128,21913,9,10,0,0,0,19,10,10,0,0,0,20,nowin,loss,beat,dlwin,0,10,19,227,0.356828194,0.052863436,0.577092511,0,0.012352564
11473,107,21913,10,8,0,0,0,18,10,10,0,0,0,20,nowin,loss,beat,dlwin,0,10,18,218,0.444954128,0.073394495,0.600917431,2,0.605210014
11474,140,21913,4,9,0,10,0,23,10,10,0,0,0,20,nowin,loss,bust,plbust,0,10,13,210,0.466666667,0.023809524,0.604761905,3,0.915293335
11475,49,21913,9,5,0,7,0,21,10,10,0,0,0,20,nowin,win,plwin,beat,20,0,14,207,0.396135266,0.053140097,0.594202899,0,0.028306925
11476,109,21913,8,2,10,0,0,20,10,10,0,0,0,20,nowin,push,push,push,10,0,10,221,0.461538462,0.058823529,0.597285068,3,0.901830309
11477,16,21913,10,10,0,0,0,20,10,10,0,0,0,20,nowin,push,push,push,10,0,20,220,0.427272727,0.081818182,0.6,2,0.588660176
11478,38,21914,11,6,4,0,0,21,7,10,0,0,0,17,nowin,win,plwin,beat,20,0,17,202,0.361386139,0.03960396,0.564356436,0,0.010597953
11479,71,21914,6,10,0,7,0,23,7,10,0,0,0,17,nowin,loss,bust,plbust,0,10,16,193,0.352331606,0.046632124,0.585492228,0,0.013063661
11480,150,21914,6,4,3,5,0,18,7,10,0,0,0,17,nowin,win,plwin,beat,20,0,10,192,0.401041667,0.036458333,0.567708333,0,0.023287458
11481,125,21914,9,10,0,0,0,19,7,10,0,0,0,17,nowin,win,plwin,beat,20,0,19,219,0.438356164,0.050228311,0.575342466,1,0.308411257
11482,32,21914,10,6,0,2,0,18,7,10,0,0,0,17,nowin,win,plwin,beat,20,0,16,189,0.391534392,0.037037037,0.53968254,0,0.013579086
11483,130,21914,10,5,0,10,0,25,7,10,0,0,0,17,nowin,loss,bust,plbust,0,10,15,219,0.410958904,0.03652968,0.566210046,0,0.025888739
11484,78,21915,6,8,0,10,0,24,9,4,10,0,0,23,nowin,loss,bust,plbust,0,10,14,201,0.517412935,0.034825871,0.587064677,3,0.95871112
11485,150,21915,8,10,0,0,0,18,9,4,10,0,0,23,nowin,win,dlbust,bust,20,0,18,192,0.401041667,0.036458333,0.567708333,0,0.023287458
11486,57,21915,2,9,10,0,0,21,9,4,10,0,0,23,nowin,win,dlbust,bust,20,0,11,192,0.46875,0.052083333,0.59375,3,0.907001181
11487,149,21915,2,2,2,1,10,17,9,4,10,0,0,23,nowin,win,dlbust,bust,20,0,4,225,0.457777778,0.057777778,0.648888889,2,0.651965595
11488,9,21915,10,9,0,0,0,19,9,4,10,0,0,23,nowin,win,dlbust,bust,20,0,19,194,0.37628866,0.015463918,0.541237113,0,0.009396796
11489,87,21915,7,7,0,4,0,18,9,4,10,0,0,23,nowin,win,dlbust,bust,20,0,14,202,0.405940594,0.054455446,0.628712871,2,0.590599801
11490,128,21916,4,7,3,4,0,18,8,8,10,0,0,26,nowin,win,dlbust,bust,20,0,11,227,0.356828194,0.052863436,0.577092511,0,0.012352564
11491,148,21916,10,10,0,0,0,20,8,8,10,0,0,26,nowin,win,dlbust,bust,20,0,20,204,0.401960784,0.078431373,0.593137255,0,0.029789521
11492,54,21916,10,5,0,9,0,24,8,8,10,0,0,26,nowin,loss,bust,plbust,0,10,15,185,0.437837838,0.032432432,0.556756757,1,0.29899854
11493,136,21916,2,11,2,5,0,20,8,8,10,0,0,26,nowin,win,dlbust,bust,20,0,13,194,0.396907216,0.025773196,0.597938144,0,0.029452644
11494,106,21916,10,5,0,4,0,19,8,8,10,0,0,26,nowin,win,dlbust,bust,20,0,15,192,0.411458333,0.026041667,0.557291667,0,0.023854304
11495,74,21916,3,5,10,0,0,18,8,8,10,0,0,26,nowin,win,dlbust,bust,20,0,8,209,0.411483254,0.04784689,0.531100478,0,0.017448125
11496,121,21917,10,10,0,0,0,20,3,10,10,0,0,23,nowin,win,dlbust,bust,20,0,20,195,0.456410256,0.025641026,0.512820513,1,0.288597791
11497,18,21917,10,5,0,0,0,15,3,10,10,0,0,23,nowin,win,dlbust,bust,20,0,15,182,0.461538462,0.043956044,0.587912088,3,0.892649374
11498,142,21917,8,5,0,0,0,13,3,10,10,0,0,23,nowin,win,dlbust,bust,20,0,13,211,0.417061611,0.047393365,0.526066351,1,0.271531309
11499,83,21917,10,10,0,0,0,20,3,10,10,0,0,23,nowin,win,dlbust,bust,20,0,20,193,0.424870466,0.051813472,0.678756477,2,0.644360335
11500,90,21917,3,5,6,0,0,14,3,10,10,0,0,23,nowin,win,dlbust,bust,20,0,8,201,0.447761194,0.049751244,0.60199005,3,0.889945023
11501,36,21917,5,2,10,0,0,17,3,10,10,0,0,23,nowin,win,dlbust,bust,20,0,7,229,0.445414847,0.056768559,0.655021834,2,0.645370571
11502,77,21918,10,3,0,1,10,24,7,3,5,10,0,25,nowin,loss,bust,plbust,0,10,13,200,0.455,0.04,0.62,3,0.916252116
11503,43,21918,10,4,0,10,0,24,7,3,5,10,0,25,nowin,loss,bust,plbust,0,10,14,192,0.40625,0.041666667,0.609375,2,0.576671372
11504,36,21918,2,2,3,1,3,11,7,3,5,10,0,25,nowin,win,dlbust,bust,20,0,4,229,0.445414847,0.056768559,0.655021834,2,0.645370571
11505,36,21918,5,10,0,6,0,21,7,3,5,10,0,25,nowin,win,dlbust,bust,20,0,15,229,0.445414847,0.056768559,0.655021834,2,0.645370571
11506,34,21918,10,8,0,0,0,18,7,3,5,10,0,25,nowin,win,dlbust,bust,20,0,18,202,0.5,0.079207921,0.618811881,3,0.968961434
11507,146,21918,6,9,0,3,0,18,7,3,5,10,0,25,nowin,win,dlbust,bust,20,0,15,221,0.43438914,0.040723982,0.542986425,1,0.290190091
11508,71,21919,5,10,0,0,0,15,2,6,10,0,0,18,nowin,loss,beat,dlwin,0,10,15,193,0.352331606,0.046632124,0.585492228,0,0.013063661
11509,79,21919,10,10,0,0,0,20,2,6,10,0,0,18,nowin,win,plwin,beat,20,0,20,211,0.436018957,0.028436019,0.672985782,2,0.650131054
11510,59,21919,10,10,0,0,0,20,2,6,10,0,0,18,nowin,win,plwin,beat,20,0,20,228,0.429824561,0.048245614,0.543859649,1,0.287885446
11511,130,21919,10,10,0,0,0,20,2,6,10,0,0,18,nowin,win,plwin,beat,20,0,20,219,0.410958904,0.03652968,0.566210046,0,0.025888739
11512,133,21919,7,8,0,0,0,15,2,6,10,0,0,18,nowin,loss,beat,dlwin,0,10,15,201,0.47761194,0.064676617,0.611940299,3,0.935428111
11513,93,21919,11,10,0,0,0,21,2,6,10,0,0,18,win,win,plwin,beat,25,0,21,175,0.485714286,0.051428571,0.548571429,1,0.323648091
11514,10,21920,3,8,8,0,0,19,3,6,5,4,0,18,nowin,win,plwin,beat,20,0,11,191,0.413612565,0.057591623,0.596858639,2,0.574087175
11515,82,21920,2,6,9,0,0,17,3,6,5,4,0,18,nowin,loss,beat,dlwin,0,10,8,225,0.408888889,0.075555556,0.577777778,0,0.028101874
11516,59,21920,10,10,0,0,0,20,3,6,5,4,0,18,nowin,win,plwin,beat,20,0,20,228,0.429824561,0.048245614,0.543859649,1,0.287885446
11517,127,21920,8,9,0,0,0,17,3,6,5,4,0,18,nowin,loss,beat,dlwin,0,10,17,201,0.402985075,0.029850746,0.60199005,0,0.032263937
11518,4,21920,3,9,0,4,0,16,3,6,5,4,0,18,nowin,loss,beat,dlwin,0,10,12,217,0.460829493,0.036866359,0.562211982,1,0.315432839
11519,109,21920,6,10,0,0,0,16,3,6,5,4,0,18,nowin,loss,beat,dlwin,0,10,16,221,0.461538462,0.058823529,0.597285068,3,0.901830309
11520,119,21921,7,10,0,0,0,17,7,10,0,0,0,17,nowin,push,push,push,10,0,17,190,0.405263158,0.068421053,0.515789474,0,0.011837158
11521,98,21921,5,10,0,6,0,21,7,10,0,0,0,17,nowin,win,plwin,beat,20,0,15,220,0.422727273,0.054545455,0.55,1,0.28664435
11522,104,21921,8,9,0,0,0,17,7,10,0,0,0,17,nowin,push,push,push,10,0,17,209,0.363636364,0.052631579,0.593301435,0,0.018359419
11523,146,21921,3,10,0,4,0,17,7,10,0,0,0,17,nowin,push,push,push,10,0,13,221,0.43438914,0.040723982,0.542986425,1,0.290190091
11524,109,21921,7,6,0,9,0,22,7,10,0,0,0,17,nowin,loss,bust,plbust,0,10,13,221,0.461538462,0.058823529,0.597285068,3,0.901830309
11525,147,21921,3,11,7,0,0,21,7,10,0,0,0,17,nowin,win,plwin,beat,20,0,14,205,0.380487805,0.014634146,0.536585366,0,0.00951447
11526,73,21922,10,4,0,3,0,17,8,7,10,0,0,25,nowin,win,dlbust,bust,20,0,14,181,0.375690608,0.011049724,0.596685083,0,0.022795773
11527,38,21922,2,9,6,0,0,17,8,7,10,0,0,25,nowin,win,dlbust,bust,20,0,11,202,0.361386139,0.03960396,0.564356436,0,0.010597953
11528,111,21922,8,10,0,0,0,18,8,7,10,0,0,25,nowin,win,dlbust,bust,20,0,18,180,0.433333333,0.055555556,0.611111111,2,0.602264492
11529,137,21922,1,4,7,10,0,22,8,7,10,0,0,25,nowin,loss,bust,plbust,0,10,5,194,0.417525773,0.046391753,0.536082474,1,0.276714602
11530,87,21922,3,8,2,10,0,23,8,7,10,0,0,25,nowin,loss,bust,plbust,0,10,11,202,0.405940594,0.054455446,0.628712871,2,0.590599801
11531,73,21922,3,11,2,10,0,26,8,7,10,0,0,25,nowin,loss,bust,plbust,0,10,14,181,0.375690608,0.011049724,0.596685083,0,0.022795773
11532,145,21923,5,3,3,1,10,22,10,11,0,0,0,21,nowin,loss,bust,plbust,0,10,8,188,0.441489362,0.031914894,0.622340426,2,0.617837093
11533,27,21923,9,6,0,5,0,20,10,11,0,0,0,21,nowin,loss,beat,dlwin,0,10,15,178,0.370786517,0.016853933,0.573033708,0,0.015536309
11534,103,21923,6,10,0,10,0,26,10,11,0,0,0,21,nowin,loss,bust,plbust,0,10,16,203,0.379310345,0.064039409,0.551724138,0,0.012869209
11535,28,21923,4,9,0,6,0,19,10,11,0,0,0,21,nowin,loss,beat,dlwin,0,10,13,199,0.422110553,0.045226131,0.542713568,1,0.282706618
11536,27,21923,10,4,0,10,0,24,10,11,0,0,0,21,nowin,loss,bust,plbust,0,10,14,178,0.370786517,0.016853933,0.573033708,0,0.015536309
11537,109,21923,9,10,0,0,0,19,10,11,0,0,0,21,nowin,loss,beat,dlwin,0,10,19,221,0.461538462,0.058823529,0.597285068,3,0.901830309
11538,20,21924,10,10,0,0,0,20,10,5,2,0,0,17,nowin,win,plwin,beat,20,0,20,186,0.456989247,0.037634409,0.537634409,1,0.301097108
11539,102,21924,4,4,5,5,0,18,10,5,2,0,0,17,nowin,win,plwin,beat,20,0,8,192,0.338541667,0.046875,0.5625,0,0.003306118
11540,59,21924,10,9,0,0,0,19,10,5,2,0,0,17,nowin,win,plwin,beat,20,0,19,228,0.429824561,0.048245614,0.543859649,1,0.287885446
11541,20,21924,3,10,0,8,0,21,10,5,2,0,0,17,nowin,win,plwin,beat,20,0,13,186,0.456989247,0.037634409,0.537634409,1,0.301097108
11542,19,21924,8,10,0,0,0,18,10,5,2,0,0,17,nowin,win,plwin,beat,20,0,18,237,0.41350211,0.054852321,0.628691983,2,0.597373826
11543,59,21924,3,10,0,1,5,19,10,5,2,0,0,17,nowin,win,plwin,beat,20,0,13,228,0.429824561,0.048245614,0.543859649,1,0.287885446
11544,112,21925,7,5,0,0,0,12,5,4,4,10,0,23,nowin,win,dlbust,bust,20,0,12,203,0.448275862,0.054187192,0.600985222,3,0.889576933
11545,92,21925,3,4,3,9,0,19,5,4,4,10,0,23,nowin,win,dlbust,bust,20,0,7,186,0.446236559,0.059139785,0.564516129,1,0.307826125
11546,134,21925,3,10,0,0,0,13,5,4,4,10,0,23,nowin,win,dlbust,bust,20,0,13,185,0.443243243,0.021621622,0.545945946,1,0.296939509
11547,105,21925,10,3,0,0,0,13,5,4,4,10,0,23,nowin,win,dlbust,bust,20,0,13,198,0.414141414,0.070707071,0.590909091,0,0.032889494
11548,83,21925,10,10,0,0,0,20,5,4,4,10,0,23,nowin,win,dlbust,bust,20,0,20,193,0.424870466,0.051813472,0.678756477,2,0.644360335
11549,2,21925,9,8,0,0,0,17,5,4,4,10,0,23,nowin,win,dlbust,bust,20,0,17,200,0.445,0.035,0.64,2,0.633962549
11550,147,21926,10,5,0,7,0,22,10,5,1,10,0,26,nowin,loss,bust,plbust,0,10,15,205,0.380487805,0.014634146,0.536585366,0,0.00951447
11551,99,21926,4,10,0,4,0,18,10,5,1,10,0,26,nowin,win,dlbust,bust,20,0,14,207,0.47826087,0.062801932,0.637681159,3,0.961418446
11552,23,21926,2,1,10,10,0,23,10,5,1,10,0,26,nowin,loss,bust,plbust,0,10,3,208,0.427884615,0.0625,0.552884615,1,0.29114424
11553,31,21926,10,10,0,0,0,20,10,5,1,10,0,26,nowin,win,dlbust,bust,20,0,20,188,0.473404255,0.058510638,0.515957447,1,0.300306557
11554,94,21926,10,10,0,0,0,20,10,5,1,10,0,26,nowin,win,dlbust,bust,20,0,20,183,0.43715847,0.043715847,0.540983607,1,0.290866892
11555,65,21926,10,3,0,9,0,22,10,5,1,10,0,26,nowin,loss,bust,plbust,0,10,13,203,0.492610837,0.054187192,0.571428571,3,0.913702814
11556,31,21927,8,9,0,0,0,17,9,6,10,0,0,25,nowin,win,dlbust,bust,20,0,17,188,0.473404255,0.058510638,0.515957447,1,0.300306557
11557,76,21927,10,11,0,0,0,21,9,6,10,0,0,25,win,win,dlbust,bust,25,0,21,189,0.534391534,0.079365079,0.608465608,3,1
11558,125,21927,11,5,5,0,0,21,9,6,10,0,0,25,nowin,win,dlbust,bust,20,0,16,219,0.438356164,0.050228311,0.575342466,1,0.308411257
11559,12,21927,10,6,0,10,0,26,9,6,10,0,0,25,nowin,loss,bust,plbust,0,10,16,189,0.470899471,0.015873016,0.613756614,3,0.929171178
11560,70,21927,8,5,0,1,10,24,9,6,10,0,0,25,nowin,loss,bust,plbust,0,10,13,228,0.385964912,0.039473684,0.557017544,0,0.016157125
11561,139,21927,10,8,0,0,0,18,9,6,10,0,0,25,nowin,win,dlbust,bust,20,0,18,192,0.380208333,0.036458333,0.59375,0,0.023429169
11562,1,21928,10,11,0,0,0,21,10,10,0,0,0,20,win,win,plwin,beat,25,0,21,197,0.406091371,0.025380711,0.649746193,2,0.606186955
11563,8,21928,6,3,7,9,0,25,10,10,0,0,0,20,nowin,loss,bust,plbust,0,10,9,181,0.44198895,0.071823204,0.596685083,2,0.599438402
11564,95,21928,4,10,0,6,0,20,10,10,0,0,0,20,nowin,push,push,push,10,0,14,218,0.412844037,0.04587156,0.559633028,0,0.024842385
11565,135,21928,2,7,10,0,0,19,10,10,0,0,0,20,nowin,loss,beat,dlwin,0,10,9,179,0.391061453,0.067039106,0.586592179,0,0.024924662
11566,81,21928,3,6,2,6,0,17,10,10,0,0,0,20,nowin,loss,beat,dlwin,0,10,9,182,0.395604396,0.043956044,0.60989011,2,0.567491261
11567,79,21928,7,10,0,0,0,17,10,10,0,0,0,20,nowin,loss,beat,dlwin,0,10,17,211,0.436018957,0.028436019,0.672985782,2,0.650131054
11568,96,21929,1,5,10,10,0,26,8,6,7,0,0,21,nowin,loss,bust,plbust,0,10,6,190,0.468421053,0.057894737,0.584210526,3,0.897263354
11569,88,21929,4,7,2,2,3,18,8,6,7,0,0,21,nowin,loss,beat,dlwin,0,10,11,206,0.466019417,0.033980583,0.54368932,1,0.309467903
11570,30,21929,10,4,0,2,10,26,8,6,7,0,0,21,nowin,loss,bust,plbust,0,10,14,206,0.393203883,0.033980583,0.601941748,0,0.029324648
11571,121,21929,4,10,0,10,0,24,8,6,7,0,0,21,nowin,loss,bust,plbust,0,10,14,195,0.456410256,0.025641026,0.512820513,1,0.288597791
11572,109,21929,10,3,0,2,9,24,8,6,7,0,0,21,nowin,loss,bust,plbust,0,10,13,221,0.461538462,0.058823529,0.597285068,3,0.901830309
11573,109,21929,3,2,8,5,0,18,8,6,7,0,0,21,nowin,loss,beat,dlwin,0,10,5,221,0.461538462,0.058823529,0.597285068,3,0.901830309
11574,61,21930,9,5,0,10,0,24,9,10,0,0,0,19,nowin,loss,bust,plbust,0,10,14,194,0.427835052,0.077319588,0.603092784,2,0.591437139
11575,57,21930,5,7,0,10,0,22,9,10,0,0,0,19,nowin,loss,bust,plbust,0,10,12,192,0.46875,0.052083333,0.59375,3,0.907001181
11576,93,21930,10,7,0,0,0,17,9,10,0,0,0,19,nowin,loss,beat,dlwin,0,10,17,175,0.485714286,0.051428571,0.548571429,1,0.323648091
11577,82,21930,10,10,0,0,0,20,9,10,0,0,0,19,nowin,win,plwin,beat,20,0,20,225,0.408888889,0.075555556,0.577777778,0,0.028101874
11578,138,21930,11,3,6,0,0,20,9,10,0,0,0,19,nowin,win,plwin,beat,20,0,14,190,0.442105263,0.047368421,0.610526316,2,0.609711065
11579,2,21930,3,9,0,10,0,22,9,10,0,0,0,19,nowin,loss,bust,plbust,0,10,12,200,0.445,0.035,0.64,2,0.633962549
11580,110,21931,7,4,3,0,0,14,3,5,5,5,0,18,nowin,loss,beat,dlwin,0,10,11,192,0.416666667,0.046875,0.557291667,0,0.025413132
11581,124,21931,10,8,0,0,0,18,3,5,5,5,0,18,nowin,push,push,push,10,0,18,202,0.47029703,0.064356436,0.584158416,3,0.899458193
11582,108,21931,10,10,0,0,0,20,3,5,5,5,0,18,nowin,win,plwin,beat,20,0,20,193,0.435233161,0.056994819,0.559585492,1,0.298824795
11583,127,21931,7,7,0,0,0,14,3,5,5,5,0,18,nowin,loss,beat,dlwin,0,10,14,201,0.402985075,0.029850746,0.60199005,0,0.032263937
11584,128,21931,6,4,10,0,0,20,3,5,5,5,0,18,nowin,win,plwin,beat,20,0,10,227,0.356828194,0.052863436,0.577092511,0,0.012352564
11585,9,21931,8,11,0,0,0,19,3,5,5,5,0,18,nowin,win,plwin,beat,20,0,19,194,0.37628866,0.015463918,0.541237113,0,0.009396796
11586,39,21932,9,10,0,0,0,19,9,7,10,0,0,26,nowin,win,dlbust,bust,20,0,19,191,0.429319372,0.062827225,0.57591623,0,0.033760763
11587,69,21932,10,2,0,1,10,23,9,7,10,0,0,26,nowin,loss,bust,plbust,0,10,12,194,0.365979381,0.030927835,0.515463918,0,0
11588,69,21932,2,6,4,10,0,22,9,7,10,0,0,26,nowin,loss,bust,plbust,0,10,8,194,0.365979381,0.030927835,0.515463918,0,0
11589,111,21932,2,10,0,6,0,18,9,7,10,0,0,26,nowin,win,dlbust,bust,20,0,12,180,0.433333333,0.055555556,0.611111111,2,0.602264492
11590,137,21932,2,5,6,1,10,24,9,7,10,0,0,26,nowin,loss,bust,plbust,0,10,7,194,0.417525773,0.046391753,0.536082474,1,0.276714602
11591,45,21932,10,4,0,5,0,19,9,7,10,0,0,26,nowin,win,dlbust,bust,20,0,14,196,0.428571429,0.051020408,0.612244898,2,0.598821767
11592,43,21933,5,4,3,2,1,15,10,11,0,0,0,21,nowin,loss,beat,dlwin,0,10,9,192,0.40625,0.041666667,0.609375,2,0.576671372
11593,56,21933,10,6,0,10,0,26,10,11,0,0,0,21,nowin,loss,bust,plbust,0,10,16,175,0.4,0.057142857,0.582857143,0,0.026685297
11594,10,21933,10,10,0,0,0,20,10,11,0,0,0,21,nowin,loss,beat,dlwin,0,10,20,191,0.413612565,0.057591623,0.596858639,2,0.574087175
11595,97,21933,5,10,0,10,0,25,10,11,0,0,0,21,nowin,loss,bust,plbust,0,10,15,182,0.450549451,0.06043956,0.692307692,2,0.677372279
11596,116,21933,5,10,0,3,0,18,10,11,0,0,0,21,nowin,loss,beat,dlwin,0,10,15,195,0.425641026,0.056410256,0.538461538,1,0.28273747
11597,97,21933,7,8,0,2,0,17,10,11,0,0,0,21,nowin,loss,beat,dlwin,0,10,15,182,0.450549451,0.06043956,0.692307692,2,0.677372279
11598,110,21934,11,1,6,0,0,18,7,8,1,10,0,26,nowin,win,dlbust,bust,20,0,12,192,0.416666667,0.046875,0.557291667,0,0.025413132
11599,61,21934,10,10,0,0,0,20,7,8,1,10,0,26,nowin,win,dlbust,bust,20,0,20,194,0.427835052,0.077319588,0.603092784,2,0.591437139
11600,25,21934,4,8,0,10,0,22,7,8,1,10,0,26,nowin,loss,bust,plbust,0,10,12,190,0.463157895,0.063157895,0.536842105,1,0.304401563
11601,16,21934,2,10,0,1,1,14,7,8,1,10,0,26,nowin,win,dlbust,bust,20,0,12,220,0.427272727,0.081818182,0.6,2,0.588660176
11602,42,21934,4,10,0,10,0,24,7,8,1,10,0,26,nowin,loss,bust,plbust,0,10,14,212,0.443396226,0.051886792,0.570754717,1,0.309181312
11603,85,21934,10,3,0,7,0,20,7,8,1,10,0,26,nowin,win,dlbust,bust,20,0,13,195,0.41025641,0.066666667,0.594871795,0,0.03269711
11604,107,21935,5,5,9,0,0,19,4,10,5,0,0,19,nowin,push,push,push,10,0,10,218,0.444954128,0.073394495,0.600917431,2,0.605210014
11605,57,21935,9,10,0,0,0,19,4,10,5,0,0,19,nowin,push,push,push,10,0,19,192,0.46875,0.052083333,0.59375,3,0.907001181
11606,114,21935,3,10,0,0,0,13,4,10,5,0,0,19,nowin,loss,beat,dlwin,0,10,13,198,0.47979798,0.025252525,0.611111111,3,0.937232995
11607,44,21935,7,4,6,0,0,17,4,10,5,0,0,19,nowin,loss,beat,dlwin,0,10,11,219,0.433789954,0.050228311,0.534246575,1,0.285551035
11608,69,21935,10,8,0,0,0,18,4,10,5,0,0,19,nowin,loss,beat,dlwin,0,10,18,194,0.365979381,0.030927835,0.515463918,0,0
11609,145,21935,2,6,7,0,0,15,4,10,5,0,0,19,nowin,loss,beat,dlwin,0,10,8,188,0.441489362,0.031914894,0.622340426,2,0.617837093
11610,99,21936,6,4,10,0,0,20,10,9,0,0,0,19,nowin,win,plwin,beat,20,0,10,207,0.47826087,0.062801932,0.637681159,3,0.961418446
11611,48,21936,10,4,0,5,0,19,10,9,0,0,0,19,nowin,push,push,push,10,0,14,203,0.413793103,0.019704433,0.600985222,2,0.577280801
11612,11,21936,10,10,0,0,0,20,10,9,0,0,0,19,nowin,win,plwin,beat,20,0,20,236,0.457627119,0.016949153,0.588983051,3,0.889015813
11613,48,21936,7,10,0,0,0,17,10,9,0,0,0,19,nowin,loss,beat,dlwin,0,10,17,203,0.413793103,0.019704433,0.600985222,2,0.577280801
11614,85,21936,9,2,7,0,0,18,10,9,0,0,0,19,nowin,loss,beat,dlwin,0,10,11,195,0.41025641,0.066666667,0.594871795,0,0.03269711
11615,110,21936,9,10,0,0,0,19,10,9,0,0,0,19,nowin,push,push,push,10,0,19,192,0.416666667,0.046875,0.557291667,0,0.025413132
11616,39,21937,5,7,0,0,0,12,4,7,4,10,0,25,nowin,win,dlbust,bust,20,0,12,191,0.429319372,0.062827225,0.57591623,0,0.033760763
11617,144,21937,1,1,10,0,0,12,4,7,4,10,0,25,nowin,win,dlbust,bust,20,0,2,202,0.386138614,0.054455446,0.564356436,0,0.018006244
11618,103,21937,9,4,0,0,0,13,4,7,4,10,0,25,nowin,win,dlbust,bust,20,0,13,203,0.379310345,0.064039409,0.551724138,0,0.012869209
11619,107,21937,10,2,0,0,0,12,4,7,4,10,0,25,nowin,win,dlbust,bust,20,0,12,218,0.444954128,0.073394495,0.600917431,2,0.605210014
11620,14,21937,3,7,4,0,0,14,4,7,4,10,0,25,nowin,win,dlbust,bust,20,0,10,202,0.391089109,0.01980198,0.628712871,2,0.577264877
11621,53,21937,3,10,0,0,0,13,4,7,4,10,0,25,nowin,win,dlbust,bust,20,0,13,250,0.372,0.064,0.564,0,0.013687345
11622,150,21938,7,4,8,0,0,19,8,10,0,0,0,18,nowin,win,plwin,beat,20,0,11,192,0.401041667,0.036458333,0.567708333,0,0.023287458
11623,94,21938,10,2,0,4,10,26,8,10,0,0,0,18,nowin,loss,bust,plbust,0,10,12,183,0.43715847,0.043715847,0.540983607,1,0.290866892
11624,57,21938,8,2,10,0,0,20,8,10,0,0,0,18,nowin,win,plwin,beat,20,0,10,192,0.46875,0.052083333,0.59375,3,0.907001181
11625,72,21938,4,3,10,0,0,17,8,10,0,0,0,18,nowin,loss,beat,dlwin,0,10,7,185,0.394594595,0.032432432,0.508108108,0,0.006763115
11626,128,21938,6,10,0,5,0,21,8,10,0,0,0,18,nowin,win,plwin,beat,20,0,16,227,0.356828194,0.052863436,0.577092511,0,0.012352564
11627,121,21938,10,10,0,0,0,20,8,10,0,0,0,18,nowin,win,plwin,beat,20,0,20,195,0.456410256,0.025641026,0.512820513,1,0.288597791
11628,100,21939,6,6,0,3,10,25,10,11,0,0,0,21,nowin,loss,bust,plbust,0,10,12,190,0.452631579,0.036842105,0.594736842,3,0.888671154
11629,52,21939,6,10,0,10,0,26,10,11,0,0,0,21,nowin,loss,bust,plbust,0,10,16,217,0.414746544,0.02764977,0.599078341,2,0.576736024
11630,117,21939,10,7,0,0,0,17,10,11,0,0,0,21,nowin,loss,beat,dlwin,0,10,17,173,0.410404624,0.069364162,0.606936416,2,0.578610282
11631,79,21939,3,6,10,0,0,19,10,11,0,0,0,21,nowin,loss,beat,dlwin,0,10,9,211,0.436018957,0.028436019,0.672985782,2,0.650131054
11632,55,21939,6,4,11,0,0,21,10,11,0,0,0,21,nowin,push,push,push,10,0,10,191,0.371727749,0.057591623,0.54973822,0,0.01011347
11633,54,21939,3,9,0,10,0,22,10,11,0,0,0,21,nowin,loss,bust,plbust,0,10,12,185,0.437837838,0.032432432,0.556756757,1,0.29899854
11634,14,21940,9,2,6,0,0,17,6,10,10,0,0,26,nowin,win,dlbust,bust,20,0,11,202,0.391089109,0.01980198,0.628712871,2,0.577264877
11635,34,21940,7,11,0,0,0,18,6,10,10,0,0,26,nowin,win,dlbust,bust,20,0,18,202,0.5,0.079207921,0.618811881,3,0.968961434
11636,84,21940,6,1,10,0,0,17,6,10,10,0,0,26,nowin,win,dlbust,bust,20,0,7,195,0.379487179,0.056410256,0.569230769,0,0.017209119
11637,106,21940,4,10,0,0,0,14,6,10,10,0,0,26,nowin,win,dlbust,bust,20,0,14,192,0.411458333,0.026041667,0.557291667,0,0.023854304
11638,15,21940,10,10,0,0,0,20,6,10,10,0,0,26,nowin,win,dlbust,bust,20,0,20,212,0.410377358,0.051886792,0.561320755,0,0.024517408
11639,43,21940,1,5,9,0,0,15,6,10,10,0,0,26,nowin,win,dlbust,bust,20,0,6,192,0.40625,0.041666667,0.609375,2,0.576671372
11640,141,21941,10,5,0,0,0,15,3,5,4,10,0,22,nowin,win,dlbust,bust,20,0,15,202,0.420792079,0.074257426,0.564356436,0,0.028377851
11641,80,21941,4,5,7,0,0,16,3,5,4,10,0,22,nowin,win,dlbust,bust,20,0,9,186,0.419354839,0.059139785,0.623655914,2,0.59892924
11642,98,21941,1,6,10,0,0,17,3,5,4,10,0,22,nowin,win,dlbust,bust,20,0,7,220,0.422727273,0.054545455,0.55,1,0.28664435
11643,114,21941,3,5,8,0,0,16,3,5,4,10,0,22,nowin,win,dlbust,bust,20,0,8,198,0.47979798,0.025252525,0.611111111,3,0.937232995
11644,86,21941,5,4,10,0,0,19,3,5,4,10,0,22,nowin,win,dlbust,bust,20,0,9,196,0.454081633,0.040816327,0.591836735,3,0.887566443
11645,78,21941,2,10,0,2,0,14,3,5,4,10,0,22,nowin,win,dlbust,bust,20,0,12,201,0.517412935,0.034825871,0.587064677,3,0.95871112
11646,81,21942,2,9,6,0,0,17,4,4,10,0,0,18,nowin,loss,beat,dlwin,0,10,11,182,0.395604396,0.043956044,0.60989011,2,0.567491261
11647,122,21942,1,4,10,0,0,15,4,4,10,0,0,18,nowin,loss,beat,dlwin,0,10,5,210,0.347619048,0.052380952,0.59047619,0,0.012873677
11648,130,21942,4,5,10,0,0,19,4,4,10,0,0,18,nowin,win,plwin,beat,20,0,9,219,0.410958904,0.03652968,0.566210046,0,0.025888739
11649,125,21942,8,10,0,0,0,18,4,4,10,0,0,18,nowin,push,push,push,10,0,18,219,0.438356164,0.050228311,0.575342466,1,0.308411257
11650,128,21942,10,8,0,0,0,18,4,4,10,0,0,18,nowin,push,push,push,10,0,18,227,0.356828194,0.052863436,0.577092511,0,0.012352564
11651,126,21942,11,9,0,0,0,20,4,4,10,0,0,18,nowin,win,plwin,beat,20,0,20,188,0.457446809,0.074468085,0.60106383,3,0.900633203
11652,114,21943,10,3,0,0,0,13,2,6,4,9,0,21,nowin,loss,beat,dlwin,0,10,13,198,0.47979798,0.025252525,0.611111111,3,0.937232995
11653,12,21943,10,2,0,9,0,21,2,6,4,9,0,21,nowin,push,push,push,10,0,12,189,0.470899471,0.015873016,0.613756614,3,0.929171178
11654,72,21943,8,11,0,0,0,19,2,6,4,9,0,21,nowin,loss,beat,dlwin,0,10,19,185,0.394594595,0.032432432,0.508108108,0,0.006763115
11655,9,21943,10,2,0,4,0,16,2,6,4,9,0,21,nowin,loss,beat,dlwin,0,10,12,194,0.37628866,0.015463918,0.541237113,0,0.009396796
11656,112,21943,5,10,0,0,0,15,2,6,4,9,0,21,nowin,loss,beat,dlwin,0,10,15,203,0.448275862,0.054187192,0.600985222,3,0.889576933
11657,20,21943,10,11,0,0,0,21,2,6,4,9,0,21,win,push,push,push,10,0,21,186,0.456989247,0.037634409,0.537634409,1,0.301097108
11658,117,21944,3,10,0,0,0,13,3,3,7,10,0,23,nowin,win,dlbust,bust,20,0,13,173,0.410404624,0.069364162,0.606936416,2,0.578610282
11659,23,21944,7,11,0,0,0,18,3,3,7,10,0,23,nowin,win,dlbust,bust,20,0,18,208,0.427884615,0.0625,0.552884615,1,0.29114424
11660,82,21944,10,3,0,0,0,13,3,3,7,10,0,23,nowin,win,dlbust,bust,20,0,13,225,0.408888889,0.075555556,0.577777778,0,0.028101874
11661,129,21944,10,9,0,0,0,19,3,3,7,10,0,23,nowin,win,dlbust,bust,20,0,19,201,0.422885572,0.064676617,0.55721393,0,0.027255383
11662,112,21944,5,3,10,0,0,18,3,3,7,10,0,23,nowin,win,dlbust,bust,20,0,8,203,0.448275862,0.054187192,0.600985222,3,0.889576933
11663,53,21944,10,7,0,0,0,17,3,3,7,10,0,23,nowin,win,dlbust,bust,20,0,17,250,0.372,0.064,0.564,0,0.013687345
11664,46,21945,10,6,0,0,0,16,6,4,5,3,0,18,nowin,loss,beat,dlwin,0,10,16,186,0.403225806,0.048387097,0.591397849,0,0.029742194
11665,87,21945,4,6,6,0,0,16,6,4,5,3,0,18,nowin,loss,beat,dlwin,0,10,10,202,0.405940594,0.054455446,0.628712871,2,0.590599801
11666,34,21945,4,6,5,0,0,15,6,4,5,3,0,18,nowin,loss,beat,dlwin,0,10,10,202,0.5,0.079207921,0.618811881,3,0.968961434
11667,139,21945,7,10,0,0,0,17,6,4,5,3,0,18,nowin,loss,beat,dlwin,0,10,17,192,0.380208333,0.036458333,0.59375,0,0.023429169
11668,79,21945,2,3,9,0,0,14,6,4,5,3,0,18,nowin,loss,beat,dlwin,0,10,5,211,0.436018957,0.028436019,0.672985782,2,0.650131054
11669,25,21945,8,4,0,0,0,12,6,4,5,3,0,18,nowin,loss,beat,dlwin,0,10,12,190,0.463157895,0.063157895,0.536842105,1,0.304401563
11670,145,21946,4,1,9,0,0,14,2,10,10,0,0,22,nowin,win,dlbust,bust,20,0,5,188,0.441489362,0.031914894,0.622340426,2,0.617837093
11671,63,21946,3,10,0,0,0,13,2,10,10,0,0,22,nowin,win,dlbust,bust,20,0,13,216,0.467592593,0.037037037,0.62037037,3,0.931690496
11672,77,21946,4,10,0,0,0,14,2,10,10,0,0,22,nowin,win,dlbust,bust,20,0,14,200,0.455,0.04,0.62,3,0.916252116
11673,104,21946,10,8,0,0,0,18,2,10,10,0,0,22,nowin,win,dlbust,bust,20,0,18,209,0.363636364,0.052631579,0.593301435,0,0.018359419
11674,125,21946,4,4,10,0,0,18,2,10,10,0,0,22,nowin,win,dlbust,bust,20,0,8,219,0.438356164,0.050228311,0.575342466,1,0.308411257
11675,119,21946,8,10,0,0,0,18,2,10,10,0,0,22,nowin,win,dlbust,bust,20,0,18,190,0.405263158,0.068421053,0.515789474,0,0.011837158
11676,119,21947,10,10,0,0,0,20,7,9,7,0,0,23,nowin,win,dlbust,bust,20,0,20,190,0.405263158,0.068421053,0.515789474,0,0.011837158
11677,14,21947,2,7,5,5,0,19,7,9,7,0,0,23,nowin,win,dlbust,bust,20,0,9,202,0.391089109,0.01980198,0.628712871,2,0.577264877
11678,144,21947,5,9,0,6,0,20,7,9,7,0,0,23,nowin,win,dlbust,bust,20,0,14,202,0.386138614,0.054455446,0.564356436,0,0.018006244
11679,66,21947,10,2,0,4,10,26,7,9,7,0,0,23,nowin,loss,bust,plbust,0,10,12,217,0.456221198,0.064516129,0.626728111,3,0.924304367
11680,24,21947,9,6,0,4,0,19,7,9,7,0,0,23,nowin,win,dlbust,bust,20,0,15,207,0.458937198,0.048309179,0.570048309,1,0.318138014
11681,129,21947,11,6,2,0,0,19,7,9,7,0,0,23,nowin,win,dlbust,bust,20,0,17,201,0.422885572,0.064676617,0.55721393,0,0.027255383
11682,139,21948,4,9,0,10,0,23,10,2,10,0,0,22,nowin,loss,bust,plbust,0,10,13,192,0.380208333,0.036458333,0.59375,0,0.023429169
11683,128,21948,10,9,0,0,0,19,10,2,10,0,0,22,nowin,win,dlbust,bust,20,0,19,227,0.356828194,0.052863436,0.577092511,0,0.012352564
11684,42,21948,7,10,0,0,0,17,10,2,10,0,0,22,nowin,win,dlbust,bust,20,0,17,212,0.443396226,0.051886792,0.570754717,1,0.309181312
11685,86,21948,10,6,0,10,0,26,10,2,10,0,0,22,nowin,loss,bust,plbust,0,10,16,196,0.454081633,0.040816327,0.591836735,3,0.887566443
11686,33,21948,10,9,0,0,0,19,10,2,10,0,0,22,nowin,win,dlbust,bust,20,0,19,192,0.4375,0.057291667,0.625,2,0.616208916
11687,81,21948,5,11,5,0,0,21,10,2,10,0,0,22,nowin,win,dlbust,bust,20,0,16,182,0.395604396,0.043956044,0.60989011,2,0.567491261
11688,133,21949,10,11,0,0,0,21,1,3,10,10,0,24,win,win,dlbust,bust,25,0,21,201,0.47761194,0.064676617,0.611940299,3,0.935428111
11689,76,21949,9,6,0,10,0,25,1,3,10,10,0,24,nowin,loss,bust,plbust,0,10,15,189,0.534391534,0.079365079,0.608465608,3,1
11690,50,21949,4,2,4,4,1,15,1,3,10,10,0,24,nowin,win,dlbust,bust,20,0,6,202,0.405940594,0.04950495,0.54950495,0,0.020296079
11691,37,21949,7,6,0,5,0,18,1,3,10,10,0,24,nowin,win,dlbust,bust,20,0,13,208,0.394230769,0.038461538,0.581730769,0,0.024682772
11692,39,21949,3,5,8,8,0,24,1,3,10,10,0,24,nowin,loss,bust,plbust,0,10,8,191,0.429319372,0.062827225,0.57591623,0,0.033760763
11693,63,21949,8,3,6,0,0,17,1,3,10,10,0,24,nowin,win,dlbust,bust,20,0,11,216,0.467592593,0.037037037,0.62037037,3,0.931690496
11694,143,21950,10,3,0,0,0,13,3,5,7,2,0,17,nowin,loss,beat,dlwin,0,10,13,203,0.463054187,0.044334975,0.57635468,3,0.883143365
11695,24,21950,10,7,0,0,0,17,3,5,7,2,0,17,nowin,push,push,push,10,0,17,207,0.458937198,0.048309179,0.570048309,1,0.318138014
11696,123,21950,11,6,1,0,0,18,3,5,7,2,0,17,nowin,win,plwin,beat,20,0,17,205,0.43902439,0.034146341,0.614634146,2,0.609962544
11697,23,21950,10,9,0,0,0,19,3,5,7,2,0,17,nowin,win,plwin,beat,20,0,19,208,0.427884615,0.0625,0.552884615,1,0.29114424
11698,17,21950,3,5,2,4,0,14,3,5,7,2,0,17,nowin,loss,beat,dlwin,0,10,8,171,0.444444444,0.070175439,0.555555556,1,0.302364894
11699,98,21950,10,5,0,0,0,15,3,5,7,2,0,17,nowin,loss,beat,dlwin,0,10,15,220,0.422727273,0.054545455,0.55,1,0.28664435
11700,64,21951,10,7,0,0,0,17,10,10,0,0,0,20,nowin,loss,beat,dlwin,0,10,17,187,0.363636364,0.048128342,0.631016043,0,0.027594885
11701,59,21951,9,2,5,10,0,26,10,10,0,0,0,20,nowin,loss,bust,plbust,0,10,11,228,0.429824561,0.048245614,0.543859649,1,0.287885446
11702,32,21951,10,10,0,0,0,20,10,10,0,0,0,20,nowin,push,push,push,10,0,20,189,0.391534392,0.037037037,0.53968254,0,0.013579086
11703,38,21951,10,8,0,0,0,18,10,10,0,0,0,20,nowin,loss,beat,dlwin,0,10,18,202,0.361386139,0.03960396,0.564356436,0,0.010597953
11704,55,21951,7,6,0,7,0,20,10,10,0,0,0,20,nowin,push,push,push,10,0,13,191,0.371727749,0.057591623,0.54973822,0,0.01011347
11705,33,21951,10,4,0,9,0,23,10,10,0,0,0,20,nowin,loss,bust,plbust,0,10,14,192,0.4375,0.057291667,0.625,2,0.616208916
11706,16,21952,7,3,2,5,0,17,7,8,8,0,0,23,nowin,win,dlbust,bust,20,0,10,220,0.427272727,0.081818182,0.6,2,0.588660176
11707,6,21952,8,7,0,10,0,25,7,8,8,0,0,23,nowin,loss,bust,plbust,0,10,15,191,0.439790576,0.047120419,0.581151832,1,0.31211505
11708,119,21952,3,10,0,1,7,21,7,8,8,0,0,23,nowin,win,dlbust,bust,20,0,13,190,0.405263158,0.068421053,0.515789474,0,0.011837158
11709,1,21952,10,4,0,7,0,21,7,8,8,0,0,23,nowin,win,dlbust,bust,20,0,14,197,0.406091371,0.025380711,0.649746193,2,0.606186955
11710,133,21952,10,10,0,0,0,20,7,8,8,0,0,23,nowin,win,dlbust,bust,20,0,20,201,0.47761194,0.064676617,0.611940299,3,0.935428111
11711,45,21952,11,10,0,0,0,21,7,8,8,0,0,23,win,win,dlbust,bust,25,0,21,196,0.428571429,0.051020408,0.612244898,2,0.598821767
11712,134,21953,9,11,0,0,0,20,3,2,6,3,6,20,nowin,push,push,push,10,0,20,185,0.443243243,0.021621622,0.545945946,1,0.296939509
11713,135,21953,8,7,0,0,0,15,3,2,6,3,6,20,nowin,loss,beat,dlwin,0,10,15,179,0.391061453,0.067039106,0.586592179,0,0.024924662
11714,12,21953,7,2,11,0,0,20,3,2,6,3,6,20,nowin,push,push,push,10,0,9,189,0.470899471,0.015873016,0.613756614,3,0.929171178
11715,5,21953,8,10,0,0,0,18,3,2,6,3,6,20,nowin,loss,beat,dlwin,0,10,18,203,0.42364532,0.02955665,0.596059113,2,0.582508076
11716,105,21953,9,4,0,0,0,13,3,2,6,3,6,20,nowin,loss,beat,dlwin,0,10,13,198,0.414141414,0.070707071,0.590909091,0,0.032889494
11717,124,21953,2,8,10,0,0,20,3,2,6,3,6,20,nowin,push,push,push,10,0,10,202,0.47029703,0.064356436,0.584158416,3,0.899458193
11718,29,21954,10,6,0,4,0,20,10,7,0,0,0,17,nowin,win,plwin,beat,20,0,16,189,0.44973545,0.058201058,0.544973545,1,0.300349439
11719,44,21954,4,10,0,7,0,21,10,7,0,0,0,17,nowin,win,plwin,beat,20,0,14,219,0.433789954,0.050228311,0.534246575,1,0.285551035
11720,37,21954,8,4,0,5,0,17,10,7,0,0,0,17,nowin,push,push,push,10,0,12,208,0.394230769,0.038461538,0.581730769,0,0.024682772
11721,125,21954,10,10,0,0,0,20,10,7,0,0,0,17,nowin,win,plwin,beat,20,0,20,219,0.438356164,0.050228311,0.575342466,1,0.308411257
11722,77,21954,6,9,0,9,0,24,10,7,0,0,0,17,nowin,loss,bust,plbust,0,10,15,200,0.455,0.04,0.62,3,0.916252116
11723,78,21954,2,9,9,0,0,20,10,7,0,0,0,17,nowin,win,plwin,beat,20,0,11,201,0.517412935,0.034825871,0.587064677,3,0.95871112
11724,89,21955,7,3,11,0,0,21,11,10,0,0,0,21,nowin,push,push,push,10,0,10,212,0.537735849,0.047169811,0.594339623,3,0.990167191
11725,15,21955,8,2,10,0,0,20,11,10,0,0,0,21,nowin,loss,beat,dlwin,0,10,10,212,0.410377358,0.051886792,0.561320755,0,0.024517408
11726,72,21955,3,10,0,10,0,23,11,10,0,0,0,21,nowin,loss,bust,plbust,0,10,13,185,0.394594595,0.032432432,0.508108108,0,0.006763115
11727,64,21955,9,9,0,0,0,18,11,10,0,0,0,21,nowin,loss,beat,dlwin,0,10,18,187,0.363636364,0.048128342,0.631016043,0,0.027594885
11728,96,21955,7,7,0,2,10,26,11,10,0,0,0,21,nowin,loss,bust,plbust,0,10,14,190,0.468421053,0.057894737,0.584210526,3,0.897263354
11729,134,21955,11,2,4,0,0,17,11,10,0,0,0,21,nowin,loss,beat,dlwin,0,10,13,185,0.443243243,0.021621622,0.545945946,1,0.296939509
11730,53,21956,3,11,1,6,0,21,7,10,0,0,0,17,nowin,win,plwin,beat,20,0,14,250,0.372,0.064,0.564,0,0.013687345
11731,57,21956,10,2,0,5,0,17,7,10,0,0,0,17,nowin,push,push,push,10,0,12,192,0.46875,0.052083333,0.59375,3,0.907001181
11732,11,21956,9,4,0,8,0,21,7,10,0,0,0,17,nowin,win,plwin,beat,20,0,13,236,0.457627119,0.016949153,0.588983051,3,0.889015813
11733,79,21956,10,10,0,0,0,20,7,10,0,0,0,17,nowin,win,plwin,beat,20,0,20,211,0.436018957,0.028436019,0.672985782,2,0.650131054
11734,71,21956,3,5,8,1,0,17,7,10,0,0,0,17,nowin,push,push,push,10,0,8,193,0.352331606,0.046632124,0.585492228,0,0.013063661
11735,90,21956,9,8,0,0,0,17,7,10,0,0,0,17,nowin,push,push,push,10,0,17,201,0.447761194,0.049751244,0.60199005,3,0.889945023
11736,1,21957,6,10,0,0,0,16,4,10,2,1,0,17,nowin,loss,beat,dlwin,0,10,16,197,0.406091371,0.025380711,0.649746193,2,0.606186955
11737,40,21957,4,10,0,0,0,14,4,10,2,1,0,17,nowin,loss,beat,dlwin,0,10,14,196,0.367346939,0.030612245,0.617346939,0,0.025358183
11738,19,21957,9,2,5,0,0,16,4,10,2,1,0,17,nowin,loss,beat,dlwin,0,10,11,237,0.41350211,0.054852321,0.628691983,2,0.597373826
11739,136,21957,4,4,7,0,0,15,4,10,2,1,0,17,nowin,loss,beat,dlwin,0,10,8,194,0.396907216,0.025773196,0.597938144,0,0.029452644
11740,127,21957,3,3,10,0,0,16,4,10,2,1,0,17,nowin,loss,beat,dlwin,0,10,6,201,0.402985075,0.029850746,0.60199005,0,0.032263937
11741,14,21957,6,6,0,0,0,12,4,10,2,1,0,17,nowin,loss,beat,dlwin,0,10,12,202,0.391089109,0.01980198,0.628712871,2,0.577264877
11742,69,21958,3,9,0,10,0,22,10,6,8,0,0,24,nowin,loss,bust,plbust,0,10,12,194,0.365979381,0.030927835,0.515463918,0,0
11743,73,21958,2,8,8,0,0,18,10,6,8,0,0,24,nowin,win,dlbust,bust,20,0,10,181,0.375690608,0.011049724,0.596685083,0,0.022795773
11744,2,21958,1,6,10,0,0,17,10,6,8,0,0,24,nowin,win,dlbust,bust,20,0,7,200,0.445,0.035,0.64,2,0.633962549
11745,81,21958,9,9,0,0,0,18,10,6,8,0,0,24,nowin,win,dlbust,bust,20,0,18,182,0.395604396,0.043956044,0.60989011,2,0.567491261
11746,109,21958,2,7,2,2,10,23,10,6,8,0,0,24,nowin,loss,bust,plbust,0,10,9,221,0.461538462,0.058823529,0.597285068,3,0.901830309
11747,83,21958,10,10,0,0,0,20,10,6,8,0,0,24,nowin,win,dlbust,bust,20,0,20,193,0.424870466,0.051813472,0.678756477,2,0.644360335
11748,53,21959,4,8,0,10,0,22,9,8,0,0,0,17,nowin,loss,bust,plbust,0,10,12,250,0.372,0.064,0.564,0,0.013687345
11749,144,21959,10,4,0,10,0,24,9,8,0,0,0,17,nowin,loss,bust,plbust,0,10,14,202,0.386138614,0.054455446,0.564356436,0,0.018006244
11750,108,21959,3,10,0,6,0,19,9,8,0,0,0,17,nowin,win,plwin,beat,20,0,13,193,0.435233161,0.056994819,0.559585492,1,0.298824795
11751,47,21959,6,5,2,6,0,19,9,8,0,0,0,17,nowin,win,plwin,beat,20,0,11,210,0.438095238,0.057142857,0.623809524,2,0.615868808
11752,133,21959,2,2,11,1,10,26,9,8,0,0,0,17,nowin,loss,bust,plbust,0,10,4,201,0.47761194,0.064676617,0.611940299,3,0.935428111
11753,98,21959,10,10,0,0,0,20,9,8,0,0,0,17,nowin,win,plwin,beat,20,0,20,220,0.422727273,0.054545455,0.55,1,0.28664435
11754,82,21960,1,1,10,10,0,22,10,3,10,0,0,23,nowin,loss,bust,plbust,0,10,2,225,0.408888889,0.075555556,0.577777778,0,0.028101874
11755,46,21960,6,9,0,1,9,25,10,3,10,0,0,23,nowin,loss,bust,plbust,0,10,15,186,0.403225806,0.048387097,0.591397849,0,0.029742194
11756,52,21960,10,10,0,0,0,20,10,3,10,0,0,23,nowin,win,dlbust,bust,20,0,20,217,0.414746544,0.02764977,0.599078341,2,0.576736024
11757,90,21960,7,5,0,10,0,22,10,3,10,0,0,23,nowin,loss,bust,plbust,0,10,12,201,0.447761194,0.049751244,0.60199005,3,0.889945023
11758,37,21960,11,9,0,0,0,20,10,3,10,0,0,23,nowin,win,dlbust,bust,20,0,20,208,0.394230769,0.038461538,0.581730769,0,0.024682772
11759,108,21960,6,3,10,0,0,19,10,3,10,0,0,23,nowin,win,dlbust,bust,20,0,9,193,0.435233161,0.056994819,0.559585492,1,0.298824795
11760,91,21961,3,4,10,0,0,17,7,10,0,0,0,17,nowin,push,push,push,10,0,7,194,0.417525773,0.046391753,0.515463918,1,0.266616552
11761,61,21961,9,7,0,10,0,26,7,10,0,0,0,17,nowin,loss,bust,plbust,0,10,16,194,0.427835052,0.077319588,0.603092784,2,0.591437139
11762,117,21961,7,9,0,10,0,26,7,10,0,0,0,17,nowin,loss,bust,plbust,0,10,16,173,0.410404624,0.069364162,0.606936416,2,0.578610282
11763,149,21961,8,9,0,0,0,17,7,10,0,0,0,17,nowin,push,push,push,10,0,17,225,0.457777778,0.057777778,0.648888889,2,0.651965595
11764,81,21961,8,10,0,0,0,18,7,10,0,0,0,17,nowin,win,plwin,beat,20,0,18,182,0.395604396,0.043956044,0.60989011,2,0.567491261
11765,57,21961,10,7,0,0,0,17,7,10,0,0,0,17,nowin,push,push,push,10,0,17,192,0.46875,0.052083333,0.59375,3,0.907001181
11766,127,21962,2,10,0,3,5,20,10,6,4,0,0,20,nowin,push,push,push,10,0,12,201,0.402985075,0.029850746,0.60199005,0,0.032263937
11767,144,21962,10,10,0,0,0,20,10,6,4,0,0,20,nowin,push,push,push,10,0,20,202,0.386138614,0.054455446,0.564356436,0,0.018006244
11768,81,21962,6,2,2,10,0,20,10,6,4,0,0,20,nowin,push,push,push,10,0,8,182,0.395604396,0.043956044,0.60989011,2,0.567491261
11769,142,21962,3,6,10,0,0,19,10,6,4,0,0,20,nowin,loss,beat,dlwin,0,10,9,211,0.417061611,0.047393365,0.526066351,1,0.271531309
11770,125,21962,10,10,0,0,0,20,10,6,4,0,0,20,nowin,push,push,push,10,0,20,219,0.438356164,0.050228311,0.575342466,1,0.308411257
11771,78,21962,8,2,5,1,10,26,10,6,4,0,0,20,nowin,loss,bust,plbust,0,10,10,201,0.517412935,0.034825871,0.587064677,3,0.95871112
11772,89,21963,10,3,0,0,0,13,6,10,10,0,0,26,nowin,win,dlbust,bust,20,0,13,212,0.537735849,0.047169811,0.594339623,3,0.990167191
11773,89,21963,10,6,0,0,0,16,6,10,10,0,0,26,nowin,win,dlbust,bust,20,0,16,212,0.537735849,0.047169811,0.594339623,3,0.990167191
11774,66,21963,8,6,0,0,0,14,6,10,10,0,0,26,nowin,win,dlbust,bust,20,0,14,217,0.456221198,0.064516129,0.626728111,3,0.924304367
11775,146,21963,2,10,0,0,0,12,6,10,10,0,0,26,nowin,win,dlbust,bust,20,0,12,221,0.43438914,0.040723982,0.542986425,1,0.290190091
11776,34,21963,11,10,0,0,0,21,6,10,10,0,0,26,win,win,dlbust,bust,25,0,21,202,0.5,0.079207921,0.618811881,3,0.968961434
11777,28,21963,6,3,7,0,0,16,6,10,10,0,0,26,nowin,win,dlbust,bust,20,0,9,199,0.422110553,0.045226131,0.542713568,1,0.282706618
11778,40,21964,7,6,0,1,5,19,8,10,0,0,0,18,nowin,win,plwin,beat,20,0,13,196,0.367346939,0.030612245,0.617346939,0,0.025358183
11779,48,21964,3,10,0,5,0,18,8,10,0,0,0,18,nowin,push,push,push,10,0,13,203,0.413793103,0.019704433,0.600985222,2,0.577280801
11780,121,21964,10,10,0,0,0,20,8,10,0,0,0,18,nowin,win,plwin,beat,20,0,20,195,0.456410256,0.025641026,0.512820513,1,0.288597791
11781,40,21964,9,9,0,0,0,18,8,10,0,0,0,18,nowin,push,push,push,10,0,18,196,0.367346939,0.030612245,0.617346939,0,0.025358183
11782,104,21964,3,4,6,10,0,23,8,10,0,0,0,18,nowin,loss,bust,plbust,0,10,7,209,0.363636364,0.052631579,0.593301435,0,0.018359419
11783,99,21964,2,10,0,4,10,26,8,10,0,0,0,18,nowin,loss,bust,plbust,0,10,12,207,0.47826087,0.062801932,0.637681159,3,0.961418446
11784,139,21965,8,6,0,2,8,24,11,8,0,0,0,19,nowin,loss,bust,plbust,0,10,14,192,0.380208333,0.036458333,0.59375,0,0.023429169
11785,1,21965,9,7,0,8,0,24,11,8,0,0,0,19,nowin,loss,bust,plbust,0,10,16,197,0.406091371,0.025380711,0.649746193,2,0.606186955
11786,30,21965,7,4,6,0,0,17,11,8,0,0,0,19,nowin,loss,beat,dlwin,0,10,11,206,0.393203883,0.033980583,0.601941748,0,0.029324648
11787,83,21965,10,9,0,0,0,19,11,8,0,0,0,19,nowin,push,push,push,10,0,19,193,0.424870466,0.051813472,0.678756477,2,0.644360335
11788,4,21965,9,10,0,0,0,19,11,8,0,0,0,19,nowin,push,push,push,10,0,19,217,0.460829493,0.036866359,0.562211982,1,0.315432839
11789,94,21965,11,10,0,0,0,21,11,8,0,0,0,19,win,win,plwin,beat,25,0,21,183,0.43715847,0.043715847,0.540983607,1,0.290866892
11790,35,21966,10,8,0,0,0,18,11,9,0,0,0,20,nowin,loss,beat,dlwin,0,10,18,202,0.410891089,0.044554455,0.633663366,2,0.598681573
11791,36,21966,3,3,3,5,8,22,11,9,0,0,0,20,nowin,loss,bust,plbust,0,10,6,229,0.445414847,0.056768559,0.655021834,2,0.645370571
11792,67,21966,4,5,10,0,0,19,11,9,0,0,0,20,nowin,loss,beat,dlwin,0,10,9,195,0.369230769,0.041025641,0.569230769,0,0.014139427
11793,101,21966,4,4,9,0,0,17,11,9,0,0,0,20,nowin,loss,beat,dlwin,0,10,8,205,0.424390244,0.068292683,0.63902439,2,0.614740646
11794,146,21966,5,10,0,8,0,23,11,9,0,0,0,20,nowin,loss,bust,plbust,0,10,15,221,0.43438914,0.040723982,0.542986425,1,0.290190091
11795,141,21966,10,10,0,0,0,20,11,9,0,0,0,20,nowin,push,push,push,10,0,20,202,0.420792079,0.074257426,0.564356436,0,0.028377851
11796,133,21967,10,4,0,9,0,23,10,6,10,0,0,26,nowin,loss,bust,plbust,0,10,14,201,0.47761194,0.064676617,0.611940299,3,0.935428111
11797,66,21967,3,3,4,8,0,18,10,6,10,0,0,26,nowin,win,dlbust,bust,20,0,6,217,0.456221198,0.064516129,0.626728111,3,0.924304367
11798,90,21967,9,11,0,0,0,20,10,6,10,0,0,26,nowin,win,dlbust,bust,20,0,20,201,0.447761194,0.049751244,0.60199005,3,0.889945023
11799,91,21967,9,3,0,10,0,22,10,6,10,0,0,26,nowin,loss,bust,plbust,0,10,12,194,0.417525773,0.046391753,0.515463918,1,0.266616552
11800,76,21967,11,9,0,0,0,20,10,6,10,0,0,26,nowin,win,dlbust,bust,20,0,20,189,0.534391534,0.079365079,0.608465608,3,1
11801,134,21967,7,8,0,7,0,22,10,6,10,0,0,26,nowin,loss,bust,plbust,0,10,15,185,0.443243243,0.021621622,0.545945946,1,0.296939509
11802,1,21968,10,10,0,0,0,20,7,10,0,0,0,17,nowin,win,plwin,beat,20,0,20,197,0.406091371,0.025380711,0.649746193,2,0.606186955
11803,126,21968,5,10,0,8,0,23,7,10,0,0,0,17,nowin,loss,bust,plbust,0,10,15,188,0.457446809,0.074468085,0.60106383,3,0.900633203
11804,5,21968,10,10,0,0,0,20,7,10,0,0,0,17,nowin,win,plwin,beat,20,0,20,203,0.42364532,0.02955665,0.596059113,2,0.582508076
11805,36,21968,5,10,0,4,0,19,7,10,0,0,0,17,nowin,win,plwin,beat,20,0,15,229,0.445414847,0.056768559,0.655021834,2,0.645370571
11806,10,21968,5,10,0,5,0,20,7,10,0,0,0,17,nowin,win,plwin,beat,20,0,15,191,0.413612565,0.057591623,0.596858639,2,0.574087175
11807,46,21968,3,7,9,0,0,19,7,10,0,0,0,17,nowin,win,plwin,beat,20,0,10,186,0.403225806,0.048387097,0.591397849,0,0.029742194
11808,15,21969,3,3,9,0,0,15,4,10,6,0,0,20,nowin,loss,beat,dlwin,0,10,6,212,0.410377358,0.051886792,0.561320755,0,0.024517408
11809,55,21969,10,6,0,0,0,16,4,10,6,0,0,20,nowin,loss,beat,dlwin,0,10,16,191,0.371727749,0.057591623,0.54973822,0,0.01011347
11810,69,21969,8,10,0,0,0,18,4,10,6,0,0,20,nowin,loss,beat,dlwin,0,10,18,194,0.365979381,0.030927835,0.515463918,0,0
11811,52,21969,6,7,0,0,0,13,4,10,6,0,0,20,nowin,loss,beat,dlwin,0,10,13,217,0.414746544,0.02764977,0.599078341,2,0.576736024
11812,27,21969,9,9,0,0,0,18,4,10,6,0,0,20,nowin,loss,beat,dlwin,0,10,18,178,0.370786517,0.016853933,0.573033708,0,0.015536309
11813,140,21969,1,4,8,0,0,13,4,10,6,0,0,20,nowin,loss,beat,dlwin,0,10,5,210,0.466666667,0.023809524,0.604761905,3,0.915293335
11814,4,21970,7,9,0,5,0,21,7,4,10,0,0,21,nowin,push,push,push,10,0,16,217,0.460829493,0.036866359,0.562211982,1,0.315432839
11815,5,21970,11,10,0,0,0,21,7,4,10,0,0,21,win,push,push,push,10,0,21,203,0.42364532,0.02955665,0.596059113,2,0.582508076
11816,141,21970,5,3,4,9,0,21,7,4,10,0,0,21,nowin,push,push,push,10,0,8,202,0.420792079,0.074257426,0.564356436,0,0.028377851
11817,7,21970,11,8,0,0,0,19,7,4,10,0,0,21,nowin,loss,beat,dlwin,0,10,19,183,0.442622951,0.06010929,0.62295082,2,0.619303341
11818,102,21970,7,8,0,2,0,17,7,4,10,0,0,21,nowin,loss,beat,dlwin,0,10,15,192,0.338541667,0.046875,0.5625,0,0.003306118
11819,40,21970,5,5,8,0,0,18,7,4,10,0,0,21,nowin,loss,beat,dlwin,0,10,10,196,0.367346939,0.030612245,0.617346939,0,0.025358183
11820,97,21971,6,3,8,0,0,17,2,8,6,9,0,25,nowin,win,dlbust,bust,20,0,9,182,0.450549451,0.06043956,0.692307692,2,0.677372279
11821,26,21971,10,10,0,0,0,20,2,8,6,9,0,25,nowin,win,dlbust,bust,20,0,20,203,0.463054187,0.0591133,0.541871921,1,0.306802864
11822,54,21971,3,10,0,0,0,13,2,8,6,9,0,25,nowin,win,dlbust,bust,20,0,13,185,0.437837838,0.032432432,0.556756757,1,0.29899854
11823,129,21971,9,6,0,0,0,15,2,8,6,9,0,25,nowin,win,dlbust,bust,20,0,15,201,0.422885572,0.064676617,0.55721393,0,0.027255383
11824,116,21971,5,10,0,0,0,15,2,8,6,9,0,25,nowin,win,dlbust,bust,20,0,15,195,0.425641026,0.056410256,0.538461538,1,0.28273747
11825,128,21971,2,10,0,1,0,13,2,8,6,9,0,25,nowin,win,dlbust,bust,20,0,12,227,0.356828194,0.052863436,0.577092511,0,0.012352564
11826,50,21972,10,10,0,0,0,20,4,10,3,0,0,17,nowin,win,plwin,beat,20,0,20,202,0.405940594,0.04950495,0.54950495,0,0.020296079
11827,93,21972,10,6,0,0,0,16,4,10,3,0,0,17,nowin,loss,beat,dlwin,0,10,16,175,0.485714286,0.051428571,0.548571429,1,0.323648091
11828,36,21972,8,10,0,0,0,18,4,10,3,0,0,17,nowin,win,plwin,beat,20,0,18,229,0.445414847,0.056768559,0.655021834,2,0.645370571
11829,115,21972,7,3,10,0,0,20,4,10,3,0,0,17,nowin,win,plwin,beat,20,0,10,194,0.427835052,0.041237113,0.592783505,2,0.583863602
11830,63,21972,11,9,0,0,0,20,4,10,3,0,0,17,nowin,win,plwin,beat,20,0,20,216,0.467592593,0.037037037,0.62037037,3,0.931690496
11831,91,21972,10,11,0,0,0,21,4,10,3,0,0,17,win,win,plwin,beat,25,0,21,194,0.417525773,0.046391753,0.515463918,1,0.266616552
11832,49,21973,9,11,0,0,0,20,8,10,0,0,0,18,nowin,win,plwin,beat,20,0,20,207,0.396135266,0.053140097,0.594202899,0,0.028306925
11833,97,21973,3,10,0,7,0,20,8,10,0,0,0,18,nowin,win,plwin,beat,20,0,13,182,0.450549451,0.06043956,0.692307692,2,0.677372279
11834,146,21973,9,10,0,0,0,19,8,10,0,0,0,18,nowin,win,plwin,beat,20,0,19,221,0.43438914,0.040723982,0.542986425,1,0.290190091
11835,73,21973,1,6,10,0,0,17,8,10,0,0,0,18,nowin,loss,beat,dlwin,0,10,7,181,0.375690608,0.011049724,0.596685083,0,0.022795773
11836,11,21973,10,4,0,10,0,24,8,10,0,0,0,18,nowin,loss,bust,plbust,0,10,14,236,0.457627119,0.016949153,0.588983051,3,0.889015813
11837,102,21973,10,7,0,0,0,17,8,10,0,0,0,18,nowin,loss,beat,dlwin,0,10,17,192,0.338541667,0.046875,0.5625,0,0.003306118
11838,64,21974,7,8,0,10,0,25,9,8,0,0,0,17,nowin,loss,bust,plbust,0,10,15,187,0.363636364,0.048128342,0.631016043,0,0.027594885
11839,146,21974,5,5,4,9,0,23,9,8,0,0,0,17,nowin,loss,bust,plbust,0,10,10,221,0.43438914,0.040723982,0.542986425,1,0.290190091
11840,87,21974,4,10,0,4,0,18,9,8,0,0,0,17,nowin,win,plwin,beat,20,0,14,202,0.405940594,0.054455446,0.628712871,2,0.590599801
11841,131,21974,8,11,0,0,0,19,9,8,0,0,0,17,nowin,win,plwin,beat,20,0,19,217,0.410138249,0.069124424,0.543778802,0,0.02015021
11842,131,21974,9,10,0,0,0,19,9,8,0,0,0,17,nowin,win,plwin,beat,20,0,19,217,0.410138249,0.069124424,0.543778802,0,0.02015021
11843,32,21974,3,4,3,2,4,16,9,8,0,0,0,17,nowin,loss,beat,dlwin,0,10,7,189,0.391534392,0.037037037,0.53968254,0,0.013579086
11844,36,21975,7,9,0,0,0,16,5,3,10,0,0,18,nowin,loss,beat,dlwin,0,10,16,229,0.445414847,0.056768559,0.655021834,2,0.645370571
11845,53,21975,10,2,0,0,0,12,5,3,10,0,0,18,nowin,loss,beat,dlwin,0,10,12,250,0.372,0.064,0.564,0,0.013687345
11846,73,21975,9,10,0,0,0,19,5,3,10,0,0,18,nowin,win,plwin,beat,20,0,19,181,0.375690608,0.011049724,0.596685083,0,0.022795773
11847,132,21975,11,7,0,0,0,18,5,3,10,0,0,18,nowin,push,push,push,10,0,18,194,0.412371134,0.036082474,0.649484536,2,0.611633238
11848,142,21975,3,10,0,0,0,13,5,3,10,0,0,18,nowin,loss,beat,dlwin,0,10,13,211,0.417061611,0.047393365,0.526066351,1,0.271531309
11849,129,21975,5,11,1,0,0,17,5,3,10,0,0,18,nowin,loss,beat,dlwin,0,10,16,201,0.422885572,0.064676617,0.55721393,0,0.027255383
11850,10,21976,6,11,3,0,0,20,8,10,0,0,0,18,nowin,win,plwin,beat,20,0,17,191,0.413612565,0.057591623,0.596858639,2,0.574087175
11851,112,21976,4,10,0,10,0,24,8,10,0,0,0,18,nowin,loss,bust,plbust,0,10,14,203,0.448275862,0.054187192,0.600985222,3,0.889576933
11852,8,21976,7,10,0,0,0,17,8,10,0,0,0,18,nowin,loss,beat,dlwin,0,10,17,181,0.44198895,0.071823204,0.596685083,2,0.599438402
11853,16,21976,4,9,0,7,0,20,8,10,0,0,0,18,nowin,win,plwin,beat,20,0,13,220,0.427272727,0.081818182,0.6,2,0.588660176
11854,68,21976,6,9,0,10,0,25,8,10,0,0,0,18,nowin,loss,bust,plbust,0,10,15,205,0.434146341,0.029268293,0.6,2,0.59483189
11855,102,21976,9,5,0,2,10,26,8,10,0,0,0,18,nowin,loss,bust,plbust,0,10,14,192,0.338541667,0.046875,0.5625,0,0.003306118
11856,5,21977,2,8,9,0,0,19,9,10,0,0,0,19,nowin,push,push,push,10,0,10,203,0.42364532,0.02955665,0.596059113,2,0.582508076
11857,75,21977,7,2,10,0,0,19,9,10,0,0,0,19,nowin,push,push,push,10,0,9,191,0.418848168,0.052356021,0.570680628,0,0.029344702
11858,40,21977,5,10,0,4,0,19,9,10,0,0,0,19,nowin,push,push,push,10,0,15,196,0.367346939,0.030612245,0.617346939,0,0.025358183
11859,105,21977,7,11,0,0,0,18,9,10,0,0,0,19,nowin,loss,beat,dlwin,0,10,18,198,0.414141414,0.070707071,0.590909091,0,0.032889494
11860,93,21977,10,11,0,0,0,21,9,10,0,0,0,19,win,win,plwin,beat,25,0,21,175,0.485714286,0.051428571,0.548571429,1,0.323648091
11861,147,21977,8,5,0,3,10,26,9,10,0,0,0,19,nowin,loss,bust,plbust,0,10,13,205,0.380487805,0.014634146,0.536585366,0,0.00951447
11862,80,21978,2,10,0,0,0,12,4,10,2,7,0,23,nowin,win,dlbust,bust,20,0,12,186,0.419354839,0.059139785,0.623655914,2,0.59892924
11863,17,21978,10,4,0,0,0,14,4,10,2,7,0,23,nowin,win,dlbust,bust,20,0,14,171,0.444444444,0.070175439,0.555555556,1,0.302364894
11864,24,21978,10,10,0,0,0,20,4,10,2,7,0,23,nowin,win,dlbust,bust,20,0,20,207,0.458937198,0.048309179,0.570048309,1,0.318138014
11865,146,21978,2,10,0,0,0,12,4,10,2,7,0,23,nowin,win,dlbust,bust,20,0,12,221,0.43438914,0.040723982,0.542986425,1,0.290190091
11866,82,21978,11,10,0,0,0,21,4,10,2,7,0,23,win,win,dlbust,bust,25,0,21,225,0.408888889,0.075555556,0.577777778,0,0.028101874
11867,80,21978,9,10,0,0,0,19,4,10,2,7,0,23,nowin,win,dlbust,bust,20,0,19,186,0.419354839,0.059139785,0.623655914,2,0.59892924
11868,48,21979,6,6,0,1,10,23,9,5,10,0,0,24,nowin,loss,bust,plbust,0,10,12,203,0.413793103,0.019704433,0.600985222,2,0.577280801
11869,114,21979,8,2,8,0,0,18,9,5,10,0,0,24,nowin,win,dlbust,bust,20,0,10,198,0.47979798,0.025252525,0.611111111,3,0.937232995
11870,70,21979,3,7,10,0,0,20,9,5,10,0,0,24,nowin,win,dlbust,bust,20,0,10,228,0.385964912,0.039473684,0.557017544,0,0.016157125
11871,11,21979,10,10,0,0,0,20,9,5,10,0,0,24,nowin,win,dlbust,bust,20,0,20,236,0.457627119,0.016949153,0.588983051,3,0.889015813
11872,72,21979,3,10,0,6,0,19,9,5,10,0,0,24,nowin,win,dlbust,bust,20,0,13,185,0.394594595,0.032432432,0.508108108,0,0.006763115
11873,94,21979,8,10,0,0,0,18,9,5,10,0,0,24,nowin,win,dlbust,bust,20,0,18,183,0.43715847,0.043715847,0.540983607,1,0.290866892
11874,128,21980,4,10,0,3,0,17,7,6,6,0,0,19,nowin,loss,beat,dlwin,0,10,14,227,0.356828194,0.052863436,0.577092511,0,0.012352564
11875,139,21980,7,5,0,10,0,22,7,6,6,0,0,19,nowin,loss,bust,plbust,0,10,12,192,0.380208333,0.036458333,0.59375,0,0.023429169
11876,76,21980,5,8,0,7,0,20,7,6,6,0,0,19,nowin,win,plwin,beat,20,0,13,189,0.534391534,0.079365079,0.608465608,3,1
11877,141,21980,11,10,0,0,0,21,7,6,6,0,0,19,win,win,plwin,beat,25,0,21,202,0.420792079,0.074257426,0.564356436,0,0.028377851
11878,25,21980,11,10,0,0,0,21,7,6,6,0,0,19,win,win,plwin,beat,25,0,21,190,0.463157895,0.063157895,0.536842105,1,0.304401563
11879,33,21980,10,10,0,0,0,20,7,6,6,0,0,19,nowin,win,plwin,beat,20,0,20,192,0.4375,0.057291667,0.625,2,0.616208916
11880,46,21981,3,4,5,10,0,22,11,10,0,0,0,21,nowin,loss,bust,plbust,0,10,7,186,0.403225806,0.048387097,0.591397849,0,0.029742194
11881,113,21981,8,3,10,0,0,21,11,10,0,0,0,21,nowin,push,push,push,10,0,11,199,0.407035176,0.055276382,0.668341709,2,0.620695264
11882,38,21981,9,4,0,6,0,19,11,10,0,0,0,21,nowin,loss,beat,dlwin,0,10,13,202,0.361386139,0.03960396,0.564356436,0,0.010597953
11883,54,21981,8,10,0,0,0,18,11,10,0,0,0,21,nowin,loss,beat,dlwin,0,10,18,185,0.437837838,0.032432432,0.556756757,1,0.29899854
11884,34,21981,4,10,0,1,1,16,11,10,0,0,0,21,nowin,loss,beat,dlwin,0,10,14,202,0.5,0.079207921,0.618811881,3,0.968961434
11885,8,21981,11,10,0,0,0,21,11,10,0,0,0,21,win,push,push,push,10,0,21,181,0.44198895,0.071823204,0.596685083,2,0.599438402
11886,8,21982,10,5,0,6,0,21,10,6,2,0,0,18,nowin,win,plwin,beat,20,0,15,181,0.44198895,0.071823204,0.596685083,2,0.599438402
11887,123,21982,6,10,0,8,0,24,10,6,2,0,0,18,nowin,loss,bust,plbust,0,10,16,205,0.43902439,0.034146341,0.614634146,2,0.609962544
11888,56,21982,3,10,0,3,5,21,10,6,2,0,0,18,nowin,win,plwin,beat,20,0,13,175,0.4,0.057142857,0.582857143,0,0.026685297
11889,93,21982,8,4,0,6,0,18,10,6,2,0,0,18,nowin,push,push,push,10,0,12,175,0.485714286,0.051428571,0.548571429,1,0.323648091
11890,96,21982,10,4,0,6,0,20,10,6,2,0,0,18,nowin,win,plwin,beat,20,0,14,190,0.468421053,0.057894737,0.584210526,3,0.897263354
11891,118,21982,8,8,0,10,0,26,10,6,2,0,0,18,nowin,loss,bust,plbust,0,10,16,216,0.393518519,0.037037037,0.555555556,0,0.018059873
11892,58,21983,7,9,0,3,0,19,10,3,6,0,0,19,nowin,push,push,push,10,0,16,195,0.430769231,0.041025641,0.584615385,2,0.580497586
11893,111,21983,10,2,0,1,10,23,10,3,6,0,0,19,nowin,loss,bust,plbust,0,10,12,180,0.433333333,0.055555556,0.611111111,2,0.602264492
11894,58,21983,4,4,10,0,0,18,10,3,6,0,0,19,nowin,loss,beat,dlwin,0,10,8,195,0.430769231,0.041025641,0.584615385,2,0.580497586
11895,53,21983,10,6,0,1,0,17,10,3,6,0,0,19,nowin,loss,beat,dlwin,0,10,16,250,0.372,0.064,0.564,0,0.013687345
11896,59,21983,11,9,0,0,0,20,10,3,6,0,0,19,nowin,win,plwin,beat,20,0,20,228,0.429824561,0.048245614,0.543859649,1,0.287885446
11897,107,21983,7,4,10,0,0,21,10,3,6,0,0,19,nowin,win,plwin,beat,20,0,11,218,0.444954128,0.073394495,0.600917431,2,0.605210014
11898,42,21984,10,5,0,10,0,25,8,9,0,0,0,17,nowin,loss,bust,plbust,0,10,15,212,0.443396226,0.051886792,0.570754717,1,0.309181312
11899,98,21984,11,10,0,0,0,21,8,9,0,0,0,17,win,win,plwin,beat,25,0,21,220,0.422727273,0.054545455,0.55,1,0.28664435
11900,22,21984,6,1,10,0,0,17,8,9,0,0,0,17,nowin,push,push,push,10,0,7,187,0.481283422,0.042780749,0.577540107,3,0.906128176
11901,2,21984,10,7,0,0,0,17,8,9,0,0,0,17,nowin,push,push,push,10,0,17,200,0.445,0.035,0.64,2,0.633962549
11902,71,21984,4,7,3,9,0,23,8,9,0,0,0,17,nowin,loss,bust,plbust,0,10,11,193,0.352331606,0.046632124,0.585492228,0,0.013063661
11903,147,21984,9,7,0,7,0,23,8,9,0,0,0,17,nowin,loss,bust,plbust,0,10,16,205,0.380487805,0.014634146,0.536585366,0,0.00951447
11904,9,21985,3,10,0,4,0,17,10,10,0,0,0,20,nowin,loss,beat,dlwin,0,10,13,194,0.37628866,0.015463918,0.541237113,0,0.009396796
11905,69,21985,9,10,0,0,0,19,10,10,0,0,0,20,nowin,loss,beat,dlwin,0,10,19,194,0.365979381,0.030927835,0.515463918,0,0
11906,99,21985,5,3,10,0,0,18,10,10,0,0,0,20,nowin,loss,beat,dlwin,0,10,8,207,0.47826087,0.062801932,0.637681159,3,0.961418446
11907,64,21985,10,10,0,0,0,20,10,10,0,0,0,20,nowin,push,push,push,10,0,20,187,0.363636364,0.048128342,0.631016043,0,0.027594885
11908,56,21985,5,10,0,3,0,18,10,10,0,0,0,20,nowin,loss,beat,dlwin,0,10,15,175,0.4,0.057142857,0.582857143,0,0.026685297
11909,1,21985,8,10,0,0,0,18,10,10,0,0,0,20,nowin,loss,beat,dlwin,0,10,18,197,0.406091371,0.025380711,0.649746193,2,0.606186955
11910,5,21986,10,5,0,3,0,18,8,5,10,0,0,23,nowin,win,dlbust,bust,20,0,15,203,0.42364532,0.02955665,0.596059113,2,0.582508076
11911,114,21986,4,5,10,0,0,19,8,5,10,0,0,23,nowin,win,dlbust,bust,20,0,9,198,0.47979798,0.025252525,0.611111111,3,0.937232995
11912,144,21986,10,2,0,10,0,22,8,5,10,0,0,23,nowin,loss,bust,plbust,0,10,12,202,0.386138614,0.054455446,0.564356436,0,0.018006244
11913,46,21986,4,3,11,0,0,18,8,5,10,0,0,23,nowin,win,dlbust,bust,20,0,7,186,0.403225806,0.048387097,0.591397849,0,0.029742194
11914,67,21986,6,7,0,10,0,23,8,5,10,0,0,23,nowin,loss,bust,plbust,0,10,13,195,0.369230769,0.041025641,0.569230769,0,0.014139427
11915,75,21986,10,3,0,5,0,18,8,5,10,0,0,23,nowin,win,dlbust,bust,20,0,13,191,0.418848168,0.052356021,0.570680628,0,0.029344702
11916,126,21987,8,10,0,0,0,18,3,8,10,0,0,21,nowin,loss,beat,dlwin,0,10,18,188,0.457446809,0.074468085,0.60106383,3,0.900633203
11917,113,21987,9,10,0,0,0,19,3,8,10,0,0,21,nowin,loss,beat,dlwin,0,10,19,199,0.407035176,0.055276382,0.668341709,2,0.620695264
11918,40,21987,9,5,0,0,0,14,3,8,10,0,0,21,nowin,loss,beat,dlwin,0,10,14,196,0.367346939,0.030612245,0.617346939,0,0.025358183
11919,146,21987,10,7,0,0,0,17,3,8,10,0,0,21,nowin,loss,beat,dlwin,0,10,17,221,0.43438914,0.040723982,0.542986425,1,0.290190091
11920,145,21987,11,10,0,0,0,21,3,8,10,0,0,21,win,push,push,push,10,0,21,188,0.441489362,0.031914894,0.622340426,2,0.617837093
11921,106,21987,7,7,0,0,0,14,3,8,10,0,0,21,nowin,loss,beat,dlwin,0,10,14,192,0.411458333,0.026041667,0.557291667,0,0.023854304
11922,135,21988,4,5,10,0,0,19,2,10,7,0,0,19,nowin,push,push,push,10,0,9,179,0.391061453,0.067039106,0.586592179,0,0.024924662
11923,130,21988,4,10,0,0,0,14,2,10,7,0,0,19,nowin,loss,beat,dlwin,0,10,14,219,0.410958904,0.03652968,0.566210046,0,0.025888739
11924,61,21988,10,8,0,0,0,18,2,10,7,0,0,19,nowin,loss,beat,dlwin,0,10,18,194,0.427835052,0.077319588,0.603092784,2,0.591437139
11925,50,21988,9,11,0,0,0,20,2,10,7,0,0,19,nowin,win,plwin,beat,20,0,20,202,0.405940594,0.04950495,0.54950495,0,0.020296079
11926,136,21988,11,10,0,0,0,21,2,10,7,0,0,19,win,win,plwin,beat,25,0,21,194,0.396907216,0.025773196,0.597938144,0,0.029452644
11927,49,21988,4,11,2,0,0,17,2,10,7,0,0,19,nowin,loss,beat,dlwin,0,10,15,207,0.396135266,0.053140097,0.594202899,0,0.028306925
11928,80,21989,10,9,0,0,0,19,8,9,0,0,0,17,nowin,win,plwin,beat,20,0,19,186,0.419354839,0.059139785,0.623655914,2,0.59892924
11929,48,21989,8,2,10,0,0,20,8,9,0,0,0,17,nowin,win,plwin,beat,20,0,10,203,0.413793103,0.019704433,0.600985222,2,0.577280801
11930,48,21989,10,10,0,0,0,20,8,9,0,0,0,17,nowin,win,plwin,beat,20,0,20,203,0.413793103,0.019704433,0.600985222,2,0.577280801
11931,86,21989,3,1,10,5,0,19,8,9,0,0,0,17,nowin,win,plwin,beat,20,0,4,196,0.454081633,0.040816327,0.591836735,3,0.887566443
11932,76,21989,8,2,5,9,0,24,8,9,0,0,0,17,nowin,loss,bust,plbust,0,10,10,189,0.534391534,0.079365079,0.608465608,3,1
11933,122,21989,2,10,0,4,10,26,8,9,0,0,0,17,nowin,loss,bust,plbust,0,10,12,210,0.347619048,0.052380952,0.59047619,0,0.012873677
11934,112,21990,6,10,0,0,0,16,3,6,9,0,0,18,nowin,loss,beat,dlwin,0,10,16,203,0.448275862,0.054187192,0.600985222,3,0.889576933
11935,111,21990,8,3,10,0,0,21,3,6,9,0,0,18,nowin,win,plwin,beat,20,0,11,180,0.433333333,0.055555556,0.611111111,2,0.602264492
11936,66,21990,10,10,0,0,0,20,3,6,9,0,0,18,nowin,win,plwin,beat,20,0,20,217,0.456221198,0.064516129,0.626728111,3,0.924304367
11937,84,21990,6,10,0,0,0,16,3,6,9,0,0,18,nowin,loss,beat,dlwin,0,10,16,195,0.379487179,0.056410256,0.569230769,0,0.017209119
11938,13,21990,5,3,10,0,0,18,3,6,9,0,0,18,nowin,push,push,push,10,0,8,206,0.417475728,0.063106796,0.621359223,2,0.59555479
11939,74,21990,3,7,10,0,0,20,3,6,9,0,0,18,nowin,win,plwin,beat,20,0,10,209,0.411483254,0.04784689,0.531100478,0,0.017448125
11940,58,21991,11,10,0,0,0,21,9,9,0,0,0,18,win,win,plwin,beat,25,0,21,195,0.430769231,0.041025641,0.584615385,2,0.580497586
11941,57,21991,11,7,0,0,0,18,9,9,0,0,0,18,nowin,push,push,push,10,0,18,192,0.46875,0.052083333,0.59375,3,0.907001181
11942,71,21991,2,3,3,4,10,22,9,9,0,0,0,18,nowin,loss,bust,plbust,0,10,5,193,0.352331606,0.046632124,0.585492228,0,0.013063661
11943,82,21991,10,5,0,7,0,22,9,9,0,0,0,18,nowin,loss,bust,plbust,0,10,15,225,0.408888889,0.075555556,0.577777778,0,0.028101874
11944,92,21991,9,10,0,0,0,19,9,9,0,0,0,18,nowin,win,plwin,beat,20,0,19,186,0.446236559,0.059139785,0.564516129,1,0.307826125
11945,69,21991,4,8,0,3,8,23,9,9,0,0,0,18,nowin,loss,bust,plbust,0,10,12,194,0.365979381,0.030927835,0.515463918,0,0
11946,118,21992,10,7,0,0,0,17,8,4,1,8,0,21,nowin,loss,beat,dlwin,0,10,17,216,0.393518519,0.037037037,0.555555556,0,0.018059873
11947,93,21992,10,2,0,10,0,22,8,4,1,8,0,21,nowin,loss,bust,plbust,0,10,12,175,0.485714286,0.051428571,0.548571429,1,0.323648091
11948,86,21992,6,10,0,10,0,26,8,4,1,8,0,21,nowin,loss,bust,plbust,0,10,16,196,0.454081633,0.040816327,0.591836735,3,0.887566443
11949,148,21992,7,6,0,6,0,19,8,4,1,8,0,21,nowin,loss,beat,dlwin,0,10,13,204,0.401960784,0.078431373,0.593137255,0,0.029789521
11950,141,21992,10,5,0,10,0,25,8,4,1,8,0,21,nowin,loss,bust,plbust,0,10,15,202,0.420792079,0.074257426,0.564356436,0,0.028377851
11951,35,21992,11,10,0,0,0,21,8,4,1,8,0,21,win,push,push,push,10,0,21,202,0.410891089,0.044554455,0.633663366,2,0.598681573
11952,56,21993,10,7,0,0,0,17,6,3,4,3,10,26,nowin,win,dlbust,bust,20,0,17,175,0.4,0.057142857,0.582857143,0,0.026685297
11953,50,21993,2,8,7,0,0,17,6,3,4,3,10,26,nowin,win,dlbust,bust,20,0,10,202,0.405940594,0.04950495,0.54950495,0,0.020296079
11954,72,21993,11,10,0,0,0,21,6,3,4,3,10,26,win,win,dlbust,bust,25,0,21,185,0.394594595,0.032432432,0.508108108,0,0.006763115
11955,62,21993,2,10,0,0,0,12,6,3,4,3,10,26,nowin,win,dlbust,bust,20,0,12,178,0.370786517,0.028089888,0.54494382,0,0.008657722
11956,52,21993,11,9,0,0,0,20,6,3,4,3,10,26,nowin,win,dlbust,bust,20,0,20,217,0.414746544,0.02764977,0.599078341,2,0.576736024
11957,67,21993,10,10,0,0,0,20,6,3,4,3,10,26,nowin,win,dlbust,bust,20,0,20,195,0.369230769,0.041025641,0.569230769,0,0.014139427
11958,41,21994,10,8,0,0,0,18,2,5,6,10,0,23,nowin,win,dlbust,bust,20,0,18,192,0.364583333,0.036458333,0.520833333,0,0.00089702
11959,142,21994,6,2,4,10,0,22,2,5,6,10,0,23,nowin,loss,bust,plbust,0,10,8,211,0.417061611,0.047393365,0.526066351,1,0.271531309
11960,3,21994,10,10,0,0,0,20,2,5,6,10,0,23,nowin,win,dlbust,bust,20,0,20,190,0.431578947,0.026315789,0.542105263,1,0.288076384
11961,98,21994,3,6,8,0,0,17,2,5,6,10,0,23,nowin,win,dlbust,bust,20,0,9,220,0.422727273,0.054545455,0.55,1,0.28664435
11962,100,21994,7,5,0,10,0,22,2,5,6,10,0,23,nowin,loss,bust,plbust,0,10,12,190,0.452631579,0.036842105,0.594736842,3,0.888671154
11963,103,21994,1,4,10,0,0,15,2,5,6,10,0,23,nowin,win,dlbust,bust,20,0,5,203,0.379310345,0.064039409,0.551724138,0,0.012869209
11964,25,21995,7,9,0,10,0,26,8,7,4,0,0,19,nowin,loss,bust,plbust,0,10,16,190,0.463157895,0.063157895,0.536842105,1,0.304401563
11965,59,21995,10,4,0,8,0,22,8,7,4,0,0,19,nowin,loss,bust,plbust,0,10,14,228,0.429824561,0.048245614,0.543859649,1,0.287885446
11966,98,21995,10,10,0,0,0,20,8,7,4,0,0,19,nowin,win,plwin,beat,20,0,20,220,0.422727273,0.054545455,0.55,1,0.28664435
11967,117,21995,9,4,0,1,5,19,8,7,4,0,0,19,nowin,push,push,push,10,0,13,173,0.410404624,0.069364162,0.606936416,2,0.578610282
11968,84,21995,4,10,0,10,0,24,8,7,4,0,0,19,nowin,loss,bust,plbust,0,10,14,195,0.379487179,0.056410256,0.569230769,0,0.017209119
11969,19,21995,10,7,0,0,0,17,8,7,4,0,0,19,nowin,loss,beat,dlwin,0,10,17,237,0.41350211,0.054852321,0.628691983,2,0.597373826
11970,112,21996,3,11,1,0,0,15,4,10,2,10,0,26,nowin,win,dlbust,bust,20,0,14,203,0.448275862,0.054187192,0.600985222,3,0.889576933
11971,40,21996,8,3,1,0,0,12,4,10,2,10,0,26,nowin,win,dlbust,bust,20,0,11,196,0.367346939,0.030612245,0.617346939,0,0.025358183
11972,77,21996,4,3,10,0,0,17,4,10,2,10,0,26,nowin,win,dlbust,bust,20,0,7,200,0.455,0.04,0.62,3,0.916252116
11973,44,21996,5,8,0,0,0,13,4,10,2,10,0,26,nowin,win,dlbust,bust,20,0,13,219,0.433789954,0.050228311,0.534246575,1,0.285551035
11974,86,21996,10,10,0,0,0,20,4,10,2,10,0,26,nowin,win,dlbust,bust,20,0,20,196,0.454081633,0.040816327,0.591836735,3,0.887566443
11975,140,21996,5,10,0,0,0,15,4,10,2,10,0,26,nowin,win,dlbust,bust,20,0,15,210,0.466666667,0.023809524,0.604761905,3,0.915293335
11976,122,21997,10,10,0,0,0,20,4,6,3,5,0,18,nowin,win,plwin,beat,20,0,20,210,0.347619048,0.052380952,0.59047619,0,0.012873677
11977,29,21997,6,10,0,0,0,16,4,6,3,5,0,18,nowin,loss,beat,dlwin,0,10,16,189,0.44973545,0.058201058,0.544973545,1,0.300349439
11978,13,21997,7,3,10,0,0,20,4,6,3,5,0,18,nowin,win,plwin,beat,20,0,10,206,0.417475728,0.063106796,0.621359223,2,0.59555479
11979,15,21997,8,10,0,0,0,18,4,6,3,5,0,18,nowin,push,push,push,10,0,18,212,0.410377358,0.051886792,0.561320755,0,0.024517408
11980,25,21997,3,2,11,0,0,16,4,6,3,5,0,18,nowin,loss,beat,dlwin,0,10,5,190,0.463157895,0.063157895,0.536842105,1,0.304401563
11981,131,21997,10,10,0,0,0,20,4,6,3,5,0,18,nowin,win,plwin,beat,20,0,20,217,0.410138249,0.069124424,0.543778802,0,0.02015021
11982,60,21998,6,6,0,3,9,24,8,5,6,0,0,19,nowin,loss,bust,plbust,0,10,12,227,0.418502203,0.022026432,0.559471366,0,0.026496258
11983,79,21998,2,3,10,7,0,22,8,5,6,0,0,19,nowin,loss,bust,plbust,0,10,5,211,0.436018957,0.028436019,0.672985782,2,0.650131054
11984,86,21998,10,5,0,10,0,25,8,5,6,0,0,19,nowin,loss,bust,plbust,0,10,15,196,0.454081633,0.040816327,0.591836735,3,0.887566443
11985,85,21998,10,10,0,0,0,20,8,5,6,0,0,19,nowin,win,plwin,beat,20,0,20,195,0.41025641,0.066666667,0.594871795,0,0.03269711
11986,39,21998,8,6,0,8,0,22,8,5,6,0,0,19,nowin,loss,bust,plbust,0,10,14,191,0.429319372,0.062827225,0.57591623,0,0.033760763
11987,47,21998,4,2,2,10,0,18,8,5,6,0,0,19,nowin,loss,beat,dlwin,0,10,6,210,0.438095238,0.057142857,0.623809524,2,0.615868808
11988,10,21999,4,10,0,0,0,14,2,9,6,0,0,17,nowin,loss,beat,dlwin,0,10,14,191,0.413612565,0.057591623,0.596858639,2,0.574087175
11989,131,21999,3,3,7,0,0,13,2,9,6,0,0,17,nowin,loss,beat,dlwin,0,10,6,217,0.410138249,0.069124424,0.543778802,0,0.02015021
11990,101,21999,11,2,4,0,0,17,2,9,6,0,0,17,nowin,push,push,push,10,0,13,205,0.424390244,0.068292683,0.63902439,2,0.614740646
11991,82,21999,9,11,0,0,0,20,2,9,6,0,0,17,nowin,win,plwin,beat,20,0,20,225,0.408888889,0.075555556,0.577777778,0,0.028101874
11992,99,21999,10,7,0,0,0,17,2,9,6,0,0,17,nowin,push,push,push,10,0,17,207,0.47826087,0.062801932,0.637681159,3,0.961418446
11993,139,21999,7,10,0,0,0,17,2,9,6,0,0,17,nowin,push,push,push,10,0,17,192,0.380208333,0.036458333,0.59375,0,0.023429169
11994,50,22000,3,6,11,0,0,20,10,10,0,0,0,20,nowin,push,push,push,10,0,9,202,0.405940594,0.04950495,0.54950495,0,0.020296079
11995,127,22000,2,10,0,5,0,17,10,10,0,0,0,20,nowin,loss,beat,dlwin,0,10,12,201,0.402985075,0.029850746,0.60199005,0,0.032263937
11996,78,22000,10,5,0,5,0,20,10,10,0,0,0,20,nowin,push,push,push,10,0,15,201,0.517412935,0.034825871,0.587064677,3,0.95871112
11997,24,22000,10,10,0,0,0,20,10,10,0,0,0,20,nowin,push,push,push,10,0,20,207,0.458937198,0.048309179,0.570048309,1,0.318138014
11998,142,22000,2,10,0,7,0,19,10,10,0,0,0,20,nowin,loss,beat,dlwin,0,10,12,211,0.417061611,0.047393365,0.526066351,1,0.271531309
11999,21,22000,10,2,0,8,0,20,10,10,0,0,0,20,nowin,push,push,push,10,0,12,214,0.359813084,0.042056075,0.626168224,0,0.025263474
12000,44,22001,11,10,0,0,0,21,3,4,3,3,8,21,win,push,push,push,10,0,21,219,0.433789954,0.050228311,0.534246575,1,0.285551035
12001,92,22001,10,7,0,0,0,17,3,4,3,3,8,21,nowin,loss,beat,dlwin,0,10,17,186,0.446236559,0.059139785,0.564516129,1,0.307826125
12002,124,22001,8,8,0,0,0,16,3,4,3,3,8,21,nowin,loss,beat,dlwin,0,10,16,202,0.47029703,0.064356436,0.584158416,3,0.899458193
12003,132,22001,10,10,0,0,0,20,3,4,3,3,8,21,nowin,loss,beat,dlwin,0,10,20,194,0.412371134,0.036082474,0.649484536,2,0.611633238
12004,56,22001,2,5,10,0,0,17,3,4,3,3,8,21,nowin,loss,beat,dlwin,0,10,7,175,0.4,0.057142857,0.582857143,0,0.026685297
12005,121,22001,6,7,0,0,0,13,3,4,3,3,8,21,nowin,loss,beat,dlwin,0,10,13,195,0.456410256,0.025641026,0.512820513,1,0.288597791
12006,21,22002,9,6,0,0,0,15,6,11,0,0,0,17,nowin,loss,beat,dlwin,0,10,15,214,0.359813084,0.042056075,0.626168224,0,0.025263474
12007,69,22002,4,9,0,0,0,13,6,11,0,0,0,17,nowin,loss,beat,dlwin,0,10,13,194,0.365979381,0.030927835,0.515463918,0,0
12008,1,22002,5,10,0,0,0,15,6,11,0,0,0,17,nowin,loss,beat,dlwin,0,10,15,197,0.406091371,0.025380711,0.649746193,2,0.606186955
12009,94,22002,10,5,0,0,0,15,6,11,0,0,0,17,nowin,loss,beat,dlwin,0,10,15,183,0.43715847,0.043715847,0.540983607,1,0.290866892
12010,124,22002,11,10,0,0,0,21,6,11,0,0,0,17,win,win,plwin,beat,25,0,21,202,0.47029703,0.064356436,0.584158416,3,0.899458193
12011,66,22002,10,11,0,0,0,21,6,11,0,0,0,17,win,win,plwin,beat,25,0,21,217,0.456221198,0.064516129,0.626728111,3,0.924304367
12012,50,22003,6,10,0,10,0,26,10,3,8,0,0,21,nowin,loss,bust,plbust,0,10,16,202,0.405940594,0.04950495,0.54950495,0,0.020296079
12013,73,22003,2,4,10,10,0,26,10,3,8,0,0,21,nowin,loss,bust,plbust,0,10,6,181,0.375690608,0.011049724,0.596685083,0,0.022795773
12014,137,22003,10,7,0,0,0,17,10,3,8,0,0,21,nowin,loss,beat,dlwin,0,10,17,194,0.417525773,0.046391753,0.536082474,1,0.276714602
12015,84,22003,10,10,0,0,0,20,10,3,8,0,0,21,nowin,loss,beat,dlwin,0,10,20,195,0.379487179,0.056410256,0.569230769,0,0.017209119
12016,68,22003,5,9,0,10,0,24,10,3,8,0,0,21,nowin,loss,bust,plbust,0,10,14,205,0.434146341,0.029268293,0.6,2,0.59483189
12017,13,22003,10,11,0,0,0,21,10,3,8,0,0,21,win,push,push,push,10,0,21,206,0.417475728,0.063106796,0.621359223,2,0.59555479
12018,129,22004,10,10,0,0,0,20,7,7,3,0,0,17,nowin,win,plwin,beat,20,0,20,201,0.422885572,0.064676617,0.55721393,0,0.027255383
12019,84,22004,10,7,0,0,0,17,7,7,3,0,0,17,nowin,push,push,push,10,0,17,195,0.379487179,0.056410256,0.569230769,0,0.017209119
12020,13,22004,2,6,7,4,0,19,7,7,3,0,0,17,nowin,win,plwin,beat,20,0,8,206,0.417475728,0.063106796,0.621359223,2,0.59555479
12021,128,22004,8,7,0,10,0,25,7,7,3,0,0,17,nowin,loss,bust,plbust,0,10,15,227,0.356828194,0.052863436,0.577092511,0,0.012352564
12022,70,22004,11,1,4,3,0,19,7,7,3,0,0,17,nowin,win,plwin,beat,20,0,12,228,0.385964912,0.039473684,0.557017544,0,0.016157125
12023,134,22004,6,10,0,10,0,26,7,7,3,0,0,17,nowin,loss,bust,plbust,0,10,16,185,0.443243243,0.021621622,0.545945946,1,0.296939509
12024,140,22005,6,4,10,0,0,20,10,8,0,0,0,18,nowin,win,plwin,beat,20,0,10,210,0.466666667,0.023809524,0.604761905,3,0.915293335
12025,47,22005,6,9,0,7,0,22,10,8,0,0,0,18,nowin,loss,bust,plbust,0,10,15,210,0.438095238,0.057142857,0.623809524,2,0.615868808
12026,67,22005,2,10,0,10,0,22,10,8,0,0,0,18,nowin,loss,bust,plbust,0,10,12,195,0.369230769,0.041025641,0.569230769,0,0.014139427
12027,120,22005,7,10,0,0,0,17,10,8,0,0,0,18,nowin,loss,beat,dlwin,0,10,17,202,0.440594059,0.034653465,0.618811881,2,0.614441029
12028,134,22005,10,5,0,8,0,23,10,8,0,0,0,18,nowin,loss,bust,plbust,0,10,15,185,0.443243243,0.021621622,0.545945946,1,0.296939509
12029,42,22005,11,10,0,0,0,21,10,8,0,0,0,18,win,win,plwin,beat,25,0,21,212,0.443396226,0.051886792,0.570754717,1,0.309181312
12030,63,22006,3,5,10,0,0,18,10,5,10,0,0,25,nowin,win,dlbust,bust,20,0,8,216,0.467592593,0.037037037,0.62037037,3,0.931690496
12031,96,22006,10,6,0,8,0,24,10,5,10,0,0,25,nowin,loss,bust,plbust,0,10,16,190,0.468421053,0.057894737,0.584210526,3,0.897263354
12032,33,22006,7,9,0,7,0,23,10,5,10,0,0,25,nowin,loss,bust,plbust,0,10,16,192,0.4375,0.057291667,0.625,2,0.616208916
12033,104,22006,2,10,0,5,0,17,10,5,10,0,0,25,nowin,win,dlbust,bust,20,0,12,209,0.363636364,0.052631579,0.593301435,0,0.018359419
12034,134,22006,9,4,0,5,0,18,10,5,10,0,0,25,nowin,win,dlbust,bust,20,0,13,185,0.443243243,0.021621622,0.545945946,1,0.296939509
12035,5,22006,2,11,2,9,0,24,10,5,10,0,0,25,nowin,loss,bust,plbust,0,10,13,203,0.42364532,0.02955665,0.596059113,2,0.582508076
12036,77,22007,10,9,0,0,0,19,10,9,0,0,0,19,nowin,push,push,push,10,0,19,200,0.455,0.04,0.62,3,0.916252116
12037,18,22007,5,11,1,0,0,17,10,9,0,0,0,19,nowin,loss,beat,dlwin,0,10,16,182,0.461538462,0.043956044,0.587912088,3,0.892649374
12038,41,22007,9,11,0,0,0,20,10,9,0,0,0,19,nowin,win,plwin,beat,20,0,20,192,0.364583333,0.036458333,0.520833333,0,0.00089702
12039,16,22007,3,5,11,0,0,19,10,9,0,0,0,19,nowin,push,push,push,10,0,8,220,0.427272727,0.081818182,0.6,2,0.588660176
12040,77,22007,3,3,10,10,0,26,10,9,0,0,0,19,nowin,loss,bust,plbust,0,10,6,200,0.455,0.04,0.62,3,0.916252116
12041,87,22007,3,2,2,3,1,11,10,9,0,0,0,19,nowin,loss,beat,dlwin,0,10,5,202,0.405940594,0.054455446,0.628712871,2,0.590599801
12042,92,22008,8,7,0,9,0,24,10,10,0,0,0,20,nowin,loss,bust,plbust,0,10,15,186,0.446236559,0.059139785,0.564516129,1,0.307826125
12043,144,22008,10,11,0,0,0,21,10,10,0,0,0,20,win,win,plwin,beat,25,0,21,202,0.386138614,0.054455446,0.564356436,0,0.018006244
12044,89,22008,10,10,0,0,0,20,10,10,0,0,0,20,nowin,push,push,push,10,0,20,212,0.537735849,0.047169811,0.594339623,3,0.990167191
12045,136,22008,9,9,0,0,0,18,10,10,0,0,0,20,nowin,loss,beat,dlwin,0,10,18,194,0.396907216,0.025773196,0.597938144,0,0.029452644
12046,148,22008,10,2,0,9,0,21,10,10,0,0,0,20,nowin,win,plwin,beat,20,0,12,204,0.401960784,0.078431373,0.593137255,0,0.029789521
12047,82,22008,5,8,0,10,0,23,10,10,0,0,0,20,nowin,loss,bust,plbust,0,10,13,225,0.408888889,0.075555556,0.577777778,0,0.028101874
12048,78,22009,10,6,0,0,0,16,5,10,7,0,0,22,nowin,win,dlbust,bust,20,0,16,201,0.517412935,0.034825871,0.587064677,3,0.95871112
12049,118,22009,8,9,0,0,0,17,5,10,7,0,0,22,nowin,win,dlbust,bust,20,0,17,216,0.393518519,0.037037037,0.555555556,0,0.018059873
12050,129,22009,4,10,0,0,0,14,5,10,7,0,0,22,nowin,win,dlbust,bust,20,0,14,201,0.422885572,0.064676617,0.55721393,0,0.027255383
12051,106,22009,10,10,0,0,0,20,5,10,7,0,0,22,nowin,win,dlbust,bust,20,0,20,192,0.411458333,0.026041667,0.557291667,0,0.023854304
12052,96,22009,7,6,0,0,0,13,5,10,7,0,0,22,nowin,win,dlbust,bust,20,0,13,190,0.468421053,0.057894737,0.584210526,3,0.897263354
12053,138,22009,8,10,0,0,0,18,5,10,7,0,0,22,nowin,win,dlbust,bust,20,0,18,190,0.442105263,0.047368421,0.610526316,2,0.609711065
12054,7,22010,1,5,10,10,0,26,7,4,8,0,0,19,nowin,loss,bust,plbust,0,10,6,183,0.442622951,0.06010929,0.62295082,2,0.619303341
12055,35,22010,10,8,0,0,0,18,7,4,8,0,0,19,nowin,loss,beat,dlwin,0,10,18,202,0.410891089,0.044554455,0.633663366,2,0.598681573
12056,86,22010,9,3,0,5,0,17,7,4,8,0,0,19,nowin,loss,beat,dlwin,0,10,12,196,0.454081633,0.040816327,0.591836735,3,0.887566443
12057,42,22010,4,9,0,2,10,25,7,4,8,0,0,19,nowin,loss,bust,plbust,0,10,13,212,0.443396226,0.051886792,0.570754717,1,0.309181312
12058,72,22010,6,9,0,10,0,25,7,4,8,0,0,19,nowin,loss,bust,plbust,0,10,15,185,0.394594595,0.032432432,0.508108108,0,0.006763115
12059,26,22010,9,5,0,6,0,20,7,4,8,0,0,19,nowin,win,plwin,beat,20,0,14,203,0.463054187,0.0591133,0.541871921,1,0.306802864
12060,125,22011,8,5,0,0,0,13,4,10,10,0,0,24,nowin,win,dlbust,bust,20,0,13,219,0.438356164,0.050228311,0.575342466,1,0.308411257
12061,54,22011,9,5,0,0,0,14,4,10,10,0,0,24,nowin,win,dlbust,bust,20,0,14,185,0.437837838,0.032432432,0.556756757,1,0.29899854
12062,127,22011,2,4,10,0,0,16,4,10,10,0,0,24,nowin,win,dlbust,bust,20,0,6,201,0.402985075,0.029850746,0.60199005,0,0.032263937
12063,3,22011,10,7,0,0,0,17,4,10,10,0,0,24,nowin,win,dlbust,bust,20,0,17,190,0.431578947,0.026315789,0.542105263,1,0.288076384
12064,75,22011,10,5,0,0,0,15,4,10,10,0,0,24,nowin,win,dlbust,bust,20,0,15,191,0.418848168,0.052356021,0.570680628,0,0.029344702
12065,94,22011,4,3,4,1,0,12,4,10,10,0,0,24,nowin,win,dlbust,bust,20,0,7,183,0.43715847,0.043715847,0.540983607,1,0.290866892
12066,3,22012,8,11,0,0,0,19,8,11,0,0,0,19,nowin,push,push,push,10,0,19,190,0.431578947,0.026315789,0.542105263,1,0.288076384
12067,131,22012,10,7,0,0,0,17,8,11,0,0,0,19,nowin,loss,beat,dlwin,0,10,17,217,0.410138249,0.069124424,0.543778802,0,0.02015021
12068,2,22012,7,11,0,0,0,18,8,11,0,0,0,19,nowin,loss,beat,dlwin,0,10,18,200,0.445,0.035,0.64,2,0.633962549
12069,97,22012,4,10,0,4,0,18,8,11,0,0,0,19,nowin,loss,beat,dlwin,0,10,14,182,0.450549451,0.06043956,0.692307692,2,0.677372279
12070,50,22012,6,9,0,9,0,24,8,11,0,0,0,19,nowin,loss,bust,plbust,0,10,15,202,0.405940594,0.04950495,0.54950495,0,0.020296079
12071,95,22012,7,4,1,10,0,22,8,11,0,0,0,19,nowin,loss,bust,plbust,0,10,11,218,0.412844037,0.04587156,0.559633028,0,0.024842385
12072,1,22013,5,10,0,0,0,15,5,10,2,0,0,17,nowin,loss,beat,dlwin,0,10,15,197,0.406091371,0.025380711,0.649746193,2,0.606186955
12073,69,22013,7,6,0,0,0,13,5,10,2,0,0,17,nowin,loss,beat,dlwin,0,10,13,194,0.365979381,0.030927835,0.515463918,0,0
12074,82,22013,10,6,0,0,0,16,5,10,2,0,0,17,nowin,loss,beat,dlwin,0,10,16,225,0.408888889,0.075555556,0.577777778,0,0.028101874
12075,28,22013,10,11,0,0,0,21,5,10,2,0,0,17,win,win,plwin,beat,25,0,21,199,0.422110553,0.045226131,0.542713568,1,0.282706618
12076,68,22013,10,9,0,0,0,19,5,10,2,0,0,17,nowin,win,plwin,beat,20,0,19,205,0.434146341,0.029268293,0.6,2,0.59483189
12077,141,22013,10,10,0,0,0,20,5,10,2,0,0,17,nowin,win,plwin,beat,20,0,20,202,0.420792079,0.074257426,0.564356436,0,0.028377851
12078,54,22014,10,10,0,0,0,20,10,8,0,0,0,18,nowin,win,plwin,beat,20,0,20,185,0.437837838,0.032432432,0.556756757,1,0.29899854
12079,91,22014,2,3,3,9,0,17,10,8,0,0,0,18,nowin,loss,beat,dlwin,0,10,5,194,0.417525773,0.046391753,0.515463918,1,0.266616552
12080,36,22014,10,10,0,0,0,20,10,8,0,0,0,18,nowin,win,plwin,beat,20,0,20,229,0.445414847,0.056768559,0.655021834,2,0.645370571
12081,111,22014,10,6,0,10,0,26,10,8,0,0,0,18,nowin,loss,bust,plbust,0,10,16,180,0.433333333,0.055555556,0.611111111,2,0.602264492
12082,123,22014,6,10,0,10,0,26,10,8,0,0,0,18,nowin,loss,bust,plbust,0,10,16,205,0.43902439,0.034146341,0.614634146,2,0.609962544
12083,123,22014,10,8,0,0,0,18,10,8,0,0,0,18,nowin,push,push,push,10,0,18,205,0.43902439,0.034146341,0.614634146,2,0.609962544
12084,79,22015,7,3,2,6,0,18,8,11,0,0,0,19,nowin,loss,beat,dlwin,0,10,10,211,0.436018957,0.028436019,0.672985782,2,0.650131054
12085,124,22015,10,11,0,0,0,21,8,11,0,0,0,19,win,win,plwin,beat,25,0,21,202,0.47029703,0.064356436,0.584158416,3,0.899458193
12086,55,22015,3,4,10,0,0,17,8,11,0,0,0,19,nowin,loss,beat,dlwin,0,10,7,191,0.371727749,0.057591623,0.54973822,0,0.01011347
12087,51,22015,6,10,0,6,0,22,8,11,0,0,0,19,nowin,loss,bust,plbust,0,10,16,189,0.529100529,0.068783069,0.608465608,3,0.993665715
12088,17,22015,9,6,0,7,0,22,8,11,0,0,0,19,nowin,loss,bust,plbust,0,10,15,171,0.444444444,0.070175439,0.555555556,1,0.302364894
12089,34,22015,7,2,6,9,0,24,8,11,0,0,0,19,nowin,loss,bust,plbust,0,10,9,202,0.5,0.079207921,0.618811881,3,0.968961434
12090,20,22016,2,4,10,10,0,26,1,3,10,4,0,18,nowin,loss,bust,plbust,0,10,6,186,0.456989247,0.037634409,0.537634409,1,0.301097108
12091,116,22016,10,10,0,0,0,20,1,3,10,4,0,18,nowin,win,plwin,beat,20,0,20,195,0.425641026,0.056410256,0.538461538,1,0.28273747
12092,12,22016,8,8,0,3,0,19,1,3,10,4,0,18,nowin,win,plwin,beat,20,0,16,189,0.470899471,0.015873016,0.613756614,3,0.929171178
12093,38,22016,10,2,0,10,0,22,1,3,10,4,0,18,nowin,loss,bust,plbust,0,10,12,202,0.361386139,0.03960396,0.564356436,0,0.010597953
12094,28,22016,6,2,5,10,0,23,1,3,10,4,0,18,nowin,loss,bust,plbust,0,10,8,199,0.422110553,0.045226131,0.542713568,1,0.282706618
12095,36,22016,10,9,0,0,0,19,1,3,10,4,0,18,nowin,win,plwin,beat,20,0,19,229,0.445414847,0.056768559,0.655021834,2,0.645370571
12096,120,22017,10,9,0,0,0,19,6,10,7,0,0,23,nowin,win,dlbust,bust,20,0,19,202,0.440594059,0.034653465,0.618811881,2,0.614441029
12097,102,22017,7,11,0,0,0,18,6,10,7,0,0,23,nowin,win,dlbust,bust,20,0,18,192,0.338541667,0.046875,0.5625,0,0.003306118
12098,144,22017,8,7,0,0,0,15,6,10,7,0,0,23,nowin,win,dlbust,bust,20,0,15,202,0.386138614,0.054455446,0.564356436,0,0.018006244
12099,28,22017,10,11,0,0,0,21,6,10,7,0,0,23,win,win,dlbust,bust,25,0,21,199,0.422110553,0.045226131,0.542713568,1,0.282706618
12100,129,22017,10,10,0,0,0,20,6,10,7,0,0,23,nowin,win,dlbust,bust,20,0,20,201,0.422885572,0.064676617,0.55721393,0,0.027255383
12101,85,22017,8,5,0,0,0,13,6,10,7,0,0,23,nowin,win,dlbust,bust,20,0,13,195,0.41025641,0.066666667,0.594871795,0,0.03269711
12102,127,22018,5,1,6,9,0,21,10,10,0,0,0,20,nowin,win,plwin,beat,20,0,6,201,0.402985075,0.029850746,0.60199005,0,0.032263937
12103,109,22018,7,7,0,2,7,23,10,10,0,0,0,20,nowin,loss,bust,plbust,0,10,14,221,0.461538462,0.058823529,0.597285068,3,0.901830309
12104,80,22018,5,10,0,8,0,23,10,10,0,0,0,20,nowin,loss,bust,plbust,0,10,15,186,0.419354839,0.059139785,0.623655914,2,0.59892924
12105,90,22018,5,10,0,10,0,25,10,10,0,0,0,20,nowin,loss,bust,plbust,0,10,15,201,0.447761194,0.049751244,0.60199005,3,0.889945023
12106,150,22018,3,5,3,9,0,20,10,10,0,0,0,20,nowin,push,push,push,10,0,8,192,0.401041667,0.036458333,0.567708333,0,0.023287458
12107,32,22018,10,10,0,0,0,20,10,10,0,0,0,20,nowin,push,push,push,10,0,20,189,0.391534392,0.037037037,0.53968254,0,0.013579086
12108,116,22019,7,10,0,0,0,17,3,10,5,0,0,18,nowin,loss,beat,dlwin,0,10,17,195,0.425641026,0.056410256,0.538461538,1,0.28273747
12109,86,22019,3,3,5,8,0,19,3,10,5,0,0,18,nowin,win,plwin,beat,20,0,6,196,0.454081633,0.040816327,0.591836735,3,0.887566443
12110,33,22019,8,10,0,0,0,18,3,10,5,0,0,18,nowin,push,push,push,10,0,18,192,0.4375,0.057291667,0.625,2,0.616208916
12111,118,22019,10,3,0,0,0,13,3,10,5,0,0,18,nowin,loss,beat,dlwin,0,10,13,216,0.393518519,0.037037037,0.555555556,0,0.018059873
12112,44,22019,10,9,0,0,0,19,3,10,5,0,0,18,nowin,win,plwin,beat,20,0,19,219,0.433789954,0.050228311,0.534246575,1,0.285551035
12113,58,22019,10,8,0,0,0,18,3,10,5,0,0,18,nowin,push,push,push,10,0,18,195,0.430769231,0.041025641,0.584615385,2,0.580497586
12114,59,22020,10,5,0,0,0,15,2,3,11,1,0,17,nowin,loss,beat,dlwin,0,10,15,228,0.429824561,0.048245614,0.543859649,1,0.287885446
12115,143,22020,10,10,0,0,0,20,2,3,11,1,0,17,nowin,win,plwin,beat,20,0,20,203,0.463054187,0.044334975,0.57635468,3,0.883143365
12116,138,22020,2,9,4,0,0,15,2,3,11,1,0,17,nowin,loss,beat,dlwin,0,10,11,190,0.442105263,0.047368421,0.610526316,2,0.609711065
12117,16,22020,4,10,0,0,0,14,2,3,11,1,0,17,nowin,loss,beat,dlwin,0,10,14,220,0.427272727,0.081818182,0.6,2,0.588660176
12118,144,22020,11,10,0,0,0,21,2,3,11,1,0,17,win,win,plwin,beat,25,0,21,202,0.386138614,0.054455446,0.564356436,0,0.018006244
12119,61,22020,6,5,3,0,0,14,2,3,11,1,0,17,nowin,loss,beat,dlwin,0,10,11,194,0.427835052,0.077319588,0.603092784,2,0.591437139
12120,78,22021,3,10,0,8,0,21,10,10,0,0,0,20,nowin,win,plwin,beat,20,0,13,201,0.517412935,0.034825871,0.587064677,3,0.95871112
12121,58,22021,6,5,6,0,0,17,10,10,0,0,0,20,nowin,loss,beat,dlwin,0,10,11,195,0.430769231,0.041025641,0.584615385,2,0.580497586
12122,130,22021,3,10,0,2,10,25,10,10,0,0,0,20,nowin,loss,bust,plbust,0,10,13,219,0.410958904,0.03652968,0.566210046,0,0.025888739
12123,85,22021,8,7,0,4,0,19,10,10,0,0,0,20,nowin,loss,beat,dlwin,0,10,15,195,0.41025641,0.066666667,0.594871795,0,0.03269711
12124,141,22021,10,11,0,0,0,21,10,10,0,0,0,20,win,win,plwin,beat,25,0,21,202,0.420792079,0.074257426,0.564356436,0,0.028377851
12125,147,22021,4,10,0,10,0,24,10,10,0,0,0,20,nowin,loss,bust,plbust,0,10,14,205,0.380487805,0.014634146,0.536585366,0,0.00951447
12126,118,22022,10,8,0,0,0,18,10,3,5,0,0,18,nowin,push,push,push,10,0,18,216,0.393518519,0.037037037,0.555555556,0,0.018059873
12127,76,22022,3,10,0,10,0,23,10,3,5,0,0,18,nowin,loss,bust,plbust,0,10,13,189,0.534391534,0.079365079,0.608465608,3,1
12128,57,22022,10,3,0,8,0,21,10,3,5,0,0,18,nowin,win,plwin,beat,20,0,13,192,0.46875,0.052083333,0.59375,3,0.907001181
12129,142,22022,10,2,0,1,10,23,10,3,5,0,0,18,nowin,loss,bust,plbust,0,10,12,211,0.417061611,0.047393365,0.526066351,1,0.271531309
12130,147,22022,10,2,0,2,10,24,10,3,5,0,0,18,nowin,loss,bust,plbust,0,10,12,205,0.380487805,0.014634146,0.536585366,0,0.00951447
12131,86,22022,10,8,0,0,0,18,10,3,5,0,0,18,nowin,push,push,push,10,0,18,196,0.454081633,0.040816327,0.591836735,3,0.887566443
12132,145,22023,6,10,0,10,0,26,11,3,7,0,0,21,nowin,loss,bust,plbust,0,10,16,188,0.441489362,0.031914894,0.622340426,2,0.617837093
12133,9,22023,4,4,11,0,0,19,11,3,7,0,0,21,nowin,loss,beat,dlwin,0,10,8,194,0.37628866,0.015463918,0.541237113,0,0.009396796
12134,4,22023,10,5,0,5,0,20,11,3,7,0,0,21,nowin,loss,beat,dlwin,0,10,15,217,0.460829493,0.036866359,0.562211982,1,0.315432839
12135,79,22023,4,7,10,0,0,21,11,3,7,0,0,21,nowin,push,push,push,10,0,11,211,0.436018957,0.028436019,0.672985782,2,0.650131054
12136,30,22023,8,4,0,7,0,19,11,3,7,0,0,21,nowin,loss,beat,dlwin,0,10,12,206,0.393203883,0.033980583,0.601941748,0,0.029324648
12137,150,22023,10,10,0,0,0,20,11,3,7,0,0,21,nowin,loss,beat,dlwin,0,10,20,192,0.401041667,0.036458333,0.567708333,0,0.023287458
12138,73,22024,1,2,9,10,0,22,9,6,4,0,0,19,nowin,loss,bust,plbust,0,10,3,181,0.375690608,0.011049724,0.596685083,0,0.022795773
12139,38,22024,10,10,0,0,0,20,9,6,4,0,0,19,nowin,win,plwin,beat,20,0,20,202,0.361386139,0.03960396,0.564356436,0,0.010597953
12140,44,22024,10,10,0,0,0,20,9,6,4,0,0,19,nowin,win,plwin,beat,20,0,20,219,0.433789954,0.050228311,0.534246575,1,0.285551035
12141,112,22024,2,7,7,2,0,18,9,6,4,0,0,19,nowin,loss,beat,dlwin,0,10,9,203,0.448275862,0.054187192,0.600985222,3,0.889576933
12142,137,22024,8,10,0,0,0,18,9,6,4,0,0,19,nowin,loss,beat,dlwin,0,10,18,194,0.417525773,0.046391753,0.536082474,1,0.276714602
12143,101,22024,10,4,0,6,0,20,9,6,4,0,0,19,nowin,win,plwin,beat,20,0,14,205,0.424390244,0.068292683,0.63902439,2,0.614740646
12144,11,22025,5,10,0,8,0,23,10,10,0,0,0,20,nowin,loss,bust,plbust,0,10,15,236,0.457627119,0.016949153,0.588983051,3,0.889015813
12145,25,22025,10,10,0,0,0,20,10,10,0,0,0,20,nowin,push,push,push,10,0,20,190,0.463157895,0.063157895,0.536842105,1,0.304401563
12146,12,22025,5,5,8,0,0,18,10,10,0,0,0,20,nowin,loss,beat,dlwin,0,10,10,189,0.470899471,0.015873016,0.613756614,3,0.929171178
12147,104,22025,10,6,0,10,0,26,10,10,0,0,0,20,nowin,loss,bust,plbust,0,10,16,209,0.363636364,0.052631579,0.593301435,0,0.018359419
12148,33,22025,10,5,0,6,0,21,10,10,0,0,0,20,nowin,win,plwin,beat,20,0,15,192,0.4375,0.057291667,0.625,2,0.616208916
12149,69,22025,5,10,0,4,0,19,10,10,0,0,0,20,nowin,loss,beat,dlwin,0,10,15,194,0.365979381,0.030927835,0.515463918,0,0
12150,117,22026,10,10,0,0,0,20,9,10,0,0,0,19,nowin,win,plwin,beat,20,0,20,173,0.410404624,0.069364162,0.606936416,2,0.578610282
12151,110,22026,3,2,8,6,0,19,9,10,0,0,0,19,nowin,push,push,push,10,0,5,192,0.416666667,0.046875,0.557291667,0,0.025413132
12152,41,22026,6,10,0,9,0,25,9,10,0,0,0,19,nowin,loss,bust,plbust,0,10,16,192,0.364583333,0.036458333,0.520833333,0,0.00089702
12153,132,22026,4,7,4,9,0,24,9,10,0,0,0,19,nowin,loss,bust,plbust,0,10,11,194,0.412371134,0.036082474,0.649484536,2,0.611633238
12154,107,22026,10,10,0,0,0,20,9,10,0,0,0,19,nowin,win,plwin,beat,20,0,20,218,0.444954128,0.073394495,0.600917431,2,0.605210014
12155,23,22026,9,10,0,0,0,19,9,10,0,0,0,19,nowin,push,push,push,10,0,19,208,0.427884615,0.0625,0.552884615,1,0.29114424
12156,109,22027,6,8,0,0,0,14,6,7,4,0,0,17,nowin,loss,beat,dlwin,0,10,14,221,0.461538462,0.058823529,0.597285068,3,0.901830309
12157,103,22027,5,5,8,0,0,18,6,7,4,0,0,17,nowin,win,plwin,beat,20,0,10,203,0.379310345,0.064039409,0.551724138,0,0.012869209
12158,20,22027,10,7,0,0,0,17,6,7,4,0,0,17,nowin,push,push,push,10,0,17,186,0.456989247,0.037634409,0.537634409,1,0.301097108
12159,60,22027,10,10,0,0,0,20,6,7,4,0,0,17,nowin,win,plwin,beat,20,0,20,227,0.418502203,0.022026432,0.559471366,0,0.026496258
12160,76,22027,10,11,0,0,0,21,6,7,4,0,0,17,win,win,plwin,beat,25,0,21,189,0.534391534,0.079365079,0.608465608,3,1
12161,88,22027,11,9,0,0,0,20,6,7,4,0,0,17,nowin,win,plwin,beat,20,0,20,206,0.466019417,0.033980583,0.54368932,1,0.309467903
12162,32,22028,10,10,0,0,0,20,10,9,0,0,0,19,nowin,win,plwin,beat,20,0,20,189,0.391534392,0.037037037,0.53968254,0,0.013579086
12163,37,22028,2,1,10,10,0,23,10,9,0,0,0,19,nowin,loss,bust,plbust,0,10,3,208,0.394230769,0.038461538,0.581730769,0,0.024682772
12164,67,22028,9,9,0,0,0,18,10,9,0,0,0,19,nowin,loss,beat,dlwin,0,10,18,195,0.369230769,0.041025641,0.569230769,0,0.014139427
12165,55,22028,7,10,0,0,0,17,10,9,0,0,0,19,nowin,loss,beat,dlwin,0,10,17,191,0.371727749,0.057591623,0.54973822,0,0.01011347
12166,14,22028,9,7,0,4,0,20,10,9,0,0,0,19,nowin,win,plwin,beat,20,0,16,202,0.391089109,0.01980198,0.628712871,2,0.577264877
12167,106,22028,5,2,4,1,9,21,10,9,0,0,0,19,nowin,win,plwin,beat,20,0,7,192,0.411458333,0.026041667,0.557291667,0,0.023854304
12168,77,22029,7,3,7,0,0,17,10,10,0,0,0,20,nowin,loss,beat,dlwin,0,10,10,200,0.455,0.04,0.62,3,0.916252116
12169,36,22029,10,10,0,0,0,20,10,10,0,0,0,20,nowin,push,push,push,10,0,20,229,0.445414847,0.056768559,0.655021834,2,0.645370571
12170,22,22029,10,4,0,10,0,24,10,10,0,0,0,20,nowin,loss,bust,plbust,0,10,14,187,0.481283422,0.042780749,0.577540107,3,0.906128176
12171,125,22029,6,10,0,2,0,18,10,10,0,0,0,20,nowin,loss,beat,dlwin,0,10,16,219,0.438356164,0.050228311,0.575342466,1,0.308411257
12172,149,22029,9,6,0,1,10,26,10,10,0,0,0,20,nowin,loss,bust,plbust,0,10,15,225,0.457777778,0.057777778,0.648888889,2,0.651965595
12173,90,22029,9,10,0,0,0,19,10,10,0,0,0,20,nowin,loss,beat,dlwin,0,10,19,201,0.447761194,0.049751244,0.60199005,3,0.889945023
12174,50,22030,8,11,0,0,0,19,6,2,11,0,0,19,nowin,push,push,push,10,0,19,202,0.405940594,0.04950495,0.54950495,0,0.020296079
12175,90,22030,4,8,0,0,0,12,6,2,11,0,0,19,nowin,loss,beat,dlwin,0,10,12,201,0.447761194,0.049751244,0.60199005,3,0.889945023
12176,128,22030,1,5,10,0,0,16,6,2,11,0,0,19,nowin,loss,beat,dlwin,0,10,6,227,0.356828194,0.052863436,0.577092511,0,0.012352564
12177,6,22030,10,10,0,0,0,20,6,2,11,0,0,19,nowin,win,plwin,beat,20,0,20,191,0.439790576,0.047120419,0.581151832,1,0.31211505
12178,29,22030,8,10,0,0,0,18,6,2,11,0,0,19,nowin,loss,beat,dlwin,0,10,18,189,0.44973545,0.058201058,0.544973545,1,0.300349439
12179,140,22030,1,5,10,0,0,16,6,2,11,0,0,19,nowin,loss,beat,dlwin,0,10,6,210,0.466666667,0.023809524,0.604761905,3,0.915293335
12180,45,22031,7,10,0,0,0,17,2,10,7,0,0,19,nowin,loss,beat,dlwin,0,10,17,196,0.428571429,0.051020408,0.612244898,2,0.598821767
12181,20,22031,6,5,10,0,0,21,2,10,7,0,0,19,nowin,win,plwin,beat,20,0,11,186,0.456989247,0.037634409,0.537634409,1,0.301097108
12182,54,22031,3,6,11,0,0,20,2,10,7,0,0,19,nowin,win,plwin,beat,20,0,9,185,0.437837838,0.032432432,0.556756757,1,0.29899854
12183,89,22031,10,10,0,0,0,20,2,10,7,0,0,19,nowin,win,plwin,beat,20,0,20,212,0.537735849,0.047169811,0.594339623,3,0.990167191
12184,64,22031,11,8,0,0,0,19,2,10,7,0,0,19,nowin,push,push,push,10,0,19,187,0.363636364,0.048128342,0.631016043,0,0.027594885
12185,83,22031,11,9,0,0,0,20,2,10,7,0,0,19,nowin,win,plwin,beat,20,0,20,193,0.424870466,0.051813472,0.678756477,2,0.644360335
12186,9,22032,6,8,0,0,0,14,6,10,5,0,0,21,nowin,loss,beat,dlwin,0,10,14,194,0.37628866,0.015463918,0.541237113,0,0.009396796
12187,79,22032,9,10,0,0,0,19,6,10,5,0,0,21,nowin,loss,beat,dlwin,0,10,19,211,0.436018957,0.028436019,0.672985782,2,0.650131054
12188,100,22032,7,10,0,0,0,17,6,10,5,0,0,21,nowin,loss,beat,dlwin,0,10,17,190,0.452631579,0.036842105,0.594736842,3,0.888671154
12189,80,22032,7,11,0,0,0,18,6,10,5,0,0,21,nowin,loss,beat,dlwin,0,10,18,186,0.419354839,0.059139785,0.623655914,2,0.59892924
12190,37,22032,2,10,0,0,0,12,6,10,5,0,0,21,nowin,loss,beat,dlwin,0,10,12,208,0.394230769,0.038461538,0.581730769,0,0.024682772
12191,58,22032,9,7,0,0,0,16,6,10,5,0,0,21,nowin,loss,beat,dlwin,0,10,16,195,0.430769231,0.041025641,0.584615385,2,0.580497586
12192,35,22033,2,4,10,5,0,21,9,10,0,0,0,19,nowin,win,plwin,beat,20,0,6,202,0.410891089,0.044554455,0.633663366,2,0.598681573
12193,45,22033,10,10,0,0,0,20,9,10,0,0,0,19,nowin,win,plwin,beat,20,0,20,196,0.428571429,0.051020408,0.612244898,2,0.598821767
12194,142,22033,10,2,0,9,0,21,9,10,0,0,0,19,nowin,win,plwin,beat,20,0,12,211,0.417061611,0.047393365,0.526066351,1,0.271531309
12195,27,22033,2,6,3,8,0,19,9,10,0,0,0,19,nowin,push,push,push,10,0,8,178,0.370786517,0.016853933,0.573033708,0,0.015536309
12196,27,22033,5,10,0,9,0,24,9,10,0,0,0,19,nowin,loss,bust,plbust,0,10,15,178,0.370786517,0.016853933,0.573033708,0,0.015536309
12197,132,22033,10,10,0,0,0,20,9,10,0,0,0,19,nowin,win,plwin,beat,20,0,20,194,0.412371134,0.036082474,0.649484536,2,0.611633238
12198,106,22034,4,10,0,0,0,14,3,5,10,0,0,18,nowin,loss,beat,dlwin,0,10,14,192,0.411458333,0.026041667,0.557291667,0,0.023854304
12199,9,22034,10,3,0,0,0,13,3,5,10,0,0,18,nowin,loss,beat,dlwin,0,10,13,194,0.37628866,0.015463918,0.541237113,0,0.009396796
12200,10,22034,8,10,0,0,0,18,3,5,10,0,0,18,nowin,push,push,push,10,0,18,191,0.413612565,0.057591623,0.596858639,2,0.574087175
12201,142,22034,3,1,9,0,0,13,3,5,10,0,0,18,nowin,loss,beat,dlwin,0,10,4,211,0.417061611,0.047393365,0.526066351,1,0.271531309
12202,30,22034,5,7,0,8,0,20,3,5,10,0,0,18,nowin,win,plwin,beat,20,0,12,206,0.393203883,0.033980583,0.601941748,0,0.029324648
12203,138,22034,8,9,0,0,0,17,3,5,10,0,0,18,nowin,loss,beat,dlwin,0,10,17,190,0.442105263,0.047368421,0.610526316,2,0.609711065
12204,130,22035,10,8,0,0,0,18,4,5,5,6,0,20,nowin,loss,beat,dlwin,0,10,18,219,0.410958904,0.03652968,0.566210046,0,0.025888739
12205,19,22035,3,9,0,0,0,12,4,5,5,6,0,20,nowin,loss,beat,dlwin,0,10,12,237,0.41350211,0.054852321,0.628691983,2,0.597373826
12206,140,22035,10,5,0,0,0,15,4,5,5,6,0,20,nowin,loss,beat,dlwin,0,10,15,210,0.466666667,0.023809524,0.604761905,3,0.915293335
12207,6,22035,10,2,0,0,0,12,4,5,5,6,0,20,nowin,loss,beat,dlwin,0,10,12,191,0.439790576,0.047120419,0.581151832,1,0.31211505
12208,146,22035,10,5,0,0,0,15,4,5,5,6,0,20,nowin,loss,beat,dlwin,0,10,15,221,0.43438914,0.040723982,0.542986425,1,0.290190091
12209,121,22035,6,4,11,0,0,21,4,5,5,6,0,20,nowin,win,plwin,beat,20,0,10,195,0.456410256,0.025641026,0.512820513,1,0.288597791
12210,95,22036,10,10,0,0,0,20,10,8,0,0,0,18,nowin,win,plwin,beat,20,0,20,218,0.412844037,0.04587156,0.559633028,0,0.024842385
12211,18,22036,10,7,0,0,0,17,10,8,0,0,0,18,nowin,loss,beat,dlwin,0,10,17,182,0.461538462,0.043956044,0.587912088,3,0.892649374
12212,88,22036,3,3,6,9,0,21,10,8,0,0,0,18,nowin,win,plwin,beat,20,0,6,206,0.466019417,0.033980583,0.54368932,1,0.309467903
12213,77,22036,10,11,0,0,0,21,10,8,0,0,0,18,win,win,plwin,beat,25,0,21,200,0.455,0.04,0.62,3,0.916252116
12214,145,22036,9,5,0,8,0,22,10,8,0,0,0,18,nowin,loss,bust,plbust,0,10,14,188,0.441489362,0.031914894,0.622340426,2,0.617837093
12215,65,22036,2,7,3,9,0,21,10,8,0,0,0,18,nowin,win,plwin,beat,20,0,9,203,0.492610837,0.054187192,0.571428571,3,0.913702814
12216,1,22037,4,10,0,1,6,21,7,10,0,0,0,17,nowin,win,plwin,beat,20,0,14,197,0.406091371,0.025380711,0.649746193,2,0.606186955
12217,146,22037,9,4,0,9,0,22,7,10,0,0,0,17,nowin,loss,bust,plbust,0,10,13,221,0.43438914,0.040723982,0.542986425,1,0.290190091
12218,1,22037,2,8,6,6,0,22,7,10,0,0,0,17,nowin,loss,bust,plbust,0,10,10,197,0.406091371,0.025380711,0.649746193,2,0.606186955
12219,86,22037,10,10,0,0,0,20,7,10,0,0,0,17,nowin,win,plwin,beat,20,0,20,196,0.454081633,0.040816327,0.591836735,3,0.887566443
12220,98,22037,5,8,0,2,10,25,7,10,0,0,0,17,nowin,loss,bust,plbust,0,10,13,220,0.422727273,0.054545455,0.55,1,0.28664435
12221,64,22037,9,10,0,0,0,19,7,10,0,0,0,17,nowin,win,plwin,beat,20,0,19,187,0.363636364,0.048128342,0.631016043,0,0.027594885
12222,80,22038,6,8,0,8,0,22,7,10,0,0,0,17,nowin,loss,bust,plbust,0,10,14,186,0.419354839,0.059139785,0.623655914,2,0.59892924
12223,21,22038,7,2,10,0,0,19,7,10,0,0,0,17,nowin,win,plwin,beat,20,0,9,214,0.359813084,0.042056075,0.626168224,0,0.025263474
12224,115,22038,9,10,0,0,0,19,7,10,0,0,0,17,nowin,win,plwin,beat,20,0,19,194,0.427835052,0.041237113,0.592783505,2,0.583863602
12225,144,22038,3,4,10,0,0,17,7,10,0,0,0,17,nowin,push,push,push,10,0,7,202,0.386138614,0.054455446,0.564356436,0,0.018006244
12226,129,22038,2,3,10,10,0,25,7,10,0,0,0,17,nowin,loss,bust,plbust,0,10,5,201,0.422885572,0.064676617,0.55721393,0,0.027255383
12227,92,22038,10,4,0,1,10,25,7,10,0,0,0,17,nowin,loss,bust,plbust,0,10,14,186,0.446236559,0.059139785,0.564516129,1,0.307826125
12228,112,22039,6,8,0,1,10,25,8,2,7,0,0,17,nowin,loss,bust,plbust,0,10,14,203,0.448275862,0.054187192,0.600985222,3,0.889576933
12229,54,22039,1,4,10,2,0,17,8,2,7,0,0,17,nowin,push,push,push,10,0,5,185,0.437837838,0.032432432,0.556756757,1,0.29899854
12230,57,22039,2,9,7,0,0,18,8,2,7,0,0,17,nowin,win,plwin,beat,20,0,11,192,0.46875,0.052083333,0.59375,3,0.907001181
12231,35,22039,10,5,0,10,0,25,8,2,7,0,0,17,nowin,loss,bust,plbust,0,10,15,202,0.410891089,0.044554455,0.633663366,2,0.598681573
12232,14,22039,8,10,0,0,0,18,8,2,7,0,0,17,nowin,win,plwin,beat,20,0,18,202,0.391089109,0.01980198,0.628712871,2,0.577264877
12233,101,22039,10,4,0,9,0,23,8,2,7,0,0,17,nowin,loss,bust,plbust,0,10,14,205,0.424390244,0.068292683,0.63902439,2,0.614740646
12234,88,22040,4,6,3,7,0,20,10,2,10,0,0,22,nowin,win,dlbust,bust,20,0,10,206,0.466019417,0.033980583,0.54368932,1,0.309467903
12235,17,22040,7,4,10,0,0,21,10,2,10,0,0,22,nowin,win,dlbust,bust,20,0,11,171,0.444444444,0.070175439,0.555555556,1,0.302364894
12236,132,22040,11,10,0,0,0,21,10,2,10,0,0,22,win,win,dlbust,bust,25,0,21,194,0.412371134,0.036082474,0.649484536,2,0.611633238
12237,24,22040,4,7,8,0,0,19,10,2,10,0,0,22,nowin,win,dlbust,bust,20,0,11,207,0.458937198,0.048309179,0.570048309,1,0.318138014
12238,93,22040,5,6,10,0,0,21,10,2,10,0,0,22,nowin,win,dlbust,bust,20,0,11,175,0.485714286,0.051428571,0.548571429,1,0.323648091
12239,134,22040,10,6,0,10,0,26,10,2,10,0,0,22,nowin,loss,bust,plbust,0,10,16,185,0.443243243,0.021621622,0.545945946,1,0.296939509
12240,33,22041,5,10,0,7,0,22,9,2,10,0,0,21,nowin,loss,bust,plbust,0,10,15,192,0.4375,0.057291667,0.625,2,0.616208916
12241,70,22041,5,4,7,3,0,19,9,2,10,0,0,21,nowin,loss,beat,dlwin,0,10,9,228,0.385964912,0.039473684,0.557017544,0,0.016157125
12242,89,22041,10,5,0,5,0,20,9,2,10,0,0,21,nowin,loss,beat,dlwin,0,10,15,212,0.537735849,0.047169811,0.594339623,3,0.990167191
12243,116,22041,5,9,0,8,0,22,9,2,10,0,0,21,nowin,loss,bust,plbust,0,10,14,195,0.425641026,0.056410256,0.538461538,1,0.28273747
12244,14,22041,10,10,0,0,0,20,9,2,10,0,0,21,nowin,loss,beat,dlwin,0,10,20,202,0.391089109,0.01980198,0.628712871,2,0.577264877
12245,20,22041,5,9,0,2,2,18,9,2,10,0,0,21,nowin,loss,beat,dlwin,0,10,14,186,0.456989247,0.037634409,0.537634409,1,0.301097108
12246,136,22042,3,3,4,7,0,17,11,1,5,0,0,17,nowin,push,push,push,10,0,6,194,0.396907216,0.025773196,0.597938144,0,0.029452644
12247,29,22042,5,10,0,10,0,25,11,1,5,0,0,17,nowin,loss,bust,plbust,0,10,15,189,0.44973545,0.058201058,0.544973545,1,0.300349439
12248,87,22042,8,5,0,9,0,22,11,1,5,0,0,17,nowin,loss,bust,plbust,0,10,13,202,0.405940594,0.054455446,0.628712871,2,0.590599801
12249,142,22042,10,10,0,0,0,20,11,1,5,0,0,17,nowin,win,plwin,beat,20,0,20,211,0.417061611,0.047393365,0.526066351,1,0.271531309
12250,109,22042,10,10,0,0,0,20,11,1,5,0,0,17,nowin,win,plwin,beat,20,0,20,221,0.461538462,0.058823529,0.597285068,3,0.901830309
12251,76,22042,8,11,0,0,0,19,11,1,5,0,0,17,nowin,win,plwin,beat,20,0,19,189,0.534391534,0.079365079,0.608465608,3,1
12252,140,22043,10,10,0,0,0,20,3,8,10,0,0,21,nowin,loss,beat,dlwin,0,10,20,210,0.466666667,0.023809524,0.604761905,3,0.915293335
12253,45,22043,3,6,2,6,0,17,3,8,10,0,0,21,nowin,loss,beat,dlwin,0,10,9,196,0.428571429,0.051020408,0.612244898,2,0.598821767
12254,113,22043,10,10,0,0,0,20,3,8,10,0,0,21,nowin,loss,beat,dlwin,0,10,20,199,0.407035176,0.055276382,0.668341709,2,0.620695264
12255,75,22043,5,4,8,0,0,17,3,8,10,0,0,21,nowin,loss,beat,dlwin,0,10,9,191,0.418848168,0.052356021,0.570680628,0,0.029344702
12256,99,22043,6,10,0,0,0,16,3,8,10,0,0,21,nowin,loss,beat,dlwin,0,10,16,207,0.47826087,0.062801932,0.637681159,3,0.961418446
12257,9,22043,6,9,0,0,0,15,3,8,10,0,0,21,nowin,loss,beat,dlwin,0,10,15,194,0.37628866,0.015463918,0.541237113,0,0.009396796
12258,100,22044,4,8,0,6,0,18,2,10,6,0,0,18,nowin,push,push,push,10,0,12,190,0.452631579,0.036842105,0.594736842,3,0.888671154
12259,24,22044,10,10,0,0,0,20,2,10,6,0,0,18,nowin,win,plwin,beat,20,0,20,207,0.458937198,0.048309179,0.570048309,1,0.318138014
12260,105,22044,8,7,0,0,0,15,2,10,6,0,0,18,nowin,loss,beat,dlwin,0,10,15,198,0.414141414,0.070707071,0.590909091,0,0.032889494
12261,141,22044,3,10,0,0,0,13,2,10,6,0,0,18,nowin,loss,beat,dlwin,0,10,13,202,0.420792079,0.074257426,0.564356436,0,0.028377851
12262,10,22044,10,8,0,0,0,18,2,10,6,0,0,18,nowin,push,push,push,10,0,18,191,0.413612565,0.057591623,0.596858639,2,0.574087175
12263,7,22044,10,10,0,0,0,20,2,10,6,0,0,18,nowin,win,plwin,beat,20,0,20,183,0.442622951,0.06010929,0.62295082,2,0.619303341
12264,4,22045,8,11,0,0,0,19,5,10,4,0,0,19,nowin,push,push,push,10,0,19,217,0.460829493,0.036866359,0.562211982,1,0.315432839
12265,105,22045,4,10,0,0,0,14,5,10,4,0,0,19,nowin,loss,beat,dlwin,0,10,14,198,0.414141414,0.070707071,0.590909091,0,0.032889494
12266,12,22045,5,5,4,0,0,14,5,10,4,0,0,19,nowin,loss,beat,dlwin,0,10,10,189,0.470899471,0.015873016,0.613756614,3,0.929171178
12267,63,22045,2,10,0,0,0,12,5,10,4,0,0,19,nowin,loss,beat,dlwin,0,10,12,216,0.467592593,0.037037037,0.62037037,3,0.931690496
12268,52,22045,4,2,3,9,0,18,5,10,4,0,0,19,nowin,loss,beat,dlwin,0,10,6,217,0.414746544,0.02764977,0.599078341,2,0.576736024
12269,28,22045,8,7,0,0,0,15,5,10,4,0,0,19,nowin,loss,beat,dlwin,0,10,15,199,0.422110553,0.045226131,0.542713568,1,0.282706618
12270,122,22046,11,9,0,0,0,20,2,10,8,0,0,20,nowin,push,push,push,10,0,20,210,0.347619048,0.052380952,0.59047619,0,0.012873677
12271,14,22046,10,7,0,0,0,17,2,10,8,0,0,20,nowin,loss,beat,dlwin,0,10,17,202,0.391089109,0.01980198,0.628712871,2,0.577264877
12272,91,22046,10,10,0,0,0,20,2,10,8,0,0,20,nowin,push,push,push,10,0,20,194,0.417525773,0.046391753,0.515463918,1,0.266616552
12273,118,22046,5,7,0,9,0,21,2,10,8,0,0,20,nowin,win,plwin,beat,20,0,12,216,0.393518519,0.037037037,0.555555556,0,0.018059873
12274,63,22046,3,10,0,0,0,13,2,10,8,0,0,20,nowin,loss,beat,dlwin,0,10,13,216,0.467592593,0.037037037,0.62037037,3,0.931690496
12275,84,22046,10,6,0,0,0,16,2,10,8,0,0,20,nowin,loss,beat,dlwin,0,10,16,195,0.379487179,0.056410256,0.569230769,0,0.017209119
12276,24,22047,10,10,0,0,0,20,10,7,0,0,0,17,nowin,win,plwin,beat,20,0,20,207,0.458937198,0.048309179,0.570048309,1,0.318138014
12277,105,22047,2,9,6,0,0,17,10,7,0,0,0,17,nowin,push,push,push,10,0,11,198,0.414141414,0.070707071,0.590909091,0,0.032889494
12278,82,22047,2,9,3,5,0,19,10,7,0,0,0,17,nowin,win,plwin,beat,20,0,11,225,0.408888889,0.075555556,0.577777778,0,0.028101874
12279,128,22047,2,9,10,0,0,21,10,7,0,0,0,17,nowin,win,plwin,beat,20,0,11,227,0.356828194,0.052863436,0.577092511,0,0.012352564
12280,82,22047,6,8,0,10,0,24,10,7,0,0,0,17,nowin,loss,bust,plbust,0,10,14,225,0.408888889,0.075555556,0.577777778,0,0.028101874
12281,25,22047,11,10,0,0,0,21,10,7,0,0,0,17,win,win,plwin,beat,25,0,21,190,0.463157895,0.063157895,0.536842105,1,0.304401563
12282,21,22048,9,3,0,10,0,22,10,10,0,0,0,20,nowin,loss,bust,plbust,0,10,12,214,0.359813084,0.042056075,0.626168224,0,0.025263474
12283,44,22048,3,9,0,4,3,19,10,10,0,0,0,20,nowin,loss,beat,dlwin,0,10,12,219,0.433789954,0.050228311,0.534246575,1,0.285551035
12284,125,22048,8,4,0,9,0,21,10,10,0,0,0,20,nowin,win,plwin,beat,20,0,12,219,0.438356164,0.050228311,0.575342466,1,0.308411257
12285,116,22048,10,4,0,10,0,24,10,10,0,0,0,20,nowin,loss,bust,plbust,0,10,14,195,0.425641026,0.056410256,0.538461538,1,0.28273747
12286,41,22048,10,5,0,9,0,24,10,10,0,0,0,20,nowin,loss,bust,plbust,0,10,15,192,0.364583333,0.036458333,0.520833333,0,0.00089702
12287,60,22048,6,3,11,0,0,20,10,10,0,0,0,20,nowin,push,push,push,10,0,9,227,0.418502203,0.022026432,0.559471366,0,0.026496258
12288,36,22049,2,1,10,7,0,20,8,5,9,0,0,22,nowin,win,dlbust,bust,20,0,3,229,0.445414847,0.056768559,0.655021834,2,0.645370571
12289,36,22049,8,9,0,0,0,17,8,5,9,0,0,22,nowin,win,dlbust,bust,20,0,17,229,0.445414847,0.056768559,0.655021834,2,0.645370571
12290,77,22049,10,4,0,3,0,17,8,5,9,0,0,22,nowin,win,dlbust,bust,20,0,14,200,0.455,0.04,0.62,3,0.916252116
12291,128,22049,6,1,8,3,0,18,8,5,9,0,0,22,nowin,win,dlbust,bust,20,0,7,227,0.356828194,0.052863436,0.577092511,0,0.012352564
12292,96,22049,9,4,0,5,0,18,8,5,9,0,0,22,nowin,win,dlbust,bust,20,0,13,190,0.468421053,0.057894737,0.584210526,3,0.897263354
12293,37,22049,10,10,0,0,0,20,8,5,9,0,0,22,nowin,win,dlbust,bust,20,0,20,208,0.394230769,0.038461538,0.581730769,0,0.024682772
12294,81,22050,10,6,0,3,0,19,10,10,0,0,0,20,nowin,loss,beat,dlwin,0,10,16,182,0.395604396,0.043956044,0.60989011,2,0.567491261
12295,107,22050,2,5,2,2,8,19,10,10,0,0,0,20,nowin,loss,beat,dlwin,0,10,7,218,0.444954128,0.073394495,0.600917431,2,0.605210014
12296,34,22050,10,11,0,0,0,21,10,10,0,0,0,20,win,win,plwin,beat,25,0,21,202,0.5,0.079207921,0.618811881,3,0.968961434
12297,30,22050,7,3,9,0,0,19,10,10,0,0,0,20,nowin,loss,beat,dlwin,0,10,10,206,0.393203883,0.033980583,0.601941748,0,0.029324648
12298,55,22050,8,3,10,0,0,21,10,10,0,0,0,20,nowin,win,plwin,beat,20,0,11,191,0.371727749,0.057591623,0.54973822,0,0.01011347
12299,98,22050,5,10,0,4,0,19,10,10,0,0,0,20,nowin,loss,beat,dlwin,0,10,15,220,0.422727273,0.054545455,0.55,1,0.28664435
12300,74,22051,10,10,0,0,0,20,10,10,0,0,0,20,nowin,push,push,push,10,0,20,209,0.411483254,0.04784689,0.531100478,0,0.017448125
12301,68,22051,3,5,11,0,0,19,10,10,0,0,0,20,nowin,loss,beat,dlwin,0,10,8,205,0.434146341,0.029268293,0.6,2,0.59483189
12302,19,22051,10,7,0,0,0,17,10,10,0,0,0,20,nowin,loss,beat,dlwin,0,10,17,237,0.41350211,0.054852321,0.628691983,2,0.597373826
12303,31,22051,4,10,0,3,0,17,10,10,0,0,0,20,nowin,loss,beat,dlwin,0,10,14,188,0.473404255,0.058510638,0.515957447,1,0.300306557
12304,110,22051,2,10,0,1,10,23,10,10,0,0,0,20,nowin,loss,bust,plbust,0,10,12,192,0.416666667,0.046875,0.557291667,0,0.025413132
12305,20,22051,9,10,0,0,0,19,10,10,0,0,0,20,nowin,loss,beat,dlwin,0,10,19,186,0.456989247,0.037634409,0.537634409,1,0.301097108
12306,140,22052,10,10,0,0,0,20,10,9,0,0,0,19,nowin,win,plwin,beat,20,0,20,210,0.466666667,0.023809524,0.604761905,3,0.915293335
12307,74,22052,3,5,8,10,0,26,10,9,0,0,0,19,nowin,loss,bust,plbust,0,10,8,209,0.411483254,0.04784689,0.531100478,0,0.017448125
12308,95,22052,10,10,0,0,0,20,10,9,0,0,0,19,nowin,win,plwin,beat,20,0,20,218,0.412844037,0.04587156,0.559633028,0,0.024842385
12309,2,22052,7,10,0,0,0,17,10,9,0,0,0,19,nowin,loss,beat,dlwin,0,10,17,200,0.445,0.035,0.64,2,0.633962549
12310,84,22052,10,9,0,0,0,19,10,9,0,0,0,19,nowin,push,push,push,10,0,19,195,0.379487179,0.056410256,0.569230769,0,0.017209119
12311,103,22052,11,7,0,0,0,18,10,9,0,0,0,19,nowin,loss,beat,dlwin,0,10,18,203,0.379310345,0.064039409,0.551724138,0,0.012869209
12312,75,22053,3,3,4,10,0,20,8,10,0,0,0,18,nowin,win,plwin,beat,20,0,6,191,0.418848168,0.052356021,0.570680628,0,0.029344702
12313,36,22053,8,6,0,3,0,17,8,10,0,0,0,18,nowin,loss,beat,dlwin,0,10,14,229,0.445414847,0.056768559,0.655021834,2,0.645370571
12314,112,22053,2,6,6,10,0,24,8,10,0,0,0,18,nowin,loss,bust,plbust,0,10,8,203,0.448275862,0.054187192,0.600985222,3,0.889576933
12315,40,22053,10,4,0,4,0,18,8,10,0,0,0,18,nowin,push,push,push,10,0,14,196,0.367346939,0.030612245,0.617346939,0,0.025358183
12316,141,22053,8,10,0,0,0,18,8,10,0,0,0,18,nowin,push,push,push,10,0,18,202,0.420792079,0.074257426,0.564356436,0,0.028377851
12317,80,22053,7,8,0,10,0,25,8,10,0,0,0,18,nowin,loss,bust,plbust,0,10,15,186,0.419354839,0.059139785,0.623655914,2,0.59892924
12318,39,22054,9,9,0,0,0,18,4,6,11,0,0,21,nowin,loss,beat,dlwin,0,10,18,191,0.429319372,0.062827225,0.57591623,0,0.033760763
12319,70,22054,5,4,7,0,0,16,4,6,11,0,0,21,nowin,loss,beat,dlwin,0,10,9,228,0.385964912,0.039473684,0.557017544,0,0.016157125
12320,126,22054,10,11,0,0,0,21,4,6,11,0,0,21,win,push,push,push,10,0,21,188,0.457446809,0.074468085,0.60106383,3,0.900633203
12321,73,22054,10,10,0,0,0,20,4,6,11,0,0,21,nowin,loss,beat,dlwin,0,10,20,181,0.375690608,0.011049724,0.596685083,0,0.022795773
12322,1,22054,3,8,10,0,0,21,4,6,11,0,0,21,nowin,push,push,push,10,0,11,197,0.406091371,0.025380711,0.649746193,2,0.606186955
12323,58,22054,9,11,0,0,0,20,4,6,11,0,0,21,nowin,loss,beat,dlwin,0,10,20,195,0.430769231,0.041025641,0.584615385,2,0.580497586
12324,131,22055,11,10,0,0,0,21,10,10,0,0,0,20,win,win,plwin,beat,25,0,21,217,0.410138249,0.069124424,0.543778802,0,0.02015021
12325,137,22055,5,10,0,3,0,18,10,10,0,0,0,20,nowin,loss,beat,dlwin,0,10,15,194,0.417525773,0.046391753,0.536082474,1,0.276714602
12326,62,22055,2,9,10,0,0,21,10,10,0,0,0,20,nowin,win,plwin,beat,20,0,11,178,0.370786517,0.028089888,0.54494382,0,0.008657722
12327,128,22055,9,4,0,9,0,22,10,10,0,0,0,20,nowin,loss,bust,plbust,0,10,13,227,0.356828194,0.052863436,0.577092511,0,0.012352564
12328,48,22055,6,10,0,9,0,25,10,10,0,0,0,20,nowin,loss,bust,plbust,0,10,16,203,0.413793103,0.019704433,0.600985222,2,0.577280801
12329,33,22055,7,5,0,10,0,22,10,10,0,0,0,20,nowin,loss,bust,plbust,0,10,12,192,0.4375,0.057291667,0.625,2,0.616208916
12330,125,22056,10,6,0,0,0,16,6,10,8,0,0,24,nowin,win,dlbust,bust,20,0,16,219,0.438356164,0.050228311,0.575342466,1,0.308411257
12331,70,22056,11,3,2,0,0,16,6,10,8,0,0,24,nowin,win,dlbust,bust,20,0,14,228,0.385964912,0.039473684,0.557017544,0,0.016157125
12332,116,22056,11,10,0,0,0,21,6,10,8,0,0,24,win,win,dlbust,bust,25,0,21,195,0.425641026,0.056410256,0.538461538,1,0.28273747
12333,129,22056,3,2,10,0,0,15,6,10,8,0,0,24,nowin,win,dlbust,bust,20,0,5,201,0.422885572,0.064676617,0.55721393,0,0.027255383
12334,126,22056,5,10,0,0,0,15,6,10,8,0,0,24,nowin,win,dlbust,bust,20,0,15,188,0.457446809,0.074468085,0.60106383,3,0.900633203
12335,40,22056,2,10,0,0,0,12,6,10,8,0,0,24,nowin,win,dlbust,bust,20,0,12,196,0.367346939,0.030612245,0.617346939,0,0.025358183
12336,41,22057,3,2,7,10,0,22,2,10,1,10,0,23,nowin,loss,bust,plbust,0,10,5,192,0.364583333,0.036458333,0.520833333,0,0.00089702
12337,76,22057,2,10,0,1,0,13,2,10,1,10,0,23,nowin,win,dlbust,bust,20,0,12,189,0.534391534,0.079365079,0.608465608,3,1
12338,27,22057,6,6,0,10,0,22,2,10,1,10,0,23,nowin,loss,bust,plbust,0,10,12,178,0.370786517,0.016853933,0.573033708,0,0.015536309
12339,12,22057,5,8,0,0,0,13,2,10,1,10,0,23,nowin,win,dlbust,bust,20,0,13,189,0.470899471,0.015873016,0.613756614,3,0.929171178
12340,53,22057,9,11,0,0,0,20,2,10,1,10,0,23,nowin,win,dlbust,bust,20,0,20,250,0.372,0.064,0.564,0,0.013687345
12341,111,22057,8,6,0,0,0,14,2,10,1,10,0,23,nowin,win,dlbust,bust,20,0,14,180,0.433333333,0.055555556,0.611111111,2,0.602264492
12342,42,22058,4,2,10,10,0,26,10,2,10,0,0,22,nowin,loss,bust,plbust,0,10,6,212,0.443396226,0.051886792,0.570754717,1,0.309181312
12343,139,22058,5,10,0,10,0,25,10,2,10,0,0,22,nowin,loss,bust,plbust,0,10,15,192,0.380208333,0.036458333,0.59375,0,0.023429169
12344,28,22058,10,4,0,5,0,19,10,2,10,0,0,22,nowin,win,dlbust,bust,20,0,14,199,0.422110553,0.045226131,0.542713568,1,0.282706618
12345,141,22058,10,10,0,0,0,20,10,2,10,0,0,22,nowin,win,dlbust,bust,20,0,20,202,0.420792079,0.074257426,0.564356436,0,0.028377851
12346,117,22058,7,10,0,0,0,17,10,2,10,0,0,22,nowin,win,dlbust,bust,20,0,17,173,0.410404624,0.069364162,0.606936416,2,0.578610282
12347,13,22058,5,9,0,2,1,17,10,2,10,0,0,22,nowin,win,dlbust,bust,20,0,14,206,0.417475728,0.063106796,0.621359223,2,0.59555479
12348,79,22059,11,6,3,0,0,20,10,7,0,0,0,17,nowin,win,plwin,beat,20,0,17,211,0.436018957,0.028436019,0.672985782,2,0.650131054
12349,19,22059,9,5,0,9,0,23,10,7,0,0,0,17,nowin,loss,bust,plbust,0,10,14,237,0.41350211,0.054852321,0.628691983,2,0.597373826
12350,116,22059,9,8,0,0,0,17,10,7,0,0,0,17,nowin,push,push,push,10,0,17,195,0.425641026,0.056410256,0.538461538,1,0.28273747
12351,112,22059,2,8,8,0,0,18,10,7,0,0,0,17,nowin,win,plwin,beat,20,0,10,203,0.448275862,0.054187192,0.600985222,3,0.889576933
12352,62,22059,10,6,0,10,0,26,10,7,0,0,0,17,nowin,loss,bust,plbust,0,10,16,178,0.370786517,0.028089888,0.54494382,0,0.008657722
12353,11,22059,4,3,11,0,0,18,10,7,0,0,0,17,nowin,win,plwin,beat,20,0,7,236,0.457627119,0.016949153,0.588983051,3,0.889015813
12354,6,22060,3,10,0,10,0,23,9,5,10,0,0,24,nowin,loss,bust,plbust,0,10,13,191,0.439790576,0.047120419,0.581151832,1,0.31211505
12355,3,22060,10,10,0,0,0,20,9,5,10,0,0,24,nowin,win,dlbust,bust,20,0,20,190,0.431578947,0.026315789,0.542105263,1,0.288076384
12356,38,22060,10,10,0,0,0,20,9,5,10,0,0,24,nowin,win,dlbust,bust,20,0,20,202,0.361386139,0.03960396,0.564356436,0,0.010597953
12357,46,22060,1,4,10,6,0,21,9,5,10,0,0,24,nowin,win,dlbust,bust,20,0,5,186,0.403225806,0.048387097,0.591397849,0,0.029742194
12358,46,22060,3,6,8,0,0,17,9,5,10,0,0,24,nowin,win,dlbust,bust,20,0,9,186,0.403225806,0.048387097,0.591397849,0,0.029742194
12359,145,22060,10,9,0,0,0,19,9,5,10,0,0,24,nowin,win,dlbust,bust,20,0,19,188,0.441489362,0.031914894,0.622340426,2,0.617837093
12360,22,22061,5,10,0,1,10,26,10,10,0,0,0,20,nowin,loss,bust,plbust,0,10,15,187,0.481283422,0.042780749,0.577540107,3,0.906128176
12361,80,22061,7,10,0,0,0,17,10,10,0,0,0,20,nowin,loss,beat,dlwin,0,10,17,186,0.419354839,0.059139785,0.623655914,2,0.59892924
12362,5,22061,10,7,0,0,0,17,10,10,0,0,0,20,nowin,loss,beat,dlwin,0,10,17,203,0.42364532,0.02955665,0.596059113,2,0.582508076
12363,10,22061,1,2,9,7,0,19,10,10,0,0,0,20,nowin,loss,beat,dlwin,0,10,3,191,0.413612565,0.057591623,0.596858639,2,0.574087175
12364,77,22061,10,5,0,2,0,17,10,10,0,0,0,20,nowin,loss,beat,dlwin,0,10,15,200,0.455,0.04,0.62,3,0.916252116
12365,109,22061,4,2,3,10,0,19,10,10,0,0,0,20,nowin,loss,beat,dlwin,0,10,6,221,0.461538462,0.058823529,0.597285068,3,0.901830309
12366,130,22062,10,2,0,9,0,21,9,9,0,0,0,18,nowin,win,plwin,beat,20,0,12,219,0.410958904,0.03652968,0.566210046,0,0.025888739
12367,95,22062,4,3,11,0,0,18,9,9,0,0,0,18,nowin,push,push,push,10,0,7,218,0.412844037,0.04587156,0.559633028,0,0.024842385
12368,48,22062,6,6,0,6,0,18,9,9,0,0,0,18,nowin,push,push,push,10,0,12,203,0.413793103,0.019704433,0.600985222,2,0.577280801
12369,64,22062,11,4,2,0,0,17,9,9,0,0,0,18,nowin,loss,beat,dlwin,0,10,15,187,0.363636364,0.048128342,0.631016043,0,0.027594885
12370,129,22062,8,4,0,8,0,20,9,9,0,0,0,18,nowin,win,plwin,beat,20,0,12,201,0.422885572,0.064676617,0.55721393,0,0.027255383
12371,145,22062,3,6,2,10,0,21,9,9,0,0,0,18,nowin,win,plwin,beat,20,0,9,188,0.441489362,0.031914894,0.622340426,2,0.617837093
12372,130,22063,6,10,0,10,0,26,10,3,9,0,0,22,nowin,loss,bust,plbust,0,10,16,219,0.410958904,0.03652968,0.566210046,0,0.025888739
12373,14,22063,10,5,0,10,0,25,10,3,9,0,0,22,nowin,loss,bust,plbust,0,10,15,202,0.391089109,0.01980198,0.628712871,2,0.577264877
12374,131,22063,3,8,2,8,0,21,10,3,9,0,0,22,nowin,win,dlbust,bust,20,0,11,217,0.410138249,0.069124424,0.543778802,0,0.02015021
12375,67,22063,6,10,0,10,0,26,10,3,9,0,0,22,nowin,loss,bust,plbust,0,10,16,195,0.369230769,0.041025641,0.569230769,0,0.014139427
12376,83,22063,10,11,0,0,0,21,10,3,9,0,0,22,win,win,dlbust,bust,25,0,21,193,0.424870466,0.051813472,0.678756477,2,0.644360335
12377,56,22063,10,8,0,0,0,18,10,3,9,0,0,22,nowin,win,dlbust,bust,20,0,18,175,0.4,0.057142857,0.582857143,0,0.026685297
12378,12,22064,10,8,0,0,0,18,10,8,0,0,0,18,nowin,push,push,push,10,0,18,189,0.470899471,0.015873016,0.613756614,3,0.929171178
12379,80,22064,9,11,0,0,0,20,10,8,0,0,0,18,nowin,win,plwin,beat,20,0,20,186,0.419354839,0.059139785,0.623655914,2,0.59892924
12380,98,22064,3,2,10,10,0,25,10,8,0,0,0,18,nowin,loss,bust,plbust,0,10,5,220,0.422727273,0.054545455,0.55,1,0.28664435
12381,58,22064,7,10,0,0,0,17,10,8,0,0,0,18,nowin,loss,beat,dlwin,0,10,17,195,0.430769231,0.041025641,0.584615385,2,0.580497586
12382,90,22064,6,3,9,0,0,18,10,8,0,0,0,18,nowin,push,push,push,10,0,9,201,0.447761194,0.049751244,0.60199005,3,0.889945023
12383,147,22064,4,7,7,0,0,18,10,8,0,0,0,18,nowin,push,push,push,10,0,11,205,0.380487805,0.014634146,0.536585366,0,0.00951447
12384,145,22065,10,2,0,6,0,18,2,2,10,7,0,21,nowin,loss,beat,dlwin,0,10,12,188,0.441489362,0.031914894,0.622340426,2,0.617837093
12385,4,22065,10,4,0,0,0,14,2,2,10,7,0,21,nowin,loss,beat,dlwin,0,10,14,217,0.460829493,0.036866359,0.562211982,1,0.315432839
12386,139,22065,10,6,0,0,0,16,2,2,10,7,0,21,nowin,loss,beat,dlwin,0,10,16,192,0.380208333,0.036458333,0.59375,0,0.023429169
12387,26,22065,10,3,0,0,0,13,2,2,10,7,0,21,nowin,loss,beat,dlwin,0,10,13,203,0.463054187,0.0591133,0.541871921,1,0.306802864
12388,30,22065,10,8,0,0,0,18,2,2,10,7,0,21,nowin,loss,beat,dlwin,0,10,18,206,0.393203883,0.033980583,0.601941748,0,0.029324648
12389,78,22065,9,11,0,0,0,20,2,2,10,7,0,21,nowin,loss,beat,dlwin,0,10,20,201,0.517412935,0.034825871,0.587064677,3,0.95871112
12390,108,22066,5,10,0,0,0,15,4,1,8,9,0,22,nowin,win,dlbust,bust,20,0,15,193,0.435233161,0.056994819,0.559585492,1,0.298824795
12391,63,22066,7,3,5,0,0,15,4,1,8,9,0,22,nowin,win,dlbust,bust,20,0,10,216,0.467592593,0.037037037,0.62037037,3,0.931690496
12392,3,22066,10,3,0,0,0,13,4,1,8,9,0,22,nowin,win,dlbust,bust,20,0,13,190,0.431578947,0.026315789,0.542105263,1,0.288076384
12393,46,22066,11,4,6,0,0,21,4,1,8,9,0,22,nowin,win,dlbust,bust,20,0,15,186,0.403225806,0.048387097,0.591397849,0,0.029742194
12394,22,22066,10,2,0,0,0,12,4,1,8,9,0,22,nowin,win,dlbust,bust,20,0,12,187,0.481283422,0.042780749,0.577540107,3,0.906128176
12395,69,22066,10,10,0,0,0,20,4,1,8,9,0,22,nowin,win,dlbust,bust,20,0,20,194,0.365979381,0.030927835,0.515463918,0,0
12396,96,22067,11,9,0,0,0,20,6,10,4,0,0,20,nowin,push,push,push,10,0,20,190,0.468421053,0.057894737,0.584210526,3,0.897263354
12397,131,22067,4,10,0,0,0,14,6,10,4,0,0,20,nowin,loss,beat,dlwin,0,10,14,217,0.410138249,0.069124424,0.543778802,0,0.02015021
12398,135,22067,4,1,10,0,0,15,6,10,4,0,0,20,nowin,loss,beat,dlwin,0,10,5,179,0.391061453,0.067039106,0.586592179,0,0.024924662
12399,132,22067,2,9,10,0,0,21,6,10,4,0,0,20,nowin,win,plwin,beat,20,0,11,194,0.412371134,0.036082474,0.649484536,2,0.611633238
12400,21,22067,6,4,2,0,0,12,6,10,4,0,0,20,nowin,loss,beat,dlwin,0,10,10,214,0.359813084,0.042056075,0.626168224,0,0.025263474
12401,4,22067,10,3,0,0,0,13,6,10,4,0,0,20,nowin,loss,beat,dlwin,0,10,13,217,0.460829493,0.036866359,0.562211982,1,0.315432839
12402,57,22068,6,2,4,0,0,12,6,11,0,0,0,17,nowin,loss,beat,dlwin,0,10,8,192,0.46875,0.052083333,0.59375,3,0.907001181
12403,26,22068,5,10,0,0,0,15,6,11,0,0,0,17,nowin,loss,beat,dlwin,0,10,15,203,0.463054187,0.0591133,0.541871921,1,0.306802864
12404,128,22068,6,10,0,0,0,16,6,11,0,0,0,17,nowin,loss,beat,dlwin,0,10,16,227,0.356828194,0.052863436,0.577092511,0,0.012352564
12405,13,22068,8,10,0,0,0,18,6,11,0,0,0,17,nowin,win,plwin,beat,20,0,18,206,0.417475728,0.063106796,0.621359223,2,0.59555479
12406,76,22068,10,10,0,0,0,20,6,11,0,0,0,17,nowin,win,plwin,beat,20,0,20,189,0.534391534,0.079365079,0.608465608,3,1
12407,51,22068,4,9,0,0,0,13,6,11,0,0,0,17,nowin,loss,beat,dlwin,0,10,13,189,0.529100529,0.068783069,0.608465608,3,0.993665715
12408,116,22069,10,9,0,0,0,19,5,3,10,0,0,18,nowin,win,plwin,beat,20,0,19,195,0.425641026,0.056410256,0.538461538,1,0.28273747
12409,125,22069,10,9,0,0,0,19,5,3,10,0,0,18,nowin,win,plwin,beat,20,0,19,219,0.438356164,0.050228311,0.575342466,1,0.308411257
12410,60,22069,10,10,0,0,0,20,5,3,10,0,0,18,nowin,win,plwin,beat,20,0,20,227,0.418502203,0.022026432,0.559471366,0,0.026496258
12411,96,22069,10,10,0,0,0,20,5,3,10,0,0,18,nowin,win,plwin,beat,20,0,20,190,0.468421053,0.057894737,0.584210526,3,0.897263354
12412,95,22069,9,8,0,0,0,17,5,3,10,0,0,18,nowin,loss,beat,dlwin,0,10,17,218,0.412844037,0.04587156,0.559633028,0,0.024842385
12413,7,22069,10,11,0,0,0,21,5,3,10,0,0,18,win,win,plwin,beat,25,0,21,183,0.442622951,0.06010929,0.62295082,2,0.619303341
12414,58,22070,10,9,0,0,0,19,9,10,0,0,0,19,nowin,push,push,push,10,0,19,195,0.430769231,0.041025641,0.584615385,2,0.580497586
12415,70,22070,8,10,0,0,0,18,9,10,0,0,0,19,nowin,loss,beat,dlwin,0,10,18,228,0.385964912,0.039473684,0.557017544,0,0.016157125
12416,88,22070,3,10,0,6,0,19,9,10,0,0,0,19,nowin,push,push,push,10,0,13,206,0.466019417,0.033980583,0.54368932,1,0.309467903
12417,56,22070,10,3,0,3,10,26,9,10,0,0,0,19,nowin,loss,bust,plbust,0,10,13,175,0.4,0.057142857,0.582857143,0,0.026685297
12418,106,22070,11,10,0,0,0,21,9,10,0,0,0,19,win,win,plwin,beat,25,0,21,192,0.411458333,0.026041667,0.557291667,0,0.023854304
12419,5,22070,10,6,0,10,0,26,9,10,0,0,0,19,nowin,loss,bust,plbust,0,10,16,203,0.42364532,0.02955665,0.596059113,2,0.582508076
12420,19,22071,2,10,0,1,5,18,8,10,0,0,0,18,nowin,push,push,push,10,0,12,237,0.41350211,0.054852321,0.628691983,2,0.597373826
12421,142,22071,5,3,9,0,0,17,8,10,0,0,0,18,nowin,loss,beat,dlwin,0,10,8,211,0.417061611,0.047393365,0.526066351,1,0.271531309
12422,93,22071,6,10,0,4,0,20,8,10,0,0,0,18,nowin,win,plwin,beat,20,0,16,175,0.485714286,0.051428571,0.548571429,1,0.323648091
12423,8,22071,11,4,5,0,0,20,8,10,0,0,0,18,nowin,win,plwin,beat,20,0,15,181,0.44198895,0.071823204,0.596685083,2,0.599438402
12424,55,22071,11,6,2,0,0,19,8,10,0,0,0,18,nowin,win,plwin,beat,20,0,17,191,0.371727749,0.057591623,0.54973822,0,0.01011347
12425,109,22071,5,9,0,3,0,17,8,10,0,0,0,18,nowin,loss,beat,dlwin,0,10,14,221,0.461538462,0.058823529,0.597285068,3,0.901830309
12426,82,22072,7,5,0,6,0,18,9,7,8,0,0,24,nowin,win,dlbust,bust,20,0,12,225,0.408888889,0.075555556,0.577777778,0,0.028101874
12427,54,22072,10,10,0,0,0,20,9,7,8,0,0,24,nowin,win,dlbust,bust,20,0,20,185,0.437837838,0.032432432,0.556756757,1,0.29899854
12428,32,22072,5,2,7,1,4,19,9,7,8,0,0,24,nowin,win,dlbust,bust,20,0,7,189,0.391534392,0.037037037,0.53968254,0,0.013579086
12429,98,22072,10,10,0,0,0,20,9,7,8,0,0,24,nowin,win,dlbust,bust,20,0,20,220,0.422727273,0.054545455,0.55,1,0.28664435
12430,19,22072,10,2,0,9,0,21,9,7,8,0,0,24,nowin,win,dlbust,bust,20,0,12,237,0.41350211,0.054852321,0.628691983,2,0.597373826
12431,24,22072,7,6,0,1,2,16,9,7,8,0,0,24,nowin,win,dlbust,bust,20,0,13,207,0.458937198,0.048309179,0.570048309,1,0.318138014
12432,41,22073,10,6,0,8,0,24,11,3,4,0,0,18,nowin,loss,bust,plbust,0,10,16,192,0.364583333,0.036458333,0.520833333,0,0.00089702
12433,41,22073,10,6,0,9,0,25,11,3,4,0,0,18,nowin,loss,bust,plbust,0,10,16,192,0.364583333,0.036458333,0.520833333,0,0.00089702
12434,74,22073,11,7,0,0,0,18,11,3,4,0,0,18,nowin,push,push,push,10,0,18,209,0.411483254,0.04784689,0.531100478,0,0.017448125
12435,104,22073,10,7,0,0,0,17,11,3,4,0,0,18,nowin,loss,beat,dlwin,0,10,17,209,0.363636364,0.052631579,0.593301435,0,0.018359419
12436,66,22073,2,7,10,0,0,19,11,3,4,0,0,18,nowin,win,plwin,beat,20,0,9,217,0.456221198,0.064516129,0.626728111,3,0.924304367
12437,149,22073,4,5,10,0,0,19,11,3,4,0,0,18,nowin,win,plwin,beat,20,0,9,225,0.457777778,0.057777778,0.648888889,2,0.651965595
12438,32,22074,9,10,0,0,0,19,2,9,2,10,0,23,nowin,win,dlbust,bust,20,0,19,189,0.391534392,0.037037037,0.53968254,0,0.013579086
12439,139,22074,4,11,5,0,0,20,2,9,2,10,0,23,nowin,win,dlbust,bust,20,0,15,192,0.380208333,0.036458333,0.59375,0,0.023429169
12440,135,22074,8,5,0,0,0,13,2,9,2,10,0,23,nowin,win,dlbust,bust,20,0,13,179,0.391061453,0.067039106,0.586592179,0,0.024924662
12441,116,22074,11,10,0,0,0,21,2,9,2,10,0,23,win,win,dlbust,bust,25,0,21,195,0.425641026,0.056410256,0.538461538,1,0.28273747
12442,52,22074,5,10,0,0,0,15,2,9,2,10,0,23,nowin,win,dlbust,bust,20,0,15,217,0.414746544,0.02764977,0.599078341,2,0.576736024
12443,116,22074,9,10,0,0,0,19,2,9,2,10,0,23,nowin,win,dlbust,bust,20,0,19,195,0.425641026,0.056410256,0.538461538,1,0.28273747
12444,90,22075,3,2,10,0,0,15,6,2,5,3,10,26,nowin,win,dlbust,bust,20,0,5,201,0.447761194,0.049751244,0.60199005,3,0.889945023
12445,8,22075,10,11,0,0,0,21,6,2,5,3,10,26,win,win,dlbust,bust,25,0,21,181,0.44198895,0.071823204,0.596685083,2,0.599438402
12446,3,22075,3,5,5,0,0,13,6,2,5,3,10,26,nowin,win,dlbust,bust,20,0,8,190,0.431578947,0.026315789,0.542105263,1,0.288076384
12447,86,22075,10,6,0,0,0,16,6,2,5,3,10,26,nowin,win,dlbust,bust,20,0,16,196,0.454081633,0.040816327,0.591836735,3,0.887566443
12448,34,22075,3,3,2,10,0,18,6,2,5,3,10,26,nowin,win,dlbust,bust,20,0,6,202,0.5,0.079207921,0.618811881,3,0.968961434
12449,147,22075,7,10,0,0,0,17,6,2,5,3,10,26,nowin,win,dlbust,bust,20,0,17,205,0.380487805,0.014634146,0.536585366,0,0.00951447
12450,119,22076,6,10,0,10,0,26,1,3,10,10,0,24,nowin,loss,bust,plbust,0,10,16,190,0.405263158,0.068421053,0.515789474,0,0.011837158
12451,83,22076,2,7,10,0,0,19,1,3,10,10,0,24,nowin,win,dlbust,bust,20,0,9,193,0.424870466,0.051813472,0.678756477,2,0.644360335
12452,45,22076,5,3,10,0,0,18,1,3,10,10,0,24,nowin,win,dlbust,bust,20,0,8,196,0.428571429,0.051020408,0.612244898,2,0.598821767
12453,15,22076,6,3,6,7,0,22,1,3,10,10,0,24,nowin,loss,bust,plbust,0,10,9,212,0.410377358,0.051886792,0.561320755,0,0.024517408
12454,112,22076,2,8,9,0,0,19,1,3,10,10,0,24,nowin,win,dlbust,bust,20,0,10,203,0.448275862,0.054187192,0.600985222,3,0.889576933
12455,98,22076,10,7,0,0,0,17,1,3,10,10,0,24,nowin,win,dlbust,bust,20,0,17,220,0.422727273,0.054545455,0.55,1,0.28664435
12456,11,22077,11,9,0,0,0,20,4,10,10,0,0,24,nowin,win,dlbust,bust,20,0,20,236,0.457627119,0.016949153,0.588983051,3,0.889015813
12457,126,22077,2,10,0,0,0,12,4,10,10,0,0,24,nowin,win,dlbust,bust,20,0,12,188,0.457446809,0.074468085,0.60106383,3,0.900633203
12458,20,22077,6,6,0,0,0,12,4,10,10,0,0,24,nowin,win,dlbust,bust,20,0,12,186,0.456989247,0.037634409,0.537634409,1,0.301097108
12459,44,22077,7,2,3,0,0,12,4,10,10,0,0,24,nowin,win,dlbust,bust,20,0,9,219,0.433789954,0.050228311,0.534246575,1,0.285551035
12460,23,22077,10,10,0,0,0,20,4,10,10,0,0,24,nowin,win,dlbust,bust,20,0,20,208,0.427884615,0.0625,0.552884615,1,0.29114424
12461,128,22077,10,5,0,0,0,15,4,10,10,0,0,24,nowin,win,dlbust,bust,20,0,15,227,0.356828194,0.052863436,0.577092511,0,0.012352564
12462,79,22078,3,1,9,0,0,13,3,5,10,0,0,18,nowin,loss,beat,dlwin,0,10,4,211,0.436018957,0.028436019,0.672985782,2,0.650131054
12463,16,22078,11,1,5,0,0,17,3,5,10,0,0,18,nowin,loss,beat,dlwin,0,10,12,220,0.427272727,0.081818182,0.6,2,0.588660176
12464,126,22078,6,10,0,0,0,16,3,5,10,0,0,18,nowin,loss,beat,dlwin,0,10,16,188,0.457446809,0.074468085,0.60106383,3,0.900633203
12465,58,22078,9,3,0,4,0,16,3,5,10,0,0,18,nowin,loss,beat,dlwin,0,10,12,195,0.430769231,0.041025641,0.584615385,2,0.580497586
12466,15,22078,6,4,4,0,0,14,3,5,10,0,0,18,nowin,loss,beat,dlwin,0,10,10,212,0.410377358,0.051886792,0.561320755,0,0.024517408
12467,70,22078,1,1,10,10,0,22,3,5,10,0,0,18,nowin,loss,bust,plbust,0,10,2,228,0.385964912,0.039473684,0.557017544,0,0.016157125
12468,115,22079,3,6,4,4,0,17,11,8,0,0,0,19,nowin,loss,beat,dlwin,0,10,9,194,0.427835052,0.041237113,0.592783505,2,0.583863602
12469,135,22079,10,10,0,0,0,20,11,8,0,0,0,19,nowin,win,plwin,beat,20,0,20,179,0.391061453,0.067039106,0.586592179,0,0.024924662
12470,26,22079,8,9,0,0,0,17,11,8,0,0,0,19,nowin,loss,beat,dlwin,0,10,17,203,0.463054187,0.0591133,0.541871921,1,0.306802864
12471,78,22079,10,5,0,3,0,18,11,8,0,0,0,19,nowin,loss,beat,dlwin,0,10,15,201,0.517412935,0.034825871,0.587064677,3,0.95871112
12472,3,22079,2,5,6,7,0,20,11,8,0,0,0,19,nowin,win,plwin,beat,20,0,7,190,0.431578947,0.026315789,0.542105263,1,0.288076384
12473,125,22079,7,8,0,3,0,18,11,8,0,0,0,19,nowin,loss,beat,dlwin,0,10,15,219,0.438356164,0.050228311,0.575342466,1,0.308411257
12474,85,22080,3,3,10,0,0,16,5,3,11,0,0,19,nowin,loss,beat,dlwin,0,10,6,195,0.41025641,0.066666667,0.594871795,0,0.03269711
12475,135,22080,8,4,0,0,0,12,5,3,11,0,0,19,nowin,loss,beat,dlwin,0,10,12,179,0.391061453,0.067039106,0.586592179,0,0.024924662
12476,119,22080,10,3,0,0,0,13,5,3,11,0,0,19,nowin,loss,beat,dlwin,0,10,13,190,0.405263158,0.068421053,0.515789474,0,0.011837158
12477,20,22080,11,9,0,0,0,20,5,3,11,0,0,19,nowin,win,plwin,beat,20,0,20,186,0.456989247,0.037634409,0.537634409,1,0.301097108
12478,18,22080,10,11,0,0,0,21,5,3,11,0,0,19,win,win,plwin,beat,25,0,21,182,0.461538462,0.043956044,0.587912088,3,0.892649374
12479,55,22080,10,8,0,0,0,18,5,3,11,0,0,19,nowin,loss,beat,dlwin,0,10,18,191,0.371727749,0.057591623,0.54973822,0,0.01011347
12480,45,22081,10,10,0,0,0,20,10,3,10,0,0,23,nowin,win,dlbust,bust,20,0,20,196,0.428571429,0.051020408,0.612244898,2,0.598821767
12481,25,22081,9,3,0,6,0,18,10,3,10,0,0,23,nowin,win,dlbust,bust,20,0,12,190,0.463157895,0.063157895,0.536842105,1,0.304401563
12482,108,22081,11,7,0,0,0,18,10,3,10,0,0,23,nowin,win,dlbust,bust,20,0,18,193,0.435233161,0.056994819,0.559585492,1,0.298824795
12483,28,22081,10,6,0,10,0,26,10,3,10,0,0,23,nowin,loss,bust,plbust,0,10,16,199,0.422110553,0.045226131,0.542713568,1,0.282706618
12484,114,22081,4,3,10,0,0,17,10,3,10,0,0,23,nowin,win,dlbust,bust,20,0,7,198,0.47979798,0.025252525,0.611111111,3,0.937232995
12485,110,22081,9,10,0,0,0,19,10,3,10,0,0,23,nowin,win,dlbust,bust,20,0,19,192,0.416666667,0.046875,0.557291667,0,0.025413132
12486,86,22082,10,6,0,8,0,24,9,6,10,0,0,25,nowin,loss,bust,plbust,0,10,16,196,0.454081633,0.040816327,0.591836735,3,0.887566443
12487,42,22082,10,5,0,6,0,21,9,6,10,0,0,25,nowin,win,dlbust,bust,20,0,15,212,0.443396226,0.051886792,0.570754717,1,0.309181312
12488,100,22082,8,6,0,10,0,24,9,6,10,0,0,25,nowin,loss,bust,plbust,0,10,14,190,0.452631579,0.036842105,0.594736842,3,0.888671154
12489,62,22082,2,10,0,1,8,21,9,6,10,0,0,25,nowin,win,dlbust,bust,20,0,12,178,0.370786517,0.028089888,0.54494382,0,0.008657722
12490,27,22082,10,6,0,5,0,21,9,6,10,0,0,25,nowin,win,dlbust,bust,20,0,16,178,0.370786517,0.016853933,0.573033708,0,0.015536309
12491,20,22082,6,10,0,10,0,26,9,6,10,0,0,25,nowin,loss,bust,plbust,0,10,16,186,0.456989247,0.037634409,0.537634409,1,0.301097108
12492,29,22083,10,8,0,0,0,18,8,9,0,0,0,17,nowin,win,plwin,beat,20,0,18,189,0.44973545,0.058201058,0.544973545,1,0.300349439
12493,50,22083,4,10,0,9,0,23,8,9,0,0,0,17,nowin,loss,bust,plbust,0,10,14,202,0.405940594,0.04950495,0.54950495,0,0.020296079
12494,87,22083,6,2,9,0,0,17,8,9,0,0,0,17,nowin,push,push,push,10,0,8,202,0.405940594,0.054455446,0.628712871,2,0.590599801
12495,142,22083,7,7,0,4,0,18,8,9,0,0,0,17,nowin,win,plwin,beat,20,0,14,211,0.417061611,0.047393365,0.526066351,1,0.271531309
12496,79,22083,7,2,10,0,0,19,8,9,0,0,0,17,nowin,win,plwin,beat,20,0,9,211,0.436018957,0.028436019,0.672985782,2,0.650131054
12497,109,22083,10,10,0,0,0,20,8,9,0,0,0,17,nowin,win,plwin,beat,20,0,20,221,0.461538462,0.058823529,0.597285068,3,0.901830309
12498,101,22084,5,10,0,10,0,25,9,10,0,0,0,19,nowin,loss,bust,plbust,0,10,15,205,0.424390244,0.068292683,0.63902439,2,0.614740646
12499,12,22084,8,10,0,0,0,18,9,10,0,0,0,19,nowin,loss,beat,dlwin,0,10,18,189,0.470899471,0.015873016,0.613756614,3,0.929171178
12500,53,22084,2,7,3,7,0,19,9,10,0,0,0,19,nowin,push,push,push,10,0,9,250,0.372,0.064,0.564,0,0.013687345
12501,125,22084,11,10,0,0,0,21,9,10,0,0,0,19,win,win,plwin,beat,25,0,21,219,0.438356164,0.050228311,0.575342466,1,0.308411257
12502,39,22084,3,2,7,9,0,21,9,10,0,0,0,19,nowin,win,plwin,beat,20,0,5,191,0.429319372,0.062827225,0.57591623,0,0.033760763
12503,11,22084,6,10,0,10,0,26,9,10,0,0,0,19,nowin,loss,bust,plbust,0,10,16,236,0.457627119,0.016949153,0.588983051,3,0.889015813
12504,124,22085,10,6,0,10,0,26,10,7,0,0,0,17,nowin,loss,bust,plbust,0,10,16,202,0.47029703,0.064356436,0.584158416,3,0.899458193
12505,56,22085,10,9,0,0,0,19,10,7,0,0,0,17,nowin,win,plwin,beat,20,0,19,175,0.4,0.057142857,0.582857143,0,0.026685297
12506,72,22085,10,6,0,5,0,21,10,7,0,0,0,17,nowin,win,plwin,beat,20,0,16,185,0.394594595,0.032432432,0.508108108,0,0.006763115
12507,148,22085,2,5,10,0,0,17,10,7,0,0,0,17,nowin,push,push,push,10,0,7,204,0.401960784,0.078431373,0.593137255,0,0.029789521
12508,47,22085,7,9,0,3,0,19,10,7,0,0,0,17,nowin,win,plwin,beat,20,0,16,210,0.438095238,0.057142857,0.623809524,2,0.615868808
12509,4,22085,7,3,10,0,0,20,10,7,0,0,0,17,nowin,win,plwin,beat,20,0,10,217,0.460829493,0.036866359,0.562211982,1,0.315432839
12510,85,22086,10,7,0,0,0,17,1,1,10,3,10,25,nowin,win,dlbust,bust,20,0,17,195,0.41025641,0.066666667,0.594871795,0,0.03269711
12511,140,22086,10,10,0,0,0,20,1,1,10,3,10,25,nowin,win,dlbust,bust,20,0,20,210,0.466666667,0.023809524,0.604761905,3,0.915293335
12512,50,22086,8,3,8,0,0,19,1,1,10,3,10,25,nowin,win,dlbust,bust,20,0,11,202,0.405940594,0.04950495,0.54950495,0,0.020296079
12513,30,22086,10,10,0,0,0,20,1,1,10,3,10,25,nowin,win,dlbust,bust,20,0,20,206,0.393203883,0.033980583,0.601941748,0,0.029324648
12514,75,22086,5,9,0,3,0,17,1,1,10,3,10,25,nowin,win,dlbust,bust,20,0,14,191,0.418848168,0.052356021,0.570680628,0,0.029344702
12515,136,22086,8,8,0,10,0,26,1,1,10,3,10,25,nowin,loss,bust,plbust,0,10,16,194,0.396907216,0.025773196,0.597938144,0,0.029452644
12516,96,22087,9,10,0,0,0,19,3,6,10,0,0,19,nowin,push,push,push,10,0,19,190,0.468421053,0.057894737,0.584210526,3,0.897263354
12517,144,22087,10,4,0,0,0,14,3,6,10,0,0,19,nowin,loss,beat,dlwin,0,10,14,202,0.386138614,0.054455446,0.564356436,0,0.018006244
12518,22,22087,7,2,9,0,0,18,3,6,10,0,0,19,nowin,loss,beat,dlwin,0,10,9,187,0.481283422,0.042780749,0.577540107,3,0.906128176
12519,63,22087,2,9,10,0,0,21,3,6,10,0,0,19,nowin,win,plwin,beat,20,0,11,216,0.467592593,0.037037037,0.62037037,3,0.931690496
12520,62,22087,8,10,0,0,0,18,3,6,10,0,0,19,nowin,loss,beat,dlwin,0,10,18,178,0.370786517,0.028089888,0.54494382,0,0.008657722
12521,72,22087,10,6,0,0,0,16,3,6,10,0,0,19,nowin,loss,beat,dlwin,0,10,16,185,0.394594595,0.032432432,0.508108108,0,0.006763115
12522,137,22088,3,2,9,5,0,19,10,8,0,0,0,18,nowin,win,plwin,beat,20,0,5,194,0.417525773,0.046391753,0.536082474,1,0.276714602
12523,95,22088,3,5,7,7,0,22,10,8,0,0,0,18,nowin,loss,bust,plbust,0,10,8,218,0.412844037,0.04587156,0.559633028,0,0.024842385
12524,62,22088,10,6,0,6,0,22,10,8,0,0,0,18,nowin,loss,bust,plbust,0,10,16,178,0.370786517,0.028089888,0.54494382,0,0.008657722
12525,104,22088,9,7,0,6,0,22,10,8,0,0,0,18,nowin,loss,bust,plbust,0,10,16,209,0.363636364,0.052631579,0.593301435,0,0.018359419
12526,50,22088,10,2,0,10,0,22,10,8,0,0,0,18,nowin,loss,bust,plbust,0,10,12,202,0.405940594,0.04950495,0.54950495,0,0.020296079
12527,71,22088,2,10,0,1,10,23,10,8,0,0,0,18,nowin,loss,bust,plbust,0,10,12,193,0.352331606,0.046632124,0.585492228,0,0.013063661
12528,38,22089,11,10,0,0,0,21,10,5,8,0,0,23,win,win,dlbust,bust,25,0,21,202,0.361386139,0.03960396,0.564356436,0,0.010597953
12529,85,22089,10,10,0,0,0,20,10,5,8,0,0,23,nowin,win,dlbust,bust,20,0,20,195,0.41025641,0.066666667,0.594871795,0,0.03269711
12530,63,22089,6,10,0,10,0,26,10,5,8,0,0,23,nowin,loss,bust,plbust,0,10,16,216,0.467592593,0.037037037,0.62037037,3,0.931690496
12531,69,22089,8,6,0,1,6,21,10,5,8,0,0,23,nowin,win,dlbust,bust,20,0,14,194,0.365979381,0.030927835,0.515463918,0,0
12532,6,22089,4,2,4,5,5,20,10,5,8,0,0,23,nowin,win,dlbust,bust,20,0,6,191,0.439790576,0.047120419,0.581151832,1,0.31211505
12533,24,22089,7,8,0,9,0,24,10,5,8,0,0,23,nowin,loss,bust,plbust,0,10,15,207,0.458937198,0.048309179,0.570048309,1,0.318138014
12534,36,22090,10,11,0,0,0,21,7,11,0,0,0,18,win,win,plwin,beat,25,0,21,229,0.445414847,0.056768559,0.655021834,2,0.645370571
12535,30,22090,9,8,0,0,0,17,7,11,0,0,0,18,nowin,loss,beat,dlwin,0,10,17,206,0.393203883,0.033980583,0.601941748,0,0.029324648
12536,144,22090,10,5,0,6,0,21,7,11,0,0,0,18,nowin,win,plwin,beat,20,0,15,202,0.386138614,0.054455446,0.564356436,0,0.018006244
12537,36,22090,10,3,0,6,0,19,7,11,0,0,0,18,nowin,win,plwin,beat,20,0,13,229,0.445414847,0.056768559,0.655021834,2,0.645370571
12538,97,22090,2,2,5,7,4,20,7,11,0,0,0,18,nowin,win,plwin,beat,20,0,4,182,0.450549451,0.06043956,0.692307692,2,0.677372279
12539,91,22090,8,4,0,8,0,20,7,11,0,0,0,18,nowin,win,plwin,beat,20,0,12,194,0.417525773,0.046391753,0.515463918,1,0.266616552
12540,76,22091,2,5,10,0,0,17,3,6,10,0,0,19,nowin,loss,beat,dlwin,0,10,7,189,0.534391534,0.079365079,0.608465608,3,1
12541,29,22091,7,2,4,0,0,13,3,6,10,0,0,19,nowin,loss,beat,dlwin,0,10,9,189,0.44973545,0.058201058,0.544973545,1,0.300349439
12542,104,22091,7,8,0,0,0,15,3,6,10,0,0,19,nowin,loss,beat,dlwin,0,10,15,209,0.363636364,0.052631579,0.593301435,0,0.018359419
12543,103,22091,10,5,0,0,0,15,3,6,10,0,0,19,nowin,loss,beat,dlwin,0,10,15,203,0.379310345,0.064039409,0.551724138,0,0.012869209
12544,132,22091,10,9,0,0,0,19,3,6,10,0,0,19,nowin,push,push,push,10,0,19,194,0.412371134,0.036082474,0.649484536,2,0.611633238
12545,7,22091,10,3,0,0,0,13,3,6,10,0,0,19,nowin,loss,beat,dlwin,0,10,13,183,0.442622951,0.06010929,0.62295082,2,0.619303341
12546,121,22092,10,10,0,0,0,20,5,8,7,0,0,20,nowin,push,push,push,10,0,20,195,0.456410256,0.025641026,0.512820513,1,0.288597791
12547,126,22092,10,10,0,0,0,20,5,8,7,0,0,20,nowin,push,push,push,10,0,20,188,0.457446809,0.074468085,0.60106383,3,0.900633203
12548,85,22092,10,5,0,0,0,15,5,8,7,0,0,20,nowin,loss,beat,dlwin,0,10,15,195,0.41025641,0.066666667,0.594871795,0,0.03269711
12549,99,22092,10,11,0,0,0,21,5,8,7,0,0,20,win,win,plwin,beat,25,0,21,207,0.47826087,0.062801932,0.637681159,3,0.961418446
12550,124,22092,4,2,11,0,0,17,5,8,7,0,0,20,nowin,loss,beat,dlwin,0,10,6,202,0.47029703,0.064356436,0.584158416,3,0.899458193
12551,147,22092,10,3,0,0,0,13,5,8,7,0,0,20,nowin,loss,beat,dlwin,0,10,13,205,0.380487805,0.014634146,0.536585366,0,0.00951447
12552,18,22093,3,11,3,0,0,17,4,6,9,0,0,19,nowin,loss,beat,dlwin,0,10,14,182,0.461538462,0.043956044,0.587912088,3,0.892649374
12553,37,22093,10,2,0,0,0,12,4,6,9,0,0,19,nowin,loss,beat,dlwin,0,10,12,208,0.394230769,0.038461538,0.581730769,0,0.024682772
12554,54,22093,2,6,5,0,0,13,4,6,9,0,0,19,nowin,loss,beat,dlwin,0,10,8,185,0.437837838,0.032432432,0.556756757,1,0.29899854
12555,136,22093,3,8,7,0,0,18,4,6,9,0,0,19,nowin,loss,beat,dlwin,0,10,11,194,0.396907216,0.025773196,0.597938144,0,0.029452644
12556,101,22093,10,5,0,0,0,15,4,6,9,0,0,19,nowin,loss,beat,dlwin,0,10,15,205,0.424390244,0.068292683,0.63902439,2,0.614740646
12557,118,22093,2,8,4,0,0,14,4,6,9,0,0,19,nowin,loss,beat,dlwin,0,10,10,216,0.393518519,0.037037037,0.555555556,0,0.018059873
12558,108,22094,7,6,0,10,0,23,10,9,0,0,0,19,nowin,loss,bust,plbust,0,10,13,193,0.435233161,0.056994819,0.559585492,1,0.298824795
12559,131,22094,10,4,0,3,0,17,10,9,0,0,0,19,nowin,loss,beat,dlwin,0,10,14,217,0.410138249,0.069124424,0.543778802,0,0.02015021
12560,53,22094,2,10,0,10,0,22,10,9,0,0,0,19,nowin,loss,bust,plbust,0,10,12,250,0.372,0.064,0.564,0,0.013687345
12561,43,22094,4,7,6,0,0,17,10,9,0,0,0,19,nowin,loss,beat,dlwin,0,10,11,192,0.40625,0.041666667,0.609375,2,0.576671372
12562,148,22094,9,4,0,10,0,23,10,9,0,0,0,19,nowin,loss,bust,plbust,0,10,13,204,0.401960784,0.078431373,0.593137255,0,0.029789521
12563,70,22094,5,2,5,6,0,18,10,9,0,0,0,19,nowin,loss,beat,dlwin,0,10,7,228,0.385964912,0.039473684,0.557017544,0,0.016157125
12564,62,22095,6,9,0,2,0,17,9,5,4,0,0,18,nowin,loss,beat,dlwin,0,10,15,178,0.370786517,0.028089888,0.54494382,0,0.008657722
12565,29,22095,4,10,0,10,0,24,9,5,4,0,0,18,nowin,loss,bust,plbust,0,10,14,189,0.44973545,0.058201058,0.544973545,1,0.300349439
12566,124,22095,10,4,0,7,0,21,9,5,4,0,0,18,nowin,win,plwin,beat,20,0,14,202,0.47029703,0.064356436,0.584158416,3,0.899458193
12567,138,22095,10,8,0,0,0,18,9,5,4,0,0,18,nowin,push,push,push,10,0,18,190,0.442105263,0.047368421,0.610526316,2,0.609711065
12568,36,22095,3,4,10,0,0,17,9,5,4,0,0,18,nowin,loss,beat,dlwin,0,10,7,229,0.445414847,0.056768559,0.655021834,2,0.645370571
12569,17,22095,9,6,0,5,0,20,9,5,4,0,0,18,nowin,win,plwin,beat,20,0,15,171,0.444444444,0.070175439,0.555555556,1,0.302364894
12570,62,22096,10,10,0,0,0,20,4,3,2,8,0,17,nowin,win,plwin,beat,20,0,20,178,0.370786517,0.028089888,0.54494382,0,0.008657722
12571,3,22096,10,3,0,0,0,13,4,3,2,8,0,17,nowin,loss,beat,dlwin,0,10,13,190,0.431578947,0.026315789,0.542105263,1,0.288076384
12572,14,22096,9,11,0,0,0,20,4,3,2,8,0,17,nowin,win,plwin,beat,20,0,20,202,0.391089109,0.01980198,0.628712871,2,0.577264877
12573,7,22096,9,4,0,0,0,13,4,3,2,8,0,17,nowin,loss,beat,dlwin,0,10,13,183,0.442622951,0.06010929,0.62295082,2,0.619303341
12574,97,22096,10,10,0,0,0,20,4,3,2,8,0,17,nowin,win,plwin,beat,20,0,20,182,0.450549451,0.06043956,0.692307692,2,0.677372279
12575,34,22096,10,10,0,0,0,20,4,3,2,8,0,17,nowin,win,plwin,beat,20,0,20,202,0.5,0.079207921,0.618811881,3,0.968961434
12576,106,22097,2,6,8,0,0,16,2,10,2,10,0,24,nowin,win,dlbust,bust,20,0,8,192,0.411458333,0.026041667,0.557291667,0,0.023854304
12577,56,22097,10,3,0,0,0,13,2,10,2,10,0,24,nowin,win,dlbust,bust,20,0,13,175,0.4,0.057142857,0.582857143,0,0.026685297
12578,23,22097,10,10,0,0,0,20,2,10,2,10,0,24,nowin,win,dlbust,bust,20,0,20,208,0.427884615,0.0625,0.552884615,1,0.29114424
12579,73,22097,6,10,0,0,0,16,2,10,2,10,0,24,nowin,win,dlbust,bust,20,0,16,181,0.375690608,0.011049724,0.596685083,0,0.022795773
12580,128,22097,10,4,0,0,0,14,2,10,2,10,0,24,nowin,win,dlbust,bust,20,0,14,227,0.356828194,0.052863436,0.577092511,0,0.012352564
12581,100,22097,6,10,0,0,0,16,2,10,2,10,0,24,nowin,win,dlbust,bust,20,0,16,190,0.452631579,0.036842105,0.594736842,3,0.888671154
12582,8,22098,10,7,0,0,0,17,4,7,5,6,0,22,nowin,win,dlbust,bust,20,0,17,181,0.44198895,0.071823204,0.596685083,2,0.599438402
12583,138,22098,8,10,0,0,0,18,4,7,5,6,0,22,nowin,win,dlbust,bust,20,0,18,190,0.442105263,0.047368421,0.610526316,2,0.609711065
12584,125,22098,7,11,0,0,0,18,4,7,5,6,0,22,nowin,win,dlbust,bust,20,0,18,219,0.438356164,0.050228311,0.575342466,1,0.308411257
12585,36,22098,7,3,6,0,0,16,4,7,5,6,0,22,nowin,win,dlbust,bust,20,0,10,229,0.445414847,0.056768559,0.655021834,2,0.645370571
12586,83,22098,9,8,0,0,0,17,4,7,5,6,0,22,nowin,win,dlbust,bust,20,0,17,193,0.424870466,0.051813472,0.678756477,2,0.644360335
12587,98,22098,10,10,0,0,0,20,4,7,5,6,0,22,nowin,win,dlbust,bust,20,0,20,220,0.422727273,0.054545455,0.55,1,0.28664435
12588,12,22099,10,8,0,0,0,18,11,10,0,0,0,21,nowin,loss,beat,dlwin,0,10,18,189,0.470899471,0.015873016,0.613756614,3,0.929171178
12589,149,22099,3,10,0,10,0,23,11,10,0,0,0,21,nowin,loss,bust,plbust,0,10,13,225,0.457777778,0.057777778,0.648888889,2,0.651965595
12590,108,22099,3,10,0,9,0,22,11,10,0,0,0,21,nowin,loss,bust,plbust,0,10,13,193,0.435233161,0.056994819,0.559585492,1,0.298824795
12591,47,22099,6,9,0,9,0,24,11,10,0,0,0,21,nowin,loss,bust,plbust,0,10,15,210,0.438095238,0.057142857,0.623809524,2,0.615868808
12592,37,22099,10,10,0,0,0,20,11,10,0,0,0,21,nowin,loss,beat,dlwin,0,10,20,208,0.394230769,0.038461538,0.581730769,0,0.024682772
12593,1,22099,7,7,0,7,0,21,11,10,0,0,0,21,nowin,push,push,push,10,0,14,197,0.406091371,0.025380711,0.649746193,2,0.606186955
12594,29,22100,6,10,0,10,0,26,10,6,1,0,0,17,nowin,loss,bust,plbust,0,10,16,189,0.44973545,0.058201058,0.544973545,1,0.300349439
12595,80,22100,10,10,0,0,0,20,10,6,1,0,0,17,nowin,win,plwin,beat,20,0,20,186,0.419354839,0.059139785,0.623655914,2,0.59892924
12596,76,22100,10,6,0,10,0,26,10,6,1,0,0,17,nowin,loss,bust,plbust,0,10,16,189,0.534391534,0.079365079,0.608465608,3,1
12597,43,22100,11,10,0,0,0,21,10,6,1,0,0,17,win,win,plwin,beat,25,0,21,192,0.40625,0.041666667,0.609375,2,0.576671372
12598,74,22100,3,9,0,10,0,22,10,6,1,0,0,17,nowin,loss,bust,plbust,0,10,12,209,0.411483254,0.04784689,0.531100478,0,0.017448125
12599,96,22100,10,3,0,3,10,26,10,6,1,0,0,17,nowin,loss,bust,plbust,0,10,13,190,0.468421053,0.057894737,0.584210526,3,0.897263354
12600,86,22101,11,10,0,0,0,21,6,8,3,0,0,17,win,win,plwin,beat,25,0,21,196,0.454081633,0.040816327,0.591836735,3,0.887566443
12601,103,22101,10,3,0,0,0,13,6,8,3,0,0,17,nowin,loss,beat,dlwin,0,10,13,203,0.379310345,0.064039409,0.551724138,0,0.012869209
12602,52,22101,5,10,0,0,0,15,6,8,3,0,0,17,nowin,loss,beat,dlwin,0,10,15,217,0.414746544,0.02764977,0.599078341,2,0.576736024
12603,27,22101,4,10,0,0,0,14,6,8,3,0,0,17,nowin,loss,beat,dlwin,0,10,14,178,0.370786517,0.016853933,0.573033708,0,0.015536309
12604,97,22101,7,9,0,0,0,16,6,8,3,0,0,17,nowin,loss,beat,dlwin,0,10,16,182,0.450549451,0.06043956,0.692307692,2,0.677372279
12605,66,22101,11,10,0,0,0,21,6,8,3,0,0,17,win,win,plwin,beat,25,0,21,217,0.456221198,0.064516129,0.626728111,3,0.924304367
12606,114,22102,10,3,0,6,0,19,11,6,0,0,0,17,nowin,win,plwin,beat,20,0,13,198,0.47979798,0.025252525,0.611111111,3,0.937232995
12607,105,22102,4,5,6,8,0,23,11,6,0,0,0,17,nowin,loss,bust,plbust,0,10,9,198,0.414141414,0.070707071,0.590909091,0,0.032889494
12608,105,22102,10,10,0,0,0,20,11,6,0,0,0,17,nowin,win,plwin,beat,20,0,20,198,0.414141414,0.070707071,0.590909091,0,0.032889494
12609,59,22102,6,9,0,8,0,23,11,6,0,0,0,17,nowin,loss,bust,plbust,0,10,15,228,0.429824561,0.048245614,0.543859649,1,0.287885446
12610,110,22102,4,4,3,8,0,19,11,6,0,0,0,17,nowin,win,plwin,beat,20,0,8,192,0.416666667,0.046875,0.557291667,0,0.025413132
12611,146,22102,8,2,10,0,0,20,11,6,0,0,0,17,nowin,win,plwin,beat,20,0,10,221,0.43438914,0.040723982,0.542986425,1,0.290190091
12612,129,22103,10,10,0,0,0,20,10,10,0,0,0,20,nowin,push,push,push,10,0,20,201,0.422885572,0.064676617,0.55721393,0,0.027255383
12613,140,22103,4,10,0,7,0,21,10,10,0,0,0,20,nowin,win,plwin,beat,20,0,14,210,0.466666667,0.023809524,0.604761905,3,0.915293335
12614,88,22103,1,4,10,2,0,17,10,10,0,0,0,20,nowin,loss,beat,dlwin,0,10,5,206,0.466019417,0.033980583,0.54368932,1,0.309467903
12615,95,22103,10,3,0,3,8,24,10,10,0,0,0,20,nowin,loss,bust,plbust,0,10,13,218,0.412844037,0.04587156,0.559633028,0,0.024842385
12616,8,22103,10,9,0,0,0,19,10,10,0,0,0,20,nowin,loss,beat,dlwin,0,10,19,181,0.44198895,0.071823204,0.596685083,2,0.599438402
12617,39,22103,7,7,0,9,0,23,10,10,0,0,0,20,nowin,loss,bust,plbust,0,10,14,191,0.429319372,0.062827225,0.57591623,0,0.033760763
12618,63,22104,10,6,0,9,0,25,10,8,0,0,0,18,nowin,loss,bust,plbust,0,10,16,216,0.467592593,0.037037037,0.62037037,3,0.931690496
12619,53,22104,10,11,0,0,0,21,10,8,0,0,0,18,win,win,plwin,beat,25,0,21,250,0.372,0.064,0.564,0,0.013687345
12620,22,22104,10,2,0,2,7,21,10,8,0,0,0,18,nowin,win,plwin,beat,20,0,12,187,0.481283422,0.042780749,0.577540107,3,0.906128176
12621,141,22104,7,7,0,10,0,24,10,8,0,0,0,18,nowin,loss,bust,plbust,0,10,14,202,0.420792079,0.074257426,0.564356436,0,0.028377851
12622,108,22104,4,6,7,0,0,17,10,8,0,0,0,18,nowin,loss,beat,dlwin,0,10,10,193,0.435233161,0.056994819,0.559585492,1,0.298824795
12623,130,22104,11,7,0,0,0,18,10,8,0,0,0,18,nowin,push,push,push,10,0,18,219,0.410958904,0.03652968,0.566210046,0,0.025888739
12624,24,22105,8,11,0,0,0,19,6,8,10,0,0,24,nowin,win,dlbust,bust,20,0,19,207,0.458937198,0.048309179,0.570048309,1,0.318138014
12625,18,22105,5,2,8,0,0,15,6,8,10,0,0,24,nowin,win,dlbust,bust,20,0,7,182,0.461538462,0.043956044,0.587912088,3,0.892649374
12626,47,22105,10,11,0,0,0,21,6,8,10,0,0,24,win,win,dlbust,bust,25,0,21,210,0.438095238,0.057142857,0.623809524,2,0.615868808
12627,141,22105,11,7,0,0,0,18,6,8,10,0,0,24,nowin,win,dlbust,bust,20,0,18,202,0.420792079,0.074257426,0.564356436,0,0.028377851
12628,22,22105,8,10,0,0,0,18,6,8,10,0,0,24,nowin,win,dlbust,bust,20,0,18,187,0.481283422,0.042780749,0.577540107,3,0.906128176
12629,48,22105,10,9,0,0,0,19,6,8,10,0,0,24,nowin,win,dlbust,bust,20,0,19,203,0.413793103,0.019704433,0.600985222,2,0.577280801
12630,83,22106,7,10,0,0,0,17,11,4,1,10,0,26,nowin,win,dlbust,bust,20,0,17,193,0.424870466,0.051813472,0.678756477,2,0.644360335
12631,24,22106,10,8,0,0,0,18,11,4,1,10,0,26,nowin,win,dlbust,bust,20,0,18,207,0.458937198,0.048309179,0.570048309,1,0.318138014
12632,98,22106,2,8,7,0,0,17,11,4,1,10,0,26,nowin,win,dlbust,bust,20,0,10,220,0.422727273,0.054545455,0.55,1,0.28664435
12633,70,22106,3,3,10,10,0,26,11,4,1,10,0,26,nowin,loss,bust,plbust,0,10,6,228,0.385964912,0.039473684,0.557017544,0,0.016157125
12634,16,22106,11,1,6,0,0,18,11,4,1,10,0,26,nowin,win,dlbust,bust,20,0,12,220,0.427272727,0.081818182,0.6,2,0.588660176
12635,150,22106,4,3,10,0,0,17,11,4,1,10,0,26,nowin,win,dlbust,bust,20,0,7,192,0.401041667,0.036458333,0.567708333,0,0.023287458
12636,11,22107,10,9,0,0,0,19,9,10,0,0,0,19,nowin,push,push,push,10,0,19,236,0.457627119,0.016949153,0.588983051,3,0.889015813
12637,148,22107,8,10,0,0,0,18,9,10,0,0,0,19,nowin,loss,beat,dlwin,0,10,18,204,0.401960784,0.078431373,0.593137255,0,0.029789521
12638,19,22107,10,10,0,0,0,20,9,10,0,0,0,19,nowin,win,plwin,beat,20,0,20,237,0.41350211,0.054852321,0.628691983,2,0.597373826
12639,128,22107,7,2,10,0,0,19,9,10,0,0,0,19,nowin,push,push,push,10,0,9,227,0.356828194,0.052863436,0.577092511,0,0.012352564
12640,145,22107,5,1,10,5,0,21,9,10,0,0,0,19,nowin,win,plwin,beat,20,0,6,188,0.441489362,0.031914894,0.622340426,2,0.617837093
12641,108,22107,7,4,7,0,0,18,9,10,0,0,0,19,nowin,loss,beat,dlwin,0,10,11,193,0.435233161,0.056994819,0.559585492,1,0.298824795
12642,115,22108,9,10,0,0,0,19,4,5,10,0,0,19,nowin,push,push,push,10,0,19,194,0.427835052,0.041237113,0.592783505,2,0.583863602
12643,42,22108,9,10,0,0,0,19,4,5,10,0,0,19,nowin,push,push,push,10,0,19,212,0.443396226,0.051886792,0.570754717,1,0.309181312
12644,43,22108,11,4,6,0,0,21,4,5,10,0,0,19,nowin,win,plwin,beat,20,0,15,192,0.40625,0.041666667,0.609375,2,0.576671372
12645,122,22108,6,8,0,0,0,14,4,5,10,0,0,19,nowin,loss,beat,dlwin,0,10,14,210,0.347619048,0.052380952,0.59047619,0,0.012873677
12646,109,22108,10,2,0,0,0,12,4,5,10,0,0,19,nowin,loss,beat,dlwin,0,10,12,221,0.461538462,0.058823529,0.597285068,3,0.901830309
12647,63,22108,7,10,0,0,0,17,4,5,10,0,0,19,nowin,loss,beat,dlwin,0,10,17,216,0.467592593,0.037037037,0.62037037,3,0.931690496
12648,68,22109,9,2,5,1,0,17,11,10,0,0,0,21,nowin,loss,beat,dlwin,0,10,11,205,0.434146341,0.029268293,0.6,2,0.59483189
12649,56,22109,2,4,3,2,7,18,11,10,0,0,0,21,nowin,loss,beat,dlwin,0,10,6,175,0.4,0.057142857,0.582857143,0,0.026685297
12650,134,22109,8,10,0,0,0,18,11,10,0,0,0,21,nowin,loss,beat,dlwin,0,10,18,185,0.443243243,0.021621622,0.545945946,1,0.296939509
12651,124,22109,2,5,7,10,0,24,11,10,0,0,0,21,nowin,loss,bust,plbust,0,10,7,202,0.47029703,0.064356436,0.584158416,3,0.899458193
12652,69,22109,10,6,0,9,0,25,11,10,0,0,0,21,nowin,loss,bust,plbust,0,10,16,194,0.365979381,0.030927835,0.515463918,0,0
12653,149,22109,7,10,0,0,0,17,11,10,0,0,0,21,nowin,loss,beat,dlwin,0,10,17,225,0.457777778,0.057777778,0.648888889,2,0.651965595
12654,38,22110,10,3,0,0,0,13,2,2,10,4,0,18,nowin,loss,beat,dlwin,0,10,13,202,0.361386139,0.03960396,0.564356436,0,0.010597953
12655,77,22110,10,4,0,0,0,14,2,2,10,4,0,18,nowin,loss,beat,dlwin,0,10,14,200,0.455,0.04,0.62,3,0.916252116
12656,141,22110,10,7,0,0,0,17,2,2,10,4,0,18,nowin,loss,beat,dlwin,0,10,17,202,0.420792079,0.074257426,0.564356436,0,0.028377851
12657,13,22110,9,9,0,0,0,18,2,2,10,4,0,18,nowin,push,push,push,10,0,18,206,0.417475728,0.063106796,0.621359223,2,0.59555479
12658,56,22110,4,6,3,0,0,13,2,2,10,4,0,18,nowin,loss,beat,dlwin,0,10,10,175,0.4,0.057142857,0.582857143,0,0.026685297
12659,79,22110,4,10,0,0,0,14,2,2,10,4,0,18,nowin,loss,beat,dlwin,0,10,14,211,0.436018957,0.028436019,0.672985782,2,0.650131054
12660,78,22111,2,4,7,5,0,18,10,10,0,0,0,20,nowin,loss,beat,dlwin,0,10,6,201,0.517412935,0.034825871,0.587064677,3,0.95871112
12661,6,22111,10,8,0,0,0,18,10,10,0,0,0,20,nowin,loss,beat,dlwin,0,10,18,191,0.439790576,0.047120419,0.581151832,1,0.31211505
12662,143,22111,11,10,0,0,0,21,10,10,0,0,0,20,win,win,plwin,beat,25,0,21,203,0.463054187,0.044334975,0.57635468,3,0.883143365
12663,128,22111,4,4,4,7,0,19,10,10,0,0,0,20,nowin,loss,beat,dlwin,0,10,8,227,0.356828194,0.052863436,0.577092511,0,0.012352564
12664,135,22111,8,6,0,6,0,20,10,10,0,0,0,20,nowin,push,push,push,10,0,14,179,0.391061453,0.067039106,0.586592179,0,0.024924662
12665,52,22111,7,7,0,10,0,24,10,10,0,0,0,20,nowin,loss,bust,plbust,0,10,14,217,0.414746544,0.02764977,0.599078341,2,0.576736024
12666,94,22112,10,6,0,0,0,16,2,7,8,0,0,17,nowin,loss,beat,dlwin,0,10,16,183,0.43715847,0.043715847,0.540983607,1,0.290866892
12667,115,22112,10,8,0,0,0,18,2,7,8,0,0,17,nowin,win,plwin,beat,20,0,18,194,0.427835052,0.041237113,0.592783505,2,0.583863602
12668,68,22112,10,10,0,0,0,20,2,7,8,0,0,17,nowin,win,plwin,beat,20,0,20,205,0.434146341,0.029268293,0.6,2,0.59483189
12669,61,22112,10,4,0,0,0,14,2,7,8,0,0,17,nowin,loss,beat,dlwin,0,10,14,194,0.427835052,0.077319588,0.603092784,2,0.591437139
12670,72,22112,10,4,0,0,0,14,2,7,8,0,0,17,nowin,loss,beat,dlwin,0,10,14,185,0.394594595,0.032432432,0.508108108,0,0.006763115
12671,80,22112,5,2,10,0,0,17,2,7,8,0,0,17,nowin,push,push,push,10,0,7,186,0.419354839,0.059139785,0.623655914,2,0.59892924
12672,118,22113,7,4,10,0,0,21,3,3,8,2,6,22,nowin,win,dlbust,bust,20,0,11,216,0.393518519,0.037037037,0.555555556,0,0.018059873
12673,69,22113,10,5,0,0,0,15,3,3,8,2,6,22,nowin,win,dlbust,bust,20,0,15,194,0.365979381,0.030927835,0.515463918,0,0
12674,100,22113,5,10,0,0,0,15,3,3,8,2,6,22,nowin,win,dlbust,bust,20,0,15,190,0.452631579,0.036842105,0.594736842,3,0.888671154
12675,78,22113,5,9,0,0,0,14,3,3,8,2,6,22,nowin,win,dlbust,bust,20,0,14,201,0.517412935,0.034825871,0.587064677,3,0.95871112
12676,50,22113,3,6,10,0,0,19,3,3,8,2,6,22,nowin,win,dlbust,bust,20,0,9,202,0.405940594,0.04950495,0.54950495,0,0.020296079
12677,9,22113,6,10,0,0,0,16,3,3,8,2,6,22,nowin,win,dlbust,bust,20,0,16,194,0.37628866,0.015463918,0.541237113,0,0.009396796
12678,95,22114,7,10,0,0,0,17,8,6,4,0,0,18,nowin,loss,beat,dlwin,0,10,17,218,0.412844037,0.04587156,0.559633028,0,0.024842385
12679,114,22114,9,6,0,10,0,25,8,6,4,0,0,18,nowin,loss,bust,plbust,0,10,15,198,0.47979798,0.025252525,0.611111111,3,0.937232995
12680,50,22114,11,7,0,0,0,18,8,6,4,0,0,18,nowin,push,push,push,10,0,18,202,0.405940594,0.04950495,0.54950495,0,0.020296079
12681,67,22114,2,1,9,10,0,22,8,6,4,0,0,18,nowin,loss,bust,plbust,0,10,3,195,0.369230769,0.041025641,0.569230769,0,0.014139427
12682,116,22114,1,4,8,10,0,23,8,6,4,0,0,18,nowin,loss,bust,plbust,0,10,5,195,0.425641026,0.056410256,0.538461538,1,0.28273747
12683,88,22114,10,4,0,9,0,23,8,6,4,0,0,18,nowin,loss,bust,plbust,0,10,14,206,0.466019417,0.033980583,0.54368932,1,0.309467903
12684,77,22115,10,10,0,0,0,20,7,6,10,0,0,23,nowin,win,dlbust,bust,20,0,20,200,0.455,0.04,0.62,3,0.916252116
12685,122,22115,5,10,0,7,0,22,7,6,10,0,0,23,nowin,loss,bust,plbust,0,10,15,210,0.347619048,0.052380952,0.59047619,0,0.012873677
12686,25,22115,9,11,0,0,0,20,7,6,10,0,0,23,nowin,win,dlbust,bust,20,0,20,190,0.463157895,0.063157895,0.536842105,1,0.304401563
12687,17,22115,6,10,0,9,0,25,7,6,10,0,0,23,nowin,loss,bust,plbust,0,10,16,171,0.444444444,0.070175439,0.555555556,1,0.302364894
12688,146,22115,10,11,0,0,0,21,7,6,10,0,0,23,win,win,dlbust,bust,25,0,21,221,0.43438914,0.040723982,0.542986425,1,0.290190091
12689,9,22115,9,8,0,0,0,17,7,6,10,0,0,23,nowin,win,dlbust,bust,20,0,17,194,0.37628866,0.015463918,0.541237113,0,0.009396796
12690,9,22116,10,7,0,0,0,17,10,10,0,0,0,20,nowin,loss,beat,dlwin,0,10,17,194,0.37628866,0.015463918,0.541237113,0,0.009396796
12691,141,22116,6,4,2,5,0,17,10,10,0,0,0,20,nowin,loss,beat,dlwin,0,10,10,202,0.420792079,0.074257426,0.564356436,0,0.028377851
12692,75,22116,10,11,0,0,0,21,10,10,0,0,0,20,win,win,plwin,beat,25,0,21,191,0.418848168,0.052356021,0.570680628,0,0.029344702
12693,149,22116,10,5,0,10,0,25,10,10,0,0,0,20,nowin,loss,bust,plbust,0,10,15,225,0.457777778,0.057777778,0.648888889,2,0.651965595
12694,71,22116,8,2,7,0,0,17,10,10,0,0,0,20,nowin,loss,beat,dlwin,0,10,10,193,0.352331606,0.046632124,0.585492228,0,0.013063661
12695,91,22116,6,7,0,10,0,23,10,10,0,0,0,20,nowin,loss,bust,plbust,0,10,13,194,0.417525773,0.046391753,0.515463918,1,0.266616552
12696,149,22117,2,3,8,9,0,22,10,7,0,0,0,17,nowin,loss,bust,plbust,0,10,5,225,0.457777778,0.057777778,0.648888889,2,0.651965595
12697,91,22117,10,9,0,0,0,19,10,7,0,0,0,17,nowin,win,plwin,beat,20,0,19,194,0.417525773,0.046391753,0.515463918,1,0.266616552
12698,79,22117,3,1,10,10,0,24,10,7,0,0,0,17,nowin,loss,bust,plbust,0,10,4,211,0.436018957,0.028436019,0.672985782,2,0.650131054
12699,55,22117,6,3,4,9,0,22,10,7,0,0,0,17,nowin,loss,bust,plbust,0,10,9,191,0.371727749,0.057591623,0.54973822,0,0.01011347
12700,22,22117,10,2,0,1,8,21,10,7,0,0,0,17,nowin,win,plwin,beat,20,0,12,187,0.481283422,0.042780749,0.577540107,3,0.906128176
12701,1,22117,10,9,0,0,0,19,10,7,0,0,0,17,nowin,win,plwin,beat,20,0,19,197,0.406091371,0.025380711,0.649746193,2,0.606186955
12702,66,22118,4,6,5,10,0,25,10,6,10,0,0,26,nowin,loss,bust,plbust,0,10,10,217,0.456221198,0.064516129,0.626728111,3,0.924304367
12703,70,22118,1,5,10,5,0,21,10,6,10,0,0,26,nowin,win,dlbust,bust,20,0,6,228,0.385964912,0.039473684,0.557017544,0,0.016157125
12704,15,22118,11,10,0,0,0,21,10,6,10,0,0,26,win,win,dlbust,bust,25,0,21,212,0.410377358,0.051886792,0.561320755,0,0.024517408
12705,145,22118,4,11,6,0,0,21,10,6,10,0,0,26,nowin,win,dlbust,bust,20,0,15,188,0.441489362,0.031914894,0.622340426,2,0.617837093
12706,48,22118,5,5,10,0,0,20,10,6,10,0,0,26,nowin,win,dlbust,bust,20,0,10,203,0.413793103,0.019704433,0.600985222,2,0.577280801
12707,70,22118,5,10,0,10,0,25,10,6,10,0,0,26,nowin,loss,bust,plbust,0,10,15,228,0.385964912,0.039473684,0.557017544,0,0.016157125
12708,66,22119,7,11,0,0,0,18,2,9,2,4,0,17,nowin,win,plwin,beat,20,0,18,217,0.456221198,0.064516129,0.626728111,3,0.924304367
12709,30,22119,10,4,0,0,0,14,2,9,2,4,0,17,nowin,loss,beat,dlwin,0,10,14,206,0.393203883,0.033980583,0.601941748,0,0.029324648
12710,79,22119,8,11,0,0,0,19,2,9,2,4,0,17,nowin,win,plwin,beat,20,0,19,211,0.436018957,0.028436019,0.672985782,2,0.650131054
12711,121,22119,9,10,0,0,0,19,2,9,2,4,0,17,nowin,win,plwin,beat,20,0,19,195,0.456410256,0.025641026,0.512820513,1,0.288597791
12712,77,22119,6,5,6,0,0,17,2,9,2,4,0,17,nowin,push,push,push,10,0,11,200,0.455,0.04,0.62,3,0.916252116
12713,60,22119,2,8,4,0,0,14,2,9,2,4,0,17,nowin,loss,beat,dlwin,0,10,10,227,0.418502203,0.022026432,0.559471366,0,0.026496258
12714,35,22120,10,8,0,0,0,18,9,10,0,0,0,19,nowin,loss,beat,dlwin,0,10,18,202,0.410891089,0.044554455,0.633663366,2,0.598681573
12715,19,22120,10,3,0,5,0,18,9,10,0,0,0,19,nowin,loss,beat,dlwin,0,10,13,237,0.41350211,0.054852321,0.628691983,2,0.597373826
12716,66,22120,8,10,0,0,0,18,9,10,0,0,0,19,nowin,loss,beat,dlwin,0,10,18,217,0.456221198,0.064516129,0.626728111,3,0.924304367
12717,125,22120,7,9,0,6,0,22,9,10,0,0,0,19,nowin,loss,bust,plbust,0,10,16,219,0.438356164,0.050228311,0.575342466,1,0.308411257
12718,27,22120,7,10,0,0,0,17,9,10,0,0,0,19,nowin,loss,beat,dlwin,0,10,17,178,0.370786517,0.016853933,0.573033708,0,0.015536309
12719,142,22120,7,7,0,2,10,26,9,10,0,0,0,19,nowin,loss,bust,plbust,0,10,14,211,0.417061611,0.047393365,0.526066351,1,0.271531309
12720,49,22121,10,8,0,0,0,18,4,10,10,0,0,24,nowin,win,dlbust,bust,20,0,18,207,0.396135266,0.053140097,0.594202899,0,0.028306925
12721,148,22121,11,10,0,0,0,21,4,10,10,0,0,24,win,win,dlbust,bust,25,0,21,204,0.401960784,0.078431373,0.593137255,0,0.029789521
12722,129,22121,10,5,0,0,0,15,4,10,10,0,0,24,nowin,win,dlbust,bust,20,0,15,201,0.422885572,0.064676617,0.55721393,0,0.027255383
12723,11,22121,7,6,0,0,0,13,4,10,10,0,0,24,nowin,win,dlbust,bust,20,0,13,236,0.457627119,0.016949153,0.588983051,3,0.889015813
12724,73,22121,3,11,3,0,0,17,4,10,10,0,0,24,nowin,win,dlbust,bust,20,0,14,181,0.375690608,0.011049724,0.596685083,0,0.022795773
12725,78,22121,6,8,0,0,0,14,4,10,10,0,0,24,nowin,win,dlbust,bust,20,0,14,201,0.517412935,0.034825871,0.587064677,3,0.95871112
12726,141,22122,6,3,9,0,0,18,9,11,0,0,0,20,nowin,loss,beat,dlwin,0,10,9,202,0.420792079,0.074257426,0.564356436,0,0.028377851
12727,129,22122,10,6,0,4,0,20,9,11,0,0,0,20,nowin,push,push,push,10,0,16,201,0.422885572,0.064676617,0.55721393,0,0.027255383
12728,148,22122,2,3,3,7,9,24,9,11,0,0,0,20,nowin,loss,bust,plbust,0,10,5,204,0.401960784,0.078431373,0.593137255,0,0.029789521
12729,7,22122,6,3,4,10,0,23,9,11,0,0,0,20,nowin,loss,bust,plbust,0,10,9,183,0.442622951,0.06010929,0.62295082,2,0.619303341
12730,143,22122,10,3,0,10,0,23,9,11,0,0,0,20,nowin,loss,bust,plbust,0,10,13,203,0.463054187,0.044334975,0.57635468,3,0.883143365
12731,42,22122,6,3,10,0,0,19,9,11,0,0,0,20,nowin,loss,beat,dlwin,0,10,9,212,0.443396226,0.051886792,0.570754717,1,0.309181312
12732,141,22123,4,4,4,9,0,21,10,10,0,0,0,20,nowin,win,plwin,beat,20,0,8,202,0.420792079,0.074257426,0.564356436,0,0.028377851
12733,114,22123,10,9,0,0,0,19,10,10,0,0,0,20,nowin,loss,beat,dlwin,0,10,19,198,0.47979798,0.025252525,0.611111111,3,0.937232995
12734,65,22123,10,11,0,0,0,21,10,10,0,0,0,20,win,win,plwin,beat,25,0,21,203,0.492610837,0.054187192,0.571428571,3,0.913702814
12735,73,22123,9,6,0,10,0,25,10,10,0,0,0,20,nowin,loss,bust,plbust,0,10,15,181,0.375690608,0.011049724,0.596685083,0,0.022795773
12736,137,22123,5,9,0,9,0,23,10,10,0,0,0,20,nowin,loss,bust,plbust,0,10,14,194,0.417525773,0.046391753,0.536082474,1,0.276714602
12737,112,22123,11,8,0,0,0,19,10,10,0,0,0,20,nowin,loss,beat,dlwin,0,10,19,203,0.448275862,0.054187192,0.600985222,3,0.889576933
12738,28,22124,2,4,11,0,0,17,5,10,6,0,0,21,nowin,loss,beat,dlwin,0,10,6,199,0.422110553,0.045226131,0.542713568,1,0.282706618
12739,64,22124,10,10,0,0,0,20,5,10,6,0,0,21,nowin,loss,beat,dlwin,0,10,20,187,0.363636364,0.048128342,0.631016043,0,0.027594885
12740,123,22124,3,2,5,10,0,20,5,10,6,0,0,21,nowin,loss,beat,dlwin,0,10,5,205,0.43902439,0.034146341,0.614634146,2,0.609962544
12741,42,22124,5,7,0,0,0,12,5,10,6,0,0,21,nowin,loss,beat,dlwin,0,10,12,212,0.443396226,0.051886792,0.570754717,1,0.309181312
12742,1,22124,1,1,10,0,0,12,5,10,6,0,0,21,nowin,loss,beat,dlwin,0,10,2,197,0.406091371,0.025380711,0.649746193,2,0.606186955
12743,109,22124,10,10,0,0,0,20,5,10,6,0,0,21,nowin,loss,beat,dlwin,0,10,20,221,0.461538462,0.058823529,0.597285068,3,0.901830309
12744,58,22125,3,10,0,3,9,25,7,10,0,0,0,17,nowin,loss,bust,plbust,0,10,13,195,0.430769231,0.041025641,0.584615385,2,0.580497586
12745,90,22125,9,10,0,0,0,19,7,10,0,0,0,17,nowin,win,plwin,beat,20,0,19,201,0.447761194,0.049751244,0.60199005,3,0.889945023
12746,113,22125,10,6,0,3,0,19,7,10,0,0,0,17,nowin,win,plwin,beat,20,0,16,199,0.407035176,0.055276382,0.668341709,2,0.620695264
12747,97,22125,5,3,10,0,0,18,7,10,0,0,0,17,nowin,win,plwin,beat,20,0,8,182,0.450549451,0.06043956,0.692307692,2,0.677372279
12748,149,22125,4,3,10,0,0,17,7,10,0,0,0,17,nowin,push,push,push,10,0,7,225,0.457777778,0.057777778,0.648888889,2,0.651965595
12749,61,22125,2,8,3,2,10,25,7,10,0,0,0,17,nowin,loss,bust,plbust,0,10,10,194,0.427835052,0.077319588,0.603092784,2,0.591437139
12750,30,22126,10,5,0,8,0,23,10,5,9,0,0,24,nowin,loss,bust,plbust,0,10,15,206,0.393203883,0.033980583,0.601941748,0,0.029324648
12751,96,22126,9,7,0,10,0,26,10,5,9,0,0,24,nowin,loss,bust,plbust,0,10,16,190,0.468421053,0.057894737,0.584210526,3,0.897263354
12752,141,22126,5,5,3,8,0,21,10,5,9,0,0,24,nowin,win,dlbust,bust,20,0,10,202,0.420792079,0.074257426,0.564356436,0,0.028377851
12753,89,22126,11,10,0,0,0,21,10,5,9,0,0,24,win,win,dlbust,bust,25,0,21,212,0.537735849,0.047169811,0.594339623,3,0.990167191
12754,93,22126,10,8,0,0,0,18,10,5,9,0,0,24,nowin,win,dlbust,bust,20,0,18,175,0.485714286,0.051428571,0.548571429,1,0.323648091
12755,20,22126,10,11,0,0,0,21,10,5,9,0,0,24,win,win,dlbust,bust,25,0,21,186,0.456989247,0.037634409,0.537634409,1,0.301097108
12756,105,22127,7,10,0,0,0,17,1,3,10,3,0,17,nowin,push,push,push,10,0,17,198,0.414141414,0.070707071,0.590909091,0,0.032889494
12757,13,22127,9,9,0,0,0,18,1,3,10,3,0,17,nowin,win,plwin,beat,20,0,18,206,0.417475728,0.063106796,0.621359223,2,0.59555479
12758,132,22127,9,2,2,5,0,18,1,3,10,3,0,17,nowin,win,plwin,beat,20,0,11,194,0.412371134,0.036082474,0.649484536,2,0.611633238
12759,150,22127,5,10,0,2,0,17,1,3,10,3,0,17,nowin,push,push,push,10,0,15,192,0.401041667,0.036458333,0.567708333,0,0.023287458
12760,142,22127,1,6,6,2,2,17,1,3,10,3,0,17,nowin,push,push,push,10,0,7,211,0.417061611,0.047393365,0.526066351,1,0.271531309
12761,44,22127,10,4,0,10,0,24,1,3,10,3,0,17,nowin,loss,bust,plbust,0,10,14,219,0.433789954,0.050228311,0.534246575,1,0.285551035
12762,118,22128,2,4,2,10,0,18,9,10,0,0,0,19,nowin,loss,beat,dlwin,0,10,6,216,0.393518519,0.037037037,0.555555556,0,0.018059873
12763,48,22128,7,6,0,3,2,18,9,10,0,0,0,19,nowin,loss,beat,dlwin,0,10,13,203,0.413793103,0.019704433,0.600985222,2,0.577280801
12764,129,22128,9,10,0,0,0,19,9,10,0,0,0,19,nowin,push,push,push,10,0,19,201,0.422885572,0.064676617,0.55721393,0,0.027255383
12765,123,22128,10,7,0,0,0,17,9,10,0,0,0,19,nowin,loss,beat,dlwin,0,10,17,205,0.43902439,0.034146341,0.614634146,2,0.609962544
12766,8,22128,2,10,0,1,1,14,9,10,0,0,0,19,nowin,loss,beat,dlwin,0,10,12,181,0.44198895,0.071823204,0.596685083,2,0.599438402
12767,122,22128,4,10,0,10,0,24,9,10,0,0,0,19,nowin,loss,bust,plbust,0,10,14,210,0.347619048,0.052380952,0.59047619,0,0.012873677
12768,80,22129,9,11,0,0,0,20,9,10,0,0,0,19,nowin,win,plwin,beat,20,0,20,186,0.419354839,0.059139785,0.623655914,2,0.59892924
12769,103,22129,10,10,0,0,0,20,9,10,0,0,0,19,nowin,win,plwin,beat,20,0,20,203,0.379310345,0.064039409,0.551724138,0,0.012869209
12770,8,22129,10,4,0,6,0,20,9,10,0,0,0,19,nowin,win,plwin,beat,20,0,14,181,0.44198895,0.071823204,0.596685083,2,0.599438402
12771,45,22129,10,3,0,2,10,25,9,10,0,0,0,19,nowin,loss,bust,plbust,0,10,13,196,0.428571429,0.051020408,0.612244898,2,0.598821767
12772,30,22129,9,8,0,0,0,17,9,10,0,0,0,19,nowin,loss,beat,dlwin,0,10,17,206,0.393203883,0.033980583,0.601941748,0,0.029324648
12773,105,22129,8,11,0,0,0,19,9,10,0,0,0,19,nowin,push,push,push,10,0,19,198,0.414141414,0.070707071,0.590909091,0,0.032889494
12774,76,22130,11,9,0,0,0,20,10,10,0,0,0,20,nowin,push,push,push,10,0,20,189,0.534391534,0.079365079,0.608465608,3,1
12775,30,22130,10,5,0,6,0,21,10,10,0,0,0,20,nowin,win,plwin,beat,20,0,15,206,0.393203883,0.033980583,0.601941748,0,0.029324648
12776,26,22130,10,8,0,0,0,18,10,10,0,0,0,20,nowin,loss,beat,dlwin,0,10,18,203,0.463054187,0.0591133,0.541871921,1,0.306802864
12777,115,22130,10,11,0,0,0,21,10,10,0,0,0,20,win,win,plwin,beat,25,0,21,194,0.427835052,0.041237113,0.592783505,2,0.583863602
12778,49,22130,5,4,2,1,2,14,10,10,0,0,0,20,nowin,loss,beat,dlwin,0,10,9,207,0.396135266,0.053140097,0.594202899,0,0.028306925
12779,87,22130,2,6,10,0,0,18,10,10,0,0,0,20,nowin,loss,beat,dlwin,0,10,8,202,0.405940594,0.054455446,0.628712871,2,0.590599801
12780,96,22131,7,7,0,0,0,14,6,7,9,0,0,22,nowin,win,dlbust,bust,20,0,14,190,0.468421053,0.057894737,0.584210526,3,0.897263354
12781,13,22131,11,2,4,0,0,17,6,7,9,0,0,22,nowin,win,dlbust,bust,20,0,13,206,0.417475728,0.063106796,0.621359223,2,0.59555479
12782,59,22131,10,8,0,0,0,18,6,7,9,0,0,22,nowin,win,dlbust,bust,20,0,18,228,0.429824561,0.048245614,0.543859649,1,0.287885446
12783,129,22131,7,10,0,0,0,17,6,7,9,0,0,22,nowin,win,dlbust,bust,20,0,17,201,0.422885572,0.064676617,0.55721393,0,0.027255383
12784,68,22131,1,1,10,0,0,12,6,7,9,0,0,22,nowin,win,dlbust,bust,20,0,2,205,0.434146341,0.029268293,0.6,2,0.59483189
12785,146,22131,3,5,5,0,0,13,6,7,9,0,0,22,nowin,win,dlbust,bust,20,0,8,221,0.43438914,0.040723982,0.542986425,1,0.290190091
12786,50,22132,2,9,3,10,0,24,11,7,0,0,0,18,nowin,loss,bust,plbust,0,10,11,202,0.405940594,0.04950495,0.54950495,0,0.020296079
12787,118,22132,8,10,0,0,0,18,11,7,0,0,0,18,nowin,push,push,push,10,0,18,216,0.393518519,0.037037037,0.555555556,0,0.018059873
12788,70,22132,10,5,0,10,0,25,11,7,0,0,0,18,nowin,loss,bust,plbust,0,10,15,228,0.385964912,0.039473684,0.557017544,0,0.016157125
12789,132,22132,4,2,7,5,0,18,11,7,0,0,0,18,nowin,push,push,push,10,0,6,194,0.412371134,0.036082474,0.649484536,2,0.611633238
12790,12,22132,10,10,0,0,0,20,11,7,0,0,0,18,nowin,win,plwin,beat,20,0,20,189,0.470899471,0.015873016,0.613756614,3,0.929171178
12791,99,22132,6,10,0,10,0,26,11,7,0,0,0,18,nowin,loss,bust,plbust,0,10,16,207,0.47826087,0.062801932,0.637681159,3,0.961418446
12792,76,22133,2,10,0,1,4,17,10,10,0,0,0,20,nowin,loss,beat,dlwin,0,10,12,189,0.534391534,0.079365079,0.608465608,3,1
12793,119,22133,3,7,5,4,0,19,10,10,0,0,0,20,nowin,loss,beat,dlwin,0,10,10,190,0.405263158,0.068421053,0.515789474,0,0.011837158
12794,59,22133,4,5,10,0,0,19,10,10,0,0,0,20,nowin,loss,beat,dlwin,0,10,9,228,0.429824561,0.048245614,0.543859649,1,0.287885446
12795,131,22133,10,10,0,0,0,20,10,10,0,0,0,20,nowin,push,push,push,10,0,20,217,0.410138249,0.069124424,0.543778802,0,0.02015021
12796,131,22133,6,9,0,6,0,21,10,10,0,0,0,20,nowin,win,plwin,beat,20,0,15,217,0.410138249,0.069124424,0.543778802,0,0.02015021
12797,150,22133,4,7,3,10,0,24,10,10,0,0,0,20,nowin,loss,bust,plbust,0,10,11,192,0.401041667,0.036458333,0.567708333,0,0.023287458
12798,69,22134,9,10,0,0,0,19,10,8,0,0,0,18,nowin,win,plwin,beat,20,0,19,194,0.365979381,0.030927835,0.515463918,0,0
12799,101,22134,4,1,10,4,0,19,10,8,0,0,0,18,nowin,win,plwin,beat,20,0,5,205,0.424390244,0.068292683,0.63902439,2,0.614740646
12800,1,22134,10,8,0,0,0,18,10,8,0,0,0,18,nowin,push,push,push,10,0,18,197,0.406091371,0.025380711,0.649746193,2,0.606186955
12801,92,22134,6,10,0,9,0,25,10,8,0,0,0,18,nowin,loss,bust,plbust,0,10,16,186,0.446236559,0.059139785,0.564516129,1,0.307826125
12802,57,22134,10,6,0,10,0,26,10,8,0,0,0,18,nowin,loss,bust,plbust,0,10,16,192,0.46875,0.052083333,0.59375,3,0.907001181
12803,29,22134,8,2,9,0,0,19,10,8,0,0,0,18,nowin,win,plwin,beat,20,0,10,189,0.44973545,0.058201058,0.544973545,1,0.300349439
12804,142,22135,10,9,0,0,0,19,3,10,10,0,0,23,nowin,win,dlbust,bust,20,0,19,211,0.417061611,0.047393365,0.526066351,1,0.271531309
12805,86,22135,9,10,0,0,0,19,3,10,10,0,0,23,nowin,win,dlbust,bust,20,0,19,196,0.454081633,0.040816327,0.591836735,3,0.887566443
12806,68,22135,10,7,0,0,0,17,3,10,10,0,0,23,nowin,win,dlbust,bust,20,0,17,205,0.434146341,0.029268293,0.6,2,0.59483189
12807,98,22135,8,8,0,0,0,16,3,10,10,0,0,23,nowin,win,dlbust,bust,20,0,16,220,0.422727273,0.054545455,0.55,1,0.28664435
12808,92,22135,10,10,0,0,0,20,3,10,10,0,0,23,nowin,win,dlbust,bust,20,0,20,186,0.446236559,0.059139785,0.564516129,1,0.307826125
12809,83,22135,9,3,0,2,0,14,3,10,10,0,0,23,nowin,win,dlbust,bust,20,0,12,193,0.424870466,0.051813472,0.678756477,2,0.644360335
12810,106,22136,3,7,10,0,0,20,2,8,5,3,0,18,nowin,win,plwin,beat,20,0,10,192,0.411458333,0.026041667,0.557291667,0,0.023854304
12811,67,22136,6,10,0,0,0,16,2,8,5,3,0,18,nowin,loss,beat,dlwin,0,10,16,195,0.369230769,0.041025641,0.569230769,0,0.014139427
12812,47,22136,5,1,10,0,0,16,2,8,5,3,0,18,nowin,loss,beat,dlwin,0,10,6,210,0.438095238,0.057142857,0.623809524,2,0.615868808
12813,85,22136,9,7,0,0,0,16,2,8,5,3,0,18,nowin,loss,beat,dlwin,0,10,16,195,0.41025641,0.066666667,0.594871795,0,0.03269711
12814,97,22136,4,9,0,0,0,13,2,8,5,3,0,18,nowin,loss,beat,dlwin,0,10,13,182,0.450549451,0.06043956,0.692307692,2,0.677372279
12815,31,22136,7,6,0,0,0,13,2,8,5,3,0,18,nowin,loss,beat,dlwin,0,10,13,188,0.473404255,0.058510638,0.515957447,1,0.300306557
12816,34,22137,2,7,4,0,0,13,2,3,9,10,0,24,nowin,win,dlbust,bust,20,0,9,202,0.5,0.079207921,0.618811881,3,0.968961434
12817,62,22137,7,4,10,0,0,21,2,3,9,10,0,24,nowin,win,dlbust,bust,20,0,11,178,0.370786517,0.028089888,0.54494382,0,0.008657722
12818,102,22137,6,8,0,0,0,14,2,3,9,10,0,24,nowin,win,dlbust,bust,20,0,14,192,0.338541667,0.046875,0.5625,0,0.003306118
12819,79,22137,10,2,0,7,0,19,2,3,9,10,0,24,nowin,win,dlbust,bust,20,0,12,211,0.436018957,0.028436019,0.672985782,2,0.650131054
12820,38,22137,4,1,10,0,0,15,2,3,9,10,0,24,nowin,win,dlbust,bust,20,0,5,202,0.361386139,0.03960396,0.564356436,0,0.010597953
12821,92,22137,10,8,0,0,0,18,2,3,9,10,0,24,nowin,win,dlbust,bust,20,0,18,186,0.446236559,0.059139785,0.564516129,1,0.307826125
12822,49,22138,8,8,0,0,0,16,2,10,4,10,0,26,nowin,win,dlbust,bust,20,0,16,207,0.396135266,0.053140097,0.594202899,0,0.028306925
12823,10,22138,5,10,0,0,0,15,2,10,4,10,0,26,nowin,win,dlbust,bust,20,0,15,191,0.413612565,0.057591623,0.596858639,2,0.574087175
12824,143,22138,10,7,0,0,0,17,2,10,4,10,0,26,nowin,win,dlbust,bust,20,0,17,203,0.463054187,0.044334975,0.57635468,3,0.883143365
12825,10,22138,4,10,0,0,0,14,2,10,4,10,0,26,nowin,win,dlbust,bust,20,0,14,191,0.413612565,0.057591623,0.596858639,2,0.574087175
12826,66,22138,11,2,6,0,0,19,2,10,4,10,0,26,nowin,win,dlbust,bust,20,0,13,217,0.456221198,0.064516129,0.626728111,3,0.924304367
12827,106,22138,7,4,7,0,0,18,2,10,4,10,0,26,nowin,win,dlbust,bust,20,0,11,192,0.411458333,0.026041667,0.557291667,0,0.023854304
12828,17,22139,2,11,5,0,0,18,8,10,0,0,0,18,nowin,push,push,push,10,0,13,171,0.444444444,0.070175439,0.555555556,1,0.302364894
12829,79,22139,7,2,2,4,5,20,8,10,0,0,0,18,nowin,win,plwin,beat,20,0,9,211,0.436018957,0.028436019,0.672985782,2,0.650131054
12830,125,22139,10,3,0,10,0,23,8,10,0,0,0,18,nowin,loss,bust,plbust,0,10,13,219,0.438356164,0.050228311,0.575342466,1,0.308411257
12831,49,22139,10,8,0,0,0,18,8,10,0,0,0,18,nowin,push,push,push,10,0,18,207,0.396135266,0.053140097,0.594202899,0,0.028306925
12832,17,22139,2,10,0,2,3,17,8,10,0,0,0,18,nowin,loss,beat,dlwin,0,10,12,171,0.444444444,0.070175439,0.555555556,1,0.302364894
12833,96,22139,8,10,0,0,0,18,8,10,0,0,0,18,nowin,push,push,push,10,0,18,190,0.468421053,0.057894737,0.584210526,3,0.897263354
12834,103,22140,10,3,0,0,0,13,3,3,10,3,0,19,nowin,loss,beat,dlwin,0,10,13,203,0.379310345,0.064039409,0.551724138,0,0.012869209
12835,9,22140,10,10,0,0,0,20,3,3,10,3,0,19,nowin,win,plwin,beat,20,0,20,194,0.37628866,0.015463918,0.541237113,0,0.009396796
12836,121,22140,10,6,0,0,0,16,3,3,10,3,0,19,nowin,loss,beat,dlwin,0,10,16,195,0.456410256,0.025641026,0.512820513,1,0.288597791
12837,41,22140,6,7,0,0,0,13,3,3,10,3,0,19,nowin,loss,beat,dlwin,0,10,13,192,0.364583333,0.036458333,0.520833333,0,0.00089702
12838,145,22140,11,10,0,0,0,21,3,3,10,3,0,19,win,win,plwin,beat,25,0,21,188,0.441489362,0.031914894,0.622340426,2,0.617837093
12839,35,22140,10,8,0,0,0,18,3,3,10,3,0,19,nowin,loss,beat,dlwin,0,10,18,202,0.410891089,0.044554455,0.633663366,2,0.598681573
12840,110,22141,10,10,0,0,0,20,10,3,1,10,0,24,nowin,win,dlbust,bust,20,0,20,192,0.416666667,0.046875,0.557291667,0,0.025413132
12841,150,22141,2,7,10,0,0,19,10,3,1,10,0,24,nowin,win,dlbust,bust,20,0,9,192,0.401041667,0.036458333,0.567708333,0,0.023287458
12842,75,22141,10,11,0,0,0,21,10,3,1,10,0,24,win,win,dlbust,bust,25,0,21,191,0.418848168,0.052356021,0.570680628,0,0.029344702
12843,61,22141,9,4,0,1,10,24,10,3,1,10,0,24,nowin,loss,bust,plbust,0,10,13,194,0.427835052,0.077319588,0.603092784,2,0.591437139
12844,122,22141,9,3,0,6,0,18,10,3,1,10,0,24,nowin,win,dlbust,bust,20,0,12,210,0.347619048,0.052380952,0.59047619,0,0.012873677
12845,21,22141,5,8,0,2,6,21,10,3,1,10,0,24,nowin,win,dlbust,bust,20,0,13,214,0.359813084,0.042056075,0.626168224,0,0.025263474
12846,124,22142,6,10,0,10,0,26,10,10,0,0,0,20,nowin,loss,bust,plbust,0,10,16,202,0.47029703,0.064356436,0.584158416,3,0.899458193
12847,110,22142,10,2,0,6,0,18,10,10,0,0,0,20,nowin,loss,beat,dlwin,0,10,12,192,0.416666667,0.046875,0.557291667,0,0.025413132
12848,54,22142,4,10,0,10,0,24,10,10,0,0,0,20,nowin,loss,bust,plbust,0,10,14,185,0.437837838,0.032432432,0.556756757,1,0.29899854
12849,113,22142,6,5,1,5,0,17,10,10,0,0,0,20,nowin,loss,beat,dlwin,0,10,11,199,0.407035176,0.055276382,0.668341709,2,0.620695264
12850,91,22142,4,8,0,10,0,22,10,10,0,0,0,20,nowin,loss,bust,plbust,0,10,12,194,0.417525773,0.046391753,0.515463918,1,0.266616552
12851,37,22142,7,4,3,1,1,16,10,10,0,0,0,20,nowin,loss,beat,dlwin,0,10,11,208,0.394230769,0.038461538,0.581730769,0,0.024682772
12852,47,22143,6,5,3,4,0,18,10,2,10,0,0,22,nowin,win,dlbust,bust,20,0,11,210,0.438095238,0.057142857,0.623809524,2,0.615868808
12853,56,22143,11,8,0,0,0,19,10,2,10,0,0,22,nowin,win,dlbust,bust,20,0,19,175,0.4,0.057142857,0.582857143,0,0.026685297
12854,67,22143,10,10,0,0,0,20,10,2,10,0,0,22,nowin,win,dlbust,bust,20,0,20,195,0.369230769,0.041025641,0.569230769,0,0.014139427
12855,63,22143,7,5,0,10,0,22,10,2,10,0,0,22,nowin,loss,bust,plbust,0,10,12,216,0.467592593,0.037037037,0.62037037,3,0.931690496
12856,135,22143,10,8,0,0,0,18,10,2,10,0,0,22,nowin,win,dlbust,bust,20,0,18,179,0.391061453,0.067039106,0.586592179,0,0.024924662
12857,132,22143,11,1,1,9,0,22,10,2,10,0,0,22,nowin,loss,bust,plbust,0,10,12,194,0.412371134,0.036082474,0.649484536,2,0.611633238
12858,72,22144,2,5,10,0,0,17,8,9,0,0,0,17,nowin,push,push,push,10,0,7,185,0.394594595,0.032432432,0.508108108,0,0.006763115
12859,99,22144,5,10,0,7,0,22,8,9,0,0,0,17,nowin,loss,bust,plbust,0,10,15,207,0.47826087,0.062801932,0.637681159,3,0.961418446
12860,122,22144,9,8,0,0,0,17,8,9,0,0,0,17,nowin,push,push,push,10,0,17,210,0.347619048,0.052380952,0.59047619,0,0.012873677
12861,79,22144,10,4,0,3,0,17,8,9,0,0,0,17,nowin,push,push,push,10,0,14,211,0.436018957,0.028436019,0.672985782,2,0.650131054
12862,118,22144,10,9,0,0,0,19,8,9,0,0,0,17,nowin,win,plwin,beat,20,0,19,216,0.393518519,0.037037037,0.555555556,0,0.018059873
12863,35,22144,3,10,0,5,0,18,8,9,0,0,0,17,nowin,win,plwin,beat,20,0,13,202,0.410891089,0.044554455,0.633663366,2,0.598681573
12864,84,22145,4,7,6,0,0,17,6,8,10,0,0,24,nowin,win,dlbust,bust,20,0,11,195,0.379487179,0.056410256,0.569230769,0,0.017209119
12865,123,22145,7,7,0,0,0,14,6,8,10,0,0,24,nowin,win,dlbust,bust,20,0,14,205,0.43902439,0.034146341,0.614634146,2,0.609962544
12866,4,22145,9,8,0,0,0,17,6,8,10,0,0,24,nowin,win,dlbust,bust,20,0,17,217,0.460829493,0.036866359,0.562211982,1,0.315432839
12867,85,22145,10,5,0,0,0,15,6,8,10,0,0,24,nowin,win,dlbust,bust,20,0,15,195,0.41025641,0.066666667,0.594871795,0,0.03269711
12868,58,22145,4,3,10,0,0,17,6,8,10,0,0,24,nowin,win,dlbust,bust,20,0,7,195,0.430769231,0.041025641,0.584615385,2,0.580497586
12869,61,22145,2,10,0,0,0,12,6,8,10,0,0,24,nowin,win,dlbust,bust,20,0,12,194,0.427835052,0.077319588,0.603092784,2,0.591437139
12870,72,22146,5,10,0,3,0,18,10,7,0,0,0,17,nowin,win,plwin,beat,20,0,15,185,0.394594595,0.032432432,0.508108108,0,0.006763115
12871,86,22146,9,4,0,1,6,20,10,7,0,0,0,17,nowin,win,plwin,beat,20,0,13,196,0.454081633,0.040816327,0.591836735,3,0.887566443
12872,93,22146,10,6,0,8,0,24,10,7,0,0,0,17,nowin,loss,bust,plbust,0,10,16,175,0.485714286,0.051428571,0.548571429,1,0.323648091
12873,62,22146,10,10,0,0,0,20,10,7,0,0,0,17,nowin,win,plwin,beat,20,0,20,178,0.370786517,0.028089888,0.54494382,0,0.008657722
12874,34,22146,10,11,0,0,0,21,10,7,0,0,0,17,win,win,plwin,beat,25,0,21,202,0.5,0.079207921,0.618811881,3,0.968961434
12875,73,22146,1,6,5,7,0,19,10,7,0,0,0,17,nowin,win,plwin,beat,20,0,7,181,0.375690608,0.011049724,0.596685083,0,0.022795773
12876,38,22147,10,7,0,0,0,17,2,10,6,0,0,18,nowin,loss,beat,dlwin,0,10,17,202,0.361386139,0.03960396,0.564356436,0,0.010597953
12877,139,22147,10,3,0,0,0,13,2,10,6,0,0,18,nowin,loss,beat,dlwin,0,10,13,192,0.380208333,0.036458333,0.59375,0,0.023429169
12878,81,22147,5,5,7,0,0,17,2,10,6,0,0,18,nowin,loss,beat,dlwin,0,10,10,182,0.395604396,0.043956044,0.60989011,2,0.567491261
12879,55,22147,7,5,0,6,0,18,2,10,6,0,0,18,nowin,push,push,push,10,0,12,191,0.371727749,0.057591623,0.54973822,0,0.01011347
12880,39,22147,4,10,0,0,0,14,2,10,6,0,0,18,nowin,loss,beat,dlwin,0,10,14,191,0.429319372,0.062827225,0.57591623,0,0.033760763
12881,78,22147,5,10,0,0,0,15,2,10,6,0,0,18,nowin,loss,beat,dlwin,0,10,15,201,0.517412935,0.034825871,0.587064677,3,0.95871112
12882,98,22148,5,10,0,1,2,18,8,2,10,0,0,20,nowin,loss,beat,dlwin,0,10,15,220,0.422727273,0.054545455,0.55,1,0.28664435
12883,59,22148,8,2,4,5,0,19,8,2,10,0,0,20,nowin,loss,beat,dlwin,0,10,10,228,0.429824561,0.048245614,0.543859649,1,0.287885446
12884,46,22148,10,5,0,10,0,25,8,2,10,0,0,20,nowin,loss,bust,plbust,0,10,15,186,0.403225806,0.048387097,0.591397849,0,0.029742194
12885,104,22148,4,3,3,3,10,23,8,2,10,0,0,20,nowin,loss,bust,plbust,0,10,7,209,0.363636364,0.052631579,0.593301435,0,0.018359419
12886,35,22148,10,10,0,0,0,20,8,2,10,0,0,20,nowin,push,push,push,10,0,20,202,0.410891089,0.044554455,0.633663366,2,0.598681573
12887,130,22148,10,11,0,0,0,21,8,2,10,0,0,20,win,win,plwin,beat,25,0,21,219,0.410958904,0.03652968,0.566210046,0,0.025888739
12888,90,22149,10,9,0,0,0,19,11,10,0,0,0,21,nowin,loss,beat,dlwin,0,10,19,201,0.447761194,0.049751244,0.60199005,3,0.889945023
12889,117,22149,8,4,0,10,0,22,11,10,0,0,0,21,nowin,loss,bust,plbust,0,10,12,173,0.410404624,0.069364162,0.606936416,2,0.578610282
12890,65,22149,3,7,2,2,9,23,11,10,0,0,0,21,nowin,loss,bust,plbust,0,10,10,203,0.492610837,0.054187192,0.571428571,3,0.913702814
12891,4,22149,3,11,1,10,0,25,11,10,0,0,0,21,nowin,loss,bust,plbust,0,10,14,217,0.460829493,0.036866359,0.562211982,1,0.315432839
12892,27,22149,11,10,0,0,0,21,11,10,0,0,0,21,win,push,push,push,10,0,21,178,0.370786517,0.016853933,0.573033708,0,0.015536309
12893,76,22149,8,10,0,0,0,18,11,10,0,0,0,21,nowin,loss,beat,dlwin,0,10,18,189,0.534391534,0.079365079,0.608465608,3,1
12894,103,22150,5,5,10,0,0,20,9,11,0,0,0,20,nowin,push,push,push,10,0,10,203,0.379310345,0.064039409,0.551724138,0,0.012869209
12895,68,22150,9,10,0,0,0,19,9,11,0,0,0,20,nowin,loss,beat,dlwin,0,10,19,205,0.434146341,0.029268293,0.6,2,0.59483189
12896,121,22150,10,5,0,6,0,21,9,11,0,0,0,20,nowin,win,plwin,beat,20,0,15,195,0.456410256,0.025641026,0.512820513,1,0.288597791
12897,90,22150,10,9,0,0,0,19,9,11,0,0,0,20,nowin,loss,beat,dlwin,0,10,19,201,0.447761194,0.049751244,0.60199005,3,0.889945023
12898,40,22150,2,7,4,2,5,20,9,11,0,0,0,20,nowin,push,push,push,10,0,9,196,0.367346939,0.030612245,0.617346939,0,0.025358183
12899,134,22150,3,6,6,2,0,17,9,11,0,0,0,20,nowin,loss,beat,dlwin,0,10,9,185,0.443243243,0.021621622,0.545945946,1,0.296939509
12900,84,22151,10,2,0,10,0,22,10,10,0,0,0,20,nowin,loss,bust,plbust,0,10,12,195,0.379487179,0.056410256,0.569230769,0,0.017209119
12901,14,22151,8,7,0,1,4,20,10,10,0,0,0,20,nowin,push,push,push,10,0,15,202,0.391089109,0.01980198,0.628712871,2,0.577264877
12902,30,22151,7,4,6,0,0,17,10,10,0,0,0,20,nowin,loss,beat,dlwin,0,10,11,206,0.393203883,0.033980583,0.601941748,0,0.029324648
12903,16,22151,10,3,0,8,0,21,10,10,0,0,0,20,nowin,win,plwin,beat,20,0,13,220,0.427272727,0.081818182,0.6,2,0.588660176
12904,45,22151,10,3,0,10,0,23,10,10,0,0,0,20,nowin,loss,bust,plbust,0,10,13,196,0.428571429,0.051020408,0.612244898,2,0.598821767
12905,52,22151,9,10,0,0,0,19,10,10,0,0,0,20,nowin,loss,beat,dlwin,0,10,19,217,0.414746544,0.02764977,0.599078341,2,0.576736024
12906,7,22152,6,7,0,6,0,19,8,10,0,0,0,18,nowin,win,plwin,beat,20,0,13,183,0.442622951,0.06010929,0.62295082,2,0.619303341
12907,13,22152,9,8,0,0,0,17,8,10,0,0,0,18,nowin,loss,beat,dlwin,0,10,17,206,0.417475728,0.063106796,0.621359223,2,0.59555479
12908,108,22152,8,10,0,0,0,18,8,10,0,0,0,18,nowin,push,push,push,10,0,18,193,0.435233161,0.056994819,0.559585492,1,0.298824795
12909,95,22152,2,10,0,3,8,23,8,10,0,0,0,18,nowin,loss,bust,plbust,0,10,12,218,0.412844037,0.04587156,0.559633028,0,0.024842385
12910,125,22152,7,10,0,0,0,17,8,10,0,0,0,18,nowin,loss,beat,dlwin,0,10,17,219,0.438356164,0.050228311,0.575342466,1,0.308411257
12911,87,22152,4,3,10,0,0,17,8,10,0,0,0,18,nowin,loss,beat,dlwin,0,10,7,202,0.405940594,0.054455446,0.628712871,2,0.590599801
12912,130,22153,10,4,0,10,0,24,11,10,0,0,0,21,nowin,loss,bust,plbust,0,10,14,219,0.410958904,0.03652968,0.566210046,0,0.025888739
12913,118,22153,10,3,0,2,6,21,11,10,0,0,0,21,nowin,push,push,push,10,0,13,216,0.393518519,0.037037037,0.555555556,0,0.018059873
12914,65,22153,10,10,0,0,0,20,11,10,0,0,0,21,nowin,loss,beat,dlwin,0,10,20,203,0.492610837,0.054187192,0.571428571,3,0.913702814
12915,141,22153,10,10,0,0,0,20,11,10,0,0,0,21,nowin,loss,beat,dlwin,0,10,20,202,0.420792079,0.074257426,0.564356436,0,0.028377851
12916,125,22153,9,3,0,4,3,19,11,10,0,0,0,21,nowin,loss,beat,dlwin,0,10,12,219,0.438356164,0.050228311,0.575342466,1,0.308411257
12917,111,22153,10,4,0,1,7,22,11,10,0,0,0,21,nowin,loss,bust,plbust,0,10,14,180,0.433333333,0.055555556,0.611111111,2,0.602264492
12918,81,22154,5,7,0,0,0,12,6,5,10,0,0,21,nowin,loss,beat,dlwin,0,10,12,182,0.395604396,0.043956044,0.60989011,2,0.567491261
12919,1,22154,2,7,10,0,0,19,6,5,10,0,0,21,nowin,loss,beat,dlwin,0,10,9,197,0.406091371,0.025380711,0.649746193,2,0.606186955
12920,23,22154,10,8,0,0,0,18,6,5,10,0,0,21,nowin,loss,beat,dlwin,0,10,18,208,0.427884615,0.0625,0.552884615,1,0.29114424
12921,39,22154,9,10,0,0,0,19,6,5,10,0,0,21,nowin,loss,beat,dlwin,0,10,19,191,0.429319372,0.062827225,0.57591623,0,0.033760763
12922,91,22154,7,9,0,0,0,16,6,5,10,0,0,21,nowin,loss,beat,dlwin,0,10,16,194,0.417525773,0.046391753,0.515463918,1,0.266616552
12923,123,22154,11,10,0,0,0,21,6,5,10,0,0,21,win,push,push,push,10,0,21,205,0.43902439,0.034146341,0.614634146,2,0.609962544
12924,130,22155,3,10,0,0,0,13,6,10,1,0,0,17,nowin,loss,beat,dlwin,0,10,13,219,0.410958904,0.03652968,0.566210046,0,0.025888739
12925,101,22155,9,5,0,0,0,14,6,10,1,0,0,17,nowin,loss,beat,dlwin,0,10,14,205,0.424390244,0.068292683,0.63902439,2,0.614740646
12926,138,22155,11,2,7,0,0,20,6,10,1,0,0,17,nowin,win,plwin,beat,20,0,13,190,0.442105263,0.047368421,0.610526316,2,0.609711065
12927,106,22155,10,3,0,0,0,13,6,10,1,0,0,17,nowin,loss,beat,dlwin,0,10,13,192,0.411458333,0.026041667,0.557291667,0,0.023854304
12928,56,22155,10,2,0,0,0,12,6,10,1,0,0,17,nowin,loss,beat,dlwin,0,10,12,175,0.4,0.057142857,0.582857143,0,0.026685297
12929,42,22155,10,9,0,0,0,19,6,10,1,0,0,17,nowin,win,plwin,beat,20,0,19,212,0.443396226,0.051886792,0.570754717,1,0.309181312
12930,4,22156,10,5,0,5,0,20,8,3,3,6,0,20,nowin,push,push,push,10,0,15,217,0.460829493,0.036866359,0.562211982,1,0.315432839
12931,116,22156,2,10,0,10,0,22,8,3,3,6,0,20,nowin,loss,bust,plbust,0,10,12,195,0.425641026,0.056410256,0.538461538,1,0.28273747
12932,150,22156,9,6,0,8,0,23,8,3,3,6,0,20,nowin,loss,bust,plbust,0,10,15,192,0.401041667,0.036458333,0.567708333,0,0.023287458
12933,53,22156,5,8,0,7,0,20,8,3,3,6,0,20,nowin,push,push,push,10,0,13,250,0.372,0.064,0.564,0,0.013687345
12934,131,22156,6,9,0,6,0,21,8,3,3,6,0,20,nowin,win,plwin,beat,20,0,15,217,0.410138249,0.069124424,0.543778802,0,0.02015021
12935,59,22156,5,2,10,0,0,17,8,3,3,6,0,20,nowin,loss,beat,dlwin,0,10,7,228,0.429824561,0.048245614,0.543859649,1,0.287885446
12936,39,22157,10,3,0,0,0,13,3,8,10,0,0,21,nowin,loss,beat,dlwin,0,10,13,191,0.429319372,0.062827225,0.57591623,0,0.033760763
12937,13,22157,5,10,0,0,0,15,3,8,10,0,0,21,nowin,loss,beat,dlwin,0,10,15,206,0.417475728,0.063106796,0.621359223,2,0.59555479
12938,83,22157,2,10,0,9,0,21,3,8,10,0,0,21,nowin,push,push,push,10,0,12,193,0.424870466,0.051813472,0.678756477,2,0.644360335
12939,38,22157,2,4,3,2,5,16,3,8,10,0,0,21,nowin,loss,beat,dlwin,0,10,6,202,0.361386139,0.03960396,0.564356436,0,0.010597953
12940,39,22157,8,3,10,0,0,21,3,8,10,0,0,21,nowin,push,push,push,10,0,11,191,0.429319372,0.062827225,0.57591623,0,0.033760763
12941,149,22157,4,6,6,0,0,16,3,8,10,0,0,21,nowin,loss,beat,dlwin,0,10,10,225,0.457777778,0.057777778,0.648888889,2,0.651965595
12942,71,22158,10,9,0,0,0,19,11,8,0,0,0,19,nowin,push,push,push,10,0,19,193,0.352331606,0.046632124,0.585492228,0,0.013063661
12943,92,22158,5,10,0,10,0,25,11,8,0,0,0,19,nowin,loss,bust,plbust,0,10,15,186,0.446236559,0.059139785,0.564516129,1,0.307826125
12944,30,22158,6,1,6,3,8,24,11,8,0,0,0,19,nowin,loss,bust,plbust,0,10,7,206,0.393203883,0.033980583,0.601941748,0,0.029324648
12945,54,22158,6,10,0,8,0,24,11,8,0,0,0,19,nowin,loss,bust,plbust,0,10,16,185,0.437837838,0.032432432,0.556756757,1,0.29899854
12946,88,22158,10,2,0,4,10,26,11,8,0,0,0,19,nowin,loss,bust,plbust,0,10,12,206,0.466019417,0.033980583,0.54368932,1,0.309467903
12947,112,22158,10,11,0,0,0,21,11,8,0,0,0,19,win,win,plwin,beat,25,0,21,203,0.448275862,0.054187192,0.600985222,3,0.889576933
12948,47,22159,9,10,0,0,0,19,10,8,0,0,0,18,nowin,win,plwin,beat,20,0,19,210,0.438095238,0.057142857,0.623809524,2,0.615868808
12949,138,22159,9,2,10,0,0,21,10,8,0,0,0,18,nowin,win,plwin,beat,20,0,11,190,0.442105263,0.047368421,0.610526316,2,0.609711065
12950,73,22159,10,10,0,0,0,20,10,8,0,0,0,18,nowin,win,plwin,beat,20,0,20,181,0.375690608,0.011049724,0.596685083,0,0.022795773
12951,49,22159,9,11,0,0,0,20,10,8,0,0,0,18,nowin,win,plwin,beat,20,0,20,207,0.396135266,0.053140097,0.594202899,0,0.028306925
12952,53,22159,10,2,0,3,8,23,10,8,0,0,0,18,nowin,loss,bust,plbust,0,10,12,250,0.372,0.064,0.564,0,0.013687345
12953,95,22159,6,9,0,10,0,25,10,8,0,0,0,18,nowin,loss,bust,plbust,0,10,15,218,0.412844037,0.04587156,0.559633028,0,0.024842385
12954,85,22160,6,6,0,1,10,23,10,9,0,0,0,19,nowin,loss,bust,plbust,0,10,12,195,0.41025641,0.066666667,0.594871795,0,0.03269711
12955,102,22160,10,8,0,0,0,18,10,9,0,0,0,19,nowin,loss,beat,dlwin,0,10,18,192,0.338541667,0.046875,0.5625,0,0.003306118
12956,115,22160,11,10,0,0,0,21,10,9,0,0,0,19,win,win,plwin,beat,25,0,21,194,0.427835052,0.041237113,0.592783505,2,0.583863602
12957,79,22160,7,5,0,2,10,24,10,9,0,0,0,19,nowin,loss,bust,plbust,0,10,12,211,0.436018957,0.028436019,0.672985782,2,0.650131054
12958,126,22160,3,3,6,10,0,22,10,9,0,0,0,19,nowin,loss,bust,plbust,0,10,6,188,0.457446809,0.074468085,0.60106383,3,0.900633203
12959,145,22160,10,10,0,0,0,20,10,9,0,0,0,19,nowin,win,plwin,beat,20,0,20,188,0.441489362,0.031914894,0.622340426,2,0.617837093
12960,46,22161,5,10,0,0,0,15,3,6,2,6,0,17,nowin,loss,beat,dlwin,0,10,15,186,0.403225806,0.048387097,0.591397849,0,0.029742194
12961,116,22161,8,8,0,0,0,16,3,6,2,6,0,17,nowin,loss,beat,dlwin,0,10,16,195,0.425641026,0.056410256,0.538461538,1,0.28273747
12962,117,22161,10,3,0,0,0,13,3,6,2,6,0,17,nowin,loss,beat,dlwin,0,10,13,173,0.410404624,0.069364162,0.606936416,2,0.578610282
12963,97,22161,10,9,0,0,0,19,3,6,2,6,0,17,nowin,win,plwin,beat,20,0,19,182,0.450549451,0.06043956,0.692307692,2,0.677372279
12964,45,22161,2,10,0,2,0,14,3,6,2,6,0,17,nowin,loss,beat,dlwin,0,10,12,196,0.428571429,0.051020408,0.612244898,2,0.598821767
12965,89,22161,3,4,6,0,0,13,3,6,2,6,0,17,nowin,loss,beat,dlwin,0,10,7,212,0.537735849,0.047169811,0.594339623,3,0.990167191
12966,105,22162,10,4,0,8,0,22,9,5,6,0,0,20,nowin,loss,bust,plbust,0,10,14,198,0.414141414,0.070707071,0.590909091,0,0.032889494
12967,108,22162,6,10,0,8,0,24,9,5,6,0,0,20,nowin,loss,bust,plbust,0,10,16,193,0.435233161,0.056994819,0.559585492,1,0.298824795
12968,137,22162,4,4,3,5,10,26,9,5,6,0,0,20,nowin,loss,bust,plbust,0,10,8,194,0.417525773,0.046391753,0.536082474,1,0.276714602
12969,129,22162,5,5,3,7,0,20,9,5,6,0,0,20,nowin,push,push,push,10,0,10,201,0.422885572,0.064676617,0.55721393,0,0.027255383
12970,26,22162,3,1,10,4,0,18,9,5,6,0,0,20,nowin,loss,beat,dlwin,0,10,4,203,0.463054187,0.0591133,0.541871921,1,0.306802864
12971,116,22162,5,7,0,2,10,24,9,5,6,0,0,20,nowin,loss,bust,plbust,0,10,12,195,0.425641026,0.056410256,0.538461538,1,0.28273747
12972,99,22163,10,7,0,0,0,17,11,7,0,0,0,18,nowin,loss,beat,dlwin,0,10,17,207,0.47826087,0.062801932,0.637681159,3,0.961418446
12973,37,22163,9,9,0,0,0,18,11,7,0,0,0,18,nowin,push,push,push,10,0,18,208,0.394230769,0.038461538,0.581730769,0,0.024682772
12974,93,22163,6,10,0,8,0,24,11,7,0,0,0,18,nowin,loss,bust,plbust,0,10,16,175,0.485714286,0.051428571,0.548571429,1,0.323648091
12975,32,22163,6,2,10,0,0,18,11,7,0,0,0,18,nowin,push,push,push,10,0,8,189,0.391534392,0.037037037,0.53968254,0,0.013579086
12976,8,22163,11,10,0,0,0,21,11,7,0,0,0,18,win,win,plwin,beat,25,0,21,181,0.44198895,0.071823204,0.596685083,2,0.599438402
12977,129,22163,5,6,1,5,0,17,11,7,0,0,0,18,nowin,loss,beat,dlwin,0,10,11,201,0.422885572,0.064676617,0.55721393,0,0.027255383
12978,85,22164,4,11,1,0,0,16,3,10,5,0,0,18,nowin,loss,beat,dlwin,0,10,15,195,0.41025641,0.066666667,0.594871795,0,0.03269711
12979,31,22164,6,10,0,0,0,16,3,10,5,0,0,18,nowin,loss,beat,dlwin,0,10,16,188,0.473404255,0.058510638,0.515957447,1,0.300306557
12980,100,22164,9,10,0,0,0,19,3,10,5,0,0,18,nowin,win,plwin,beat,20,0,19,190,0.452631579,0.036842105,0.594736842,3,0.888671154
12981,134,22164,7,9,0,0,0,16,3,10,5,0,0,18,nowin,loss,beat,dlwin,0,10,16,185,0.443243243,0.021621622,0.545945946,1,0.296939509
12982,93,22164,10,6,0,0,0,16,3,10,5,0,0,18,nowin,loss,beat,dlwin,0,10,16,175,0.485714286,0.051428571,0.548571429,1,0.323648091
12983,110,22164,10,11,0,0,0,21,3,10,5,0,0,18,win,win,plwin,beat,25,0,21,192,0.416666667,0.046875,0.557291667,0,0.025413132
12984,25,22165,11,8,0,0,0,19,2,7,6,10,0,25,nowin,win,dlbust,bust,20,0,19,190,0.463157895,0.063157895,0.536842105,1,0.304401563
12985,111,22165,10,11,0,0,0,21,2,7,6,10,0,25,win,win,dlbust,bust,25,0,21,180,0.433333333,0.055555556,0.611111111,2,0.602264492
12986,110,22165,2,3,5,4,0,14,2,7,6,10,0,25,nowin,win,dlbust,bust,20,0,5,192,0.416666667,0.046875,0.557291667,0,0.025413132
12987,6,22165,4,10,0,0,0,14,2,7,6,10,0,25,nowin,win,dlbust,bust,20,0,14,191,0.439790576,0.047120419,0.581151832,1,0.31211505
12988,100,22165,9,10,0,0,0,19,2,7,6,10,0,25,nowin,win,dlbust,bust,20,0,19,190,0.452631579,0.036842105,0.594736842,3,0.888671154
12989,66,22165,11,10,0,0,0,21,2,7,6,10,0,25,win,win,dlbust,bust,25,0,21,217,0.456221198,0.064516129,0.626728111,3,0.924304367
12990,144,22166,2,3,5,8,0,18,2,9,10,0,0,21,nowin,loss,beat,dlwin,0,10,5,202,0.386138614,0.054455446,0.564356436,0,0.018006244
12991,98,22166,10,10,0,0,0,20,2,9,10,0,0,21,nowin,loss,beat,dlwin,0,10,20,220,0.422727273,0.054545455,0.55,1,0.28664435
12992,110,22166,8,10,0,0,0,18,2,9,10,0,0,21,nowin,loss,beat,dlwin,0,10,18,192,0.416666667,0.046875,0.557291667,0,0.025413132
12993,41,22166,8,11,0,0,0,19,2,9,10,0,0,21,nowin,loss,beat,dlwin,0,10,19,192,0.364583333,0.036458333,0.520833333,0,0.00089702
12994,29,22166,10,5,0,0,0,15,2,9,10,0,0,21,nowin,loss,beat,dlwin,0,10,15,189,0.44973545,0.058201058,0.544973545,1,0.300349439
12995,75,22166,5,6,10,0,0,21,2,9,10,0,0,21,nowin,push,push,push,10,0,11,191,0.418848168,0.052356021,0.570680628,0,0.029344702
12996,145,22167,10,10,0,0,0,20,11,2,8,0,0,21,nowin,loss,beat,dlwin,0,10,20,188,0.441489362,0.031914894,0.622340426,2,0.617837093
12997,77,22167,3,10,0,8,0,21,11,2,8,0,0,21,nowin,push,push,push,10,0,13,200,0.455,0.04,0.62,3,0.916252116
12998,27,22167,3,4,11,0,0,18,11,2,8,0,0,21,nowin,loss,beat,dlwin,0,10,7,178,0.370786517,0.016853933,0.573033708,0,0.015536309
12999,99,22167,6,10,0,10,0,26,11,2,8,0,0,21,nowin,loss,bust,plbust,0,10,16,207,0.47826087,0.062801932,0.637681159,3,0.961418446
13000,21,22167,3,2,9,5,0,19,11,2,8,0,0,21,nowin,loss,beat,dlwin,0,10,5,214,0.359813084,0.042056075,0.626168224,0,0.025263474
13001,49,22167,10,10,0,0,0,20,11,2,8,0,0,21,nowin,loss,beat,dlwin,0,10,20,207,0.396135266,0.053140097,0.594202899,0,0.028306925
13002,95,22168,4,3,9,10,0,26,10,10,0,0,0,20,nowin,loss,bust,plbust,0,10,7,218,0.412844037,0.04587156,0.559633028,0,0.024842385
13003,25,22168,10,7,0,0,0,17,10,10,0,0,0,20,nowin,loss,beat,dlwin,0,10,17,190,0.463157895,0.063157895,0.536842105,1,0.304401563
13004,52,22168,10,10,0,0,0,20,10,10,0,0,0,20,nowin,push,push,push,10,0,20,217,0.414746544,0.02764977,0.599078341,2,0.576736024
13005,55,22168,10,7,0,0,0,17,10,10,0,0,0,20,nowin,loss,beat,dlwin,0,10,17,191,0.371727749,0.057591623,0.54973822,0,0.01011347
13006,8,22168,10,4,0,8,0,22,10,10,0,0,0,20,nowin,loss,bust,plbust,0,10,14,181,0.44198895,0.071823204,0.596685083,2,0.599438402
13007,32,22168,6,2,4,10,0,22,10,10,0,0,0,20,nowin,loss,bust,plbust,0,10,8,189,0.391534392,0.037037037,0.53968254,0,0.013579086
13008,113,22169,10,2,0,0,0,12,4,10,10,0,0,24,nowin,win,dlbust,bust,20,0,12,199,0.407035176,0.055276382,0.668341709,2,0.620695264
13009,104,22169,6,10,0,0,0,16,4,10,10,0,0,24,nowin,win,dlbust,bust,20,0,16,209,0.363636364,0.052631579,0.593301435,0,0.018359419
13010,140,22169,9,8,0,0,0,17,4,10,10,0,0,24,nowin,win,dlbust,bust,20,0,17,210,0.466666667,0.023809524,0.604761905,3,0.915293335
13011,98,22169,7,10,0,0,0,17,4,10,10,0,0,24,nowin,win,dlbust,bust,20,0,17,220,0.422727273,0.054545455,0.55,1,0.28664435
13012,25,22169,10,6,0,0,0,16,4,10,10,0,0,24,nowin,win,dlbust,bust,20,0,16,190,0.463157895,0.063157895,0.536842105,1,0.304401563
13013,92,22169,10,6,0,0,0,16,4,10,10,0,0,24,nowin,win,dlbust,bust,20,0,16,186,0.446236559,0.059139785,0.564516129,1,0.307826125
13014,79,22170,4,9,0,0,0,13,2,3,7,7,0,19,nowin,loss,beat,dlwin,0,10,13,211,0.436018957,0.028436019,0.672985782,2,0.650131054
13015,23,22170,9,6,0,0,0,15,2,3,7,7,0,19,nowin,loss,beat,dlwin,0,10,15,208,0.427884615,0.0625,0.552884615,1,0.29114424
13016,110,22170,6,3,10,0,0,19,2,3,7,7,0,19,nowin,push,push,push,10,0,9,192,0.416666667,0.046875,0.557291667,0,0.025413132
13017,31,22170,10,4,0,0,0,14,2,3,7,7,0,19,nowin,loss,beat,dlwin,0,10,14,188,0.473404255,0.058510638,0.515957447,1,0.300306557
13018,112,22170,6,8,0,0,0,14,2,3,7,7,0,19,nowin,loss,beat,dlwin,0,10,14,203,0.448275862,0.054187192,0.600985222,3,0.889576933
13019,2,22170,10,10,0,0,0,20,2,3,7,7,0,19,nowin,win,plwin,beat,20,0,20,200,0.445,0.035,0.64,2,0.633962549
13020,56,22171,8,4,0,0,0,12,5,9,4,0,0,18,nowin,loss,beat,dlwin,0,10,12,175,0.4,0.057142857,0.582857143,0,0.026685297
13021,142,22171,8,7,0,0,0,15,5,9,4,0,0,18,nowin,loss,beat,dlwin,0,10,15,211,0.417061611,0.047393365,0.526066351,1,0.271531309
13022,28,22171,8,2,5,0,0,15,5,9,4,0,0,18,nowin,loss,beat,dlwin,0,10,10,199,0.422110553,0.045226131,0.542713568,1,0.282706618
13023,21,22171,10,8,0,0,0,18,5,9,4,0,0,18,nowin,push,push,push,10,0,18,214,0.359813084,0.042056075,0.626168224,0,0.025263474
13024,76,22171,2,10,0,0,0,12,5,9,4,0,0,18,nowin,loss,beat,dlwin,0,10,12,189,0.534391534,0.079365079,0.608465608,3,1
13025,90,22171,10,10,0,0,0,20,5,9,4,0,0,18,nowin,win,plwin,beat,20,0,20,201,0.447761194,0.049751244,0.60199005,3,0.889945023
13026,1,22172,3,5,10,0,0,18,4,10,9,0,0,23,nowin,win,dlbust,bust,20,0,8,197,0.406091371,0.025380711,0.649746193,2,0.606186955
13027,2,22172,5,5,10,0,0,20,4,10,9,0,0,23,nowin,win,dlbust,bust,20,0,10,200,0.445,0.035,0.64,2,0.633962549
13028,146,22172,7,4,2,0,0,13,4,10,9,0,0,23,nowin,win,dlbust,bust,20,0,11,221,0.43438914,0.040723982,0.542986425,1,0.290190091
13029,52,22172,9,8,0,0,0,17,4,10,9,0,0,23,nowin,win,dlbust,bust,20,0,17,217,0.414746544,0.02764977,0.599078341,2,0.576736024
13030,74,22172,10,5,0,0,0,15,4,10,9,0,0,23,nowin,win,dlbust,bust,20,0,15,209,0.411483254,0.04784689,0.531100478,0,0.017448125
13031,88,22172,1,5,10,0,0,16,4,10,9,0,0,23,nowin,win,dlbust,bust,20,0,6,206,0.466019417,0.033980583,0.54368932,1,0.309467903
13032,12,22173,8,11,0,0,0,19,5,6,10,0,0,21,nowin,loss,beat,dlwin,0,10,19,189,0.470899471,0.015873016,0.613756614,3,0.929171178
13033,28,22173,11,10,0,0,0,21,5,6,10,0,0,21,win,push,push,push,10,0,21,199,0.422110553,0.045226131,0.542713568,1,0.282706618
13034,66,22173,5,10,0,0,0,15,5,6,10,0,0,21,nowin,loss,beat,dlwin,0,10,15,217,0.456221198,0.064516129,0.626728111,3,0.924304367
13035,50,22173,10,2,0,0,0,12,5,6,10,0,0,21,nowin,loss,beat,dlwin,0,10,12,202,0.405940594,0.04950495,0.54950495,0,0.020296079
13036,137,22173,5,3,8,0,0,16,5,6,10,0,0,21,nowin,loss,beat,dlwin,0,10,8,194,0.417525773,0.046391753,0.536082474,1,0.276714602
13037,72,22173,10,4,0,0,0,14,5,6,10,0,0,21,nowin,loss,beat,dlwin,0,10,14,185,0.394594595,0.032432432,0.508108108,0,0.006763115
13038,25,22174,3,9,0,10,0,22,10,4,10,0,0,24,nowin,loss,bust,plbust,0,10,12,190,0.463157895,0.063157895,0.536842105,1,0.304401563
13039,75,22174,9,5,0,10,0,24,10,4,10,0,0,24,nowin,loss,bust,plbust,0,10,14,191,0.418848168,0.052356021,0.570680628,0,0.029344702
13040,78,22174,8,7,0,1,5,21,10,4,10,0,0,24,nowin,win,dlbust,bust,20,0,15,201,0.517412935,0.034825871,0.587064677,3,0.95871112
13041,50,22174,10,7,0,0,0,17,10,4,10,0,0,24,nowin,win,dlbust,bust,20,0,17,202,0.405940594,0.04950495,0.54950495,0,0.020296079
13042,40,22174,10,2,0,10,0,22,10,4,10,0,0,24,nowin,loss,bust,plbust,0,10,12,196,0.367346939,0.030612245,0.617346939,0,0.025358183
13043,11,22174,3,7,9,0,0,19,10,4,10,0,0,24,nowin,win,dlbust,bust,20,0,10,236,0.457627119,0.016949153,0.588983051,3,0.889015813
13044,86,22175,4,10,0,0,0,14,3,4,8,3,0,18,nowin,loss,beat,dlwin,0,10,14,196,0.454081633,0.040816327,0.591836735,3,0.887566443
13045,62,22175,10,7,0,0,0,17,3,4,8,3,0,18,nowin,loss,beat,dlwin,0,10,17,178,0.370786517,0.028089888,0.54494382,0,0.008657722
13046,41,22175,8,6,0,0,0,14,3,4,8,3,0,18,nowin,loss,beat,dlwin,0,10,14,192,0.364583333,0.036458333,0.520833333,0,0.00089702
13047,139,22175,5,10,0,0,0,15,3,4,8,3,0,18,nowin,loss,beat,dlwin,0,10,15,192,0.380208333,0.036458333,0.59375,0,0.023429169
13048,86,22175,1,6,10,0,0,17,3,4,8,3,0,18,nowin,loss,beat,dlwin,0,10,7,196,0.454081633,0.040816327,0.591836735,3,0.887566443
13049,105,22175,4,2,10,0,0,16,3,4,8,3,0,18,nowin,loss,beat,dlwin,0,10,6,198,0.414141414,0.070707071,0.590909091,0,0.032889494
13050,149,22176,8,11,0,0,0,19,6,3,8,0,0,17,nowin,win,plwin,beat,20,0,19,225,0.457777778,0.057777778,0.648888889,2,0.651965595
13051,65,22176,10,10,0,0,0,20,6,3,8,0,0,17,nowin,win,plwin,beat,20,0,20,203,0.492610837,0.054187192,0.571428571,3,0.913702814
13052,34,22176,5,5,8,0,0,18,6,3,8,0,0,17,nowin,win,plwin,beat,20,0,10,202,0.5,0.079207921,0.618811881,3,0.968961434
13053,127,22176,10,10,0,0,0,20,6,3,8,0,0,17,nowin,win,plwin,beat,20,0,20,201,0.402985075,0.029850746,0.60199005,0,0.032263937
13054,5,22176,9,5,0,0,0,14,6,3,8,0,0,17,nowin,loss,beat,dlwin,0,10,14,203,0.42364532,0.02955665,0.596059113,2,0.582508076
13055,106,22176,11,10,0,0,0,21,6,3,8,0,0,17,win,win,plwin,beat,25,0,21,192,0.411458333,0.026041667,0.557291667,0,0.023854304
13056,80,22177,8,10,0,0,0,18,3,6,10,0,0,19,nowin,loss,beat,dlwin,0,10,18,186,0.419354839,0.059139785,0.623655914,2,0.59892924
13057,78,22177,7,10,0,0,0,17,3,6,10,0,0,19,nowin,loss,beat,dlwin,0,10,17,201,0.517412935,0.034825871,0.587064677,3,0.95871112
13058,141,22177,5,8,0,0,0,13,3,6,10,0,0,19,nowin,loss,beat,dlwin,0,10,13,202,0.420792079,0.074257426,0.564356436,0,0.028377851
13059,83,22177,10,9,0,0,0,19,3,6,10,0,0,19,nowin,push,push,push,10,0,19,193,0.424870466,0.051813472,0.678756477,2,0.644360335
13060,47,22177,5,7,0,3,0,15,3,6,10,0,0,19,nowin,loss,beat,dlwin,0,10,12,210,0.438095238,0.057142857,0.623809524,2,0.615868808
13061,58,22177,3,5,3,10,0,21,3,6,10,0,0,19,nowin,win,plwin,beat,20,0,8,195,0.430769231,0.041025641,0.584615385,2,0.580497586
13062,90,22178,10,10,0,0,0,20,11,9,0,0,0,20,nowin,push,push,push,10,0,20,201,0.447761194,0.049751244,0.60199005,3,0.889945023
13063,82,22178,10,5,0,10,0,25,11,9,0,0,0,20,nowin,loss,bust,plbust,0,10,15,225,0.408888889,0.075555556,0.577777778,0,0.028101874
13064,20,22178,8,10,0,0,0,18,11,9,0,0,0,20,nowin,loss,beat,dlwin,0,10,18,186,0.456989247,0.037634409,0.537634409,1,0.301097108
13065,113,22178,10,9,0,0,0,19,11,9,0,0,0,20,nowin,loss,beat,dlwin,0,10,19,199,0.407035176,0.055276382,0.668341709,2,0.620695264
13066,86,22178,9,2,7,0,0,18,11,9,0,0,0,20,nowin,loss,beat,dlwin,0,10,11,196,0.454081633,0.040816327,0.591836735,3,0.887566443
13067,23,22178,4,6,8,0,0,18,11,9,0,0,0,20,nowin,loss,beat,dlwin,0,10,10,208,0.427884615,0.0625,0.552884615,1,0.29114424
13068,63,22179,10,4,0,0,0,14,2,8,2,2,3,17,nowin,loss,beat,dlwin,0,10,14,216,0.467592593,0.037037037,0.62037037,3,0.931690496
13069,117,22179,9,8,0,0,0,17,2,8,2,2,3,17,nowin,push,push,push,10,0,17,173,0.410404624,0.069364162,0.606936416,2,0.578610282
13070,144,22179,11,10,0,0,0,21,2,8,2,2,3,17,win,win,plwin,beat,25,0,21,202,0.386138614,0.054455446,0.564356436,0,0.018006244
13071,112,22179,10,10,0,0,0,20,2,8,2,2,3,17,nowin,win,plwin,beat,20,0,20,203,0.448275862,0.054187192,0.600985222,3,0.889576933
13072,110,22179,6,10,0,0,0,16,2,8,2,2,3,17,nowin,loss,beat,dlwin,0,10,16,192,0.416666667,0.046875,0.557291667,0,0.025413132
13073,116,22179,5,10,0,0,0,15,2,8,2,2,3,17,nowin,loss,beat,dlwin,0,10,15,195,0.425641026,0.056410256,0.538461538,1,0.28273747
13074,10,22180,10,10,0,0,0,20,10,8,0,0,0,18,nowin,win,plwin,beat,20,0,20,191,0.413612565,0.057591623,0.596858639,2,0.574087175
13075,17,22180,3,2,3,5,10,23,10,8,0,0,0,18,nowin,loss,bust,plbust,0,10,5,171,0.444444444,0.070175439,0.555555556,1,0.302364894
13076,24,22180,2,4,10,2,0,18,10,8,0,0,0,18,nowin,push,push,push,10,0,6,207,0.458937198,0.048309179,0.570048309,1,0.318138014
13077,15,22180,8,10,0,0,0,18,10,8,0,0,0,18,nowin,push,push,push,10,0,18,212,0.410377358,0.051886792,0.561320755,0,0.024517408
13078,92,22180,1,4,10,8,0,23,10,8,0,0,0,18,nowin,loss,bust,plbust,0,10,5,186,0.446236559,0.059139785,0.564516129,1,0.307826125
13079,36,22180,2,3,8,1,1,15,10,8,0,0,0,18,nowin,loss,beat,dlwin,0,10,5,229,0.445414847,0.056768559,0.655021834,2,0.645370571
13080,36,22181,10,6,0,8,0,24,8,10,0,0,0,18,nowin,loss,bust,plbust,0,10,16,229,0.445414847,0.056768559,0.655021834,2,0.645370571
13081,87,22181,8,10,0,0,0,18,8,10,0,0,0,18,nowin,push,push,push,10,0,18,202,0.405940594,0.054455446,0.628712871,2,0.590599801
13082,23,22181,10,11,0,0,0,21,8,10,0,0,0,18,win,win,plwin,beat,25,0,21,208,0.427884615,0.0625,0.552884615,1,0.29114424
13083,125,22181,3,2,10,8,0,23,8,10,0,0,0,18,nowin,loss,bust,plbust,0,10,5,219,0.438356164,0.050228311,0.575342466,1,0.308411257
13084,131,22181,4,11,4,0,0,19,8,10,0,0,0,18,nowin,win,plwin,beat,20,0,15,217,0.410138249,0.069124424,0.543778802,0,0.02015021
13085,106,22181,4,4,6,7,0,21,8,10,0,0,0,18,nowin,win,plwin,beat,20,0,8,192,0.411458333,0.026041667,0.557291667,0,0.023854304
13086,58,22182,3,3,2,6,0,14,4,10,8,0,0,22,nowin,win,dlbust,bust,20,0,6,195,0.430769231,0.041025641,0.584615385,2,0.580497586
13087,29,22182,9,8,0,0,0,17,4,10,8,0,0,22,nowin,win,dlbust,bust,20,0,17,189,0.44973545,0.058201058,0.544973545,1,0.300349439
13088,97,22182,3,10,0,0,0,13,4,10,8,0,0,22,nowin,win,dlbust,bust,20,0,13,182,0.450549451,0.06043956,0.692307692,2,0.677372279
13089,12,22182,4,10,0,0,0,14,4,10,8,0,0,22,nowin,win,dlbust,bust,20,0,14,189,0.470899471,0.015873016,0.613756614,3,0.929171178
13090,80,22182,2,5,5,0,0,12,4,10,8,0,0,22,nowin,win,dlbust,bust,20,0,7,186,0.419354839,0.059139785,0.623655914,2,0.59892924
13091,76,22182,10,4,0,0,0,14,4,10,8,0,0,22,nowin,win,dlbust,bust,20,0,14,189,0.534391534,0.079365079,0.608465608,3,1
13092,40,22183,10,5,0,3,0,18,7,10,0,0,0,17,nowin,win,plwin,beat,20,0,15,196,0.367346939,0.030612245,0.617346939,0,0.025358183
13093,98,22183,9,11,0,0,0,20,7,10,0,0,0,17,nowin,win,plwin,beat,20,0,20,220,0.422727273,0.054545455,0.55,1,0.28664435
13094,121,22183,8,6,0,2,10,26,7,10,0,0,0,17,nowin,loss,bust,plbust,0,10,14,195,0.456410256,0.025641026,0.512820513,1,0.288597791
13095,55,22183,4,1,8,10,0,23,7,10,0,0,0,17,nowin,loss,bust,plbust,0,10,5,191,0.371727749,0.057591623,0.54973822,0,0.01011347
13096,115,22183,10,11,0,0,0,21,7,10,0,0,0,17,win,win,plwin,beat,25,0,21,194,0.427835052,0.041237113,0.592783505,2,0.583863602
13097,133,22183,7,5,0,1,1,14,7,10,0,0,0,17,nowin,loss,beat,dlwin,0,10,12,201,0.47761194,0.064676617,0.611940299,3,0.935428111
13098,83,22184,10,10,0,0,0,20,5,10,3,0,0,18,nowin,win,plwin,beat,20,0,20,193,0.424870466,0.051813472,0.678756477,2,0.644360335
13099,88,22184,9,6,0,0,0,15,5,10,3,0,0,18,nowin,loss,beat,dlwin,0,10,15,206,0.466019417,0.033980583,0.54368932,1,0.309467903
13100,60,22184,10,3,0,0,0,13,5,10,3,0,0,18,nowin,loss,beat,dlwin,0,10,13,227,0.418502203,0.022026432,0.559471366,0,0.026496258
13101,72,22184,5,2,10,0,0,17,5,10,3,0,0,18,nowin,loss,beat,dlwin,0,10,7,185,0.394594595,0.032432432,0.508108108,0,0.006763115
13102,41,22184,11,5,4,0,0,20,5,10,3,0,0,18,nowin,win,plwin,beat,20,0,16,192,0.364583333,0.036458333,0.520833333,0,0.00089702
13103,16,22184,10,7,0,0,0,17,5,10,3,0,0,18,nowin,loss,beat,dlwin,0,10,17,220,0.427272727,0.081818182,0.6,2,0.588660176
13104,27,22185,10,10,0,0,0,20,5,10,8,0,0,23,nowin,win,dlbust,bust,20,0,20,178,0.370786517,0.016853933,0.573033708,0,0.015536309
13105,100,22185,10,6,0,0,0,16,5,10,8,0,0,23,nowin,win,dlbust,bust,20,0,16,190,0.452631579,0.036842105,0.594736842,3,0.888671154
13106,134,22185,10,10,0,0,0,20,5,10,8,0,0,23,nowin,win,dlbust,bust,20,0,20,185,0.443243243,0.021621622,0.545945946,1,0.296939509
13107,141,22185,10,8,0,0,0,18,5,10,8,0,0,23,nowin,win,dlbust,bust,20,0,18,202,0.420792079,0.074257426,0.564356436,0,0.028377851
13108,11,22185,3,3,4,9,0,19,5,10,8,0,0,23,nowin,win,dlbust,bust,20,0,6,236,0.457627119,0.016949153,0.588983051,3,0.889015813
13109,144,22185,4,10,0,0,0,14,5,10,8,0,0,23,nowin,win,dlbust,bust,20,0,14,202,0.386138614,0.054455446,0.564356436,0,0.018006244
13110,143,22186,10,10,0,0,0,20,9,7,8,0,0,24,nowin,win,dlbust,bust,20,0,20,203,0.463054187,0.044334975,0.57635468,3,0.883143365
13111,76,22186,10,4,0,2,3,19,9,7,8,0,0,24,nowin,win,dlbust,bust,20,0,14,189,0.534391534,0.079365079,0.608465608,3,1
13112,140,22186,7,10,0,0,0,17,9,7,8,0,0,24,nowin,win,dlbust,bust,20,0,17,210,0.466666667,0.023809524,0.604761905,3,0.915293335
13113,59,22186,10,2,0,4,10,26,9,7,8,0,0,24,nowin,loss,bust,plbust,0,10,12,228,0.429824561,0.048245614,0.543859649,1,0.287885446
13114,89,22186,6,3,7,2,0,18,9,7,8,0,0,24,nowin,win,dlbust,bust,20,0,9,212,0.537735849,0.047169811,0.594339623,3,0.990167191
13115,64,22186,10,11,0,0,0,21,9,7,8,0,0,24,win,win,dlbust,bust,25,0,21,187,0.363636364,0.048128342,0.631016043,0,0.027594885
13116,104,22187,7,4,10,0,0,21,7,8,10,0,0,25,nowin,win,dlbust,bust,20,0,11,209,0.363636364,0.052631579,0.593301435,0,0.018359419
13117,98,22187,7,9,0,5,0,21,7,8,10,0,0,25,nowin,win,dlbust,bust,20,0,16,220,0.422727273,0.054545455,0.55,1,0.28664435
13118,45,22187,5,8,0,3,5,21,7,8,10,0,0,25,nowin,win,dlbust,bust,20,0,13,196,0.428571429,0.051020408,0.612244898,2,0.598821767
13119,40,22187,6,10,0,10,0,26,7,8,10,0,0,25,nowin,loss,bust,plbust,0,10,16,196,0.367346939,0.030612245,0.617346939,0,0.025358183
13120,35,22187,4,8,0,2,10,24,7,8,10,0,0,25,nowin,loss,bust,plbust,0,10,12,202,0.410891089,0.044554455,0.633663366,2,0.598681573
13121,112,22187,11,10,0,0,0,21,7,8,10,0,0,25,win,win,dlbust,bust,25,0,21,203,0.448275862,0.054187192,0.600985222,3,0.889576933
13122,109,22188,4,4,10,0,0,18,7,10,0,0,0,17,nowin,win,plwin,beat,20,0,8,221,0.461538462,0.058823529,0.597285068,3,0.901830309
13123,8,22188,10,8,0,0,0,18,7,10,0,0,0,17,nowin,win,plwin,beat,20,0,18,181,0.44198895,0.071823204,0.596685083,2,0.599438402
13124,23,22188,4,3,4,7,0,18,7,10,0,0,0,17,nowin,win,plwin,beat,20,0,7,208,0.427884615,0.0625,0.552884615,1,0.29114424
13125,42,22188,7,9,0,9,0,25,7,10,0,0,0,17,nowin,loss,bust,plbust,0,10,16,212,0.443396226,0.051886792,0.570754717,1,0.309181312
13126,62,22188,10,6,0,10,0,26,7,10,0,0,0,17,nowin,loss,bust,plbust,0,10,16,178,0.370786517,0.028089888,0.54494382,0,0.008657722
13127,41,22188,10,8,0,0,0,18,7,10,0,0,0,17,nowin,win,plwin,beat,20,0,18,192,0.364583333,0.036458333,0.520833333,0,0.00089702
13128,4,22189,10,10,0,0,0,20,4,9,3,10,0,26,nowin,win,dlbust,bust,20,0,20,217,0.460829493,0.036866359,0.562211982,1,0.315432839
13129,114,22189,8,10,0,0,0,18,4,9,3,10,0,26,nowin,win,dlbust,bust,20,0,18,198,0.47979798,0.025252525,0.611111111,3,0.937232995
13130,26,22189,5,5,7,0,0,17,4,9,3,10,0,26,nowin,win,dlbust,bust,20,0,10,203,0.463054187,0.0591133,0.541871921,1,0.306802864
13131,55,22189,2,7,4,0,0,13,4,9,3,10,0,26,nowin,win,dlbust,bust,20,0,9,191,0.371727749,0.057591623,0.54973822,0,0.01011347
13132,110,22189,2,8,3,0,0,13,4,9,3,10,0,26,nowin,win,dlbust,bust,20,0,10,192,0.416666667,0.046875,0.557291667,0,0.025413132
13133,146,22189,6,6,0,0,0,12,4,9,3,10,0,26,nowin,win,dlbust,bust,20,0,12,221,0.43438914,0.040723982,0.542986425,1,0.290190091
13134,25,22190,6,8,0,10,0,24,9,10,0,0,0,19,nowin,loss,bust,plbust,0,10,14,190,0.463157895,0.063157895,0.536842105,1,0.304401563
13135,121,22190,2,4,10,5,0,21,9,10,0,0,0,19,nowin,win,plwin,beat,20,0,6,195,0.456410256,0.025641026,0.512820513,1,0.288597791
13136,126,22190,6,8,0,7,0,21,9,10,0,0,0,19,nowin,win,plwin,beat,20,0,14,188,0.457446809,0.074468085,0.60106383,3,0.900633203
13137,57,22190,10,11,0,0,0,21,9,10,0,0,0,19,win,win,plwin,beat,25,0,21,192,0.46875,0.052083333,0.59375,3,0.907001181
13138,41,22190,4,5,10,0,0,19,9,10,0,0,0,19,nowin,push,push,push,10,0,9,192,0.364583333,0.036458333,0.520833333,0,0.00089702
13139,64,22190,11,9,0,0,0,20,9,10,0,0,0,19,nowin,win,plwin,beat,20,0,20,187,0.363636364,0.048128342,0.631016043,0,0.027594885
13140,1,22191,10,7,0,0,0,17,9,11,0,0,0,20,nowin,loss,beat,dlwin,0,10,17,197,0.406091371,0.025380711,0.649746193,2,0.606186955
13141,86,22191,6,5,5,1,0,17,9,11,0,0,0,20,nowin,loss,beat,dlwin,0,10,11,196,0.454081633,0.040816327,0.591836735,3,0.887566443
13142,34,22191,10,11,0,0,0,21,9,11,0,0,0,20,win,win,plwin,beat,25,0,21,202,0.5,0.079207921,0.618811881,3,0.968961434
13143,147,22191,6,5,2,4,0,17,9,11,0,0,0,20,nowin,loss,beat,dlwin,0,10,11,205,0.380487805,0.014634146,0.536585366,0,0.00951447
13144,97,22191,10,11,0,0,0,21,9,11,0,0,0,20,win,win,plwin,beat,25,0,21,182,0.450549451,0.06043956,0.692307692,2,0.677372279
13145,60,22191,8,11,0,0,0,19,9,11,0,0,0,20,nowin,loss,beat,dlwin,0,10,19,227,0.418502203,0.022026432,0.559471366,0,0.026496258
13146,12,22192,10,10,0,0,0,20,9,11,0,0,0,20,nowin,push,push,push,10,0,20,189,0.470899471,0.015873016,0.613756614,3,0.929171178
13147,128,22192,3,10,0,1,3,17,9,11,0,0,0,20,nowin,loss,beat,dlwin,0,10,13,227,0.356828194,0.052863436,0.577092511,0,0.012352564
13148,104,22192,7,4,3,7,0,21,9,11,0,0,0,20,nowin,win,plwin,beat,20,0,11,209,0.363636364,0.052631579,0.593301435,0,0.018359419
13149,35,22192,9,2,10,0,0,21,9,11,0,0,0,20,nowin,win,plwin,beat,20,0,11,202,0.410891089,0.044554455,0.633663366,2,0.598681573
13150,145,22192,4,10,0,4,0,18,9,11,0,0,0,20,nowin,loss,beat,dlwin,0,10,14,188,0.441489362,0.031914894,0.622340426,2,0.617837093
13151,42,22192,10,9,0,0,0,19,9,11,0,0,0,20,nowin,loss,beat,dlwin,0,10,19,212,0.443396226,0.051886792,0.570754717,1,0.309181312
13152,74,22193,1,4,9,0,0,14,3,2,10,3,0,18,nowin,loss,beat,dlwin,0,10,5,209,0.411483254,0.04784689,0.531100478,0,0.017448125
13153,120,22193,10,6,0,0,0,16,3,2,10,3,0,18,nowin,loss,beat,dlwin,0,10,16,202,0.440594059,0.034653465,0.618811881,2,0.614441029
13154,146,22193,5,6,3,0,0,14,3,2,10,3,0,18,nowin,loss,beat,dlwin,0,10,11,221,0.43438914,0.040723982,0.542986425,1,0.290190091
13155,93,22193,3,10,0,0,0,13,3,2,10,3,0,18,nowin,loss,beat,dlwin,0,10,13,175,0.485714286,0.051428571,0.548571429,1,0.323648091
13156,90,22193,10,10,0,0,0,20,3,2,10,3,0,18,nowin,win,plwin,beat,20,0,20,201,0.447761194,0.049751244,0.60199005,3,0.889945023
13157,42,22193,5,10,0,0,0,15,3,2,10,3,0,18,nowin,loss,beat,dlwin,0,10,15,212,0.443396226,0.051886792,0.570754717,1,0.309181312
13158,126,22194,2,10,0,5,0,17,10,10,0,0,0,20,nowin,loss,beat,dlwin,0,10,12,188,0.457446809,0.074468085,0.60106383,3,0.900633203
13159,41,22194,11,10,0,0,0,21,10,10,0,0,0,20,win,win,plwin,beat,25,0,21,192,0.364583333,0.036458333,0.520833333,0,0.00089702
13160,83,22194,10,9,0,0,0,19,10,10,0,0,0,20,nowin,loss,beat,dlwin,0,10,19,193,0.424870466,0.051813472,0.678756477,2,0.644360335
13161,123,22194,9,4,0,10,0,23,10,10,0,0,0,20,nowin,loss,bust,plbust,0,10,13,205,0.43902439,0.034146341,0.614634146,2,0.609962544
13162,146,22194,10,5,0,5,0,20,10,10,0,0,0,20,nowin,push,push,push,10,0,15,221,0.43438914,0.040723982,0.542986425,1,0.290190091
13163,61,22194,9,6,0,4,0,19,10,10,0,0,0,20,nowin,loss,beat,dlwin,0,10,15,194,0.427835052,0.077319588,0.603092784,2,0.591437139
13164,35,22195,10,11,0,0,0,21,6,2,10,0,0,18,win,win,plwin,beat,25,0,21,202,0.410891089,0.044554455,0.633663366,2,0.598681573
13165,132,22195,8,10,0,0,0,18,6,2,10,0,0,18,nowin,push,push,push,10,0,18,194,0.412371134,0.036082474,0.649484536,2,0.611633238
13166,93,22195,7,7,0,0,0,14,6,2,10,0,0,18,nowin,loss,beat,dlwin,0,10,14,175,0.485714286,0.051428571,0.548571429,1,0.323648091
13167,140,22195,6,10,0,0,0,16,6,2,10,0,0,18,nowin,loss,beat,dlwin,0,10,16,210,0.466666667,0.023809524,0.604761905,3,0.915293335
13168,133,22195,1,6,10,0,0,17,6,2,10,0,0,18,nowin,loss,beat,dlwin,0,10,7,201,0.47761194,0.064676617,0.611940299,3,0.935428111
13169,61,22195,10,9,0,0,0,19,6,2,10,0,0,18,nowin,win,plwin,beat,20,0,19,194,0.427835052,0.077319588,0.603092784,2,0.591437139
13170,52,22196,7,10,0,0,0,17,8,10,0,0,0,18,nowin,loss,beat,dlwin,0,10,17,217,0.414746544,0.02764977,0.599078341,2,0.576736024
13171,55,22196,10,9,0,0,0,19,8,10,0,0,0,18,nowin,win,plwin,beat,20,0,19,191,0.371727749,0.057591623,0.54973822,0,0.01011347
13172,65,22196,2,10,0,10,0,22,8,10,0,0,0,18,nowin,loss,bust,plbust,0,10,12,203,0.492610837,0.054187192,0.571428571,3,0.913702814
13173,26,22196,8,11,0,0,0,19,8,10,0,0,0,18,nowin,win,plwin,beat,20,0,19,203,0.463054187,0.0591133,0.541871921,1,0.306802864
13174,83,22196,10,8,0,0,0,18,8,10,0,0,0,18,nowin,push,push,push,10,0,18,193,0.424870466,0.051813472,0.678756477,2,0.644360335
13175,33,22196,10,10,0,0,0,20,8,10,0,0,0,18,nowin,win,plwin,beat,20,0,20,192,0.4375,0.057291667,0.625,2,0.616208916
13176,71,22197,9,2,8,0,0,19,10,10,0,0,0,20,nowin,loss,beat,dlwin,0,10,11,193,0.352331606,0.046632124,0.585492228,0,0.013063661
13177,74,22197,10,10,0,0,0,20,10,10,0,0,0,20,nowin,push,push,push,10,0,20,209,0.411483254,0.04784689,0.531100478,0,0.017448125
13178,48,22197,3,6,10,0,0,19,10,10,0,0,0,20,nowin,loss,beat,dlwin,0,10,9,203,0.413793103,0.019704433,0.600985222,2,0.577280801
13179,102,22197,2,9,9,0,0,20,10,10,0,0,0,20,nowin,push,push,push,10,0,11,192,0.338541667,0.046875,0.5625,0,0.003306118
13180,148,22197,10,10,0,0,0,20,10,10,0,0,0,20,nowin,push,push,push,10,0,20,204,0.401960784,0.078431373,0.593137255,0,0.029789521
13181,47,22197,2,7,10,0,0,19,10,10,0,0,0,20,nowin,loss,beat,dlwin,0,10,9,210,0.438095238,0.057142857,0.623809524,2,0.615868808
13182,106,22198,3,7,9,0,0,19,3,11,7,0,0,21,nowin,loss,beat,dlwin,0,10,10,192,0.411458333,0.026041667,0.557291667,0,0.023854304
13183,83,22198,7,7,0,0,0,14,3,11,7,0,0,21,nowin,loss,beat,dlwin,0,10,14,193,0.424870466,0.051813472,0.678756477,2,0.644360335
13184,67,22198,3,3,11,0,0,17,3,11,7,0,0,21,nowin,loss,beat,dlwin,0,10,6,195,0.369230769,0.041025641,0.569230769,0,0.014139427
13185,117,22198,7,2,6,0,0,15,3,11,7,0,0,21,nowin,loss,beat,dlwin,0,10,9,173,0.410404624,0.069364162,0.606936416,2,0.578610282
13186,148,22198,4,10,0,0,0,14,3,11,7,0,0,21,nowin,loss,beat,dlwin,0,10,14,204,0.401960784,0.078431373,0.593137255,0,0.029789521
13187,64,22198,10,10,0,0,0,20,3,11,7,0,0,21,nowin,loss,beat,dlwin,0,10,20,187,0.363636364,0.048128342,0.631016043,0,0.027594885
13188,13,22199,6,2,10,0,0,18,10,8,0,0,0,18,nowin,push,push,push,10,0,8,206,0.417475728,0.063106796,0.621359223,2,0.59555479
13189,36,22199,11,4,1,10,0,26,10,8,0,0,0,18,nowin,loss,bust,plbust,0,10,15,229,0.445414847,0.056768559,0.655021834,2,0.645370571
13190,120,22199,10,5,0,1,5,21,10,8,0,0,0,18,nowin,win,plwin,beat,20,0,15,202,0.440594059,0.034653465,0.618811881,2,0.614441029
13191,138,22199,11,10,0,0,0,21,10,8,0,0,0,18,win,win,plwin,beat,25,0,21,190,0.442105263,0.047368421,0.610526316,2,0.609711065
13192,24,22199,10,11,0,0,0,21,10,8,0,0,0,18,win,win,plwin,beat,25,0,21,207,0.458937198,0.048309179,0.570048309,1,0.318138014
13193,63,22199,10,10,0,0,0,20,10,8,0,0,0,18,nowin,win,plwin,beat,20,0,20,216,0.467592593,0.037037037,0.62037037,3,0.931690496
13194,70,22200,10,3,0,0,0,13,2,8,11,0,0,21,nowin,loss,beat,dlwin,0,10,13,228,0.385964912,0.039473684,0.557017544,0,0.016157125
13195,128,22200,5,10,0,0,0,15,2,8,11,0,0,21,nowin,loss,beat,dlwin,0,10,15,227,0.356828194,0.052863436,0.577092511,0,0.012352564
13196,28,22200,10,2,0,1,0,13,2,8,11,0,0,21,nowin,loss,beat,dlwin,0,10,12,199,0.422110553,0.045226131,0.542713568,1,0.282706618
13197,27,22200,7,10,0,0,0,17,2,8,11,0,0,21,nowin,loss,beat,dlwin,0,10,17,178,0.370786517,0.016853933,0.573033708,0,0.015536309
13198,24,22200,7,7,0,0,0,14,2,8,11,0,0,21,nowin,loss,beat,dlwin,0,10,14,207,0.458937198,0.048309179,0.570048309,1,0.318138014
13199,18,22200,4,4,10,0,0,18,2,8,11,0,0,21,nowin,loss,beat,dlwin,0,10,8,182,0.461538462,0.043956044,0.587912088,3,0.892649374
13200,114,22201,8,3,4,0,0,15,3,1,10,9,0,23,nowin,win,dlbust,bust,20,0,11,198,0.47979798,0.025252525,0.611111111,3,0.937232995
13201,101,22201,2,10,0,6,0,18,3,1,10,9,0,23,nowin,win,dlbust,bust,20,0,12,205,0.424390244,0.068292683,0.63902439,2,0.614740646
13202,36,22201,2,2,2,3,5,14,3,1,10,9,0,23,nowin,win,dlbust,bust,20,0,4,229,0.445414847,0.056768559,0.655021834,2,0.645370571
13203,2,22201,2,5,10,0,0,17,3,1,10,9,0,23,nowin,win,dlbust,bust,20,0,7,200,0.445,0.035,0.64,2,0.633962549
13204,29,22201,5,7,0,4,0,16,3,1,10,9,0,23,nowin,win,dlbust,bust,20,0,12,189,0.44973545,0.058201058,0.544973545,1,0.300349439
13205,58,22201,7,10,0,0,0,17,3,1,10,9,0,23,nowin,win,dlbust,bust,20,0,17,195,0.430769231,0.041025641,0.584615385,2,0.580497586
13206,59,22202,8,2,7,0,0,17,9,11,0,0,0,20,nowin,loss,beat,dlwin,0,10,10,228,0.429824561,0.048245614,0.543859649,1,0.287885446
13207,132,22202,3,5,10,0,0,18,9,11,0,0,0,20,nowin,loss,beat,dlwin,0,10,8,194,0.412371134,0.036082474,0.649484536,2,0.611633238
13208,16,22202,2,10,0,5,0,17,9,11,0,0,0,20,nowin,loss,beat,dlwin,0,10,12,220,0.427272727,0.081818182,0.6,2,0.588660176
13209,44,22202,10,10,0,0,0,20,9,11,0,0,0,20,nowin,push,push,push,10,0,20,219,0.433789954,0.050228311,0.534246575,1,0.285551035
13210,19,22202,5,2,5,2,4,18,9,11,0,0,0,20,nowin,loss,beat,dlwin,0,10,7,237,0.41350211,0.054852321,0.628691983,2,0.597373826
13211,125,22202,10,9,0,0,0,19,9,11,0,0,0,20,nowin,loss,beat,dlwin,0,10,19,219,0.438356164,0.050228311,0.575342466,1,0.308411257
13212,111,22203,10,10,0,0,0,20,11,8,0,0,0,19,nowin,win,plwin,beat,20,0,20,180,0.433333333,0.055555556,0.611111111,2,0.602264492
13213,75,22203,4,8,0,3,9,24,11,8,0,0,0,19,nowin,loss,bust,plbust,0,10,12,191,0.418848168,0.052356021,0.570680628,0,0.029344702
13214,66,22203,7,2,11,0,0,20,11,8,0,0,0,19,nowin,win,plwin,beat,20,0,9,217,0.456221198,0.064516129,0.626728111,3,0.924304367
13215,6,22203,10,4,0,10,0,24,11,8,0,0,0,19,nowin,loss,bust,plbust,0,10,14,191,0.439790576,0.047120419,0.581151832,1,0.31211505
13216,49,22203,8,2,3,9,0,22,11,8,0,0,0,19,nowin,loss,bust,plbust,0,10,10,207,0.396135266,0.053140097,0.594202899,0,0.028306925
13217,122,22203,10,7,0,0,0,17,11,8,0,0,0,19,nowin,loss,beat,dlwin,0,10,17,210,0.347619048,0.052380952,0.59047619,0,0.012873677
13218,129,22204,2,10,0,3,10,25,10,7,0,0,0,17,nowin,loss,bust,plbust,0,10,12,201,0.422885572,0.064676617,0.55721393,0,0.027255383
13219,75,22204,10,10,0,0,0,20,10,7,0,0,0,17,nowin,win,plwin,beat,20,0,20,191,0.418848168,0.052356021,0.570680628,0,0.029344702
13220,36,22204,9,8,0,0,0,17,10,7,0,0,0,17,nowin,push,push,push,10,0,17,229,0.445414847,0.056768559,0.655021834,2,0.645370571
13221,103,22204,7,8,0,10,0,25,10,7,0,0,0,17,nowin,loss,bust,plbust,0,10,15,203,0.379310345,0.064039409,0.551724138,0,0.012869209
13222,53,22204,9,11,0,0,0,20,10,7,0,0,0,17,nowin,win,plwin,beat,20,0,20,250,0.372,0.064,0.564,0,0.013687345
13223,7,22204,7,4,5,3,0,19,10,7,0,0,0,17,nowin,win,plwin,beat,20,0,11,183,0.442622951,0.06010929,0.62295082,2,0.619303341
13224,66,22205,9,10,0,0,0,19,8,10,0,0,0,18,nowin,win,plwin,beat,20,0,19,217,0.456221198,0.064516129,0.626728111,3,0.924304367
13225,88,22205,9,9,0,0,0,18,8,10,0,0,0,18,nowin,push,push,push,10,0,18,206,0.466019417,0.033980583,0.54368932,1,0.309467903
13226,148,22205,5,10,0,10,0,25,8,10,0,0,0,18,nowin,loss,bust,plbust,0,10,15,204,0.401960784,0.078431373,0.593137255,0,0.029789521
13227,134,22205,2,11,8,0,0,21,8,10,0,0,0,18,nowin,win,plwin,beat,20,0,13,185,0.443243243,0.021621622,0.545945946,1,0.296939509
13228,74,22205,3,5,3,3,10,24,8,10,0,0,0,18,nowin,loss,bust,plbust,0,10,8,209,0.411483254,0.04784689,0.531100478,0,0.017448125
13229,128,22205,4,7,10,0,0,21,8,10,0,0,0,18,nowin,win,plwin,beat,20,0,11,227,0.356828194,0.052863436,0.577092511,0,0.012352564
13230,74,22206,2,10,0,7,0,19,8,3,8,0,0,19,nowin,push,push,push,10,0,12,209,0.411483254,0.04784689,0.531100478,0,0.017448125
13231,48,22206,9,2,5,10,0,26,8,3,8,0,0,19,nowin,loss,bust,plbust,0,10,11,203,0.413793103,0.019704433,0.600985222,2,0.577280801
13232,52,22206,9,7,0,3,0,19,8,3,8,0,0,19,nowin,push,push,push,10,0,16,217,0.414746544,0.02764977,0.599078341,2,0.576736024
13233,19,22206,10,9,0,0,0,19,8,3,8,0,0,19,nowin,push,push,push,10,0,19,237,0.41350211,0.054852321,0.628691983,2,0.597373826
13234,3,22206,10,10,0,0,0,20,8,3,8,0,0,19,nowin,win,plwin,beat,20,0,20,190,0.431578947,0.026315789,0.542105263,1,0.288076384
13235,101,22206,10,10,0,0,0,20,8,3,8,0,0,19,nowin,win,plwin,beat,20,0,20,205,0.424390244,0.068292683,0.63902439,2,0.614740646
13236,73,22207,11,8,0,0,0,19,10,10,0,0,0,20,nowin,loss,beat,dlwin,0,10,19,181,0.375690608,0.011049724,0.596685083,0,0.022795773
13237,132,22207,2,10,0,4,6,22,10,10,0,0,0,20,nowin,loss,bust,plbust,0,10,12,194,0.412371134,0.036082474,0.649484536,2,0.611633238
13238,105,22207,5,4,3,3,2,17,10,10,0,0,0,20,nowin,loss,beat,dlwin,0,10,9,198,0.414141414,0.070707071,0.590909091,0,0.032889494
13239,89,22207,10,9,0,0,0,19,10,10,0,0,0,20,nowin,loss,beat,dlwin,0,10,19,212,0.537735849,0.047169811,0.594339623,3,0.990167191
13240,127,22207,10,10,0,0,0,20,10,10,0,0,0,20,nowin,push,push,push,10,0,20,201,0.402985075,0.029850746,0.60199005,0,0.032263937
13241,148,22207,7,10,0,0,0,17,10,10,0,0,0,20,nowin,loss,beat,dlwin,0,10,17,204,0.401960784,0.078431373,0.593137255,0,0.029789521
13242,101,22208,11,10,0,0,0,21,9,10,0,0,0,19,win,win,plwin,beat,25,0,21,205,0.424390244,0.068292683,0.63902439,2,0.614740646
13243,9,22208,5,1,10,1,0,17,9,10,0,0,0,19,nowin,loss,beat,dlwin,0,10,6,194,0.37628866,0.015463918,0.541237113,0,0.009396796
13244,18,22208,7,5,0,1,10,23,9,10,0,0,0,19,nowin,loss,bust,plbust,0,10,12,182,0.461538462,0.043956044,0.587912088,3,0.892649374
13245,133,22208,7,4,10,0,0,21,9,10,0,0,0,19,nowin,win,plwin,beat,20,0,11,201,0.47761194,0.064676617,0.611940299,3,0.935428111
13246,7,22208,11,10,0,0,0,21,9,10,0,0,0,19,win,win,plwin,beat,25,0,21,183,0.442622951,0.06010929,0.62295082,2,0.619303341
13247,23,22208,10,7,0,0,0,17,9,10,0,0,0,19,nowin,loss,beat,dlwin,0,10,17,208,0.427884615,0.0625,0.552884615,1,0.29114424
13248,60,22209,8,6,0,10,0,24,7,11,0,0,0,18,nowin,loss,bust,plbust,0,10,14,227,0.418502203,0.022026432,0.559471366,0,0.026496258
13249,139,22209,2,10,0,1,1,14,7,11,0,0,0,18,nowin,loss,beat,dlwin,0,10,12,192,0.380208333,0.036458333,0.59375,0,0.023429169
13250,81,22209,10,8,0,0,0,18,7,11,0,0,0,18,nowin,push,push,push,10,0,18,182,0.395604396,0.043956044,0.60989011,2,0.567491261
13251,94,22209,10,7,0,0,0,17,7,11,0,0,0,18,nowin,loss,beat,dlwin,0,10,17,183,0.43715847,0.043715847,0.540983607,1,0.290866892
13252,37,22209,7,10,0,0,0,17,7,11,0,0,0,18,nowin,loss,beat,dlwin,0,10,17,208,0.394230769,0.038461538,0.581730769,0,0.024682772
13253,15,22209,4,7,7,0,0,18,7,11,0,0,0,18,nowin,push,push,push,10,0,11,212,0.410377358,0.051886792,0.561320755,0,0.024517408
13254,125,22210,8,10,0,0,0,18,10,10,0,0,0,20,nowin,loss,beat,dlwin,0,10,18,219,0.438356164,0.050228311,0.575342466,1,0.308411257
13255,119,22210,5,2,5,6,0,18,10,10,0,0,0,20,nowin,loss,beat,dlwin,0,10,7,190,0.405263158,0.068421053,0.515789474,0,0.011837158
13256,78,22210,10,3,0,3,2,18,10,10,0,0,0,20,nowin,loss,beat,dlwin,0,10,13,201,0.517412935,0.034825871,0.587064677,3,0.95871112
13257,21,22210,3,8,10,0,0,21,10,10,0,0,0,20,nowin,win,plwin,beat,20,0,11,214,0.359813084,0.042056075,0.626168224,0,0.025263474
13258,12,22210,8,3,10,0,0,21,10,10,0,0,0,20,nowin,win,plwin,beat,20,0,11,189,0.470899471,0.015873016,0.613756614,3,0.929171178
13259,55,22210,8,6,0,9,0,23,10,10,0,0,0,20,nowin,loss,bust,plbust,0,10,14,191,0.371727749,0.057591623,0.54973822,0,0.01011347
13260,2,22211,10,8,0,0,0,18,10,8,0,0,0,18,nowin,push,push,push,10,0,18,200,0.445,0.035,0.64,2,0.633962549
13261,103,22211,10,4,0,3,0,17,10,8,0,0,0,18,nowin,loss,beat,dlwin,0,10,14,203,0.379310345,0.064039409,0.551724138,0,0.012869209
13262,62,22211,4,6,5,6,0,21,10,8,0,0,0,18,nowin,win,plwin,beat,20,0,10,178,0.370786517,0.028089888,0.54494382,0,0.008657722
13263,146,22211,9,10,0,0,0,19,10,8,0,0,0,18,nowin,win,plwin,beat,20,0,19,221,0.43438914,0.040723982,0.542986425,1,0.290190091
13264,100,22211,4,1,8,10,0,23,10,8,0,0,0,18,nowin,loss,bust,plbust,0,10,5,190,0.452631579,0.036842105,0.594736842,3,0.888671154
13265,139,22211,5,1,10,7,0,23,10,8,0,0,0,18,nowin,loss,bust,plbust,0,10,6,192,0.380208333,0.036458333,0.59375,0,0.023429169
13266,5,22212,8,3,9,0,0,20,10,9,0,0,0,19,nowin,win,plwin,beat,20,0,11,203,0.42364532,0.02955665,0.596059113,2,0.582508076
13267,86,22212,10,8,0,0,0,18,10,9,0,0,0,19,nowin,loss,beat,dlwin,0,10,18,196,0.454081633,0.040816327,0.591836735,3,0.887566443
13268,71,22212,4,10,0,4,0,18,10,9,0,0,0,19,nowin,loss,beat,dlwin,0,10,14,193,0.352331606,0.046632124,0.585492228,0,0.013063661
13269,71,22212,9,8,0,0,0,17,10,9,0,0,0,19,nowin,loss,beat,dlwin,0,10,17,193,0.352331606,0.046632124,0.585492228,0,0.013063661
13270,40,22212,10,2,0,1,2,15,10,9,0,0,0,19,nowin,loss,beat,dlwin,0,10,12,196,0.367346939,0.030612245,0.617346939,0,0.025358183
13271,50,22212,4,8,0,6,0,18,10,9,0,0,0,19,nowin,loss,beat,dlwin,0,10,12,202,0.405940594,0.04950495,0.54950495,0,0.020296079
13272,109,22213,10,10,0,0,0,20,6,6,8,0,0,20,nowin,push,push,push,10,0,20,221,0.461538462,0.058823529,0.597285068,3,0.901830309
13273,120,22213,10,10,0,0,0,20,6,6,8,0,0,20,nowin,push,push,push,10,0,20,202,0.440594059,0.034653465,0.618811881,2,0.614441029
13274,19,22213,6,5,10,0,0,21,6,6,8,0,0,20,nowin,win,plwin,beat,20,0,11,237,0.41350211,0.054852321,0.628691983,2,0.597373826
13275,98,22213,9,2,7,0,0,18,6,6,8,0,0,20,nowin,loss,beat,dlwin,0,10,11,220,0.422727273,0.054545455,0.55,1,0.28664435
13276,99,22213,4,3,9,0,0,16,6,6,8,0,0,20,nowin,loss,beat,dlwin,0,10,7,207,0.47826087,0.062801932,0.637681159,3,0.961418446
13277,21,22213,2,10,0,0,0,12,6,6,8,0,0,20,nowin,loss,beat,dlwin,0,10,12,214,0.359813084,0.042056075,0.626168224,0,0.025263474
13278,38,22214,10,9,0,0,0,19,9,3,1,6,0,19,nowin,push,push,push,10,0,19,202,0.361386139,0.03960396,0.564356436,0,0.010597953
13279,102,22214,8,10,0,0,0,18,9,3,1,6,0,19,nowin,loss,beat,dlwin,0,10,18,192,0.338541667,0.046875,0.5625,0,0.003306118
13280,93,22214,10,7,0,0,0,17,9,3,1,6,0,19,nowin,loss,beat,dlwin,0,10,17,175,0.485714286,0.051428571,0.548571429,1,0.323648091
13281,89,22214,2,2,10,7,0,21,9,3,1,6,0,19,nowin,win,plwin,beat,20,0,4,212,0.537735849,0.047169811,0.594339623,3,0.990167191
13282,95,22214,10,2,0,10,0,22,9,3,1,6,0,19,nowin,loss,bust,plbust,0,10,12,218,0.412844037,0.04587156,0.559633028,0,0.024842385
13283,116,22214,9,7,0,1,0,17,9,3,1,6,0,19,nowin,loss,beat,dlwin,0,10,16,195,0.425641026,0.056410256,0.538461538,1,0.28273747
13284,20,22215,3,10,0,5,0,18,11,8,0,0,0,19,nowin,loss,beat,dlwin,0,10,13,186,0.456989247,0.037634409,0.537634409,1,0.301097108
13285,42,22215,4,2,10,4,0,20,11,8,0,0,0,19,nowin,win,plwin,beat,20,0,6,212,0.443396226,0.051886792,0.570754717,1,0.309181312
13286,125,22215,5,8,0,7,0,20,11,8,0,0,0,19,nowin,win,plwin,beat,20,0,13,219,0.438356164,0.050228311,0.575342466,1,0.308411257
13287,133,22215,3,4,7,10,0,24,11,8,0,0,0,19,nowin,loss,bust,plbust,0,10,7,201,0.47761194,0.064676617,0.611940299,3,0.935428111
13288,99,22215,4,10,0,8,0,22,11,8,0,0,0,19,nowin,loss,bust,plbust,0,10,14,207,0.47826087,0.062801932,0.637681159,3,0.961418446
13289,11,22215,10,6,0,6,0,22,11,8,0,0,0,19,nowin,loss,bust,plbust,0,10,16,236,0.457627119,0.016949153,0.588983051,3,0.889015813
13290,15,22216,6,10,0,0,0,16,4,10,9,0,0,23,nowin,win,dlbust,bust,20,0,16,212,0.410377358,0.051886792,0.561320755,0,0.024517408
13291,77,22216,2,8,11,0,0,21,4,10,9,0,0,23,nowin,win,dlbust,bust,20,0,10,200,0.455,0.04,0.62,3,0.916252116
13292,69,22216,4,8,0,0,0,12,4,10,9,0,0,23,nowin,win,dlbust,bust,20,0,12,194,0.365979381,0.030927835,0.515463918,0,0
13293,56,22216,5,10,0,0,0,15,4,10,9,0,0,23,nowin,win,dlbust,bust,20,0,15,175,0.4,0.057142857,0.582857143,0,0.026685297
13294,108,22216,9,10,0,0,0,19,4,10,9,0,0,23,nowin,win,dlbust,bust,20,0,19,193,0.435233161,0.056994819,0.559585492,1,0.298824795
13295,10,22216,6,2,10,0,0,18,4,10,9,0,0,23,nowin,win,dlbust,bust,20,0,8,191,0.413612565,0.057591623,0.596858639,2,0.574087175
13296,108,22217,6,6,0,1,7,20,10,10,0,0,0,20,nowin,push,push,push,10,0,12,193,0.435233161,0.056994819,0.559585492,1,0.298824795
13297,50,22217,2,10,0,4,10,26,10,10,0,0,0,20,nowin,loss,bust,plbust,0,10,12,202,0.405940594,0.04950495,0.54950495,0,0.020296079
13298,128,22217,5,6,2,7,0,20,10,10,0,0,0,20,nowin,push,push,push,10,0,11,227,0.356828194,0.052863436,0.577092511,0,0.012352564
13299,97,22217,6,3,10,0,0,19,10,10,0,0,0,20,nowin,loss,beat,dlwin,0,10,9,182,0.450549451,0.06043956,0.692307692,2,0.677372279
13300,17,22217,7,3,11,0,0,21,10,10,0,0,0,20,nowin,win,plwin,beat,20,0,10,171,0.444444444,0.070175439,0.555555556,1,0.302364894
13301,111,22217,2,8,11,0,0,21,10,10,0,0,0,20,nowin,win,plwin,beat,20,0,10,180,0.433333333,0.055555556,0.611111111,2,0.602264492
13302,52,22218,8,10,0,0,0,18,10,6,4,0,0,20,nowin,loss,beat,dlwin,0,10,18,217,0.414746544,0.02764977,0.599078341,2,0.576736024
13303,146,22218,10,11,0,0,0,21,10,6,4,0,0,20,win,win,plwin,beat,25,0,21,221,0.43438914,0.040723982,0.542986425,1,0.290190091
13304,6,22218,8,9,0,0,0,17,10,6,4,0,0,20,nowin,loss,beat,dlwin,0,10,17,191,0.439790576,0.047120419,0.581151832,1,0.31211505
13305,62,22218,8,10,0,0,0,18,10,6,4,0,0,20,nowin,loss,beat,dlwin,0,10,18,178,0.370786517,0.028089888,0.54494382,0,0.008657722
13306,125,22218,10,5,0,8,0,23,10,6,4,0,0,20,nowin,loss,bust,plbust,0,10,15,219,0.438356164,0.050228311,0.575342466,1,0.308411257
13307,95,22218,7,5,0,2,7,21,10,6,4,0,0,20,nowin,win,plwin,beat,20,0,12,218,0.412844037,0.04587156,0.559633028,0,0.024842385
13308,43,22219,3,2,10,8,0,23,9,11,0,0,0,20,nowin,loss,bust,plbust,0,10,5,192,0.40625,0.041666667,0.609375,2,0.576671372
13309,40,22219,8,10,0,0,0,18,9,11,0,0,0,20,nowin,loss,beat,dlwin,0,10,18,196,0.367346939,0.030612245,0.617346939,0,0.025358183
13310,16,22219,9,10,0,0,0,19,9,11,0,0,0,20,nowin,loss,beat,dlwin,0,10,19,220,0.427272727,0.081818182,0.6,2,0.588660176
13311,133,22219,10,8,0,0,0,18,9,11,0,0,0,20,nowin,loss,beat,dlwin,0,10,18,201,0.47761194,0.064676617,0.611940299,3,0.935428111
13312,89,22219,11,10,0,0,0,21,9,11,0,0,0,20,win,win,plwin,beat,25,0,21,212,0.537735849,0.047169811,0.594339623,3,0.990167191
13313,96,22219,10,4,0,3,0,17,9,11,0,0,0,20,nowin,loss,beat,dlwin,0,10,14,190,0.468421053,0.057894737,0.584210526,3,0.897263354
13314,135,22220,9,9,0,0,0,18,10,10,0,0,0,20,nowin,loss,beat,dlwin,0,10,18,179,0.391061453,0.067039106,0.586592179,0,0.024924662
13315,87,22220,2,2,9,8,0,21,10,10,0,0,0,20,nowin,win,plwin,beat,20,0,4,202,0.405940594,0.054455446,0.628712871,2,0.590599801
13316,87,22220,2,3,7,3,10,25,10,10,0,0,0,20,nowin,loss,bust,plbust,0,10,5,202,0.405940594,0.054455446,0.628712871,2,0.590599801
13317,14,22220,10,7,0,0,0,17,10,10,0,0,0,20,nowin,loss,beat,dlwin,0,10,17,202,0.391089109,0.01980198,0.628712871,2,0.577264877
13318,137,22220,4,10,0,6,0,20,10,10,0,0,0,20,nowin,push,push,push,10,0,14,194,0.417525773,0.046391753,0.536082474,1,0.276714602
13319,56,22220,10,7,0,0,0,17,10,10,0,0,0,20,nowin,loss,beat,dlwin,0,10,17,175,0.4,0.057142857,0.582857143,0,0.026685297
13320,60,22221,7,11,0,0,0,18,10,10,0,0,0,20,nowin,loss,beat,dlwin,0,10,18,227,0.418502203,0.022026432,0.559471366,0,0.026496258
13321,40,22221,7,4,10,0,0,21,10,10,0,0,0,20,nowin,win,plwin,beat,20,0,11,196,0.367346939,0.030612245,0.617346939,0,0.025358183
13322,50,22221,10,8,0,0,0,18,10,10,0,0,0,20,nowin,loss,beat,dlwin,0,10,18,202,0.405940594,0.04950495,0.54950495,0,0.020296079
13323,89,22221,4,1,10,10,0,25,10,10,0,0,0,20,nowin,loss,bust,plbust,0,10,5,212,0.537735849,0.047169811,0.594339623,3,0.990167191
13324,142,22221,11,6,3,0,0,20,10,10,0,0,0,20,nowin,push,push,push,10,0,17,211,0.417061611,0.047393365,0.526066351,1,0.271531309
13325,44,22221,10,10,0,0,0,20,10,10,0,0,0,20,nowin,push,push,push,10,0,20,219,0.433789954,0.050228311,0.534246575,1,0.285551035
13326,29,22222,5,10,0,7,0,22,10,2,10,0,0,22,nowin,loss,bust,plbust,0,10,15,189,0.44973545,0.058201058,0.544973545,1,0.300349439
13327,146,22222,2,8,9,0,0,19,10,2,10,0,0,22,nowin,win,dlbust,bust,20,0,10,221,0.43438914,0.040723982,0.542986425,1,0.290190091
13328,136,22222,4,2,10,1,0,17,10,2,10,0,0,22,nowin,win,dlbust,bust,20,0,6,194,0.396907216,0.025773196,0.597938144,0,0.029452644
13329,70,22222,10,5,0,6,0,21,10,2,10,0,0,22,nowin,win,dlbust,bust,20,0,15,228,0.385964912,0.039473684,0.557017544,0,0.016157125
13330,100,22222,7,9,0,2,0,18,10,2,10,0,0,22,nowin,win,dlbust,bust,20,0,16,190,0.452631579,0.036842105,0.594736842,3,0.888671154
13331,104,22222,9,11,0,0,0,20,10,2,10,0,0,22,nowin,win,dlbust,bust,20,0,20,209,0.363636364,0.052631579,0.593301435,0,0.018359419
13332,103,22223,11,1,8,0,0,20,9,10,0,0,0,19,nowin,win,plwin,beat,20,0,12,203,0.379310345,0.064039409,0.551724138,0,0.012869209
13333,142,22223,10,3,0,10,0,23,9,10,0,0,0,19,nowin,loss,bust,plbust,0,10,13,211,0.417061611,0.047393365,0.526066351,1,0.271531309
13334,106,22223,3,10,0,3,10,26,9,10,0,0,0,19,nowin,loss,bust,plbust,0,10,13,192,0.411458333,0.026041667,0.557291667,0,0.023854304
13335,3,22223,10,3,0,10,0,23,9,10,0,0,0,19,nowin,loss,bust,plbust,0,10,13,190,0.431578947,0.026315789,0.542105263,1,0.288076384
13336,34,22223,9,10,0,0,0,19,9,10,0,0,0,19,nowin,push,push,push,10,0,19,202,0.5,0.079207921,0.618811881,3,0.968961434
13337,146,22223,10,5,0,3,0,18,9,10,0,0,0,19,nowin,loss,beat,dlwin,0,10,15,221,0.43438914,0.040723982,0.542986425,1,0.290190091
13338,63,22224,10,10,0,0,0,20,3,7,4,6,0,20,nowin,push,push,push,10,0,20,216,0.467592593,0.037037037,0.62037037,3,0.931690496
13339,106,22224,5,2,10,0,0,17,3,7,4,6,0,20,nowin,loss,beat,dlwin,0,10,7,192,0.411458333,0.026041667,0.557291667,0,0.023854304
13340,11,22224,8,10,0,0,0,18,3,7,4,6,0,20,nowin,loss,beat,dlwin,0,10,18,236,0.457627119,0.016949153,0.588983051,3,0.889015813
13341,115,22224,9,5,0,0,0,14,3,7,4,6,0,20,nowin,loss,beat,dlwin,0,10,14,194,0.427835052,0.041237113,0.592783505,2,0.583863602
13342,47,22224,9,7,0,0,0,16,3,7,4,6,0,20,nowin,loss,beat,dlwin,0,10,16,210,0.438095238,0.057142857,0.623809524,2,0.615868808
13343,112,22224,3,6,2,10,0,21,3,7,4,6,0,20,nowin,win,plwin,beat,20,0,9,203,0.448275862,0.054187192,0.600985222,3,0.889576933
13344,99,22225,7,10,0,0,0,17,10,3,10,0,0,23,nowin,win,dlbust,bust,20,0,17,207,0.47826087,0.062801932,0.637681159,3,0.961418446
13345,50,22225,8,7,0,7,0,22,10,3,10,0,0,23,nowin,loss,bust,plbust,0,10,15,202,0.405940594,0.04950495,0.54950495,0,0.020296079
13346,34,22225,5,8,0,10,0,23,10,3,10,0,0,23,nowin,loss,bust,plbust,0,10,13,202,0.5,0.079207921,0.618811881,3,0.968961434
13347,109,22225,8,5,0,1,5,19,10,3,10,0,0,23,nowin,win,dlbust,bust,20,0,13,221,0.461538462,0.058823529,0.597285068,3,0.901830309
13348,109,22225,10,8,0,0,0,18,10,3,10,0,0,23,nowin,win,dlbust,bust,20,0,18,221,0.461538462,0.058823529,0.597285068,3,0.901830309
13349,111,22225,10,3,0,5,0,18,10,3,10,0,0,23,nowin,win,dlbust,bust,20,0,13,180,0.433333333,0.055555556,0.611111111,2,0.602264492
13350,28,22226,11,10,0,0,0,21,9,11,0,0,0,20,win,win,plwin,beat,25,0,21,199,0.422110553,0.045226131,0.542713568,1,0.282706618
13351,132,22226,6,9,0,10,0,25,9,11,0,0,0,20,nowin,loss,bust,plbust,0,10,15,194,0.412371134,0.036082474,0.649484536,2,0.611633238
13352,106,22226,3,10,0,4,0,17,9,11,0,0,0,20,nowin,loss,beat,dlwin,0,10,13,192,0.411458333,0.026041667,0.557291667,0,0.023854304
13353,118,22226,8,11,0,0,0,19,9,11,0,0,0,20,nowin,loss,beat,dlwin,0,10,19,216,0.393518519,0.037037037,0.555555556,0,0.018059873
13354,55,22226,2,5,7,8,0,22,9,11,0,0,0,20,nowin,loss,bust,plbust,0,10,7,191,0.371727749,0.057591623,0.54973822,0,0.01011347
13355,114,22226,6,11,3,0,0,20,9,11,0,0,0,20,nowin,push,push,push,10,0,17,198,0.47979798,0.025252525,0.611111111,3,0.937232995
13356,140,22227,10,4,0,0,0,14,2,5,4,4,9,24,nowin,win,dlbust,bust,20,0,14,210,0.466666667,0.023809524,0.604761905,3,0.915293335
13357,4,22227,10,8,0,0,0,18,2,5,4,4,9,24,nowin,win,dlbust,bust,20,0,18,217,0.460829493,0.036866359,0.562211982,1,0.315432839
13358,29,22227,9,4,0,0,0,13,2,5,4,4,9,24,nowin,win,dlbust,bust,20,0,13,189,0.44973545,0.058201058,0.544973545,1,0.300349439
13359,106,22227,6,10,0,0,0,16,2,5,4,4,9,24,nowin,win,dlbust,bust,20,0,16,192,0.411458333,0.026041667,0.557291667,0,0.023854304
13360,50,22227,2,3,7,6,0,18,2,5,4,4,9,24,nowin,win,dlbust,bust,20,0,5,202,0.405940594,0.04950495,0.54950495,0,0.020296079
13361,67,22227,10,5,0,0,0,15,2,5,4,4,9,24,nowin,win,dlbust,bust,20,0,15,195,0.369230769,0.041025641,0.569230769,0,0.014139427
13362,20,22228,10,8,0,0,0,18,8,8,9,0,0,25,nowin,win,dlbust,bust,20,0,18,186,0.456989247,0.037634409,0.537634409,1,0.301097108
13363,47,22228,8,10,0,0,0,18,8,8,9,0,0,25,nowin,win,dlbust,bust,20,0,18,210,0.438095238,0.057142857,0.623809524,2,0.615868808
13364,113,22228,4,10,0,6,0,20,8,8,9,0,0,25,nowin,win,dlbust,bust,20,0,14,199,0.407035176,0.055276382,0.668341709,2,0.620695264
13365,95,22228,10,4,0,9,0,23,8,8,9,0,0,25,nowin,loss,bust,plbust,0,10,14,218,0.412844037,0.04587156,0.559633028,0,0.024842385
13366,96,22228,7,10,0,0,0,17,8,8,9,0,0,25,nowin,win,dlbust,bust,20,0,17,190,0.468421053,0.057894737,0.584210526,3,0.897263354
13367,136,22228,4,11,1,3,0,19,8,8,9,0,0,25,nowin,win,dlbust,bust,20,0,15,194,0.396907216,0.025773196,0.597938144,0,0.029452644
13368,148,22229,9,6,0,9,0,24,7,6,10,0,0,23,nowin,loss,bust,plbust,0,10,15,204,0.401960784,0.078431373,0.593137255,0,0.029789521
13369,23,22229,2,6,2,8,0,18,7,6,10,0,0,23,nowin,win,dlbust,bust,20,0,8,208,0.427884615,0.0625,0.552884615,1,0.29114424
13370,125,22229,6,10,0,3,0,19,7,6,10,0,0,23,nowin,win,dlbust,bust,20,0,16,219,0.438356164,0.050228311,0.575342466,1,0.308411257
13371,5,22229,10,8,0,0,0,18,7,6,10,0,0,23,nowin,win,dlbust,bust,20,0,18,203,0.42364532,0.02955665,0.596059113,2,0.582508076
13372,18,22229,9,11,0,0,0,20,7,6,10,0,0,23,nowin,win,dlbust,bust,20,0,20,182,0.461538462,0.043956044,0.587912088,3,0.892649374
13373,13,22229,2,1,10,1,6,20,7,6,10,0,0,23,nowin,win,dlbust,bust,20,0,3,206,0.417475728,0.063106796,0.621359223,2,0.59555479
13374,90,22230,4,10,0,10,0,24,8,7,8,0,0,23,nowin,loss,bust,plbust,0,10,14,201,0.447761194,0.049751244,0.60199005,3,0.889945023
13375,51,22230,10,8,0,0,0,18,8,7,8,0,0,23,nowin,win,dlbust,bust,20,0,18,189,0.529100529,0.068783069,0.608465608,3,0.993665715
13376,61,22230,9,5,0,4,0,18,8,7,8,0,0,23,nowin,win,dlbust,bust,20,0,14,194,0.427835052,0.077319588,0.603092784,2,0.591437139
13377,150,22230,10,2,0,3,3,18,8,7,8,0,0,23,nowin,win,dlbust,bust,20,0,12,192,0.401041667,0.036458333,0.567708333,0,0.023287458
13378,54,22230,10,6,0,7,0,23,8,7,8,0,0,23,nowin,loss,bust,plbust,0,10,16,185,0.437837838,0.032432432,0.556756757,1,0.29899854
13379,114,22230,2,10,0,10,0,22,8,7,8,0,0,23,nowin,loss,bust,plbust,0,10,12,198,0.47979798,0.025252525,0.611111111,3,0.937232995
13380,119,22231,9,10,0,0,0,19,7,10,0,0,0,17,nowin,win,plwin,beat,20,0,19,190,0.405263158,0.068421053,0.515789474,0,0.011837158
13381,133,22231,4,10,0,5,0,19,7,10,0,0,0,17,nowin,win,plwin,beat,20,0,14,201,0.47761194,0.064676617,0.611940299,3,0.935428111
13382,42,22231,10,7,0,0,0,17,7,10,0,0,0,17,nowin,push,push,push,10,0,17,212,0.443396226,0.051886792,0.570754717,1,0.309181312
13383,137,22231,7,8,0,4,0,19,7,10,0,0,0,17,nowin,win,plwin,beat,20,0,15,194,0.417525773,0.046391753,0.536082474,1,0.276714602
13384,16,22231,10,11,0,0,0,21,7,10,0,0,0,17,win,win,plwin,beat,25,0,21,220,0.427272727,0.081818182,0.6,2,0.588660176
13385,133,22231,11,2,8,0,0,21,7,10,0,0,0,17,nowin,win,plwin,beat,20,0,13,201,0.47761194,0.064676617,0.611940299,3,0.935428111
13386,92,22232,10,5,0,2,0,17,7,11,0,0,0,18,nowin,loss,beat,dlwin,0,10,15,186,0.446236559,0.059139785,0.564516129,1,0.307826125
13387,91,22232,2,7,2,7,0,18,7,11,0,0,0,18,nowin,push,push,push,10,0,9,194,0.417525773,0.046391753,0.515463918,1,0.266616552
13388,44,22232,3,10,0,1,4,18,7,11,0,0,0,18,nowin,push,push,push,10,0,13,219,0.433789954,0.050228311,0.534246575,1,0.285551035
13389,77,22232,5,11,3,0,0,19,7,11,0,0,0,18,nowin,win,plwin,beat,20,0,16,200,0.455,0.04,0.62,3,0.916252116
13390,144,22232,4,10,0,8,0,22,7,11,0,0,0,18,nowin,loss,bust,plbust,0,10,14,202,0.386138614,0.054455446,0.564356436,0,0.018006244
13391,39,22232,8,8,0,4,0,20,7,11,0,0,0,18,nowin,win,plwin,beat,20,0,16,191,0.429319372,0.062827225,0.57591623,0,0.033760763
13392,140,22233,2,10,0,7,0,19,10,3,7,0,0,20,nowin,loss,beat,dlwin,0,10,12,210,0.466666667,0.023809524,0.604761905,3,0.915293335
13393,67,22233,5,2,9,10,0,26,10,3,7,0,0,20,nowin,loss,bust,plbust,0,10,7,195,0.369230769,0.041025641,0.569230769,0,0.014139427
13394,125,22233,7,10,0,0,0,17,10,3,7,0,0,20,nowin,loss,beat,dlwin,0,10,17,219,0.438356164,0.050228311,0.575342466,1,0.308411257
13395,68,22233,4,6,10,0,0,20,10,3,7,0,0,20,nowin,push,push,push,10,0,10,205,0.434146341,0.029268293,0.6,2,0.59483189
13396,61,22233,9,9,0,0,0,18,10,3,7,0,0,20,nowin,loss,beat,dlwin,0,10,18,194,0.427835052,0.077319588,0.603092784,2,0.591437139
13397,27,22233,3,3,10,9,0,25,10,3,7,0,0,20,nowin,loss,bust,plbust,0,10,6,178,0.370786517,0.016853933,0.573033708,0,0.015536309
13398,142,22234,6,7,0,4,0,17,7,3,5,10,0,25,nowin,win,dlbust,bust,20,0,13,211,0.417061611,0.047393365,0.526066351,1,0.271531309
13399,101,22234,10,7,0,0,0,17,7,3,5,10,0,25,nowin,win,dlbust,bust,20,0,17,205,0.424390244,0.068292683,0.63902439,2,0.614740646
13400,8,22234,10,7,0,0,0,17,7,3,5,10,0,25,nowin,win,dlbust,bust,20,0,17,181,0.44198895,0.071823204,0.596685083,2,0.599438402
13401,119,22234,1,6,10,0,0,17,7,3,5,10,0,25,nowin,win,dlbust,bust,20,0,7,190,0.405263158,0.068421053,0.515789474,0,0.011837158
13402,3,22234,10,10,0,0,0,20,7,3,5,10,0,25,nowin,win,dlbust,bust,20,0,20,190,0.431578947,0.026315789,0.542105263,1,0.288076384
13403,99,22234,10,9,0,0,0,19,7,3,5,10,0,25,nowin,win,dlbust,bust,20,0,19,207,0.47826087,0.062801932,0.637681159,3,0.961418446
13404,21,22235,10,10,0,0,0,20,2,10,1,8,0,21,nowin,loss,beat,dlwin,0,10,20,214,0.359813084,0.042056075,0.626168224,0,0.025263474
13405,65,22235,10,10,0,0,0,20,2,10,1,8,0,21,nowin,loss,beat,dlwin,0,10,20,203,0.492610837,0.054187192,0.571428571,3,0.913702814
13406,147,22235,10,7,0,0,0,17,2,10,1,8,0,21,nowin,loss,beat,dlwin,0,10,17,205,0.380487805,0.014634146,0.536585366,0,0.00951447
13407,9,22235,9,10,0,0,0,19,2,10,1,8,0,21,nowin,loss,beat,dlwin,0,10,19,194,0.37628866,0.015463918,0.541237113,0,0.009396796
13408,111,22235,10,10,0,0,0,20,2,10,1,8,0,21,nowin,loss,beat,dlwin,0,10,20,180,0.433333333,0.055555556,0.611111111,2,0.602264492
13409,55,22235,11,10,0,0,0,21,2,10,1,8,0,21,win,push,push,push,10,0,21,191,0.371727749,0.057591623,0.54973822,0,0.01011347
13410,121,22236,5,1,10,10,0,26,9,7,4,0,0,20,nowin,loss,bust,plbust,0,10,6,195,0.456410256,0.025641026,0.512820513,1,0.288597791
13411,38,22236,10,10,0,0,0,20,9,7,4,0,0,20,nowin,push,push,push,10,0,20,202,0.361386139,0.03960396,0.564356436,0,0.010597953
13412,105,22236,10,6,0,1,0,17,9,7,4,0,0,20,nowin,loss,beat,dlwin,0,10,16,198,0.414141414,0.070707071,0.590909091,0,0.032889494
13413,140,22236,8,10,0,0,0,18,9,7,4,0,0,20,nowin,loss,beat,dlwin,0,10,18,210,0.466666667,0.023809524,0.604761905,3,0.915293335
13414,21,22236,6,10,0,3,0,19,9,7,4,0,0,20,nowin,loss,beat,dlwin,0,10,16,214,0.359813084,0.042056075,0.626168224,0,0.025263474
13415,20,22236,5,10,0,6,0,21,9,7,4,0,0,20,nowin,win,plwin,beat,20,0,15,186,0.456989247,0.037634409,0.537634409,1,0.301097108
13416,32,22237,10,3,0,0,0,13,6,10,7,0,0,23,nowin,win,dlbust,bust,20,0,13,189,0.391534392,0.037037037,0.53968254,0,0.013579086
13417,125,22237,11,10,0,0,0,21,6,10,7,0,0,23,win,win,dlbust,bust,25,0,21,219,0.438356164,0.050228311,0.575342466,1,0.308411257
13418,146,22237,6,11,1,0,0,18,6,10,7,0,0,23,nowin,win,dlbust,bust,20,0,17,221,0.43438914,0.040723982,0.542986425,1,0.290190091
13419,33,22237,9,11,0,0,0,20,6,10,7,0,0,23,nowin,win,dlbust,bust,20,0,20,192,0.4375,0.057291667,0.625,2,0.616208916
13420,83,22237,5,8,0,0,0,13,6,10,7,0,0,23,nowin,win,dlbust,bust,20,0,13,193,0.424870466,0.051813472,0.678756477,2,0.644360335
13421,140,22237,9,10,0,0,0,19,6,10,7,0,0,23,nowin,win,dlbust,bust,20,0,19,210,0.466666667,0.023809524,0.604761905,3,0.915293335
13422,128,22238,3,3,10,1,0,17,8,10,0,0,0,18,nowin,loss,beat,dlwin,0,10,6,227,0.356828194,0.052863436,0.577092511,0,0.012352564
13423,103,22238,10,10,0,0,0,20,8,10,0,0,0,18,nowin,win,plwin,beat,20,0,20,203,0.379310345,0.064039409,0.551724138,0,0.012869209
13424,99,22238,10,4,0,6,0,20,8,10,0,0,0,18,nowin,win,plwin,beat,20,0,14,207,0.47826087,0.062801932,0.637681159,3,0.961418446
13425,134,22238,9,10,0,0,0,19,8,10,0,0,0,18,nowin,win,plwin,beat,20,0,19,185,0.443243243,0.021621622,0.545945946,1,0.296939509
13426,45,22238,7,4,2,10,0,23,8,10,0,0,0,18,nowin,loss,bust,plbust,0,10,11,196,0.428571429,0.051020408,0.612244898,2,0.598821767
13427,13,22238,3,5,9,0,0,17,8,10,0,0,0,18,nowin,loss,beat,dlwin,0,10,8,206,0.417475728,0.063106796,0.621359223,2,0.59555479
13428,28,22239,3,10,0,6,0,19,10,3,8,0,0,21,nowin,loss,beat,dlwin,0,10,13,199,0.422110553,0.045226131,0.542713568,1,0.282706618
13429,41,22239,5,10,0,9,0,24,10,3,8,0,0,21,nowin,loss,bust,plbust,0,10,15,192,0.364583333,0.036458333,0.520833333,0,0.00089702
13430,81,22239,5,8,0,10,0,23,10,3,8,0,0,21,nowin,loss,bust,plbust,0,10,13,182,0.395604396,0.043956044,0.60989011,2,0.567491261
13431,16,22239,4,6,7,0,0,17,10,3,8,0,0,21,nowin,loss,beat,dlwin,0,10,10,220,0.427272727,0.081818182,0.6,2,0.588660176
13432,132,22239,3,2,4,5,4,18,10,3,8,0,0,21,nowin,loss,beat,dlwin,0,10,5,194,0.412371134,0.036082474,0.649484536,2,0.611633238
13433,102,22239,8,11,0,0,0,19,10,3,8,0,0,21,nowin,loss,beat,dlwin,0,10,19,192,0.338541667,0.046875,0.5625,0,0.003306118
13434,119,22240,8,5,0,10,0,23,10,7,0,0,0,17,nowin,loss,bust,plbust,0,10,13,190,0.405263158,0.068421053,0.515789474,0,0.011837158
13435,41,22240,1,4,10,6,0,21,10,7,0,0,0,17,nowin,win,plwin,beat,20,0,5,192,0.364583333,0.036458333,0.520833333,0,0.00089702
13436,46,22240,10,9,0,0,0,19,10,7,0,0,0,17,nowin,win,plwin,beat,20,0,19,186,0.403225806,0.048387097,0.591397849,0,0.029742194
13437,75,22240,10,8,0,0,0,18,10,7,0,0,0,17,nowin,win,plwin,beat,20,0,18,191,0.418848168,0.052356021,0.570680628,0,0.029344702
13438,101,22240,11,4,2,0,0,17,10,7,0,0,0,17,nowin,push,push,push,10,0,15,205,0.424390244,0.068292683,0.63902439,2,0.614740646
13439,79,22240,10,10,0,0,0,20,10,7,0,0,0,17,nowin,win,plwin,beat,20,0,20,211,0.436018957,0.028436019,0.672985782,2,0.650131054
13440,49,22241,10,5,0,0,0,15,3,8,9,0,0,20,nowin,loss,beat,dlwin,0,10,15,207,0.396135266,0.053140097,0.594202899,0,0.028306925
13441,15,22241,2,7,2,4,0,15,3,8,9,0,0,20,nowin,loss,beat,dlwin,0,10,9,212,0.410377358,0.051886792,0.561320755,0,0.024517408
13442,134,22241,10,4,0,0,0,14,3,8,9,0,0,20,nowin,loss,beat,dlwin,0,10,14,185,0.443243243,0.021621622,0.545945946,1,0.296939509
13443,46,22241,10,10,0,0,0,20,3,8,9,0,0,20,nowin,push,push,push,10,0,20,186,0.403225806,0.048387097,0.591397849,0,0.029742194
13444,87,22241,9,10,0,0,0,19,3,8,9,0,0,20,nowin,loss,beat,dlwin,0,10,19,202,0.405940594,0.054455446,0.628712871,2,0.590599801
13445,21,22241,8,10,0,0,0,18,3,8,9,0,0,20,nowin,loss,beat,dlwin,0,10,18,214,0.359813084,0.042056075,0.626168224,0,0.025263474
13446,43,22242,11,8,0,0,0,19,6,5,8,0,0,19,nowin,push,push,push,10,0,19,192,0.40625,0.041666667,0.609375,2,0.576671372
13447,39,22242,10,4,0,0,0,14,6,5,8,0,0,19,nowin,loss,beat,dlwin,0,10,14,191,0.429319372,0.062827225,0.57591623,0,0.033760763
13448,93,22242,11,5,4,0,0,20,6,5,8,0,0,19,nowin,win,plwin,beat,20,0,16,175,0.485714286,0.051428571,0.548571429,1,0.323648091
13449,59,22242,4,8,0,0,0,12,6,5,8,0,0,19,nowin,loss,beat,dlwin,0,10,12,228,0.429824561,0.048245614,0.543859649,1,0.287885446
13450,81,22242,9,10,0,0,0,19,6,5,8,0,0,19,nowin,push,push,push,10,0,19,182,0.395604396,0.043956044,0.60989011,2,0.567491261
13451,104,22242,5,10,0,0,0,15,6,5,8,0,0,19,nowin,loss,beat,dlwin,0,10,15,209,0.363636364,0.052631579,0.593301435,0,0.018359419
13452,39,22243,10,10,0,0,0,20,10,5,3,0,0,18,nowin,win,plwin,beat,20,0,20,191,0.429319372,0.062827225,0.57591623,0,0.033760763
13453,100,22243,1,2,10,9,0,22,10,5,3,0,0,18,nowin,loss,bust,plbust,0,10,3,190,0.452631579,0.036842105,0.594736842,3,0.888671154
13454,53,22243,8,10,0,0,0,18,10,5,3,0,0,18,nowin,push,push,push,10,0,18,250,0.372,0.064,0.564,0,0.013687345
13455,73,22243,10,9,0,0,0,19,10,5,3,0,0,18,nowin,win,plwin,beat,20,0,19,181,0.375690608,0.011049724,0.596685083,0,0.022795773
13456,116,22243,7,5,0,3,8,23,10,5,3,0,0,18,nowin,loss,bust,plbust,0,10,12,195,0.425641026,0.056410256,0.538461538,1,0.28273747
13457,110,22243,3,5,4,10,0,22,10,5,3,0,0,18,nowin,loss,bust,plbust,0,10,8,192,0.416666667,0.046875,0.557291667,0,0.025413132
13458,118,22244,3,3,4,4,10,24,10,6,10,0,0,26,nowin,loss,bust,plbust,0,10,6,216,0.393518519,0.037037037,0.555555556,0,0.018059873
13459,130,22244,10,11,0,0,0,21,10,6,10,0,0,26,win,win,dlbust,bust,25,0,21,219,0.410958904,0.03652968,0.566210046,0,0.025888739
13460,56,22244,9,2,3,2,5,21,10,6,10,0,0,26,nowin,win,dlbust,bust,20,0,11,175,0.4,0.057142857,0.582857143,0,0.026685297
13461,30,22244,2,2,3,10,0,17,10,6,10,0,0,26,nowin,win,dlbust,bust,20,0,4,206,0.393203883,0.033980583,0.601941748,0,0.029324648
13462,44,22244,8,10,0,0,0,18,10,6,10,0,0,26,nowin,win,dlbust,bust,20,0,18,219,0.433789954,0.050228311,0.534246575,1,0.285551035
13463,116,22244,4,11,5,0,0,20,10,6,10,0,0,26,nowin,win,dlbust,bust,20,0,15,195,0.425641026,0.056410256,0.538461538,1,0.28273747
13464,32,22245,5,6,10,0,0,21,2,10,5,0,0,17,nowin,win,plwin,beat,20,0,11,189,0.391534392,0.037037037,0.53968254,0,0.013579086
13465,82,22245,10,10,0,0,0,20,2,10,5,0,0,17,nowin,win,plwin,beat,20,0,20,225,0.408888889,0.075555556,0.577777778,0,0.028101874
13466,113,22245,7,3,10,0,0,20,2,10,5,0,0,17,nowin,win,plwin,beat,20,0,10,199,0.407035176,0.055276382,0.668341709,2,0.620695264
13467,18,22245,6,2,9,0,0,17,2,10,5,0,0,17,nowin,push,push,push,10,0,8,182,0.461538462,0.043956044,0.587912088,3,0.892649374
13468,7,22245,5,10,0,0,0,15,2,10,5,0,0,17,nowin,loss,beat,dlwin,0,10,15,183,0.442622951,0.06010929,0.62295082,2,0.619303341
13469,7,22245,11,10,0,0,0,21,2,10,5,0,0,17,win,win,plwin,beat,25,0,21,183,0.442622951,0.06010929,0.62295082,2,0.619303341
13470,105,22246,10,2,0,10,0,22,8,10,0,0,0,18,nowin,loss,bust,plbust,0,10,12,198,0.414141414,0.070707071,0.590909091,0,0.032889494
13471,62,22246,6,10,0,10,0,26,8,10,0,0,0,18,nowin,loss,bust,plbust,0,10,16,178,0.370786517,0.028089888,0.54494382,0,0.008657722
13472,140,22246,5,9,0,6,0,20,8,10,0,0,0,18,nowin,win,plwin,beat,20,0,14,210,0.466666667,0.023809524,0.604761905,3,0.915293335
13473,36,22246,10,10,0,0,0,20,8,10,0,0,0,18,nowin,win,plwin,beat,20,0,20,229,0.445414847,0.056768559,0.655021834,2,0.645370571
13474,48,22246,7,6,0,10,0,23,8,10,0,0,0,18,nowin,loss,bust,plbust,0,10,13,203,0.413793103,0.019704433,0.600985222,2,0.577280801
13475,33,22246,8,2,9,0,0,19,8,10,0,0,0,18,nowin,win,plwin,beat,20,0,10,192,0.4375,0.057291667,0.625,2,0.616208916
13476,43,22247,3,5,4,7,0,19,11,10,0,0,0,21,nowin,loss,beat,dlwin,0,10,8,192,0.40625,0.041666667,0.609375,2,0.576671372
13477,74,22247,7,3,3,5,0,18,11,10,0,0,0,21,nowin,loss,beat,dlwin,0,10,10,209,0.411483254,0.04784689,0.531100478,0,0.017448125
13478,12,22247,7,5,0,5,0,17,11,10,0,0,0,21,nowin,loss,beat,dlwin,0,10,12,189,0.470899471,0.015873016,0.613756614,3,0.929171178
13479,78,22247,7,4,10,0,0,21,11,10,0,0,0,21,nowin,push,push,push,10,0,11,201,0.517412935,0.034825871,0.587064677,3,0.95871112
13480,60,22247,11,4,4,0,0,19,11,10,0,0,0,21,nowin,loss,beat,dlwin,0,10,15,227,0.418502203,0.022026432,0.559471366,0,0.026496258
13481,82,22247,10,11,0,0,0,21,11,10,0,0,0,21,win,push,push,push,10,0,21,225,0.408888889,0.075555556,0.577777778,0,0.028101874
13482,10,22248,4,7,5,8,0,24,7,10,0,0,0,17,nowin,loss,bust,plbust,0,10,11,191,0.413612565,0.057591623,0.596858639,2,0.574087175
13483,3,22248,7,8,0,3,0,18,7,10,0,0,0,17,nowin,win,plwin,beat,20,0,15,190,0.431578947,0.026315789,0.542105263,1,0.288076384
13484,14,22248,6,2,9,0,0,17,7,10,0,0,0,17,nowin,push,push,push,10,0,8,202,0.391089109,0.01980198,0.628712871,2,0.577264877
13485,68,22248,10,8,0,0,0,18,7,10,0,0,0,17,nowin,win,plwin,beat,20,0,18,205,0.434146341,0.029268293,0.6,2,0.59483189
13486,36,22248,6,5,1,6,0,18,7,10,0,0,0,17,nowin,win,plwin,beat,20,0,11,229,0.445414847,0.056768559,0.655021834,2,0.645370571
13487,31,22248,6,3,10,0,0,19,7,10,0,0,0,17,nowin,win,plwin,beat,20,0,9,188,0.473404255,0.058510638,0.515957447,1,0.300306557
13488,106,22249,5,5,4,10,0,24,10,6,10,0,0,26,nowin,loss,bust,plbust,0,10,10,192,0.411458333,0.026041667,0.557291667,0,0.023854304
13489,38,22249,3,7,4,10,0,24,10,6,10,0,0,26,nowin,loss,bust,plbust,0,10,10,202,0.361386139,0.03960396,0.564356436,0,0.010597953
13490,52,22249,8,6,0,9,0,23,10,6,10,0,0,26,nowin,loss,bust,plbust,0,10,14,217,0.414746544,0.02764977,0.599078341,2,0.576736024
13491,101,22249,8,5,0,2,10,25,10,6,10,0,0,26,nowin,loss,bust,plbust,0,10,13,205,0.424390244,0.068292683,0.63902439,2,0.614740646
13492,119,22249,4,2,2,10,0,18,10,6,10,0,0,26,nowin,win,dlbust,bust,20,0,6,190,0.405263158,0.068421053,0.515789474,0,0.011837158
13493,121,22249,3,10,0,10,0,23,10,6,10,0,0,26,nowin,loss,bust,plbust,0,10,13,195,0.456410256,0.025641026,0.512820513,1,0.288597791
13494,63,22250,5,10,0,5,0,20,10,10,0,0,0,20,nowin,push,push,push,10,0,15,216,0.467592593,0.037037037,0.62037037,3,0.931690496
13495,108,22250,2,9,6,0,0,17,10,10,0,0,0,20,nowin,loss,beat,dlwin,0,10,11,193,0.435233161,0.056994819,0.559585492,1,0.298824795
13496,112,22250,11,6,2,0,0,19,10,10,0,0,0,20,nowin,loss,beat,dlwin,0,10,17,203,0.448275862,0.054187192,0.600985222,3,0.889576933
13497,86,22250,4,5,11,0,0,20,10,10,0,0,0,20,nowin,push,push,push,10,0,9,196,0.454081633,0.040816327,0.591836735,3,0.887566443
13498,125,22250,9,3,0,2,10,24,10,10,0,0,0,20,nowin,loss,bust,plbust,0,10,12,219,0.438356164,0.050228311,0.575342466,1,0.308411257
13499,144,22250,10,2,0,4,10,26,10,10,0,0,0,20,nowin,loss,bust,plbust,0,10,12,202,0.386138614,0.054455446,0.564356436,0,0.018006244
13500,17,22251,10,2,0,3,5,20,10,9,0,0,0,19,nowin,win,plwin,beat,20,0,12,171,0.444444444,0.070175439,0.555555556,1,0.302364894
13501,63,22251,9,2,6,0,0,17,10,9,0,0,0,19,nowin,loss,beat,dlwin,0,10,11,216,0.467592593,0.037037037,0.62037037,3,0.931690496
13502,87,22251,11,10,0,0,0,21,10,9,0,0,0,19,win,win,plwin,beat,25,0,21,202,0.405940594,0.054455446,0.628712871,2,0.590599801
13503,109,22251,10,3,0,6,0,19,10,9,0,0,0,19,nowin,push,push,push,10,0,13,221,0.461538462,0.058823529,0.597285068,3,0.901830309
13504,118,22251,6,10,0,10,0,26,10,9,0,0,0,19,nowin,loss,bust,plbust,0,10,16,216,0.393518519,0.037037037,0.555555556,0,0.018059873
13505,100,22251,5,5,10,0,0,20,10,9,0,0,0,19,nowin,win,plwin,beat,20,0,10,190,0.452631579,0.036842105,0.594736842,3,0.888671154
13506,37,22252,5,4,3,10,0,22,11,5,5,0,0,21,nowin,loss,bust,plbust,0,10,9,208,0.394230769,0.038461538,0.581730769,0,0.024682772
13507,38,22252,11,2,3,7,0,23,11,5,5,0,0,21,nowin,loss,bust,plbust,0,10,13,202,0.361386139,0.03960396,0.564356436,0,0.010597953
13508,68,22252,3,9,0,1,5,18,11,5,5,0,0,21,nowin,loss,beat,dlwin,0,10,12,205,0.434146341,0.029268293,0.6,2,0.59483189
13509,88,22252,6,8,0,10,0,24,11,5,5,0,0,21,nowin,loss,bust,plbust,0,10,14,206,0.466019417,0.033980583,0.54368932,1,0.309467903
13510,41,22252,10,2,0,10,0,22,11,5,5,0,0,21,nowin,loss,bust,plbust,0,10,12,192,0.364583333,0.036458333,0.520833333,0,0.00089702
13511,32,22252,2,8,10,0,0,20,11,5,5,0,0,21,nowin,loss,beat,dlwin,0,10,10,189,0.391534392,0.037037037,0.53968254,0,0.013579086
13512,55,22253,10,7,0,0,0,17,5,6,5,9,0,25,nowin,win,dlbust,bust,20,0,17,191,0.371727749,0.057591623,0.54973822,0,0.01011347
13513,2,22253,4,10,0,0,0,14,5,6,5,9,0,25,nowin,win,dlbust,bust,20,0,14,200,0.445,0.035,0.64,2,0.633962549
13514,140,22253,10,9,0,0,0,19,5,6,5,9,0,25,nowin,win,dlbust,bust,20,0,19,210,0.466666667,0.023809524,0.604761905,3,0.915293335
13515,24,22253,10,11,0,0,0,21,5,6,5,9,0,25,win,win,dlbust,bust,25,0,21,207,0.458937198,0.048309179,0.570048309,1,0.318138014
13516,57,22253,10,6,0,0,0,16,5,6,5,9,0,25,nowin,win,dlbust,bust,20,0,16,192,0.46875,0.052083333,0.59375,3,0.907001181
13517,129,22253,9,11,0,0,0,20,5,6,5,9,0,25,nowin,win,dlbust,bust,20,0,20,201,0.422885572,0.064676617,0.55721393,0,0.027255383
13518,67,22254,8,5,0,4,0,17,10,6,6,0,0,22,nowin,win,dlbust,bust,20,0,13,195,0.369230769,0.041025641,0.569230769,0,0.014139427
13519,136,22254,4,8,0,7,0,19,10,6,6,0,0,22,nowin,win,dlbust,bust,20,0,12,194,0.396907216,0.025773196,0.597938144,0,0.029452644
13520,21,22254,2,10,0,9,0,21,10,6,6,0,0,22,nowin,win,dlbust,bust,20,0,12,214,0.359813084,0.042056075,0.626168224,0,0.025263474
13521,78,22254,8,7,0,10,0,25,10,6,6,0,0,22,nowin,loss,bust,plbust,0,10,15,201,0.517412935,0.034825871,0.587064677,3,0.95871112
13522,89,22254,2,10,0,10,0,22,10,6,6,0,0,22,nowin,loss,bust,plbust,0,10,12,212,0.537735849,0.047169811,0.594339623,3,0.990167191
13523,83,22254,10,5,0,1,4,20,10,6,6,0,0,22,nowin,win,dlbust,bust,20,0,15,193,0.424870466,0.051813472,0.678756477,2,0.644360335
13524,147,22255,4,10,0,8,0,22,10,6,2,0,0,18,nowin,loss,bust,plbust,0,10,14,205,0.380487805,0.014634146,0.536585366,0,0.00951447
13525,63,22255,10,10,0,0,0,20,10,6,2,0,0,18,nowin,win,plwin,beat,20,0,20,216,0.467592593,0.037037037,0.62037037,3,0.931690496
13526,91,22255,6,2,4,9,0,21,10,6,2,0,0,18,nowin,win,plwin,beat,20,0,8,194,0.417525773,0.046391753,0.515463918,1,0.266616552
13527,126,22255,10,10,0,0,0,20,10,6,2,0,0,18,nowin,win,plwin,beat,20,0,20,188,0.457446809,0.074468085,0.60106383,3,0.900633203
13528,103,22255,6,10,0,1,0,17,10,6,2,0,0,18,nowin,loss,beat,dlwin,0,10,16,203,0.379310345,0.064039409,0.551724138,0,0.012869209
13529,80,22255,11,7,0,0,0,18,10,6,2,0,0,18,nowin,push,push,push,10,0,18,186,0.419354839,0.059139785,0.623655914,2,0.59892924
13530,150,22256,10,6,0,1,0,17,7,7,10,0,0,24,nowin,win,dlbust,bust,20,0,16,192,0.401041667,0.036458333,0.567708333,0,0.023287458
13531,114,22256,1,1,10,1,4,17,7,7,10,0,0,24,nowin,win,dlbust,bust,20,0,2,198,0.47979798,0.025252525,0.611111111,3,0.937232995
13532,107,22256,10,4,0,6,0,20,7,7,10,0,0,24,nowin,win,dlbust,bust,20,0,14,218,0.444954128,0.073394495,0.600917431,2,0.605210014
13533,131,22256,10,11,0,0,0,21,7,7,10,0,0,24,win,win,dlbust,bust,25,0,21,217,0.410138249,0.069124424,0.543778802,0,0.02015021
13534,30,22256,1,6,10,0,0,17,7,7,10,0,0,24,nowin,win,dlbust,bust,20,0,7,206,0.393203883,0.033980583,0.601941748,0,0.029324648
13535,84,22256,4,9,0,7,0,20,7,7,10,0,0,24,nowin,win,dlbust,bust,20,0,13,195,0.379487179,0.056410256,0.569230769,0,0.017209119
13536,23,22257,4,9,0,10,0,23,10,10,0,0,0,20,nowin,loss,bust,plbust,0,10,13,208,0.427884615,0.0625,0.552884615,1,0.29114424
13537,90,22257,10,10,0,0,0,20,10,10,0,0,0,20,nowin,push,push,push,10,0,20,201,0.447761194,0.049751244,0.60199005,3,0.889945023
13538,31,22257,3,5,9,0,0,17,10,10,0,0,0,20,nowin,loss,beat,dlwin,0,10,8,188,0.473404255,0.058510638,0.515957447,1,0.300306557
13539,98,22257,5,2,4,1,9,21,10,10,0,0,0,20,nowin,win,plwin,beat,20,0,7,220,0.422727273,0.054545455,0.55,1,0.28664435
13540,123,22257,3,2,10,10,0,25,10,10,0,0,0,20,nowin,loss,bust,plbust,0,10,5,205,0.43902439,0.034146341,0.614634146,2,0.609962544
13541,93,22257,10,11,0,0,0,21,10,10,0,0,0,20,win,win,plwin,beat,25,0,21,175,0.485714286,0.051428571,0.548571429,1,0.323648091
13542,143,22258,8,6,0,7,0,21,11,10,0,0,0,21,nowin,push,push,push,10,0,14,203,0.463054187,0.044334975,0.57635468,3,0.883143365
13543,24,22258,7,10,0,0,0,17,11,10,0,0,0,21,nowin,loss,beat,dlwin,0,10,17,207,0.458937198,0.048309179,0.570048309,1,0.318138014
13544,9,22258,4,2,5,8,0,19,11,10,0,0,0,21,nowin,loss,beat,dlwin,0,10,6,194,0.37628866,0.015463918,0.541237113,0,0.009396796
13545,114,22258,4,10,0,3,0,17,11,10,0,0,0,21,nowin,loss,beat,dlwin,0,10,14,198,0.47979798,0.025252525,0.611111111,3,0.937232995
13546,82,22258,10,4,0,1,10,25,11,10,0,0,0,21,nowin,loss,bust,plbust,0,10,14,225,0.408888889,0.075555556,0.577777778,0,0.028101874
13547,143,22258,9,4,0,5,0,18,11,10,0,0,0,21,nowin,loss,beat,dlwin,0,10,13,203,0.463054187,0.044334975,0.57635468,3,0.883143365
13548,44,22259,8,10,0,0,0,18,9,5,10,0,0,24,nowin,win,dlbust,bust,20,0,18,219,0.433789954,0.050228311,0.534246575,1,0.285551035
13549,125,22259,2,4,10,1,0,17,9,5,10,0,0,24,nowin,win,dlbust,bust,20,0,6,219,0.438356164,0.050228311,0.575342466,1,0.308411257
13550,27,22259,7,2,10,0,0,19,9,5,10,0,0,24,nowin,win,dlbust,bust,20,0,9,178,0.370786517,0.016853933,0.573033708,0,0.015536309
13551,4,22259,8,4,0,10,0,22,9,5,10,0,0,24,nowin,loss,bust,plbust,0,10,12,217,0.460829493,0.036866359,0.562211982,1,0.315432839
13552,115,22259,9,10,0,0,0,19,9,5,10,0,0,24,nowin,win,dlbust,bust,20,0,19,194,0.427835052,0.041237113,0.592783505,2,0.583863602
13553,121,22259,10,2,0,10,0,22,9,5,10,0,0,24,nowin,loss,bust,plbust,0,10,12,195,0.456410256,0.025641026,0.512820513,1,0.288597791
13554,93,22260,6,2,10,0,0,18,6,5,3,8,0,22,nowin,win,dlbust,bust,20,0,8,175,0.485714286,0.051428571,0.548571429,1,0.323648091
13555,135,22260,10,3,0,0,0,13,6,5,3,8,0,22,nowin,win,dlbust,bust,20,0,13,179,0.391061453,0.067039106,0.586592179,0,0.024924662
13556,3,22260,10,3,0,0,0,13,6,5,3,8,0,22,nowin,win,dlbust,bust,20,0,13,190,0.431578947,0.026315789,0.542105263,1,0.288076384
13557,82,22260,10,10,0,0,0,20,6,5,3,8,0,22,nowin,win,dlbust,bust,20,0,20,225,0.408888889,0.075555556,0.577777778,0,0.028101874
13558,135,22260,4,7,1,0,0,12,6,5,3,8,0,22,nowin,win,dlbust,bust,20,0,11,179,0.391061453,0.067039106,0.586592179,0,0.024924662
13559,97,22260,10,10,0,0,0,20,6,5,3,8,0,22,nowin,win,dlbust,bust,20,0,20,182,0.450549451,0.06043956,0.692307692,2,0.677372279
13560,141,22261,8,4,0,4,1,17,10,6,2,0,0,18,nowin,loss,beat,dlwin,0,10,12,202,0.420792079,0.074257426,0.564356436,0,0.028377851
13561,84,22261,6,8,0,9,0,23,10,6,2,0,0,18,nowin,loss,bust,plbust,0,10,14,195,0.379487179,0.056410256,0.569230769,0,0.017209119
13562,130,22261,3,5,2,9,0,19,10,6,2,0,0,18,nowin,win,plwin,beat,20,0,8,219,0.410958904,0.03652968,0.566210046,0,0.025888739
13563,61,22261,2,1,10,9,0,22,10,6,2,0,0,18,nowin,loss,bust,plbust,0,10,3,194,0.427835052,0.077319588,0.603092784,2,0.591437139
13564,11,22261,7,9,0,1,0,17,10,6,2,0,0,18,nowin,loss,beat,dlwin,0,10,16,236,0.457627119,0.016949153,0.588983051,3,0.889015813
13565,36,22261,10,3,0,5,0,18,10,6,2,0,0,18,nowin,push,push,push,10,0,13,229,0.445414847,0.056768559,0.655021834,2,0.645370571
13566,130,22262,10,10,0,0,0,20,11,10,0,0,0,21,nowin,loss,beat,dlwin,0,10,20,219,0.410958904,0.03652968,0.566210046,0,0.025888739
13567,13,22262,10,10,0,0,0,20,11,10,0,0,0,21,nowin,loss,beat,dlwin,0,10,20,206,0.417475728,0.063106796,0.621359223,2,0.59555479
13568,145,22262,10,8,0,0,0,18,11,10,0,0,0,21,nowin,loss,beat,dlwin,0,10,18,188,0.441489362,0.031914894,0.622340426,2,0.617837093
13569,143,22262,9,5,0,10,0,24,11,10,0,0,0,21,nowin,loss,bust,plbust,0,10,14,203,0.463054187,0.044334975,0.57635468,3,0.883143365
13570,101,22262,11,10,0,0,0,21,11,10,0,0,0,21,win,push,push,push,10,0,21,205,0.424390244,0.068292683,0.63902439,2,0.614740646
13571,58,22262,5,10,0,10,0,25,11,10,0,0,0,21,nowin,loss,bust,plbust,0,10,15,195,0.430769231,0.041025641,0.584615385,2,0.580497586
13572,49,22263,10,10,0,0,0,20,3,4,10,0,0,17,nowin,win,plwin,beat,20,0,20,207,0.396135266,0.053140097,0.594202899,0,0.028306925
13573,125,22263,3,11,5,0,0,19,3,4,10,0,0,17,nowin,win,plwin,beat,20,0,14,219,0.438356164,0.050228311,0.575342466,1,0.308411257
13574,98,22263,6,5,3,0,0,14,3,4,10,0,0,17,nowin,loss,beat,dlwin,0,10,11,220,0.422727273,0.054545455,0.55,1,0.28664435
13575,79,22263,10,8,0,0,0,18,3,4,10,0,0,17,nowin,win,plwin,beat,20,0,18,211,0.436018957,0.028436019,0.672985782,2,0.650131054
13576,122,22263,3,10,0,0,0,13,3,4,10,0,0,17,nowin,loss,beat,dlwin,0,10,13,210,0.347619048,0.052380952,0.59047619,0,0.012873677
13577,40,22263,3,7,10,0,0,20,3,4,10,0,0,17,nowin,win,plwin,beat,20,0,10,196,0.367346939,0.030612245,0.617346939,0,0.025358183
13578,37,22264,7,2,10,0,0,19,11,10,0,0,0,21,nowin,loss,beat,dlwin,0,10,9,208,0.394230769,0.038461538,0.581730769,0,0.024682772
13579,48,22264,4,10,0,10,0,24,11,10,0,0,0,21,nowin,loss,bust,plbust,0,10,14,203,0.413793103,0.019704433,0.600985222,2,0.577280801
13580,78,22264,6,8,0,7,0,21,11,10,0,0,0,21,nowin,push,push,push,10,0,14,201,0.517412935,0.034825871,0.587064677,3,0.95871112
13581,84,22264,11,8,0,0,0,19,11,10,0,0,0,21,nowin,loss,beat,dlwin,0,10,19,195,0.379487179,0.056410256,0.569230769,0,0.017209119
13582,31,22264,2,10,0,2,8,22,11,10,0,0,0,21,nowin,loss,bust,plbust,0,10,12,188,0.473404255,0.058510638,0.515957447,1,0.300306557
13583,86,22264,9,10,0,0,0,19,11,10,0,0,0,21,nowin,loss,beat,dlwin,0,10,19,196,0.454081633,0.040816327,0.591836735,3,0.887566443
13584,94,22265,4,6,8,0,0,18,5,10,8,0,0,23,nowin,win,dlbust,bust,20,0,10,183,0.43715847,0.043715847,0.540983607,1,0.290866892
13585,21,22265,10,10,0,0,0,20,5,10,8,0,0,23,nowin,win,dlbust,bust,20,0,20,214,0.359813084,0.042056075,0.626168224,0,0.025263474
13586,147,22265,7,5,0,0,0,12,5,10,8,0,0,23,nowin,win,dlbust,bust,20,0,12,205,0.380487805,0.014634146,0.536585366,0,0.00951447
13587,70,22265,4,8,0,0,0,12,5,10,8,0,0,23,nowin,win,dlbust,bust,20,0,12,228,0.385964912,0.039473684,0.557017544,0,0.016157125
13588,36,22265,10,11,0,0,0,21,5,10,8,0,0,23,win,win,dlbust,bust,25,0,21,229,0.445414847,0.056768559,0.655021834,2,0.645370571
13589,76,22265,10,2,0,0,0,12,5,10,8,0,0,23,nowin,win,dlbust,bust,20,0,12,189,0.534391534,0.079365079,0.608465608,3,1
13590,40,22266,10,10,0,0,0,20,8,10,0,0,0,18,nowin,win,plwin,beat,20,0,20,196,0.367346939,0.030612245,0.617346939,0,0.025358183
13591,80,22266,10,10,0,0,0,20,8,10,0,0,0,18,nowin,win,plwin,beat,20,0,20,186,0.419354839,0.059139785,0.623655914,2,0.59892924
13592,2,22266,10,7,0,0,0,17,8,10,0,0,0,18,nowin,loss,beat,dlwin,0,10,17,200,0.445,0.035,0.64,2,0.633962549
13593,60,22266,11,8,0,0,0,19,8,10,0,0,0,18,nowin,win,plwin,beat,20,0,19,227,0.418502203,0.022026432,0.559471366,0,0.026496258
13594,146,22266,10,6,0,10,0,26,8,10,0,0,0,18,nowin,loss,bust,plbust,0,10,16,221,0.43438914,0.040723982,0.542986425,1,0.290190091
13595,104,22266,10,5,0,3,0,18,8,10,0,0,0,18,nowin,push,push,push,10,0,15,209,0.363636364,0.052631579,0.593301435,0,0.018359419
13596,131,22267,10,4,0,0,0,14,2,10,8,0,0,20,nowin,loss,beat,dlwin,0,10,14,217,0.410138249,0.069124424,0.543778802,0,0.02015021
13597,121,22267,3,11,7,0,0,21,2,10,8,0,0,20,nowin,win,plwin,beat,20,0,14,195,0.456410256,0.025641026,0.512820513,1,0.288597791
13598,90,22267,4,10,0,0,0,14,2,10,8,0,0,20,nowin,loss,beat,dlwin,0,10,14,201,0.447761194,0.049751244,0.60199005,3,0.889945023
13599,70,22267,3,2,4,9,0,18,2,10,8,0,0,20,nowin,loss,beat,dlwin,0,10,5,228,0.385964912,0.039473684,0.557017544,0,0.016157125
13600,98,22267,10,10,0,0,0,20,2,10,8,0,0,20,nowin,push,push,push,10,0,20,220,0.422727273,0.054545455,0.55,1,0.28664435
13601,119,22267,9,10,0,0,0,19,2,10,8,0,0,20,nowin,loss,beat,dlwin,0,10,19,190,0.405263158,0.068421053,0.515789474,0,0.011837158
13602,24,22268,7,10,0,0,0,17,10,10,0,0,0,20,nowin,loss,beat,dlwin,0,10,17,207,0.458937198,0.048309179,0.570048309,1,0.318138014
13603,82,22268,7,10,0,0,0,17,10,10,0,0,0,20,nowin,loss,beat,dlwin,0,10,17,225,0.408888889,0.075555556,0.577777778,0,0.028101874
13604,50,22268,9,5,0,1,2,17,10,10,0,0,0,20,nowin,loss,beat,dlwin,0,10,14,202,0.405940594,0.04950495,0.54950495,0,0.020296079
13605,55,22268,7,10,0,0,0,17,10,10,0,0,0,20,nowin,loss,beat,dlwin,0,10,17,191,0.371727749,0.057591623,0.54973822,0,0.01011347
13606,6,22268,9,11,0,0,0,20,10,10,0,0,0,20,nowin,push,push,push,10,0,20,191,0.439790576,0.047120419,0.581151832,1,0.31211505
13607,1,22268,6,10,0,8,0,24,10,10,0,0,0,20,nowin,loss,bust,plbust,0,10,16,197,0.406091371,0.025380711,0.649746193,2,0.606186955
13608,140,22269,2,8,10,0,0,20,10,2,3,10,0,25,nowin,win,dlbust,bust,20,0,10,210,0.466666667,0.023809524,0.604761905,3,0.915293335
13609,128,22269,10,11,0,0,0,21,10,2,3,10,0,25,win,win,dlbust,bust,25,0,21,227,0.356828194,0.052863436,0.577092511,0,0.012352564
13610,48,22269,9,4,0,10,0,23,10,2,3,10,0,25,nowin,loss,bust,plbust,0,10,13,203,0.413793103,0.019704433,0.600985222,2,0.577280801
13611,77,22269,3,2,5,7,0,17,10,2,3,10,0,25,nowin,win,dlbust,bust,20,0,5,200,0.455,0.04,0.62,3,0.916252116
13612,30,22269,1,5,10,2,0,18,10,2,3,10,0,25,nowin,win,dlbust,bust,20,0,6,206,0.393203883,0.033980583,0.601941748,0,0.029324648
13613,108,22269,4,7,5,9,0,25,10,2,3,10,0,25,nowin,loss,bust,plbust,0,10,11,193,0.435233161,0.056994819,0.559585492,1,0.298824795
13614,75,22270,5,10,0,9,0,24,10,3,6,0,0,19,nowin,loss,bust,plbust,0,10,15,191,0.418848168,0.052356021,0.570680628,0,0.029344702
13615,137,22270,10,9,0,0,0,19,10,3,6,0,0,19,nowin,push,push,push,10,0,19,194,0.417525773,0.046391753,0.536082474,1,0.276714602
13616,45,22270,10,4,0,2,9,25,10,3,6,0,0,19,nowin,loss,bust,plbust,0,10,14,196,0.428571429,0.051020408,0.612244898,2,0.598821767
13617,77,22270,7,10,0,0,0,17,10,3,6,0,0,19,nowin,loss,beat,dlwin,0,10,17,200,0.455,0.04,0.62,3,0.916252116
13618,110,22270,10,5,0,4,0,19,10,3,6,0,0,19,nowin,push,push,push,10,0,15,192,0.416666667,0.046875,0.557291667,0,0.025413132
13619,88,22270,6,8,0,8,0,22,10,3,6,0,0,19,nowin,loss,bust,plbust,0,10,14,206,0.466019417,0.033980583,0.54368932,1,0.309467903
13620,45,22271,6,10,0,5,0,21,9,8,0,0,0,17,nowin,win,plwin,beat,20,0,16,196,0.428571429,0.051020408,0.612244898,2,0.598821767
13621,53,22271,10,3,0,8,0,21,9,8,0,0,0,17,nowin,win,plwin,beat,20,0,13,250,0.372,0.064,0.564,0,0.013687345
13622,82,22271,11,10,0,0,0,21,9,8,0,0,0,17,win,win,plwin,beat,25,0,21,225,0.408888889,0.075555556,0.577777778,0,0.028101874
13623,83,22271,7,3,10,0,0,20,9,8,0,0,0,17,nowin,win,plwin,beat,20,0,10,193,0.424870466,0.051813472,0.678756477,2,0.644360335
13624,75,22271,1,1,10,8,0,20,9,8,0,0,0,17,nowin,win,plwin,beat,20,0,2,191,0.418848168,0.052356021,0.570680628,0,0.029344702
13625,37,22271,2,5,9,9,0,25,9,8,0,0,0,17,nowin,loss,bust,plbust,0,10,7,208,0.394230769,0.038461538,0.581730769,0,0.024682772
13626,57,22272,5,8,0,6,0,19,10,6,2,0,0,18,nowin,win,plwin,beat,20,0,13,192,0.46875,0.052083333,0.59375,3,0.907001181
13627,15,22272,2,4,8,1,8,23,10,6,2,0,0,18,nowin,loss,bust,plbust,0,10,6,212,0.410377358,0.051886792,0.561320755,0,0.024517408
13628,6,22272,3,4,5,10,0,22,10,6,2,0,0,18,nowin,loss,bust,plbust,0,10,7,191,0.439790576,0.047120419,0.581151832,1,0.31211505
13629,101,22272,5,9,0,2,10,26,10,6,2,0,0,18,nowin,loss,bust,plbust,0,10,14,205,0.424390244,0.068292683,0.63902439,2,0.614740646
13630,16,22272,8,4,0,3,10,25,10,6,2,0,0,18,nowin,loss,bust,plbust,0,10,12,220,0.427272727,0.081818182,0.6,2,0.588660176
13631,70,22272,9,7,0,7,0,23,10,6,2,0,0,18,nowin,loss,bust,plbust,0,10,16,228,0.385964912,0.039473684,0.557017544,0,0.016157125
13632,3,22273,4,6,11,0,0,21,3,9,4,10,0,26,nowin,win,dlbust,bust,20,0,10,190,0.431578947,0.026315789,0.542105263,1,0.288076384
13633,124,22273,6,1,10,0,0,17,3,9,4,10,0,26,nowin,win,dlbust,bust,20,0,7,202,0.47029703,0.064356436,0.584158416,3,0.899458193
13634,59,22273,5,10,0,0,0,15,3,9,4,10,0,26,nowin,win,dlbust,bust,20,0,15,228,0.429824561,0.048245614,0.543859649,1,0.287885446
13635,140,22273,7,8,0,0,0,15,3,9,4,10,0,26,nowin,win,dlbust,bust,20,0,15,210,0.466666667,0.023809524,0.604761905,3,0.915293335
13636,66,22273,10,2,0,3,0,15,3,9,4,10,0,26,nowin,win,dlbust,bust,20,0,12,217,0.456221198,0.064516129,0.626728111,3,0.924304367
13637,66,22273,10,4,0,0,0,14,3,9,4,10,0,26,nowin,win,dlbust,bust,20,0,14,217,0.456221198,0.064516129,0.626728111,3,0.924304367
13638,121,22274,2,10,0,1,10,23,10,6,4,0,0,20,nowin,loss,bust,plbust,0,10,12,195,0.456410256,0.025641026,0.512820513,1,0.288597791
13639,101,22274,7,10,0,0,0,17,10,6,4,0,0,20,nowin,loss,beat,dlwin,0,10,17,205,0.424390244,0.068292683,0.63902439,2,0.614740646
13640,99,22274,11,10,0,0,0,21,10,6,4,0,0,20,win,win,plwin,beat,25,0,21,207,0.47826087,0.062801932,0.637681159,3,0.961418446
13641,140,22274,9,6,0,10,0,25,10,6,4,0,0,20,nowin,loss,bust,plbust,0,10,15,210,0.466666667,0.023809524,0.604761905,3,0.915293335
13642,126,22274,10,5,0,10,0,25,10,6,4,0,0,20,nowin,loss,bust,plbust,0,10,15,188,0.457446809,0.074468085,0.60106383,3,0.900633203
13643,76,22274,8,10,0,0,0,18,10,6,4,0,0,20,nowin,loss,beat,dlwin,0,10,18,189,0.534391534,0.079365079,0.608465608,3,1
13644,53,22275,8,10,0,0,0,18,6,10,10,0,0,26,nowin,win,dlbust,bust,20,0,18,250,0.372,0.064,0.564,0,0.013687345
13645,5,22275,4,10,0,0,0,14,6,10,10,0,0,26,nowin,win,dlbust,bust,20,0,14,203,0.42364532,0.02955665,0.596059113,2,0.582508076
13646,56,22275,5,10,0,0,0,15,6,10,10,0,0,26,nowin,win,dlbust,bust,20,0,15,175,0.4,0.057142857,0.582857143,0,0.026685297
13647,67,22275,11,7,0,0,0,18,6,10,10,0,0,26,nowin,win,dlbust,bust,20,0,18,195,0.369230769,0.041025641,0.569230769,0,0.014139427
13648,123,22275,9,8,0,0,0,17,6,10,10,0,0,26,nowin,win,dlbust,bust,20,0,17,205,0.43902439,0.034146341,0.614634146,2,0.609962544
13649,6,22275,8,6,0,0,0,14,6,10,10,0,0,26,nowin,win,dlbust,bust,20,0,14,191,0.439790576,0.047120419,0.581151832,1,0.31211505
13650,41,22276,3,2,10,2,0,17,10,10,0,0,0,20,nowin,loss,beat,dlwin,0,10,5,192,0.364583333,0.036458333,0.520833333,0,0.00089702
13651,70,22276,10,11,0,0,0,21,10,10,0,0,0,20,win,win,plwin,beat,25,0,21,228,0.385964912,0.039473684,0.557017544,0,0.016157125
13652,66,22276,10,9,0,0,0,19,10,10,0,0,0,20,nowin,loss,beat,dlwin,0,10,19,217,0.456221198,0.064516129,0.626728111,3,0.924304367
13653,19,22276,3,8,8,0,0,19,10,10,0,0,0,20,nowin,loss,beat,dlwin,0,10,11,237,0.41350211,0.054852321,0.628691983,2,0.597373826
13654,93,22276,7,9,0,10,0,26,10,10,0,0,0,20,nowin,loss,bust,plbust,0,10,16,175,0.485714286,0.051428571,0.548571429,1,0.323648091
13655,25,22276,10,11,0,0,0,21,10,10,0,0,0,20,win,win,plwin,beat,25,0,21,190,0.463157895,0.063157895,0.536842105,1,0.304401563
13656,19,22277,2,3,10,10,0,25,11,7,0,0,0,18,nowin,loss,bust,plbust,0,10,5,237,0.41350211,0.054852321,0.628691983,2,0.597373826
13657,66,22277,8,10,0,0,0,18,11,7,0,0,0,18,nowin,push,push,push,10,0,18,217,0.456221198,0.064516129,0.626728111,3,0.924304367
13658,39,22277,4,10,0,4,0,18,11,7,0,0,0,18,nowin,push,push,push,10,0,14,191,0.429319372,0.062827225,0.57591623,0,0.033760763
13659,92,22277,10,5,0,2,0,17,11,7,0,0,0,18,nowin,loss,beat,dlwin,0,10,15,186,0.446236559,0.059139785,0.564516129,1,0.307826125
13660,3,22277,7,8,0,10,0,25,11,7,0,0,0,18,nowin,loss,bust,plbust,0,10,15,190,0.431578947,0.026315789,0.542105263,1,0.288076384
13661,50,22277,10,8,0,0,0,18,11,7,0,0,0,18,nowin,push,push,push,10,0,18,202,0.405940594,0.04950495,0.54950495,0,0.020296079
13662,16,22278,4,10,0,0,0,14,6,2,8,6,0,22,nowin,win,dlbust,bust,20,0,14,220,0.427272727,0.081818182,0.6,2,0.588660176
13663,54,22278,3,4,9,0,0,16,6,2,8,6,0,22,nowin,win,dlbust,bust,20,0,7,185,0.437837838,0.032432432,0.556756757,1,0.29899854
13664,48,22278,7,7,0,0,0,14,6,2,8,6,0,22,nowin,win,dlbust,bust,20,0,14,203,0.413793103,0.019704433,0.600985222,2,0.577280801
13665,33,22278,2,3,6,8,0,19,6,2,8,6,0,22,nowin,win,dlbust,bust,20,0,5,192,0.4375,0.057291667,0.625,2,0.616208916
13666,90,22278,7,5,0,0,0,12,6,2,8,6,0,22,nowin,win,dlbust,bust,20,0,12,201,0.447761194,0.049751244,0.60199005,3,0.889945023
13667,109,22278,7,10,0,0,0,17,6,2,8,6,0,22,nowin,win,dlbust,bust,20,0,17,221,0.461538462,0.058823529,0.597285068,3,0.901830309
13668,35,22279,7,2,10,0,0,19,2,10,6,0,0,18,nowin,win,plwin,beat,20,0,9,202,0.410891089,0.044554455,0.633663366,2,0.598681573
13669,23,22279,9,10,0,0,0,19,2,10,6,0,0,18,nowin,win,plwin,beat,20,0,19,208,0.427884615,0.0625,0.552884615,1,0.29114424
13670,89,22279,4,10,0,0,0,14,2,10,6,0,0,18,nowin,loss,beat,dlwin,0,10,14,212,0.537735849,0.047169811,0.594339623,3,0.990167191
13671,91,22279,2,3,8,0,0,13,2,10,6,0,0,18,nowin,loss,beat,dlwin,0,10,5,194,0.417525773,0.046391753,0.515463918,1,0.266616552
13672,112,22279,4,6,2,6,0,18,2,10,6,0,0,18,nowin,push,push,push,10,0,10,203,0.448275862,0.054187192,0.600985222,3,0.889576933
13673,100,22279,6,10,0,0,0,16,2,10,6,0,0,18,nowin,loss,beat,dlwin,0,10,16,190,0.452631579,0.036842105,0.594736842,3,0.888671154
13674,49,22280,11,10,0,0,0,21,10,3,4,0,0,17,win,win,plwin,beat,25,0,21,207,0.396135266,0.053140097,0.594202899,0,0.028306925
13675,135,22280,4,8,0,3,8,23,10,3,4,0,0,17,nowin,loss,bust,plbust,0,10,12,179,0.391061453,0.067039106,0.586592179,0,0.024924662
13676,70,22280,10,6,0,2,0,18,10,3,4,0,0,17,nowin,win,plwin,beat,20,0,16,228,0.385964912,0.039473684,0.557017544,0,0.016157125
13677,41,22280,5,10,0,3,0,18,10,3,4,0,0,17,nowin,win,plwin,beat,20,0,15,192,0.364583333,0.036458333,0.520833333,0,0.00089702
13678,127,22280,3,1,10,5,0,19,10,3,4,0,0,17,nowin,win,plwin,beat,20,0,4,201,0.402985075,0.029850746,0.60199005,0,0.032263937
13679,25,22280,4,7,8,0,0,19,10,3,4,0,0,17,nowin,win,plwin,beat,20,0,11,190,0.463157895,0.063157895,0.536842105,1,0.304401563
13680,129,22281,9,9,0,0,0,18,3,10,8,0,0,21,nowin,loss,beat,dlwin,0,10,18,201,0.422885572,0.064676617,0.55721393,0,0.027255383
13681,82,22281,3,7,10,0,0,20,3,10,8,0,0,21,nowin,loss,beat,dlwin,0,10,10,225,0.408888889,0.075555556,0.577777778,0,0.028101874
13682,107,22281,7,10,0,0,0,17,3,10,8,0,0,21,nowin,loss,beat,dlwin,0,10,17,218,0.444954128,0.073394495,0.600917431,2,0.605210014
13683,54,22281,5,10,0,0,0,15,3,10,8,0,0,21,nowin,loss,beat,dlwin,0,10,15,185,0.437837838,0.032432432,0.556756757,1,0.29899854
13684,110,22281,8,6,0,0,0,14,3,10,8,0,0,21,nowin,loss,beat,dlwin,0,10,14,192,0.416666667,0.046875,0.557291667,0,0.025413132
13685,79,22281,10,3,0,0,0,13,3,10,8,0,0,21,nowin,loss,beat,dlwin,0,10,13,211,0.436018957,0.028436019,0.672985782,2,0.650131054
13686,34,22282,6,9,0,6,0,21,7,10,0,0,0,17,nowin,win,plwin,beat,20,0,15,202,0.5,0.079207921,0.618811881,3,0.968961434
13687,72,22282,10,7,0,0,0,17,7,10,0,0,0,17,nowin,push,push,push,10,0,17,185,0.394594595,0.032432432,0.508108108,0,0.006763115
13688,126,22282,5,11,3,0,0,19,7,10,0,0,0,17,nowin,win,plwin,beat,20,0,16,188,0.457446809,0.074468085,0.60106383,3,0.900633203
13689,104,22282,5,8,0,7,0,20,7,10,0,0,0,17,nowin,win,plwin,beat,20,0,13,209,0.363636364,0.052631579,0.593301435,0,0.018359419
13690,92,22282,10,4,0,8,0,22,7,10,0,0,0,17,nowin,loss,bust,plbust,0,10,14,186,0.446236559,0.059139785,0.564516129,1,0.307826125
13691,106,22282,11,8,0,0,0,19,7,10,0,0,0,17,nowin,win,plwin,beat,20,0,19,192,0.411458333,0.026041667,0.557291667,0,0.023854304
13692,79,22283,10,5,0,0,0,15,3,3,10,7,0,23,nowin,win,dlbust,bust,20,0,15,211,0.436018957,0.028436019,0.672985782,2,0.650131054
13693,18,22283,10,10,0,0,0,20,3,3,10,7,0,23,nowin,win,dlbust,bust,20,0,20,182,0.461538462,0.043956044,0.587912088,3,0.892649374
13694,140,22283,10,3,0,0,0,13,3,3,10,7,0,23,nowin,win,dlbust,bust,20,0,13,210,0.466666667,0.023809524,0.604761905,3,0.915293335
13695,144,22283,10,9,0,0,0,19,3,3,10,7,0,23,nowin,win,dlbust,bust,20,0,19,202,0.386138614,0.054455446,0.564356436,0,0.018006244
13696,100,22283,10,9,0,0,0,19,3,3,10,7,0,23,nowin,win,dlbust,bust,20,0,19,190,0.452631579,0.036842105,0.594736842,3,0.888671154
13697,118,22283,10,3,0,0,0,13,3,3,10,7,0,23,nowin,win,dlbust,bust,20,0,13,216,0.393518519,0.037037037,0.555555556,0,0.018059873
13698,107,22284,10,8,0,0,0,18,9,2,3,10,0,24,nowin,win,dlbust,bust,20,0,18,218,0.444954128,0.073394495,0.600917431,2,0.605210014
13699,62,22284,6,8,0,7,0,21,9,2,3,10,0,24,nowin,win,dlbust,bust,20,0,14,178,0.370786517,0.028089888,0.54494382,0,0.008657722
13700,133,22284,2,5,9,10,0,26,9,2,3,10,0,24,nowin,loss,bust,plbust,0,10,7,201,0.47761194,0.064676617,0.611940299,3,0.935428111
13701,101,22284,9,10,0,0,0,19,9,2,3,10,0,24,nowin,win,dlbust,bust,20,0,19,205,0.424390244,0.068292683,0.63902439,2,0.614740646
13702,111,22284,3,6,5,1,4,19,9,2,3,10,0,24,nowin,win,dlbust,bust,20,0,9,180,0.433333333,0.055555556,0.611111111,2,0.602264492
13703,99,22284,6,1,5,10,0,22,9,2,3,10,0,24,nowin,loss,bust,plbust,0,10,7,207,0.47826087,0.062801932,0.637681159,3,0.961418446
13704,136,22285,9,10,0,0,0,19,5,7,4,10,0,26,nowin,win,dlbust,bust,20,0,19,194,0.396907216,0.025773196,0.597938144,0,0.029452644
13705,95,22285,2,8,6,0,0,16,5,7,4,10,0,26,nowin,win,dlbust,bust,20,0,10,218,0.412844037,0.04587156,0.559633028,0,0.024842385
13706,7,22285,11,10,0,0,0,21,5,7,4,10,0,26,win,win,dlbust,bust,25,0,21,183,0.442622951,0.06010929,0.62295082,2,0.619303341
13707,15,22285,10,9,0,0,0,19,5,7,4,10,0,26,nowin,win,dlbust,bust,20,0,19,212,0.410377358,0.051886792,0.561320755,0,0.024517408
13708,129,22285,2,4,9,0,0,15,5,7,4,10,0,26,nowin,win,dlbust,bust,20,0,6,201,0.422885572,0.064676617,0.55721393,0,0.027255383
13709,106,22285,10,2,0,0,0,12,5,7,4,10,0,26,nowin,win,dlbust,bust,20,0,12,192,0.411458333,0.026041667,0.557291667,0,0.023854304
13710,45,22286,1,4,10,3,0,18,9,10,0,0,0,19,nowin,loss,beat,dlwin,0,10,5,196,0.428571429,0.051020408,0.612244898,2,0.598821767
13711,68,22286,3,7,5,1,10,26,9,10,0,0,0,19,nowin,loss,bust,plbust,0,10,10,205,0.434146341,0.029268293,0.6,2,0.59483189
13712,126,22286,1,6,10,0,0,17,9,10,0,0,0,19,nowin,loss,beat,dlwin,0,10,7,188,0.457446809,0.074468085,0.60106383,3,0.900633203
13713,53,22286,10,9,0,0,0,19,9,10,0,0,0,19,nowin,push,push,push,10,0,19,250,0.372,0.064,0.564,0,0.013687345
13714,34,22286,10,11,0,0,0,21,9,10,0,0,0,19,win,win,plwin,beat,25,0,21,202,0.5,0.079207921,0.618811881,3,0.968961434
13715,45,22286,1,6,6,1,5,19,9,10,0,0,0,19,nowin,push,push,push,10,0,7,196,0.428571429,0.051020408,0.612244898,2,0.598821767
13716,10,22287,9,8,0,0,0,17,10,10,0,0,0,20,nowin,loss,beat,dlwin,0,10,17,191,0.413612565,0.057591623,0.596858639,2,0.574087175
13717,105,22287,9,7,0,8,0,24,10,10,0,0,0,20,nowin,loss,bust,plbust,0,10,16,198,0.414141414,0.070707071,0.590909091,0,0.032889494
13718,65,22287,10,10,0,0,0,20,10,10,0,0,0,20,nowin,push,push,push,10,0,20,203,0.492610837,0.054187192,0.571428571,3,0.913702814
13719,27,22287,10,8,0,0,0,18,10,10,0,0,0,20,nowin,loss,beat,dlwin,0,10,18,178,0.370786517,0.016853933,0.573033708,0,0.015536309
13720,99,22287,10,8,0,0,0,18,10,10,0,0,0,20,nowin,loss,beat,dlwin,0,10,18,207,0.47826087,0.062801932,0.637681159,3,0.961418446
13721,15,22287,6,10,0,10,0,26,10,10,0,0,0,20,nowin,loss,bust,plbust,0,10,16,212,0.410377358,0.051886792,0.561320755,0,0.024517408
13722,11,22288,10,6,0,3,0,19,9,10,0,0,0,19,nowin,push,push,push,10,0,16,236,0.457627119,0.016949153,0.588983051,3,0.889015813
13723,96,22288,11,8,0,0,0,19,9,10,0,0,0,19,nowin,push,push,push,10,0,19,190,0.468421053,0.057894737,0.584210526,3,0.897263354
13724,59,22288,5,7,0,10,0,22,9,10,0,0,0,19,nowin,loss,bust,plbust,0,10,12,228,0.429824561,0.048245614,0.543859649,1,0.287885446
13725,134,22288,8,11,0,0,0,19,9,10,0,0,0,19,nowin,push,push,push,10,0,19,185,0.443243243,0.021621622,0.545945946,1,0.296939509
13726,82,22288,3,3,7,10,0,23,9,10,0,0,0,19,nowin,loss,bust,plbust,0,10,6,225,0.408888889,0.075555556,0.577777778,0,0.028101874
13727,52,22288,8,8,0,10,0,26,9,10,0,0,0,19,nowin,loss,bust,plbust,0,10,16,217,0.414746544,0.02764977,0.599078341,2,0.576736024
13728,62,22289,4,3,11,0,0,18,10,6,10,0,0,26,nowin,win,dlbust,bust,20,0,7,178,0.370786517,0.028089888,0.54494382,0,0.008657722
13729,66,22289,10,2,0,3,5,20,10,6,10,0,0,26,nowin,win,dlbust,bust,20,0,12,217,0.456221198,0.064516129,0.626728111,3,0.924304367
13730,17,22289,10,11,0,0,0,21,10,6,10,0,0,26,win,win,dlbust,bust,25,0,21,171,0.444444444,0.070175439,0.555555556,1,0.302364894
13731,74,22289,5,7,0,10,0,22,10,6,10,0,0,26,nowin,loss,bust,plbust,0,10,12,209,0.411483254,0.04784689,0.531100478,0,0.017448125
13732,9,22289,10,6,0,10,0,26,10,6,10,0,0,26,nowin,loss,bust,plbust,0,10,16,194,0.37628866,0.015463918,0.541237113,0,0.009396796
13733,27,22289,8,10,0,0,0,18,10,6,10,0,0,26,nowin,win,dlbust,bust,20,0,18,178,0.370786517,0.016853933,0.573033708,0,0.015536309
13734,107,22290,9,10,0,0,0,19,8,10,0,0,0,18,nowin,win,plwin,beat,20,0,19,218,0.444954128,0.073394495,0.600917431,2,0.605210014
13735,95,22290,4,9,0,4,0,17,8,10,0,0,0,18,nowin,loss,beat,dlwin,0,10,13,218,0.412844037,0.04587156,0.559633028,0,0.024842385
13736,148,22290,4,1,10,4,0,19,8,10,0,0,0,18,nowin,win,plwin,beat,20,0,5,204,0.401960784,0.078431373,0.593137255,0,0.029789521
13737,36,22290,10,10,0,0,0,20,8,10,0,0,0,18,nowin,win,plwin,beat,20,0,20,229,0.445414847,0.056768559,0.655021834,2,0.645370571
13738,97,22290,10,10,0,0,0,20,8,10,0,0,0,18,nowin,win,plwin,beat,20,0,20,182,0.450549451,0.06043956,0.692307692,2,0.677372279
13739,104,22290,3,3,10,7,0,23,8,10,0,0,0,18,nowin,loss,bust,plbust,0,10,6,209,0.363636364,0.052631579,0.593301435,0,0.018359419
13740,65,22291,5,10,0,4,0,19,11,7,0,0,0,18,nowin,win,plwin,beat,20,0,15,203,0.492610837,0.054187192,0.571428571,3,0.913702814
13741,100,22291,6,8,0,9,0,23,11,7,0,0,0,18,nowin,loss,bust,plbust,0,10,14,190,0.452631579,0.036842105,0.594736842,3,0.888671154
13742,130,22291,4,3,9,10,0,26,11,7,0,0,0,18,nowin,loss,bust,plbust,0,10,7,219,0.410958904,0.03652968,0.566210046,0,0.025888739
13743,132,22291,7,10,0,0,0,17,11,7,0,0,0,18,nowin,loss,beat,dlwin,0,10,17,194,0.412371134,0.036082474,0.649484536,2,0.611633238
13744,51,22291,10,10,0,0,0,20,11,7,0,0,0,18,nowin,win,plwin,beat,20,0,20,189,0.529100529,0.068783069,0.608465608,3,0.993665715
13745,86,22291,3,9,0,3,2,17,11,7,0,0,0,18,nowin,loss,beat,dlwin,0,10,12,196,0.454081633,0.040816327,0.591836735,3,0.887566443
13746,47,22292,5,5,7,0,0,17,10,10,0,0,0,20,nowin,loss,beat,dlwin,0,10,10,210,0.438095238,0.057142857,0.623809524,2,0.615868808
13747,62,22292,4,10,0,8,0,22,10,10,0,0,0,20,nowin,loss,bust,plbust,0,10,14,178,0.370786517,0.028089888,0.54494382,0,0.008657722
13748,144,22292,10,3,0,10,0,23,10,10,0,0,0,20,nowin,loss,bust,plbust,0,10,13,202,0.386138614,0.054455446,0.564356436,0,0.018006244
13749,132,22292,10,10,0,0,0,20,10,10,0,0,0,20,nowin,push,push,push,10,0,20,194,0.412371134,0.036082474,0.649484536,2,0.611633238
13750,103,22292,3,8,10,0,0,21,10,10,0,0,0,20,nowin,win,plwin,beat,20,0,11,203,0.379310345,0.064039409,0.551724138,0,0.012869209
13751,131,22292,10,6,0,10,0,26,10,10,0,0,0,20,nowin,loss,bust,plbust,0,10,16,217,0.410138249,0.069124424,0.543778802,0,0.02015021
13752,146,22293,6,8,0,0,0,14,5,9,10,0,0,24,nowin,win,dlbust,bust,20,0,14,221,0.43438914,0.040723982,0.542986425,1,0.290190091
13753,60,22293,6,6,0,0,0,12,5,9,10,0,0,24,nowin,win,dlbust,bust,20,0,12,227,0.418502203,0.022026432,0.559471366,0,0.026496258
13754,102,22293,6,9,0,0,0,15,5,9,10,0,0,24,nowin,win,dlbust,bust,20,0,15,192,0.338541667,0.046875,0.5625,0,0.003306118
13755,75,22293,8,11,0,0,0,19,5,9,10,0,0,24,nowin,win,dlbust,bust,20,0,19,191,0.418848168,0.052356021,0.570680628,0,0.029344702
13756,101,22293,10,3,0,0,0,13,5,9,10,0,0,24,nowin,win,dlbust,bust,20,0,13,205,0.424390244,0.068292683,0.63902439,2,0.614740646
13757,32,22293,7,5,0,0,0,12,5,9,10,0,0,24,nowin,win,dlbust,bust,20,0,12,189,0.391534392,0.037037037,0.53968254,0,0.013579086
13758,109,22294,10,7,0,0,0,17,4,10,10,0,0,24,nowin,win,dlbust,bust,20,0,17,221,0.461538462,0.058823529,0.597285068,3,0.901830309
13759,29,22294,10,6,0,0,0,16,4,10,10,0,0,24,nowin,win,dlbust,bust,20,0,16,189,0.44973545,0.058201058,0.544973545,1,0.300349439
13760,117,22294,10,2,0,0,0,12,4,10,10,0,0,24,nowin,win,dlbust,bust,20,0,12,173,0.410404624,0.069364162,0.606936416,2,0.578610282
13761,149,22294,7,4,7,0,0,18,4,10,10,0,0,24,nowin,win,dlbust,bust,20,0,11,225,0.457777778,0.057777778,0.648888889,2,0.651965595
13762,53,22294,6,2,4,0,0,12,4,10,10,0,0,24,nowin,win,dlbust,bust,20,0,8,250,0.372,0.064,0.564,0,0.013687345
13763,118,22294,4,9,0,0,0,13,4,10,10,0,0,24,nowin,win,dlbust,bust,20,0,13,216,0.393518519,0.037037037,0.555555556,0,0.018059873
13764,140,22295,7,10,0,0,0,17,9,5,2,10,0,26,nowin,win,dlbust,bust,20,0,17,210,0.466666667,0.023809524,0.604761905,3,0.915293335
13765,93,22295,10,10,0,0,0,20,9,5,2,10,0,26,nowin,win,dlbust,bust,20,0,20,175,0.485714286,0.051428571,0.548571429,1,0.323648091
13766,5,22295,4,2,9,5,0,20,9,5,2,10,0,26,nowin,win,dlbust,bust,20,0,6,203,0.42364532,0.02955665,0.596059113,2,0.582508076
13767,104,22295,7,9,0,10,0,26,9,5,2,10,0,26,nowin,loss,bust,plbust,0,10,16,209,0.363636364,0.052631579,0.593301435,0,0.018359419
13768,4,22295,9,2,3,4,0,18,9,5,2,10,0,26,nowin,win,dlbust,bust,20,0,11,217,0.460829493,0.036866359,0.562211982,1,0.315432839
13769,68,22295,10,7,0,0,0,17,9,5,2,10,0,26,nowin,win,dlbust,bust,20,0,17,205,0.434146341,0.029268293,0.6,2,0.59483189
13770,70,22296,9,10,0,0,0,19,2,3,4,7,10,26,nowin,win,dlbust,bust,20,0,19,228,0.385964912,0.039473684,0.557017544,0,0.016157125
13771,41,22296,10,5,0,0,0,15,2,3,4,7,10,26,nowin,win,dlbust,bust,20,0,15,192,0.364583333,0.036458333,0.520833333,0,0.00089702
13772,143,22296,10,10,0,0,0,20,2,3,4,7,10,26,nowin,win,dlbust,bust,20,0,20,203,0.463054187,0.044334975,0.57635468,3,0.883143365
13773,65,22296,10,8,0,0,0,18,2,3,4,7,10,26,nowin,win,dlbust,bust,20,0,18,203,0.492610837,0.054187192,0.571428571,3,0.913702814
13774,22,22296,5,4,11,0,0,20,2,3,4,7,10,26,nowin,win,dlbust,bust,20,0,9,187,0.481283422,0.042780749,0.577540107,3,0.906128176
13775,102,22296,10,3,0,0,0,13,2,3,4,7,10,26,nowin,win,dlbust,bust,20,0,13,192,0.338541667,0.046875,0.5625,0,0.003306118
13776,117,22297,2,3,8,0,0,13,5,3,7,5,0,20,nowin,loss,beat,dlwin,0,10,5,173,0.410404624,0.069364162,0.606936416,2,0.578610282
13777,16,22297,10,10,0,0,0,20,5,3,7,5,0,20,nowin,push,push,push,10,0,20,220,0.427272727,0.081818182,0.6,2,0.588660176
13778,46,22297,2,7,6,0,0,15,5,3,7,5,0,20,nowin,loss,beat,dlwin,0,10,9,186,0.403225806,0.048387097,0.591397849,0,0.029742194
13779,21,22297,1,4,10,0,0,15,5,3,7,5,0,20,nowin,loss,beat,dlwin,0,10,5,214,0.359813084,0.042056075,0.626168224,0,0.025263474
13780,147,22297,10,10,0,0,0,20,5,3,7,5,0,20,nowin,push,push,push,10,0,20,205,0.380487805,0.014634146,0.536585366,0,0.00951447
13781,127,22297,11,8,0,0,0,19,5,3,7,5,0,20,nowin,loss,beat,dlwin,0,10,19,201,0.402985075,0.029850746,0.60199005,0,0.032263937
13782,74,22298,8,10,0,0,0,18,4,6,7,0,0,17,nowin,win,plwin,beat,20,0,18,209,0.411483254,0.04784689,0.531100478,0,0.017448125
13783,34,22298,5,5,4,0,0,14,4,6,7,0,0,17,nowin,loss,beat,dlwin,0,10,10,202,0.5,0.079207921,0.618811881,3,0.968961434
13784,124,22298,2,7,8,0,0,17,4,6,7,0,0,17,nowin,push,push,push,10,0,9,202,0.47029703,0.064356436,0.584158416,3,0.899458193
13785,100,22298,10,10,0,0,0,20,4,6,7,0,0,17,nowin,win,plwin,beat,20,0,20,190,0.452631579,0.036842105,0.594736842,3,0.888671154
13786,7,22298,5,6,1,0,0,12,4,6,7,0,0,17,nowin,loss,beat,dlwin,0,10,11,183,0.442622951,0.06010929,0.62295082,2,0.619303341
13787,128,22298,8,9,0,0,0,17,4,6,7,0,0,17,nowin,push,push,push,10,0,17,227,0.356828194,0.052863436,0.577092511,0,0.012352564
13788,138,22299,10,2,0,5,0,17,3,4,6,7,0,20,nowin,loss,beat,dlwin,0,10,12,190,0.442105263,0.047368421,0.610526316,2,0.609711065
13789,83,22299,10,3,0,0,0,13,3,4,6,7,0,20,nowin,loss,beat,dlwin,0,10,13,193,0.424870466,0.051813472,0.678756477,2,0.644360335
13790,134,22299,6,2,5,0,0,13,3,4,6,7,0,20,nowin,loss,beat,dlwin,0,10,8,185,0.443243243,0.021621622,0.545945946,1,0.296939509
13791,64,22299,10,9,0,0,0,19,3,4,6,7,0,20,nowin,loss,beat,dlwin,0,10,19,187,0.363636364,0.048128342,0.631016043,0,0.027594885
13792,45,22299,10,11,0,0,0,21,3,4,6,7,0,20,win,win,plwin,beat,25,0,21,196,0.428571429,0.051020408,0.612244898,2,0.598821767
13793,59,22299,6,5,9,0,0,20,3,4,6,7,0,20,nowin,push,push,push,10,0,11,228,0.429824561,0.048245614,0.543859649,1,0.287885446
13794,138,22300,3,10,0,10,0,23,9,4,10,0,0,23,nowin,loss,bust,plbust,0,10,13,190,0.442105263,0.047368421,0.610526316,2,0.609711065
13795,103,22300,10,10,0,0,0,20,9,4,10,0,0,23,nowin,win,dlbust,bust,20,0,20,203,0.379310345,0.064039409,0.551724138,0,0.012869209
13796,14,22300,4,10,0,4,0,18,9,4,10,0,0,23,nowin,win,dlbust,bust,20,0,14,202,0.391089109,0.01980198,0.628712871,2,0.577264877
13797,138,22300,4,4,9,0,0,17,9,4,10,0,0,23,nowin,win,dlbust,bust,20,0,8,190,0.442105263,0.047368421,0.610526316,2,0.609711065
13798,121,22300,6,10,0,10,0,26,9,4,10,0,0,23,nowin,loss,bust,plbust,0,10,16,195,0.456410256,0.025641026,0.512820513,1,0.288597791
13799,78,22300,10,7,0,0,0,17,9,4,10,0,0,23,nowin,win,dlbust,bust,20,0,17,201,0.517412935,0.034825871,0.587064677,3,0.95871112
13800,126,22301,10,4,0,0,0,14,2,8,9,0,0,19,nowin,loss,beat,dlwin,0,10,14,188,0.457446809,0.074468085,0.60106383,3,0.900633203
13801,22,22301,2,5,8,0,0,15,2,8,9,0,0,19,nowin,loss,beat,dlwin,0,10,7,187,0.481283422,0.042780749,0.577540107,3,0.906128176
13802,71,22301,10,3,0,0,0,13,2,8,9,0,0,19,nowin,loss,beat,dlwin,0,10,13,193,0.352331606,0.046632124,0.585492228,0,0.013063661
13803,105,22301,2,5,10,0,0,17,2,8,9,0,0,19,nowin,loss,beat,dlwin,0,10,7,198,0.414141414,0.070707071,0.590909091,0,0.032889494
13804,77,22301,6,10,0,0,0,16,2,8,9,0,0,19,nowin,loss,beat,dlwin,0,10,16,200,0.455,0.04,0.62,3,0.916252116
13805,118,22301,9,6,0,0,0,15,2,8,9,0,0,19,nowin,loss,beat,dlwin,0,10,15,216,0.393518519,0.037037037,0.555555556,0,0.018059873
13806,105,22302,9,6,0,0,0,15,6,2,8,5,0,21,nowin,loss,beat,dlwin,0,10,15,198,0.414141414,0.070707071,0.590909091,0,0.032889494
13807,2,22302,7,2,4,0,0,13,6,2,8,5,0,21,nowin,loss,beat,dlwin,0,10,9,200,0.445,0.035,0.64,2,0.633962549
13808,146,22302,2,2,3,10,0,17,6,2,8,5,0,21,nowin,loss,beat,dlwin,0,10,4,221,0.43438914,0.040723982,0.542986425,1,0.290190091
13809,150,22302,4,3,10,0,0,17,6,2,8,5,0,21,nowin,loss,beat,dlwin,0,10,7,192,0.401041667,0.036458333,0.567708333,0,0.023287458
13810,85,22302,4,1,9,0,0,14,6,2,8,5,0,21,nowin,loss,beat,dlwin,0,10,5,195,0.41025641,0.066666667,0.594871795,0,0.03269711
13811,12,22302,11,2,4,0,0,17,6,2,8,5,0,21,nowin,loss,beat,dlwin,0,10,13,189,0.470899471,0.015873016,0.613756614,3,0.929171178
13812,12,22303,10,7,0,0,0,17,4,9,8,0,0,21,nowin,loss,beat,dlwin,0,10,17,189,0.470899471,0.015873016,0.613756614,3,0.929171178
13813,112,22303,10,6,0,0,0,16,4,9,8,0,0,21,nowin,loss,beat,dlwin,0,10,16,203,0.448275862,0.054187192,0.600985222,3,0.889576933
13814,56,22303,6,2,11,0,0,19,4,9,8,0,0,21,nowin,loss,beat,dlwin,0,10,8,175,0.4,0.057142857,0.582857143,0,0.026685297
13815,116,22303,10,10,0,0,0,20,4,9,8,0,0,21,nowin,loss,beat,dlwin,0,10,20,195,0.425641026,0.056410256,0.538461538,1,0.28273747
13816,35,22303,2,7,10,0,0,19,4,9,8,0,0,21,nowin,loss,beat,dlwin,0,10,9,202,0.410891089,0.044554455,0.633663366,2,0.598681573
13817,99,22303,10,5,0,0,0,15,4,9,8,0,0,21,nowin,loss,beat,dlwin,0,10,15,207,0.47826087,0.062801932,0.637681159,3,0.961418446
13818,64,22304,1,6,10,0,0,17,2,5,10,0,0,17,nowin,push,push,push,10,0,7,187,0.363636364,0.048128342,0.631016043,0,0.027594885
13819,145,22304,4,10,0,0,0,14,2,5,10,0,0,17,nowin,loss,beat,dlwin,0,10,14,188,0.441489362,0.031914894,0.622340426,2,0.617837093
13820,74,22304,4,10,0,0,0,14,2,5,10,0,0,17,nowin,loss,beat,dlwin,0,10,14,209,0.411483254,0.04784689,0.531100478,0,0.017448125
13821,68,22304,10,11,0,0,0,21,2,5,10,0,0,17,win,win,plwin,beat,25,0,21,205,0.434146341,0.029268293,0.6,2,0.59483189
13822,134,22304,4,10,0,0,0,14,2,5,10,0,0,17,nowin,loss,beat,dlwin,0,10,14,185,0.443243243,0.021621622,0.545945946,1,0.296939509
13823,85,22304,2,10,0,10,0,22,2,5,10,0,0,17,nowin,loss,bust,plbust,0,10,12,195,0.41025641,0.066666667,0.594871795,0,0.03269711
13824,12,22305,5,10,0,5,0,20,11,10,0,0,0,21,nowin,loss,beat,dlwin,0,10,15,189,0.470899471,0.015873016,0.613756614,3,0.929171178
13825,74,22305,9,10,0,0,0,19,11,10,0,0,0,21,nowin,loss,beat,dlwin,0,10,19,209,0.411483254,0.04784689,0.531100478,0,0.017448125
13826,131,22305,3,7,4,10,0,24,11,10,0,0,0,21,nowin,loss,bust,plbust,0,10,10,217,0.410138249,0.069124424,0.543778802,0,0.02015021
13827,129,22305,10,8,0,0,0,18,11,10,0,0,0,21,nowin,loss,beat,dlwin,0,10,18,201,0.422885572,0.064676617,0.55721393,0,0.027255383
13828,2,22305,10,5,0,10,0,25,11,10,0,0,0,21,nowin,loss,bust,plbust,0,10,15,200,0.445,0.035,0.64,2,0.633962549
13829,118,22305,5,10,0,9,0,24,11,10,0,0,0,21,nowin,loss,bust,plbust,0,10,15,216,0.393518519,0.037037037,0.555555556,0,0.018059873
13830,143,22306,10,6,0,6,0,22,11,10,0,0,0,21,nowin,loss,bust,plbust,0,10,16,203,0.463054187,0.044334975,0.57635468,3,0.883143365
13831,59,22306,10,6,0,4,0,20,11,10,0,0,0,21,nowin,loss,beat,dlwin,0,10,16,228,0.429824561,0.048245614,0.543859649,1,0.287885446
13832,139,22306,11,10,0,0,0,21,11,10,0,0,0,21,win,push,push,push,10,0,21,192,0.380208333,0.036458333,0.59375,0,0.023429169
13833,19,22306,9,9,0,0,0,18,11,10,0,0,0,21,nowin,loss,beat,dlwin,0,10,18,237,0.41350211,0.054852321,0.628691983,2,0.597373826
13834,144,22306,10,10,0,0,0,20,11,10,0,0,0,21,nowin,loss,beat,dlwin,0,10,20,202,0.386138614,0.054455446,0.564356436,0,0.018006244
13835,92,22306,9,10,0,0,0,19,11,10,0,0,0,21,nowin,loss,beat,dlwin,0,10,19,186,0.446236559,0.059139785,0.564516129,1,0.307826125
13836,127,22307,9,10,0,0,0,19,11,9,0,0,0,20,nowin,loss,beat,dlwin,0,10,19,201,0.402985075,0.029850746,0.60199005,0,0.032263937
13837,85,22307,11,10,0,0,0,21,11,9,0,0,0,20,win,win,plwin,beat,25,0,21,195,0.41025641,0.066666667,0.594871795,0,0.03269711
13838,133,22307,10,10,0,0,0,20,11,9,0,0,0,20,nowin,push,push,push,10,0,20,201,0.47761194,0.064676617,0.611940299,3,0.935428111
13839,39,22307,7,10,0,0,0,17,11,9,0,0,0,20,nowin,loss,beat,dlwin,0,10,17,191,0.429319372,0.062827225,0.57591623,0,0.033760763
13840,128,22307,2,9,10,0,0,21,11,9,0,0,0,20,nowin,win,plwin,beat,20,0,11,227,0.356828194,0.052863436,0.577092511,0,0.012352564
13841,31,22307,2,10,0,7,0,19,11,9,0,0,0,20,nowin,loss,beat,dlwin,0,10,12,188,0.473404255,0.058510638,0.515957447,1,0.300306557
13842,143,22308,10,10,0,0,0,20,5,6,7,0,0,18,nowin,win,plwin,beat,20,0,20,203,0.463054187,0.044334975,0.57635468,3,0.883143365
13843,103,22308,10,10,0,0,0,20,5,6,7,0,0,18,nowin,win,plwin,beat,20,0,20,203,0.379310345,0.064039409,0.551724138,0,0.012869209
13844,44,22308,10,4,0,0,0,14,5,6,7,0,0,18,nowin,loss,beat,dlwin,0,10,14,219,0.433789954,0.050228311,0.534246575,1,0.285551035
13845,44,22308,10,3,0,0,0,13,5,6,7,0,0,18,nowin,loss,beat,dlwin,0,10,13,219,0.433789954,0.050228311,0.534246575,1,0.285551035
13846,69,22308,8,7,0,0,0,15,5,6,7,0,0,18,nowin,loss,beat,dlwin,0,10,15,194,0.365979381,0.030927835,0.515463918,0,0
13847,147,22308,6,8,0,0,0,14,5,6,7,0,0,18,nowin,loss,beat,dlwin,0,10,14,205,0.380487805,0.014634146,0.536585366,0,0.00951447
13848,103,22309,4,10,0,10,0,24,11,3,2,10,0,26,nowin,loss,bust,plbust,0,10,14,203,0.379310345,0.064039409,0.551724138,0,0.012869209
13849,3,22309,10,7,0,0,0,17,11,3,2,10,0,26,nowin,win,dlbust,bust,20,0,17,190,0.431578947,0.026315789,0.542105263,1,0.288076384
13850,17,22309,10,10,0,0,0,20,11,3,2,10,0,26,nowin,win,dlbust,bust,20,0,20,171,0.444444444,0.070175439,0.555555556,1,0.302364894
13851,57,22309,9,5,0,10,0,24,11,3,2,10,0,26,nowin,loss,bust,plbust,0,10,14,192,0.46875,0.052083333,0.59375,3,0.907001181
13852,10,22309,11,10,0,0,0,21,11,3,2,10,0,26,win,win,dlbust,bust,25,0,21,191,0.413612565,0.057591623,0.596858639,2,0.574087175
13853,136,22309,4,9,0,10,0,23,11,3,2,10,0,26,nowin,loss,bust,plbust,0,10,13,194,0.396907216,0.025773196,0.597938144,0,0.029452644
13854,49,22310,7,2,4,6,0,19,7,8,7,0,0,22,nowin,win,dlbust,bust,20,0,9,207,0.396135266,0.053140097,0.594202899,0,0.028306925
13855,149,22310,7,10,0,0,0,17,7,8,7,0,0,22,nowin,win,dlbust,bust,20,0,17,225,0.457777778,0.057777778,0.648888889,2,0.651965595
13856,107,22310,10,11,0,0,0,21,7,8,7,0,0,22,win,win,dlbust,bust,25,0,21,218,0.444954128,0.073394495,0.600917431,2,0.605210014
13857,61,22310,10,8,0,0,0,18,7,8,7,0,0,22,nowin,win,dlbust,bust,20,0,18,194,0.427835052,0.077319588,0.603092784,2,0.591437139
13858,84,22310,4,7,10,0,0,21,7,8,7,0,0,22,nowin,win,dlbust,bust,20,0,11,195,0.379487179,0.056410256,0.569230769,0,0.017209119
13859,84,22310,4,10,0,4,0,18,7,8,7,0,0,22,nowin,win,dlbust,bust,20,0,14,195,0.379487179,0.056410256,0.569230769,0,0.017209119
13860,56,22311,1,5,10,10,0,26,10,5,9,0,0,24,nowin,loss,bust,plbust,0,10,6,175,0.4,0.057142857,0.582857143,0,0.026685297
13861,114,22311,3,10,0,10,0,23,10,5,9,0,0,24,nowin,loss,bust,plbust,0,10,13,198,0.47979798,0.025252525,0.611111111,3,0.937232995
13862,28,22311,6,3,2,10,0,21,10,5,9,0,0,24,nowin,win,dlbust,bust,20,0,9,199,0.422110553,0.045226131,0.542713568,1,0.282706618
13863,107,22311,8,6,0,7,0,21,10,5,9,0,0,24,nowin,win,dlbust,bust,20,0,14,218,0.444954128,0.073394495,0.600917431,2,0.605210014
13864,1,22311,9,5,0,8,0,22,10,5,9,0,0,24,nowin,loss,bust,plbust,0,10,14,197,0.406091371,0.025380711,0.649746193,2,0.606186955
13865,131,22311,9,4,0,9,0,22,10,5,9,0,0,24,nowin,loss,bust,plbust,0,10,13,217,0.410138249,0.069124424,0.543778802,0,0.02015021
13866,104,22312,9,7,0,7,0,23,10,4,7,0,0,21,nowin,loss,bust,plbust,0,10,16,209,0.363636364,0.052631579,0.593301435,0,0.018359419
13867,22,22312,10,3,0,10,0,23,10,4,7,0,0,21,nowin,loss,bust,plbust,0,10,13,187,0.481283422,0.042780749,0.577540107,3,0.906128176
13868,123,22312,10,9,0,0,0,19,10,4,7,0,0,21,nowin,loss,beat,dlwin,0,10,19,205,0.43902439,0.034146341,0.614634146,2,0.609962544
13869,114,22312,8,10,0,0,0,18,10,4,7,0,0,21,nowin,loss,beat,dlwin,0,10,18,198,0.47979798,0.025252525,0.611111111,3,0.937232995
13870,62,22312,8,3,1,1,2,15,10,4,7,0,0,21,nowin,loss,beat,dlwin,0,10,11,178,0.370786517,0.028089888,0.54494382,0,0.008657722
13871,48,22312,10,4,0,4,0,18,10,4,7,0,0,21,nowin,loss,beat,dlwin,0,10,14,203,0.413793103,0.019704433,0.600985222,2,0.577280801
13872,16,22313,4,7,2,8,0,21,9,3,6,0,0,18,nowin,win,plwin,beat,20,0,11,220,0.427272727,0.081818182,0.6,2,0.588660176
13873,128,22313,10,11,0,0,0,21,9,3,6,0,0,18,win,win,plwin,beat,25,0,21,227,0.356828194,0.052863436,0.577092511,0,0.012352564
13874,103,22313,10,10,0,0,0,20,9,3,6,0,0,18,nowin,win,plwin,beat,20,0,20,203,0.379310345,0.064039409,0.551724138,0,0.012869209
13875,49,22313,10,5,0,1,7,23,9,3,6,0,0,18,nowin,loss,bust,plbust,0,10,15,207,0.396135266,0.053140097,0.594202899,0,0.028306925
13876,124,22313,3,3,8,10,0,24,9,3,6,0,0,18,nowin,loss,bust,plbust,0,10,6,202,0.47029703,0.064356436,0.584158416,3,0.899458193
13877,48,22313,9,10,0,0,0,19,9,3,6,0,0,18,nowin,win,plwin,beat,20,0,19,203,0.413793103,0.019704433,0.600985222,2,0.577280801
13878,33,22314,10,10,0,0,0,20,2,6,2,10,0,20,nowin,push,push,push,10,0,20,192,0.4375,0.057291667,0.625,2,0.616208916
13879,102,22314,10,7,0,0,0,17,2,6,2,10,0,20,nowin,loss,beat,dlwin,0,10,17,192,0.338541667,0.046875,0.5625,0,0.003306118
13880,21,22314,7,8,0,0,0,15,2,6,2,10,0,20,nowin,loss,beat,dlwin,0,10,15,214,0.359813084,0.042056075,0.626168224,0,0.025263474
13881,101,22314,9,9,0,0,0,18,2,6,2,10,0,20,nowin,loss,beat,dlwin,0,10,18,205,0.424390244,0.068292683,0.63902439,2,0.614740646
13882,37,22314,7,10,0,0,0,17,2,6,2,10,0,20,nowin,loss,beat,dlwin,0,10,17,208,0.394230769,0.038461538,0.581730769,0,0.024682772
13883,81,22314,7,10,0,0,0,17,2,6,2,10,0,20,nowin,loss,beat,dlwin,0,10,17,182,0.395604396,0.043956044,0.60989011,2,0.567491261
13884,104,22315,10,2,0,1,4,17,10,10,0,0,0,20,nowin,loss,beat,dlwin,0,10,12,209,0.363636364,0.052631579,0.593301435,0,0.018359419
13885,63,22315,10,7,0,0,0,17,10,10,0,0,0,20,nowin,loss,beat,dlwin,0,10,17,216,0.467592593,0.037037037,0.62037037,3,0.931690496
13886,98,22315,5,9,0,4,0,18,10,10,0,0,0,20,nowin,loss,beat,dlwin,0,10,14,220,0.422727273,0.054545455,0.55,1,0.28664435
13887,29,22315,2,10,0,1,8,21,10,10,0,0,0,20,nowin,win,plwin,beat,20,0,12,189,0.44973545,0.058201058,0.544973545,1,0.300349439
13888,122,22315,5,3,10,0,0,18,10,10,0,0,0,20,nowin,loss,beat,dlwin,0,10,8,210,0.347619048,0.052380952,0.59047619,0,0.012873677
13889,131,22315,2,7,10,0,0,19,10,10,0,0,0,20,nowin,loss,beat,dlwin,0,10,9,217,0.410138249,0.069124424,0.543778802,0,0.02015021
13890,78,22316,8,9,0,0,0,17,8,11,0,0,0,19,nowin,loss,beat,dlwin,0,10,17,201,0.517412935,0.034825871,0.587064677,3,0.95871112
13891,146,22316,10,7,0,0,0,17,8,11,0,0,0,19,nowin,loss,beat,dlwin,0,10,17,221,0.43438914,0.040723982,0.542986425,1,0.290190091
13892,56,22316,7,10,0,0,0,17,8,11,0,0,0,19,nowin,loss,beat,dlwin,0,10,17,175,0.4,0.057142857,0.582857143,0,0.026685297
13893,50,22316,4,10,0,10,0,24,8,11,0,0,0,19,nowin,loss,bust,plbust,0,10,14,202,0.405940594,0.04950495,0.54950495,0,0.020296079
13894,27,22316,10,3,0,10,0,23,8,11,0,0,0,19,nowin,loss,bust,plbust,0,10,13,178,0.370786517,0.016853933,0.573033708,0,0.015536309
13895,120,22316,9,10,0,0,0,19,8,11,0,0,0,19,nowin,push,push,push,10,0,19,202,0.440594059,0.034653465,0.618811881,2,0.614441029
13896,104,22317,4,10,0,10,0,24,10,11,0,0,0,21,nowin,loss,bust,plbust,0,10,14,209,0.363636364,0.052631579,0.593301435,0,0.018359419
13897,33,22317,5,5,10,0,0,20,10,11,0,0,0,21,nowin,loss,beat,dlwin,0,10,10,192,0.4375,0.057291667,0.625,2,0.616208916
13898,63,22317,2,10,0,2,4,18,10,11,0,0,0,21,nowin,loss,beat,dlwin,0,10,12,216,0.467592593,0.037037037,0.62037037,3,0.931690496
13899,32,22317,10,5,0,7,0,22,10,11,0,0,0,21,nowin,loss,bust,plbust,0,10,15,189,0.391534392,0.037037037,0.53968254,0,0.013579086
13900,74,22317,11,9,0,0,0,20,10,11,0,0,0,21,nowin,loss,beat,dlwin,0,10,20,209,0.411483254,0.04784689,0.531100478,0,0.017448125
13901,118,22317,6,2,3,1,10,22,10,11,0,0,0,21,nowin,loss,bust,plbust,0,10,8,216,0.393518519,0.037037037,0.555555556,0,0.018059873
13902,111,22318,10,6,0,1,0,17,11,1,7,0,0,19,nowin,loss,beat,dlwin,0,10,16,180,0.433333333,0.055555556,0.611111111,2,0.602264492
13903,128,22318,10,11,0,0,0,21,11,1,7,0,0,19,win,win,plwin,beat,25,0,21,227,0.356828194,0.052863436,0.577092511,0,0.012352564
13904,23,22318,5,10,0,6,0,21,11,1,7,0,0,19,nowin,win,plwin,beat,20,0,15,208,0.427884615,0.0625,0.552884615,1,0.29114424
13905,32,22318,4,9,0,3,6,22,11,1,7,0,0,19,nowin,loss,bust,plbust,0,10,13,189,0.391534392,0.037037037,0.53968254,0,0.013579086
13906,70,22318,9,10,0,0,0,19,11,1,7,0,0,19,nowin,push,push,push,10,0,19,228,0.385964912,0.039473684,0.557017544,0,0.016157125
13907,80,22318,8,5,0,10,0,23,11,1,7,0,0,19,nowin,loss,bust,plbust,0,10,13,186,0.419354839,0.059139785,0.623655914,2,0.59892924
13908,33,22319,8,8,0,3,0,19,8,5,7,0,0,20,nowin,loss,beat,dlwin,0,10,16,192,0.4375,0.057291667,0.625,2,0.616208916
13909,88,22319,4,5,11,0,0,20,8,5,7,0,0,20,nowin,push,push,push,10,0,9,206,0.466019417,0.033980583,0.54368932,1,0.309467903
13910,88,22319,10,11,0,0,0,21,8,5,7,0,0,20,win,win,plwin,beat,25,0,21,206,0.466019417,0.033980583,0.54368932,1,0.309467903
13911,107,22319,11,4,1,9,0,25,8,5,7,0,0,20,nowin,loss,bust,plbust,0,10,15,218,0.444954128,0.073394495,0.600917431,2,0.605210014
13912,141,22319,8,6,0,3,0,17,8,5,7,0,0,20,nowin,loss,beat,dlwin,0,10,14,202,0.420792079,0.074257426,0.564356436,0,0.028377851
13913,46,22319,5,10,0,7,0,22,8,5,7,0,0,20,nowin,loss,bust,plbust,0,10,15,186,0.403225806,0.048387097,0.591397849,0,0.029742194
13914,125,22320,10,2,0,8,0,20,3,10,9,0,0,22,nowin,win,dlbust,bust,20,0,12,219,0.438356164,0.050228311,0.575342466,1,0.308411257
13915,20,22320,7,7,0,0,0,14,3,10,9,0,0,22,nowin,win,dlbust,bust,20,0,14,186,0.456989247,0.037634409,0.537634409,1,0.301097108
13916,30,22320,10,10,0,0,0,20,3,10,9,0,0,22,nowin,win,dlbust,bust,20,0,20,206,0.393203883,0.033980583,0.601941748,0,0.029324648
13917,116,22320,11,8,0,0,0,19,3,10,9,0,0,22,nowin,win,dlbust,bust,20,0,19,195,0.425641026,0.056410256,0.538461538,1,0.28273747
13918,120,22320,10,10,0,0,0,20,3,10,9,0,0,22,nowin,win,dlbust,bust,20,0,20,202,0.440594059,0.034653465,0.618811881,2,0.614441029
13919,141,22320,10,10,0,0,0,20,3,10,9,0,0,22,nowin,win,dlbust,bust,20,0,20,202,0.420792079,0.074257426,0.564356436,0,0.028377851
13920,42,22321,3,2,2,3,2,12,11,7,0,0,0,18,nowin,loss,beat,dlwin,0,10,5,212,0.443396226,0.051886792,0.570754717,1,0.309181312
13921,26,22321,7,7,0,10,0,24,11,7,0,0,0,18,nowin,loss,bust,plbust,0,10,14,203,0.463054187,0.0591133,0.541871921,1,0.306802864
13922,37,22321,10,8,0,0,0,18,11,7,0,0,0,18,nowin,push,push,push,10,0,18,208,0.394230769,0.038461538,0.581730769,0,0.024682772
13923,112,22321,7,3,10,0,0,20,11,7,0,0,0,18,nowin,win,plwin,beat,20,0,10,203,0.448275862,0.054187192,0.600985222,3,0.889576933
13924,86,22321,10,2,0,4,4,20,11,7,0,0,0,18,nowin,win,plwin,beat,20,0,12,196,0.454081633,0.040816327,0.591836735,3,0.887566443
13925,150,22321,3,10,0,10,0,23,11,7,0,0,0,18,nowin,loss,bust,plbust,0,10,13,192,0.401041667,0.036458333,0.567708333,0,0.023287458
13926,87,22322,2,10,0,10,0,22,10,11,0,0,0,21,nowin,loss,bust,plbust,0,10,12,202,0.405940594,0.054455446,0.628712871,2,0.590599801
13927,65,22322,3,2,10,10,0,25,10,11,0,0,0,21,nowin,loss,bust,plbust,0,10,5,203,0.492610837,0.054187192,0.571428571,3,0.913702814
13928,111,22322,8,10,0,0,0,18,10,11,0,0,0,21,nowin,loss,beat,dlwin,0,10,18,180,0.433333333,0.055555556,0.611111111,2,0.602264492
13929,64,22322,5,9,0,8,0,22,10,11,0,0,0,21,nowin,loss,bust,plbust,0,10,14,187,0.363636364,0.048128342,0.631016043,0,0.027594885
13930,150,22322,9,10,0,0,0,19,10,11,0,0,0,21,nowin,loss,beat,dlwin,0,10,19,192,0.401041667,0.036458333,0.567708333,0,0.023287458
13931,116,22322,8,3,2,5,0,18,10,11,0,0,0,21,nowin,loss,beat,dlwin,0,10,11,195,0.425641026,0.056410256,0.538461538,1,0.28273747
13932,108,22323,10,8,0,0,0,18,7,4,10,0,0,21,nowin,loss,beat,dlwin,0,10,18,193,0.435233161,0.056994819,0.559585492,1,0.298824795
13933,38,22323,10,10,0,0,0,20,7,4,10,0,0,21,nowin,loss,beat,dlwin,0,10,20,202,0.361386139,0.03960396,0.564356436,0,0.010597953
13934,118,22323,10,2,0,10,0,22,7,4,10,0,0,21,nowin,loss,bust,plbust,0,10,12,216,0.393518519,0.037037037,0.555555556,0,0.018059873
13935,34,22323,7,8,0,1,7,23,7,4,10,0,0,21,nowin,loss,bust,plbust,0,10,15,202,0.5,0.079207921,0.618811881,3,0.968961434
13936,20,22323,4,10,0,5,0,19,7,4,10,0,0,21,nowin,loss,beat,dlwin,0,10,14,186,0.456989247,0.037634409,0.537634409,1,0.301097108
13937,18,22323,10,6,0,6,0,22,7,4,10,0,0,21,nowin,loss,bust,plbust,0,10,16,182,0.461538462,0.043956044,0.587912088,3,0.892649374
13938,99,22324,8,2,5,4,0,19,10,7,0,0,0,17,nowin,win,plwin,beat,20,0,10,207,0.47826087,0.062801932,0.637681159,3,0.961418446
13939,8,22324,9,4,0,10,0,23,10,7,0,0,0,17,nowin,loss,bust,plbust,0,10,13,181,0.44198895,0.071823204,0.596685083,2,0.599438402
13940,60,22324,9,5,0,7,0,21,10,7,0,0,0,17,nowin,win,plwin,beat,20,0,14,227,0.418502203,0.022026432,0.559471366,0,0.026496258
13941,110,22324,5,7,0,6,0,18,10,7,0,0,0,17,nowin,win,plwin,beat,20,0,12,192,0.416666667,0.046875,0.557291667,0,0.025413132
13942,67,22324,10,8,0,0,0,18,10,7,0,0,0,17,nowin,win,plwin,beat,20,0,18,195,0.369230769,0.041025641,0.569230769,0,0.014139427
13943,85,22324,10,5,0,10,0,25,10,7,0,0,0,17,nowin,loss,bust,plbust,0,10,15,195,0.41025641,0.066666667,0.594871795,0,0.03269711
13944,83,22325,5,5,10,0,0,20,3,3,11,0,0,17,nowin,win,plwin,beat,20,0,10,193,0.424870466,0.051813472,0.678756477,2,0.644360335
13945,22,22325,4,1,10,0,0,15,3,3,11,0,0,17,nowin,loss,beat,dlwin,0,10,5,187,0.481283422,0.042780749,0.577540107,3,0.906128176
13946,129,22325,6,1,7,0,0,14,3,3,11,0,0,17,nowin,loss,beat,dlwin,0,10,7,201,0.422885572,0.064676617,0.55721393,0,0.027255383
13947,38,22325,9,10,0,0,0,19,3,3,11,0,0,17,nowin,win,plwin,beat,20,0,19,202,0.361386139,0.03960396,0.564356436,0,0.010597953
13948,18,22325,10,10,0,0,0,20,3,3,11,0,0,17,nowin,win,plwin,beat,20,0,20,182,0.461538462,0.043956044,0.587912088,3,0.892649374
13949,150,22325,8,10,0,0,0,18,3,3,11,0,0,17,nowin,win,plwin,beat,20,0,18,192,0.401041667,0.036458333,0.567708333,0,0.023287458
13950,11,22326,9,2,8,0,0,19,5,6,8,0,0,19,nowin,push,push,push,10,0,11,236,0.457627119,0.016949153,0.588983051,3,0.889015813
13951,149,22326,10,10,0,0,0,20,5,6,8,0,0,19,nowin,win,plwin,beat,20,0,20,225,0.457777778,0.057777778,0.648888889,2,0.651965595
13952,27,22326,9,4,0,0,0,13,5,6,8,0,0,19,nowin,loss,beat,dlwin,0,10,13,178,0.370786517,0.016853933,0.573033708,0,0.015536309
13953,86,22326,4,8,0,0,0,12,5,6,8,0,0,19,nowin,loss,beat,dlwin,0,10,12,196,0.454081633,0.040816327,0.591836735,3,0.887566443
13954,24,22326,10,10,0,0,0,20,5,6,8,0,0,19,nowin,win,plwin,beat,20,0,20,207,0.458937198,0.048309179,0.570048309,1,0.318138014
13955,73,22326,10,8,0,0,0,18,5,6,8,0,0,19,nowin,loss,beat,dlwin,0,10,18,181,0.375690608,0.011049724,0.596685083,0,0.022795773
13956,45,22327,4,5,7,0,0,16,5,10,10,0,0,25,nowin,win,dlbust,bust,20,0,9,196,0.428571429,0.051020408,0.612244898,2,0.598821767
13957,9,22327,11,7,0,0,0,18,5,10,10,0,0,25,nowin,win,dlbust,bust,20,0,18,194,0.37628866,0.015463918,0.541237113,0,0.009396796
13958,12,22327,10,7,0,0,0,17,5,10,10,0,0,25,nowin,win,dlbust,bust,20,0,17,189,0.470899471,0.015873016,0.613756614,3,0.929171178
13959,130,22327,3,7,10,0,0,20,5,10,10,0,0,25,nowin,win,dlbust,bust,20,0,10,219,0.410958904,0.03652968,0.566210046,0,0.025888739
13960,7,22327,2,7,11,0,0,20,5,10,10,0,0,25,nowin,win,dlbust,bust,20,0,9,183,0.442622951,0.06010929,0.62295082,2,0.619303341
13961,66,22327,6,4,7,0,0,17,5,10,10,0,0,25,nowin,win,dlbust,bust,20,0,10,217,0.456221198,0.064516129,0.626728111,3,0.924304367
13962,117,22328,8,4,0,0,0,12,6,4,4,10,0,24,nowin,win,dlbust,bust,20,0,12,173,0.410404624,0.069364162,0.606936416,2,0.578610282
13963,132,22328,10,8,0,0,0,18,6,4,4,10,0,24,nowin,win,dlbust,bust,20,0,18,194,0.412371134,0.036082474,0.649484536,2,0.611633238
13964,21,22328,7,10,0,0,0,17,6,4,4,10,0,24,nowin,win,dlbust,bust,20,0,17,214,0.359813084,0.042056075,0.626168224,0,0.025263474
13965,117,22328,2,2,3,2,10,19,6,4,4,10,0,24,nowin,win,dlbust,bust,20,0,4,173,0.410404624,0.069364162,0.606936416,2,0.578610282
13966,19,22328,10,10,0,0,0,20,6,4,4,10,0,24,nowin,win,dlbust,bust,20,0,20,237,0.41350211,0.054852321,0.628691983,2,0.597373826
13967,105,22328,10,3,0,0,0,13,6,4,4,10,0,24,nowin,win,dlbust,bust,20,0,13,198,0.414141414,0.070707071,0.590909091,0,0.032889494
13968,44,22329,10,10,0,0,0,20,11,6,0,0,0,17,nowin,win,plwin,beat,20,0,20,219,0.433789954,0.050228311,0.534246575,1,0.285551035
13969,142,22329,5,10,0,5,0,20,11,6,0,0,0,17,nowin,win,plwin,beat,20,0,15,211,0.417061611,0.047393365,0.526066351,1,0.271531309
13970,84,22329,11,10,0,0,0,21,11,6,0,0,0,17,win,win,plwin,beat,25,0,21,195,0.379487179,0.056410256,0.569230769,0,0.017209119
13971,124,22329,4,10,0,10,0,24,11,6,0,0,0,17,nowin,loss,bust,plbust,0,10,14,202,0.47029703,0.064356436,0.584158416,3,0.899458193
13972,64,22329,10,10,0,0,0,20,11,6,0,0,0,17,nowin,win,plwin,beat,20,0,20,187,0.363636364,0.048128342,0.631016043,0,0.027594885
13973,116,22329,6,7,0,10,0,23,11,6,0,0,0,17,nowin,loss,bust,plbust,0,10,13,195,0.425641026,0.056410256,0.538461538,1,0.28273747
13974,54,22330,10,10,0,0,0,20,8,10,0,0,0,18,nowin,win,plwin,beat,20,0,20,185,0.437837838,0.032432432,0.556756757,1,0.29899854
13975,92,22330,10,11,0,0,0,21,8,10,0,0,0,18,win,win,plwin,beat,25,0,21,186,0.446236559,0.059139785,0.564516129,1,0.307826125
13976,10,22330,10,5,0,3,0,18,8,10,0,0,0,18,nowin,push,push,push,10,0,15,191,0.413612565,0.057591623,0.596858639,2,0.574087175
13977,52,22330,3,6,10,0,0,19,8,10,0,0,0,18,nowin,win,plwin,beat,20,0,9,217,0.414746544,0.02764977,0.599078341,2,0.576736024
13978,131,22330,3,10,0,9,0,22,8,10,0,0,0,18,nowin,loss,bust,plbust,0,10,13,217,0.410138249,0.069124424,0.543778802,0,0.02015021
13979,30,22330,10,10,0,0,0,20,8,10,0,0,0,18,nowin,win,plwin,beat,20,0,20,206,0.393203883,0.033980583,0.601941748,0,0.029324648
13980,105,22331,5,2,6,9,0,22,10,10,0,0,0,20,nowin,loss,bust,plbust,0,10,7,198,0.414141414,0.070707071,0.590909091,0,0.032889494
13981,148,22331,7,2,3,4,10,26,10,10,0,0,0,20,nowin,loss,bust,plbust,0,10,9,204,0.401960784,0.078431373,0.593137255,0,0.029789521
13982,22,22331,10,10,0,0,0,20,10,10,0,0,0,20,nowin,push,push,push,10,0,20,187,0.481283422,0.042780749,0.577540107,3,0.906128176
13983,14,22331,10,10,0,0,0,20,10,10,0,0,0,20,nowin,push,push,push,10,0,20,202,0.391089109,0.01980198,0.628712871,2,0.577264877
13984,108,22331,3,10,0,9,0,22,10,10,0,0,0,20,nowin,loss,bust,plbust,0,10,13,193,0.435233161,0.056994819,0.559585492,1,0.298824795
13985,68,22331,5,9,0,8,0,22,10,10,0,0,0,20,nowin,loss,bust,plbust,0,10,14,205,0.434146341,0.029268293,0.6,2,0.59483189
13986,57,22332,10,10,0,0,0,20,3,10,1,4,0,18,nowin,win,plwin,beat,20,0,20,192,0.46875,0.052083333,0.59375,3,0.907001181
13987,67,22332,2,8,10,0,0,20,3,10,1,4,0,18,nowin,win,plwin,beat,20,0,10,195,0.369230769,0.041025641,0.569230769,0,0.014139427
13988,52,22332,9,8,0,0,0,17,3,10,1,4,0,18,nowin,loss,beat,dlwin,0,10,17,217,0.414746544,0.02764977,0.599078341,2,0.576736024
13989,46,22332,7,10,0,0,0,17,3,10,1,4,0,18,nowin,loss,beat,dlwin,0,10,17,186,0.403225806,0.048387097,0.591397849,0,0.029742194
13990,52,22332,8,10,0,0,0,18,3,10,1,4,0,18,nowin,push,push,push,10,0,18,217,0.414746544,0.02764977,0.599078341,2,0.576736024
13991,145,22332,8,10,0,0,0,18,3,10,1,4,0,18,nowin,push,push,push,10,0,18,188,0.441489362,0.031914894,0.622340426,2,0.617837093
13992,26,22333,1,6,9,4,0,20,7,5,10,0,0,22,nowin,win,dlbust,bust,20,0,7,203,0.463054187,0.0591133,0.541871921,1,0.306802864
13993,7,22333,9,6,0,10,0,25,7,5,10,0,0,22,nowin,loss,bust,plbust,0,10,15,183,0.442622951,0.06010929,0.62295082,2,0.619303341
13994,125,22333,10,10,0,0,0,20,7,5,10,0,0,22,nowin,win,dlbust,bust,20,0,20,219,0.438356164,0.050228311,0.575342466,1,0.308411257
13995,144,22333,8,10,0,0,0,18,7,5,10,0,0,22,nowin,win,dlbust,bust,20,0,18,202,0.386138614,0.054455446,0.564356436,0,0.018006244
13996,43,22333,10,2,0,10,0,22,7,5,10,0,0,22,nowin,loss,bust,plbust,0,10,12,192,0.40625,0.041666667,0.609375,2,0.576671372
13997,13,22333,9,6,0,5,0,20,7,5,10,0,0,22,nowin,win,dlbust,bust,20,0,15,206,0.417475728,0.063106796,0.621359223,2,0.59555479
13998,62,22334,8,5,0,1,10,24,7,10,0,0,0,17,nowin,loss,bust,plbust,0,10,13,178,0.370786517,0.028089888,0.54494382,0,0.008657722
13999,66,22334,5,2,3,3,2,15,7,10,0,0,0,17,nowin,loss,beat,dlwin,0,10,7,217,0.456221198,0.064516129,0.626728111,3,0.924304367
14000,86,22334,1,2,10,10,0,23,7,10,0,0,0,17,nowin,loss,bust,plbust,0,10,3,196,0.454081633,0.040816327,0.591836735,3,0.887566443
14001,3,22334,2,11,3,5,0,21,7,10,0,0,0,17,nowin,win,plwin,beat,20,0,13,190,0.431578947,0.026315789,0.542105263,1,0.288076384
14002,8,22334,10,8,0,0,0,18,7,10,0,0,0,17,nowin,win,plwin,beat,20,0,18,181,0.44198895,0.071823204,0.596685083,2,0.599438402
14003,10,22334,7,11,0,0,0,18,7,10,0,0,0,17,nowin,win,plwin,beat,20,0,18,191,0.413612565,0.057591623,0.596858639,2,0.574087175
14004,72,22335,3,5,6,0,0,14,2,7,5,1,5,20,nowin,loss,beat,dlwin,0,10,8,185,0.394594595,0.032432432,0.508108108,0,0.006763115
14005,120,22335,2,2,3,10,0,17,2,7,5,1,5,20,nowin,loss,beat,dlwin,0,10,4,202,0.440594059,0.034653465,0.618811881,2,0.614441029
14006,44,22335,6,8,0,0,0,14,2,7,5,1,5,20,nowin,loss,beat,dlwin,0,10,14,219,0.433789954,0.050228311,0.534246575,1,0.285551035
14007,90,22335,10,8,0,0,0,18,2,7,5,1,5,20,nowin,loss,beat,dlwin,0,10,18,201,0.447761194,0.049751244,0.60199005,3,0.889945023
14008,11,22335,10,9,0,0,0,19,2,7,5,1,5,20,nowin,loss,beat,dlwin,0,10,19,236,0.457627119,0.016949153,0.588983051,3,0.889015813
14009,144,22335,10,3,0,0,0,13,2,7,5,1,5,20,nowin,loss,beat,dlwin,0,10,13,202,0.386138614,0.054455446,0.564356436,0,0.018006244
14010,103,22336,10,10,0,0,0,20,2,9,10,0,0,21,nowin,loss,beat,dlwin,0,10,20,203,0.379310345,0.064039409,0.551724138,0,0.012869209
14011,1,22336,10,10,0,0,0,20,2,9,10,0,0,21,nowin,loss,beat,dlwin,0,10,20,197,0.406091371,0.025380711,0.649746193,2,0.606186955
14012,115,22336,10,7,0,0,0,17,2,9,10,0,0,21,nowin,loss,beat,dlwin,0,10,17,194,0.427835052,0.041237113,0.592783505,2,0.583863602
14013,100,22336,10,2,0,6,0,18,2,9,10,0,0,21,nowin,loss,beat,dlwin,0,10,12,190,0.452631579,0.036842105,0.594736842,3,0.888671154
14014,63,22336,10,8,0,0,0,18,2,9,10,0,0,21,nowin,loss,beat,dlwin,0,10,18,216,0.467592593,0.037037037,0.62037037,3,0.931690496
14015,147,22336,6,9,0,0,0,15,2,9,10,0,0,21,nowin,loss,beat,dlwin,0,10,15,205,0.380487805,0.014634146,0.536585366,0,0.00951447
14016,63,22337,5,4,10,0,0,19,3,11,6,0,0,20,nowin,loss,beat,dlwin,0,10,9,216,0.467592593,0.037037037,0.62037037,3,0.931690496
14017,112,22337,6,5,3,0,0,14,3,11,6,0,0,20,nowin,loss,beat,dlwin,0,10,11,203,0.448275862,0.054187192,0.600985222,3,0.889576933
14018,98,22337,8,10,0,0,0,18,3,11,6,0,0,20,nowin,loss,beat,dlwin,0,10,18,220,0.422727273,0.054545455,0.55,1,0.28664435
14019,48,22337,2,6,9,0,0,17,3,11,6,0,0,20,nowin,loss,beat,dlwin,0,10,8,203,0.413793103,0.019704433,0.600985222,2,0.577280801
14020,37,22337,10,6,0,0,0,16,3,11,6,0,0,20,nowin,loss,beat,dlwin,0,10,16,208,0.394230769,0.038461538,0.581730769,0,0.024682772
14021,58,22337,9,2,10,0,0,21,3,11,6,0,0,20,nowin,win,plwin,beat,20,0,11,195,0.430769231,0.041025641,0.584615385,2,0.580497586
14022,60,22338,3,6,7,1,0,17,10,10,0,0,0,20,nowin,loss,beat,dlwin,0,10,9,227,0.418502203,0.022026432,0.559471366,0,0.026496258
14023,100,22338,1,5,10,8,0,24,10,10,0,0,0,20,nowin,loss,bust,plbust,0,10,6,190,0.452631579,0.036842105,0.594736842,3,0.888671154
14024,55,22338,5,5,4,8,0,22,10,10,0,0,0,20,nowin,loss,bust,plbust,0,10,10,191,0.371727749,0.057591623,0.54973822,0,0.01011347
14025,143,22338,6,5,8,0,0,19,10,10,0,0,0,20,nowin,loss,beat,dlwin,0,10,11,203,0.463054187,0.044334975,0.57635468,3,0.883143365
14026,63,22338,10,5,0,7,0,22,10,10,0,0,0,20,nowin,loss,bust,plbust,0,10,15,216,0.467592593,0.037037037,0.62037037,3,0.931690496
14027,41,22338,2,7,10,0,0,19,10,10,0,0,0,20,nowin,loss,beat,dlwin,0,10,9,192,0.364583333,0.036458333,0.520833333,0,0.00089702
14028,45,22339,2,9,9,0,0,20,10,5,5,0,0,20,nowin,push,push,push,10,0,11,196,0.428571429,0.051020408,0.612244898,2,0.598821767
14029,146,22339,10,10,0,0,0,20,10,5,5,0,0,20,nowin,push,push,push,10,0,20,221,0.43438914,0.040723982,0.542986425,1,0.290190091
14030,71,22339,9,7,0,8,0,24,10,5,5,0,0,20,nowin,loss,bust,plbust,0,10,16,193,0.352331606,0.046632124,0.585492228,0,0.013063661
14031,82,22339,5,10,0,9,0,24,10,5,5,0,0,20,nowin,loss,bust,plbust,0,10,15,225,0.408888889,0.075555556,0.577777778,0,0.028101874
14032,122,22339,2,4,10,3,0,19,10,5,5,0,0,20,nowin,loss,beat,dlwin,0,10,6,210,0.347619048,0.052380952,0.59047619,0,0.012873677
14033,5,22339,4,10,0,1,8,23,10,5,5,0,0,20,nowin,loss,bust,plbust,0,10,14,203,0.42364532,0.02955665,0.596059113,2,0.582508076
14034,130,22340,8,7,0,0,0,15,5,10,10,0,0,25,nowin,win,dlbust,bust,20,0,15,219,0.410958904,0.03652968,0.566210046,0,0.025888739
14035,101,22340,10,8,0,0,0,18,5,10,10,0,0,25,nowin,win,dlbust,bust,20,0,18,205,0.424390244,0.068292683,0.63902439,2,0.614740646
14036,75,22340,10,3,0,0,0,13,5,10,10,0,0,25,nowin,win,dlbust,bust,20,0,13,191,0.418848168,0.052356021,0.570680628,0,0.029344702
14037,120,22340,11,9,0,0,0,20,5,10,10,0,0,25,nowin,win,dlbust,bust,20,0,20,202,0.440594059,0.034653465,0.618811881,2,0.614441029
14038,137,22340,10,7,0,0,0,17,5,10,10,0,0,25,nowin,win,dlbust,bust,20,0,17,194,0.417525773,0.046391753,0.536082474,1,0.276714602
14039,40,22340,10,10,0,0,0,20,5,10,10,0,0,25,nowin,win,dlbust,bust,20,0,20,196,0.367346939,0.030612245,0.617346939,0,0.025358183
14040,73,22341,10,10,0,0,0,20,5,7,2,10,0,24,nowin,win,dlbust,bust,20,0,20,181,0.375690608,0.011049724,0.596685083,0,0.022795773
14041,94,22341,6,5,2,0,0,13,5,7,2,10,0,24,nowin,win,dlbust,bust,20,0,11,183,0.43715847,0.043715847,0.540983607,1,0.290866892
14042,119,22341,10,11,0,0,0,21,5,7,2,10,0,24,win,win,dlbust,bust,25,0,21,190,0.405263158,0.068421053,0.515789474,0,0.011837158
14043,12,22341,3,6,4,0,0,13,5,7,2,10,0,24,nowin,win,dlbust,bust,20,0,9,189,0.470899471,0.015873016,0.613756614,3,0.929171178
14044,49,22341,11,7,0,0,0,18,5,7,2,10,0,24,nowin,win,dlbust,bust,20,0,18,207,0.396135266,0.053140097,0.594202899,0,0.028306925
14045,99,22341,5,3,2,5,0,15,5,7,2,10,0,24,nowin,win,dlbust,bust,20,0,8,207,0.47826087,0.062801932,0.637681159,3,0.961418446
14046,102,22342,3,2,5,4,10,24,10,10,0,0,0,20,nowin,loss,bust,plbust,0,10,5,192,0.338541667,0.046875,0.5625,0,0.003306118
14047,144,22342,10,7,0,0,0,17,10,10,0,0,0,20,nowin,loss,beat,dlwin,0,10,17,202,0.386138614,0.054455446,0.564356436,0,0.018006244
14048,118,22342,2,10,0,1,5,18,10,10,0,0,0,20,nowin,loss,beat,dlwin,0,10,12,216,0.393518519,0.037037037,0.555555556,0,0.018059873
14049,137,22342,8,6,0,7,0,21,10,10,0,0,0,20,nowin,win,plwin,beat,20,0,14,194,0.417525773,0.046391753,0.536082474,1,0.276714602
14050,62,22342,10,6,0,10,0,26,10,10,0,0,0,20,nowin,loss,bust,plbust,0,10,16,178,0.370786517,0.028089888,0.54494382,0,0.008657722
14051,45,22342,10,7,0,0,0,17,10,10,0,0,0,20,nowin,loss,beat,dlwin,0,10,17,196,0.428571429,0.051020408,0.612244898,2,0.598821767
14052,62,22343,6,1,8,0,0,15,4,8,5,0,0,17,nowin,loss,beat,dlwin,0,10,7,178,0.370786517,0.028089888,0.54494382,0,0.008657722
14053,41,22343,9,10,0,0,0,19,4,8,5,0,0,17,nowin,win,plwin,beat,20,0,19,192,0.364583333,0.036458333,0.520833333,0,0.00089702
14054,109,22343,10,2,0,0,0,12,4,8,5,0,0,17,nowin,loss,beat,dlwin,0,10,12,221,0.461538462,0.058823529,0.597285068,3,0.901830309
14055,72,22343,7,5,0,0,0,12,4,8,5,0,0,17,nowin,loss,beat,dlwin,0,10,12,185,0.394594595,0.032432432,0.508108108,0,0.006763115
14056,112,22343,2,10,0,0,0,12,4,8,5,0,0,17,nowin,loss,beat,dlwin,0,10,12,203,0.448275862,0.054187192,0.600985222,3,0.889576933
14057,22,22343,6,10,0,0,0,16,4,8,5,0,0,17,nowin,loss,beat,dlwin,0,10,16,187,0.481283422,0.042780749,0.577540107,3,0.906128176
14058,115,22344,10,10,0,0,0,20,2,2,5,10,0,19,nowin,win,plwin,beat,20,0,20,194,0.427835052,0.041237113,0.592783505,2,0.583863602
14059,89,22344,11,8,0,0,0,19,2,2,5,10,0,19,nowin,push,push,push,10,0,19,212,0.537735849,0.047169811,0.594339623,3,0.990167191
14060,138,22344,8,10,0,0,0,18,2,2,5,10,0,19,nowin,loss,beat,dlwin,0,10,18,190,0.442105263,0.047368421,0.610526316,2,0.609711065
14061,113,22344,3,10,0,0,0,13,2,2,5,10,0,19,nowin,loss,beat,dlwin,0,10,13,199,0.407035176,0.055276382,0.668341709,2,0.620695264
14062,81,22344,10,3,0,0,0,13,2,2,5,10,0,19,nowin,loss,beat,dlwin,0,10,13,182,0.395604396,0.043956044,0.60989011,2,0.567491261
14063,4,22344,6,10,0,0,0,16,2,2,5,10,0,19,nowin,loss,beat,dlwin,0,10,16,217,0.460829493,0.036866359,0.562211982,1,0.315432839
14064,67,22345,10,5,0,0,0,15,3,2,4,8,0,17,nowin,loss,beat,dlwin,0,10,15,195,0.369230769,0.041025641,0.569230769,0,0.014139427
14065,17,22345,11,2,3,0,0,16,3,2,4,8,0,17,nowin,loss,beat,dlwin,0,10,13,171,0.444444444,0.070175439,0.555555556,1,0.302364894
14066,147,22345,5,2,10,0,0,17,3,2,4,8,0,17,nowin,push,push,push,10,0,7,205,0.380487805,0.014634146,0.536585366,0,0.00951447
14067,42,22345,4,8,0,7,0,19,3,2,4,8,0,17,nowin,win,plwin,beat,20,0,12,212,0.443396226,0.051886792,0.570754717,1,0.309181312
14068,135,22345,8,7,0,0,0,15,3,2,4,8,0,17,nowin,loss,beat,dlwin,0,10,15,179,0.391061453,0.067039106,0.586592179,0,0.024924662
14069,70,22345,5,10,0,0,0,15,3,2,4,8,0,17,nowin,loss,beat,dlwin,0,10,15,228,0.385964912,0.039473684,0.557017544,0,0.016157125
14070,49,22346,1,4,10,0,0,15,3,7,10,0,0,20,nowin,loss,beat,dlwin,0,10,5,207,0.396135266,0.053140097,0.594202899,0,0.028306925
14071,32,22346,3,8,7,0,0,18,3,7,10,0,0,20,nowin,loss,beat,dlwin,0,10,11,189,0.391534392,0.037037037,0.53968254,0,0.013579086
14072,104,22346,2,10,0,10,0,22,3,7,10,0,0,20,nowin,loss,bust,plbust,0,10,12,209,0.363636364,0.052631579,0.593301435,0,0.018359419
14073,66,22346,6,10,0,0,0,16,3,7,10,0,0,20,nowin,loss,beat,dlwin,0,10,16,217,0.456221198,0.064516129,0.626728111,3,0.924304367
14074,103,22346,5,10,0,0,0,15,3,7,10,0,0,20,nowin,loss,beat,dlwin,0,10,15,203,0.379310345,0.064039409,0.551724138,0,0.012869209
14075,9,22346,5,3,6,0,0,14,3,7,10,0,0,20,nowin,loss,beat,dlwin,0,10,8,194,0.37628866,0.015463918,0.541237113,0,0.009396796
14076,114,22347,8,3,1,0,0,12,5,10,5,0,0,20,nowin,loss,beat,dlwin,0,10,11,198,0.47979798,0.025252525,0.611111111,3,0.937232995
14077,122,22347,6,9,0,0,0,15,5,10,5,0,0,20,nowin,loss,beat,dlwin,0,10,15,210,0.347619048,0.052380952,0.59047619,0,0.012873677
14078,38,22347,7,11,0,0,0,18,5,10,5,0,0,20,nowin,loss,beat,dlwin,0,10,18,202,0.361386139,0.03960396,0.564356436,0,0.010597953
14079,125,22347,8,8,0,0,0,16,5,10,5,0,0,20,nowin,loss,beat,dlwin,0,10,16,219,0.438356164,0.050228311,0.575342466,1,0.308411257
14080,47,22347,10,3,0,0,0,13,5,10,5,0,0,20,nowin,loss,beat,dlwin,0,10,13,210,0.438095238,0.057142857,0.623809524,2,0.615868808
14081,122,22347,10,3,0,0,0,13,5,10,5,0,0,20,nowin,loss,beat,dlwin,0,10,13,210,0.347619048,0.052380952,0.59047619,0,0.012873677
14082,50,22348,2,10,0,4,7,23,8,6,10,0,0,24,nowin,loss,bust,plbust,0,10,12,202,0.405940594,0.04950495,0.54950495,0,0.020296079
14083,103,22348,5,4,10,0,0,19,8,6,10,0,0,24,nowin,win,dlbust,bust,20,0,9,203,0.379310345,0.064039409,0.551724138,0,0.012869209
14084,104,22348,10,10,0,0,0,20,8,6,10,0,0,24,nowin,win,dlbust,bust,20,0,20,209,0.363636364,0.052631579,0.593301435,0,0.018359419
14085,84,22348,10,2,0,5,0,17,8,6,10,0,0,24,nowin,win,dlbust,bust,20,0,12,195,0.379487179,0.056410256,0.569230769,0,0.017209119
14086,6,22348,10,8,0,0,0,18,8,6,10,0,0,24,nowin,win,dlbust,bust,20,0,18,191,0.439790576,0.047120419,0.581151832,1,0.31211505
14087,80,22348,10,10,0,0,0,20,8,6,10,0,0,24,nowin,win,dlbust,bust,20,0,20,186,0.419354839,0.059139785,0.623655914,2,0.59892924
14088,131,22349,5,10,0,10,0,25,10,11,0,0,0,21,nowin,loss,bust,plbust,0,10,15,217,0.410138249,0.069124424,0.543778802,0,0.02015021
14089,46,22349,8,5,0,10,0,23,10,11,0,0,0,21,nowin,loss,bust,plbust,0,10,13,186,0.403225806,0.048387097,0.591397849,0,0.029742194
14090,36,22349,10,10,0,0,0,20,10,11,0,0,0,21,nowin,loss,beat,dlwin,0,10,20,229,0.445414847,0.056768559,0.655021834,2,0.645370571
14091,108,22349,2,9,3,7,0,21,10,11,0,0,0,21,nowin,push,push,push,10,0,11,193,0.435233161,0.056994819,0.559585492,1,0.298824795
14092,24,22349,10,9,0,0,0,19,10,11,0,0,0,21,nowin,loss,beat,dlwin,0,10,19,207,0.458937198,0.048309179,0.570048309,1,0.318138014
14093,21,22349,6,5,2,3,8,24,10,11,0,0,0,21,nowin,loss,bust,plbust,0,10,11,214,0.359813084,0.042056075,0.626168224,0,0.025263474
14094,1,22350,10,9,0,0,0,19,10,6,10,0,0,26,nowin,win,dlbust,bust,20,0,19,197,0.406091371,0.025380711,0.649746193,2,0.606186955
14095,134,22350,7,11,0,0,0,18,10,6,10,0,0,26,nowin,win,dlbust,bust,20,0,18,185,0.443243243,0.021621622,0.545945946,1,0.296939509
14096,18,22350,6,5,8,0,0,19,10,6,10,0,0,26,nowin,win,dlbust,bust,20,0,11,182,0.461538462,0.043956044,0.587912088,3,0.892649374
14097,6,22350,6,10,0,10,0,26,10,6,10,0,0,26,nowin,loss,bust,plbust,0,10,16,191,0.439790576,0.047120419,0.581151832,1,0.31211505
14098,66,22350,10,11,0,0,0,21,10,6,10,0,0,26,win,win,dlbust,bust,25,0,21,217,0.456221198,0.064516129,0.626728111,3,0.924304367
14099,42,22350,10,4,0,10,0,24,10,6,10,0,0,26,nowin,loss,bust,plbust,0,10,14,212,0.443396226,0.051886792,0.570754717,1,0.309181312
14100,4,22351,4,8,0,10,0,22,7,5,6,0,0,18,nowin,loss,bust,plbust,0,10,12,217,0.460829493,0.036866359,0.562211982,1,0.315432839
14101,49,22351,10,8,0,0,0,18,7,5,6,0,0,18,nowin,push,push,push,10,0,18,207,0.396135266,0.053140097,0.594202899,0,0.028306925
14102,75,22351,10,10,0,0,0,20,7,5,6,0,0,18,nowin,win,plwin,beat,20,0,20,191,0.418848168,0.052356021,0.570680628,0,0.029344702
14103,49,22351,10,10,0,0,0,20,7,5,6,0,0,18,nowin,win,plwin,beat,20,0,20,207,0.396135266,0.053140097,0.594202899,0,0.028306925
14104,150,22351,4,5,3,8,0,20,7,5,6,0,0,18,nowin,win,plwin,beat,20,0,9,192,0.401041667,0.036458333,0.567708333,0,0.023287458
14105,88,22351,10,10,0,0,0,20,7,5,6,0,0,18,nowin,win,plwin,beat,20,0,20,206,0.466019417,0.033980583,0.54368932,1,0.309467903
14106,56,22352,6,4,5,0,0,15,2,10,2,8,0,22,nowin,win,dlbust,bust,20,0,10,175,0.4,0.057142857,0.582857143,0,0.026685297
14107,20,22352,10,4,0,0,0,14,2,10,2,8,0,22,nowin,win,dlbust,bust,20,0,14,186,0.456989247,0.037634409,0.537634409,1,0.301097108
14108,106,22352,9,5,0,0,0,14,2,10,2,8,0,22,nowin,win,dlbust,bust,20,0,14,192,0.411458333,0.026041667,0.557291667,0,0.023854304
14109,24,22352,2,9,7,0,0,18,2,10,2,8,0,22,nowin,win,dlbust,bust,20,0,11,207,0.458937198,0.048309179,0.570048309,1,0.318138014
14110,49,22352,10,10,0,0,0,20,2,10,2,8,0,22,nowin,win,dlbust,bust,20,0,20,207,0.396135266,0.053140097,0.594202899,0,0.028306925
14111,55,22352,10,2,0,6,0,18,2,10,2,8,0,22,nowin,win,dlbust,bust,20,0,12,191,0.371727749,0.057591623,0.54973822,0,0.01011347
14112,96,22353,1,4,10,9,0,24,10,10,0,0,0,20,nowin,loss,bust,plbust,0,10,5,190,0.468421053,0.057894737,0.584210526,3,0.897263354
14113,133,22353,5,10,0,10,0,25,10,10,0,0,0,20,nowin,loss,bust,plbust,0,10,15,201,0.47761194,0.064676617,0.611940299,3,0.935428111
14114,109,22353,9,8,0,0,0,17,10,10,0,0,0,20,nowin,loss,beat,dlwin,0,10,17,221,0.461538462,0.058823529,0.597285068,3,0.901830309
14115,87,22353,11,2,2,5,0,20,10,10,0,0,0,20,nowin,push,push,push,10,0,13,202,0.405940594,0.054455446,0.628712871,2,0.590599801
14116,128,22353,10,9,0,0,0,19,10,10,0,0,0,20,nowin,loss,beat,dlwin,0,10,19,227,0.356828194,0.052863436,0.577092511,0,0.012352564
14117,39,22353,7,10,0,0,0,17,10,10,0,0,0,20,nowin,loss,beat,dlwin,0,10,17,191,0.429319372,0.062827225,0.57591623,0,0.033760763
14118,97,22354,10,8,0,0,0,18,3,10,7,0,0,20,nowin,loss,beat,dlwin,0,10,18,182,0.450549451,0.06043956,0.692307692,2,0.677372279
14119,12,22354,4,9,0,0,0,13,3,10,7,0,0,20,nowin,loss,beat,dlwin,0,10,13,189,0.470899471,0.015873016,0.613756614,3,0.929171178
14120,93,22354,10,11,0,0,0,21,3,10,7,0,0,20,win,win,plwin,beat,25,0,21,175,0.485714286,0.051428571,0.548571429,1,0.323648091
14121,43,22354,7,7,0,0,0,14,3,10,7,0,0,20,nowin,loss,beat,dlwin,0,10,14,192,0.40625,0.041666667,0.609375,2,0.576671372
14122,25,22354,10,4,0,0,0,14,3,10,7,0,0,20,nowin,loss,beat,dlwin,0,10,14,190,0.463157895,0.063157895,0.536842105,1,0.304401563
14123,36,22354,7,2,5,0,0,14,3,10,7,0,0,20,nowin,loss,beat,dlwin,0,10,9,229,0.445414847,0.056768559,0.655021834,2,0.645370571
14124,118,22355,10,5,0,10,0,25,10,10,0,0,0,20,nowin,loss,bust,plbust,0,10,15,216,0.393518519,0.037037037,0.555555556,0,0.018059873
14125,63,22355,10,2,0,4,10,26,10,10,0,0,0,20,nowin,loss,bust,plbust,0,10,12,216,0.467592593,0.037037037,0.62037037,3,0.931690496
14126,19,22355,9,4,0,3,6,22,10,10,0,0,0,20,nowin,loss,bust,plbust,0,10,13,237,0.41350211,0.054852321,0.628691983,2,0.597373826
14127,15,22355,8,11,0,0,0,19,10,10,0,0,0,20,nowin,loss,beat,dlwin,0,10,19,212,0.410377358,0.051886792,0.561320755,0,0.024517408
14128,84,22355,8,10,0,0,0,18,10,10,0,0,0,20,nowin,loss,beat,dlwin,0,10,18,195,0.379487179,0.056410256,0.569230769,0,0.017209119
14129,89,22355,10,6,0,3,0,19,10,10,0,0,0,20,nowin,loss,beat,dlwin,0,10,16,212,0.537735849,0.047169811,0.594339623,3,0.990167191
14130,17,22356,2,10,0,5,0,17,10,7,0,0,0,17,nowin,push,push,push,10,0,12,171,0.444444444,0.070175439,0.555555556,1,0.302364894
14131,126,22356,4,10,0,10,0,24,10,7,0,0,0,17,nowin,loss,bust,plbust,0,10,14,188,0.457446809,0.074468085,0.60106383,3,0.900633203
14132,47,22356,10,10,0,0,0,20,10,7,0,0,0,17,nowin,win,plwin,beat,20,0,20,210,0.438095238,0.057142857,0.623809524,2,0.615868808
14133,149,22356,8,5,0,6,0,19,10,7,0,0,0,17,nowin,win,plwin,beat,20,0,13,225,0.457777778,0.057777778,0.648888889,2,0.651965595
14134,119,22356,6,2,10,0,0,18,10,7,0,0,0,17,nowin,win,plwin,beat,20,0,8,190,0.405263158,0.068421053,0.515789474,0,0.011837158
14135,147,22356,10,3,0,5,0,18,10,7,0,0,0,17,nowin,win,plwin,beat,20,0,13,205,0.380487805,0.014634146,0.536585366,0,0.00951447
14136,107,22357,10,2,0,5,0,17,9,7,1,0,0,17,nowin,push,push,push,10,0,12,218,0.444954128,0.073394495,0.600917431,2,0.605210014
14137,88,22357,4,8,0,2,1,15,9,7,1,0,0,17,nowin,loss,beat,dlwin,0,10,12,206,0.466019417,0.033980583,0.54368932,1,0.309467903
14138,82,22357,8,11,0,0,0,19,9,7,1,0,0,17,nowin,win,plwin,beat,20,0,19,225,0.408888889,0.075555556,0.577777778,0,0.028101874
14139,4,22357,9,7,0,10,0,26,9,7,1,0,0,17,nowin,loss,bust,plbust,0,10,16,217,0.460829493,0.036866359,0.562211982,1,0.315432839
14140,35,22357,10,8,0,0,0,18,9,7,1,0,0,17,nowin,win,plwin,beat,20,0,18,202,0.410891089,0.044554455,0.633663366,2,0.598681573
14141,91,22357,3,5,7,4,0,19,9,7,1,0,0,17,nowin,win,plwin,beat,20,0,8,194,0.417525773,0.046391753,0.515463918,1,0.266616552
14142,2,22358,4,10,0,0,0,14,3,1,10,10,0,24,nowin,win,dlbust,bust,20,0,14,200,0.445,0.035,0.64,2,0.633962549
14143,35,22358,3,1,10,0,0,14,3,1,10,10,0,24,nowin,win,dlbust,bust,20,0,4,202,0.410891089,0.044554455,0.633663366,2,0.598681573
14144,81,22358,6,8,0,0,0,14,3,1,10,10,0,24,nowin,win,dlbust,bust,20,0,14,182,0.395604396,0.043956044,0.60989011,2,0.567491261
14145,99,22358,4,2,4,10,0,20,3,1,10,10,0,24,nowin,win,dlbust,bust,20,0,6,207,0.47826087,0.062801932,0.637681159,3,0.961418446
14146,146,22358,6,6,0,10,0,22,3,1,10,10,0,24,nowin,loss,bust,plbust,0,10,12,221,0.43438914,0.040723982,0.542986425,1,0.290190091
14147,68,22358,8,10,0,0,0,18,3,1,10,10,0,24,nowin,win,dlbust,bust,20,0,18,205,0.434146341,0.029268293,0.6,2,0.59483189
14148,114,22359,2,10,0,6,0,18,8,4,10,0,0,22,nowin,win,dlbust,bust,20,0,12,198,0.47979798,0.025252525,0.611111111,3,0.937232995
14149,66,22359,2,10,0,10,0,22,8,4,10,0,0,22,nowin,loss,bust,plbust,0,10,12,217,0.456221198,0.064516129,0.626728111,3,0.924304367
14150,12,22359,4,10,0,7,0,21,8,4,10,0,0,22,nowin,win,dlbust,bust,20,0,14,189,0.470899471,0.015873016,0.613756614,3,0.929171178
14151,84,22359,10,2,0,10,0,22,8,4,10,0,0,22,nowin,loss,bust,plbust,0,10,12,195,0.379487179,0.056410256,0.569230769,0,0.017209119
14152,115,22359,10,9,0,0,0,19,8,4,10,0,0,22,nowin,win,dlbust,bust,20,0,19,194,0.427835052,0.041237113,0.592783505,2,0.583863602
14153,130,22359,10,5,0,3,0,18,8,4,10,0,0,22,nowin,win,dlbust,bust,20,0,15,219,0.410958904,0.03652968,0.566210046,0,0.025888739
14154,111,22360,5,10,0,0,0,15,4,1,10,10,0,25,nowin,win,dlbust,bust,20,0,15,180,0.433333333,0.055555556,0.611111111,2,0.602264492
14155,48,22360,6,9,0,0,0,15,4,1,10,10,0,25,nowin,win,dlbust,bust,20,0,15,203,0.413793103,0.019704433,0.600985222,2,0.577280801
14156,16,22360,10,9,0,0,0,19,4,1,10,10,0,25,nowin,win,dlbust,bust,20,0,19,220,0.427272727,0.081818182,0.6,2,0.588660176
14157,140,22360,6,3,2,8,0,19,4,1,10,10,0,25,nowin,win,dlbust,bust,20,0,9,210,0.466666667,0.023809524,0.604761905,3,0.915293335
14158,106,22360,10,10,0,0,0,20,4,1,10,10,0,25,nowin,win,dlbust,bust,20,0,20,192,0.411458333,0.026041667,0.557291667,0,0.023854304
14159,17,22360,2,11,2,0,0,15,4,1,10,10,0,25,nowin,win,dlbust,bust,20,0,13,171,0.444444444,0.070175439,0.555555556,1,0.302364894
14160,112,22361,10,10,0,0,0,20,4,10,10,0,0,24,nowin,win,dlbust,bust,20,0,20,203,0.448275862,0.054187192,0.600985222,3,0.889576933
14161,7,22361,7,11,0,0,0,18,4,10,10,0,0,24,nowin,win,dlbust,bust,20,0,18,183,0.442622951,0.06010929,0.62295082,2,0.619303341
14162,16,22361,10,6,0,0,0,16,4,10,10,0,0,24,nowin,win,dlbust,bust,20,0,16,220,0.427272727,0.081818182,0.6,2,0.588660176
14163,114,22361,6,9,0,0,0,15,4,10,10,0,0,24,nowin,win,dlbust,bust,20,0,15,198,0.47979798,0.025252525,0.611111111,3,0.937232995
14164,122,22361,4,1,10,0,0,15,4,10,10,0,0,24,nowin,win,dlbust,bust,20,0,5,210,0.347619048,0.052380952,0.59047619,0,0.012873677
14165,86,22361,3,1,10,0,0,14,4,10,10,0,0,24,nowin,win,dlbust,bust,20,0,4,196,0.454081633,0.040816327,0.591836735,3,0.887566443
14166,111,22362,8,2,3,0,0,13,6,10,2,0,0,18,nowin,loss,beat,dlwin,0,10,10,180,0.433333333,0.055555556,0.611111111,2,0.602264492
14167,119,22362,3,10,0,0,0,13,6,10,2,0,0,18,nowin,loss,beat,dlwin,0,10,13,190,0.405263158,0.068421053,0.515789474,0,0.011837158
14168,5,22362,6,10,0,0,0,16,6,10,2,0,0,18,nowin,loss,beat,dlwin,0,10,16,203,0.42364532,0.02955665,0.596059113,2,0.582508076
14169,63,22362,8,6,0,0,0,14,6,10,2,0,0,18,nowin,loss,beat,dlwin,0,10,14,216,0.467592593,0.037037037,0.62037037,3,0.931690496
14170,96,22362,11,9,0,0,0,20,6,10,2,0,0,18,nowin,win,plwin,beat,20,0,20,190,0.468421053,0.057894737,0.584210526,3,0.897263354
14171,91,22362,10,10,0,0,0,20,6,10,2,0,0,18,nowin,win,plwin,beat,20,0,20,194,0.417525773,0.046391753,0.515463918,1,0.266616552
14172,19,22363,10,6,0,10,0,26,11,10,0,0,0,21,nowin,loss,bust,plbust,0,10,16,237,0.41350211,0.054852321,0.628691983,2,0.597373826
14173,96,22363,3,10,0,9,0,22,11,10,0,0,0,21,nowin,loss,bust,plbust,0,10,13,190,0.468421053,0.057894737,0.584210526,3,0.897263354
14174,12,22363,4,10,0,10,0,24,11,10,0,0,0,21,nowin,loss,bust,plbust,0,10,14,189,0.470899471,0.015873016,0.613756614,3,0.929171178
14175,104,22363,3,6,10,0,0,19,11,10,0,0,0,21,nowin,loss,beat,dlwin,0,10,9,209,0.363636364,0.052631579,0.593301435,0,0.018359419
14176,34,22363,10,9,0,0,0,19,11,10,0,0,0,21,nowin,loss,beat,dlwin,0,10,19,202,0.5,0.079207921,0.618811881,3,0.968961434
14177,67,22363,7,10,0,0,0,17,11,10,0,0,0,21,nowin,loss,beat,dlwin,0,10,17,195,0.369230769,0.041025641,0.569230769,0,0.014139427
14178,120,22364,7,3,10,0,0,20,5,7,4,5,0,21,nowin,loss,beat,dlwin,0,10,10,202,0.440594059,0.034653465,0.618811881,2,0.614441029
14179,83,22364,6,1,6,0,0,13,5,7,4,5,0,21,nowin,loss,beat,dlwin,0,10,7,193,0.424870466,0.051813472,0.678756477,2,0.644360335
14180,150,22364,7,10,0,0,0,17,5,7,4,5,0,21,nowin,loss,beat,dlwin,0,10,17,192,0.401041667,0.036458333,0.567708333,0,0.023287458
14181,131,22364,10,11,0,0,0,21,5,7,4,5,0,21,win,push,push,push,10,0,21,217,0.410138249,0.069124424,0.543778802,0,0.02015021
14182,21,22364,8,10,0,0,0,18,5,7,4,5,0,21,nowin,loss,beat,dlwin,0,10,18,214,0.359813084,0.042056075,0.626168224,0,0.025263474
14183,125,22364,8,4,0,0,0,12,5,7,4,5,0,21,nowin,loss,beat,dlwin,0,10,12,219,0.438356164,0.050228311,0.575342466,1,0.308411257
14184,146,22365,5,10,0,10,0,25,10,9,0,0,0,19,nowin,loss,bust,plbust,0,10,15,221,0.43438914,0.040723982,0.542986425,1,0.290190091
14185,56,22365,10,4,0,5,0,19,10,9,0,0,0,19,nowin,push,push,push,10,0,14,175,0.4,0.057142857,0.582857143,0,0.026685297
14186,103,22365,6,7,0,4,0,17,10,9,0,0,0,19,nowin,loss,beat,dlwin,0,10,13,203,0.379310345,0.064039409,0.551724138,0,0.012869209
14187,28,22365,6,5,6,0,0,17,10,9,0,0,0,19,nowin,loss,beat,dlwin,0,10,11,199,0.422110553,0.045226131,0.542713568,1,0.282706618
14188,93,22365,5,10,0,5,0,20,10,9,0,0,0,19,nowin,win,plwin,beat,20,0,15,175,0.485714286,0.051428571,0.548571429,1,0.323648091
14189,110,22365,11,6,2,0,0,19,10,9,0,0,0,19,nowin,push,push,push,10,0,17,192,0.416666667,0.046875,0.557291667,0,0.025413132
14190,18,22366,4,10,0,4,0,18,10,2,6,0,0,18,nowin,push,push,push,10,0,14,182,0.461538462,0.043956044,0.587912088,3,0.892649374
14191,124,22366,2,10,0,10,0,22,10,2,6,0,0,18,nowin,loss,bust,plbust,0,10,12,202,0.47029703,0.064356436,0.584158416,3,0.899458193
14192,50,22366,8,7,0,10,0,25,10,2,6,0,0,18,nowin,loss,bust,plbust,0,10,15,202,0.405940594,0.04950495,0.54950495,0,0.020296079
14193,142,22366,10,10,0,0,0,20,10,2,6,0,0,18,nowin,win,plwin,beat,20,0,20,211,0.417061611,0.047393365,0.526066351,1,0.271531309
14194,65,22366,10,10,0,0,0,20,10,2,6,0,0,18,nowin,win,plwin,beat,20,0,20,203,0.492610837,0.054187192,0.571428571,3,0.913702814
14195,110,22366,9,5,0,8,0,22,10,2,6,0,0,18,nowin,loss,bust,plbust,0,10,14,192,0.416666667,0.046875,0.557291667,0,0.025413132
14196,9,22367,7,5,0,2,6,20,10,3,10,0,0,23,nowin,win,dlbust,bust,20,0,12,194,0.37628866,0.015463918,0.541237113,0,0.009396796
14197,21,22367,4,10,0,7,0,21,10,3,10,0,0,23,nowin,win,dlbust,bust,20,0,14,214,0.359813084,0.042056075,0.626168224,0,0.025263474
14198,65,22367,4,3,10,0,0,17,10,3,10,0,0,23,nowin,win,dlbust,bust,20,0,7,203,0.492610837,0.054187192,0.571428571,3,0.913702814
14199,78,22367,10,7,0,0,0,17,10,3,10,0,0,23,nowin,win,dlbust,bust,20,0,17,201,0.517412935,0.034825871,0.587064677,3,0.95871112
14200,117,22367,2,3,3,2,7,17,10,3,10,0,0,23,nowin,win,dlbust,bust,20,0,5,173,0.410404624,0.069364162,0.606936416,2,0.578610282
14201,11,22367,5,1,10,7,0,23,10,3,10,0,0,23,nowin,loss,bust,plbust,0,10,6,236,0.457627119,0.016949153,0.588983051,3,0.889015813
14202,59,22368,6,10,0,0,0,16,5,10,5,0,0,20,nowin,loss,beat,dlwin,0,10,16,228,0.429824561,0.048245614,0.543859649,1,0.287885446
14203,73,22368,10,10,0,0,0,20,5,10,5,0,0,20,nowin,push,push,push,10,0,20,181,0.375690608,0.011049724,0.596685083,0,0.022795773
14204,131,22368,4,4,10,0,0,18,5,10,5,0,0,20,nowin,loss,beat,dlwin,0,10,8,217,0.410138249,0.069124424,0.543778802,0,0.02015021
14205,83,22368,7,7,0,0,0,14,5,10,5,0,0,20,nowin,loss,beat,dlwin,0,10,14,193,0.424870466,0.051813472,0.678756477,2,0.644360335
14206,28,22368,2,9,5,0,0,16,5,10,5,0,0,20,nowin,loss,beat,dlwin,0,10,11,199,0.422110553,0.045226131,0.542713568,1,0.282706618
14207,21,22368,10,2,0,0,0,12,5,10,5,0,0,20,nowin,loss,beat,dlwin,0,10,12,214,0.359813084,0.042056075,0.626168224,0,0.025263474
14208,16,22369,10,10,0,0,0,20,11,10,0,0,0,21,nowin,loss,beat,dlwin,0,10,20,220,0.427272727,0.081818182,0.6,2,0.588660176
14209,77,22369,5,3,10,0,0,18,11,10,0,0,0,21,nowin,loss,beat,dlwin,0,10,8,200,0.455,0.04,0.62,3,0.916252116
14210,23,22369,10,11,0,0,0,21,11,10,0,0,0,21,win,push,push,push,10,0,21,208,0.427884615,0.0625,0.552884615,1,0.29114424
14211,78,22369,4,7,5,5,0,21,11,10,0,0,0,21,nowin,push,push,push,10,0,11,201,0.517412935,0.034825871,0.587064677,3,0.95871112
14212,34,22369,4,7,8,0,0,19,11,10,0,0,0,21,nowin,loss,beat,dlwin,0,10,11,202,0.5,0.079207921,0.618811881,3,0.968961434
14213,36,22369,10,11,0,0,0,21,11,10,0,0,0,21,win,push,push,push,10,0,21,229,0.445414847,0.056768559,0.655021834,2,0.645370571
14214,33,22370,5,10,0,0,0,15,4,10,10,0,0,24,nowin,win,dlbust,bust,20,0,15,192,0.4375,0.057291667,0.625,2,0.616208916
14215,56,22370,2,10,0,0,0,12,4,10,10,0,0,24,nowin,win,dlbust,bust,20,0,12,175,0.4,0.057142857,0.582857143,0,0.026685297
14216,68,22370,10,10,0,0,0,20,4,10,10,0,0,24,nowin,win,dlbust,bust,20,0,20,205,0.434146341,0.029268293,0.6,2,0.59483189
14217,61,22370,3,1,10,0,0,14,4,10,10,0,0,24,nowin,win,dlbust,bust,20,0,4,194,0.427835052,0.077319588,0.603092784,2,0.591437139
14218,48,22370,11,10,0,0,0,21,4,10,10,0,0,24,win,win,dlbust,bust,25,0,21,203,0.413793103,0.019704433,0.600985222,2,0.577280801
14219,96,22370,11,10,0,0,0,21,4,10,10,0,0,24,win,win,dlbust,bust,25,0,21,190,0.468421053,0.057894737,0.584210526,3,0.897263354
14220,55,22371,8,8,0,9,0,25,9,9,0,0,0,18,nowin,loss,bust,plbust,0,10,16,191,0.371727749,0.057591623,0.54973822,0,0.01011347
14221,41,22371,2,6,3,1,10,22,9,9,0,0,0,18,nowin,loss,bust,plbust,0,10,8,192,0.364583333,0.036458333,0.520833333,0,0.00089702
14222,23,22371,10,11,0,0,0,21,9,9,0,0,0,18,win,win,plwin,beat,25,0,21,208,0.427884615,0.0625,0.552884615,1,0.29114424
14223,85,22371,10,7,0,0,0,17,9,9,0,0,0,18,nowin,loss,beat,dlwin,0,10,17,195,0.41025641,0.066666667,0.594871795,0,0.03269711
14224,129,22371,8,9,0,0,0,17,9,9,0,0,0,18,nowin,loss,beat,dlwin,0,10,17,201,0.422885572,0.064676617,0.55721393,0,0.027255383
14225,62,22371,7,11,0,0,0,18,9,9,0,0,0,18,nowin,push,push,push,10,0,18,178,0.370786517,0.028089888,0.54494382,0,0.008657722
14226,92,22372,11,10,0,0,0,21,5,10,4,0,0,19,win,win,plwin,beat,25,0,21,186,0.446236559,0.059139785,0.564516129,1,0.307826125
14227,129,22372,10,11,0,0,0,21,5,10,4,0,0,19,win,win,plwin,beat,25,0,21,201,0.422885572,0.064676617,0.55721393,0,0.027255383
14228,92,22372,5,2,10,0,0,17,5,10,4,0,0,19,nowin,loss,beat,dlwin,0,10,7,186,0.446236559,0.059139785,0.564516129,1,0.307826125
14229,62,22372,3,1,8,0,0,12,5,10,4,0,0,19,nowin,loss,beat,dlwin,0,10,4,178,0.370786517,0.028089888,0.54494382,0,0.008657722
14230,3,22372,10,10,0,0,0,20,5,10,4,0,0,19,nowin,win,plwin,beat,20,0,20,190,0.431578947,0.026315789,0.542105263,1,0.288076384
14231,123,22372,9,11,0,0,0,20,5,10,4,0,0,19,nowin,win,plwin,beat,20,0,20,205,0.43902439,0.034146341,0.614634146,2,0.609962544
14232,61,22373,5,7,0,6,0,18,11,10,0,0,0,21,nowin,loss,beat,dlwin,0,10,12,194,0.427835052,0.077319588,0.603092784,2,0.591437139
14233,21,22373,10,5,0,10,0,25,11,10,0,0,0,21,nowin,loss,bust,plbust,0,10,15,214,0.359813084,0.042056075,0.626168224,0,0.025263474
14234,124,22373,10,3,0,10,0,23,11,10,0,0,0,21,nowin,loss,bust,plbust,0,10,13,202,0.47029703,0.064356436,0.584158416,3,0.899458193
14235,105,22373,10,11,0,0,0,21,11,10,0,0,0,21,win,push,push,push,10,0,21,198,0.414141414,0.070707071,0.590909091,0,0.032889494
14236,88,22373,7,11,0,0,0,18,11,10,0,0,0,21,nowin,loss,beat,dlwin,0,10,18,206,0.466019417,0.033980583,0.54368932,1,0.309467903
14237,8,22373,2,8,10,0,0,20,11,10,0,0,0,21,nowin,loss,beat,dlwin,0,10,10,181,0.44198895,0.071823204,0.596685083,2,0.599438402
14238,53,22374,3,7,2,4,0,16,3,3,5,10,0,21,nowin,loss,beat,dlwin,0,10,10,250,0.372,0.064,0.564,0,0.013687345
14239,90,22374,7,7,0,0,0,14,3,3,5,10,0,21,nowin,loss,beat,dlwin,0,10,14,201,0.447761194,0.049751244,0.60199005,3,0.889945023
14240,132,22374,1,4,10,0,0,15,3,3,5,10,0,21,nowin,loss,beat,dlwin,0,10,5,194,0.412371134,0.036082474,0.649484536,2,0.611633238
14241,129,22374,10,10,0,0,0,20,3,3,5,10,0,21,nowin,loss,beat,dlwin,0,10,20,201,0.422885572,0.064676617,0.55721393,0,0.027255383
14242,149,22374,7,7,0,0,0,14,3,3,5,10,0,21,nowin,loss,beat,dlwin,0,10,14,225,0.457777778,0.057777778,0.648888889,2,0.651965595
14243,52,22374,11,10,0,0,0,21,3,3,5,10,0,21,win,push,push,push,10,0,21,217,0.414746544,0.02764977,0.599078341,2,0.576736024
14244,148,22375,10,10,0,0,0,20,10,10,0,0,0,20,nowin,push,push,push,10,0,20,204,0.401960784,0.078431373,0.593137255,0,0.029789521
14245,14,22375,3,10,0,8,0,21,10,10,0,0,0,20,nowin,win,plwin,beat,20,0,13,202,0.391089109,0.01980198,0.628712871,2,0.577264877
14246,49,22375,10,10,0,0,0,20,10,10,0,0,0,20,nowin,push,push,push,10,0,20,207,0.396135266,0.053140097,0.594202899,0,0.028306925
14247,6,22375,11,8,0,0,0,19,10,10,0,0,0,20,nowin,loss,beat,dlwin,0,10,19,191,0.439790576,0.047120419,0.581151832,1,0.31211505
14248,46,22375,7,8,0,2,0,17,10,10,0,0,0,20,nowin,loss,beat,dlwin,0,10,15,186,0.403225806,0.048387097,0.591397849,0,0.029742194
14249,48,22375,1,4,10,3,0,18,10,10,0,0,0,20,nowin,loss,beat,dlwin,0,10,5,203,0.413793103,0.019704433,0.600985222,2,0.577280801
14250,52,22376,10,6,0,0,0,16,6,5,5,10,0,26,nowin,win,dlbust,bust,20,0,16,217,0.414746544,0.02764977,0.599078341,2,0.576736024
14251,150,22376,4,10,0,0,0,14,6,5,5,10,0,26,nowin,win,dlbust,bust,20,0,14,192,0.401041667,0.036458333,0.567708333,0,0.023287458
14252,103,22376,4,10,0,0,0,14,6,5,5,10,0,26,nowin,win,dlbust,bust,20,0,14,203,0.379310345,0.064039409,0.551724138,0,0.012869209
14253,43,22376,5,2,10,0,0,17,6,5,5,10,0,26,nowin,win,dlbust,bust,20,0,7,192,0.40625,0.041666667,0.609375,2,0.576671372
14254,112,22376,7,3,5,0,0,15,6,5,5,10,0,26,nowin,win,dlbust,bust,20,0,10,203,0.448275862,0.054187192,0.600985222,3,0.889576933
14255,118,22376,2,8,10,0,0,20,6,5,5,10,0,26,nowin,win,dlbust,bust,20,0,10,216,0.393518519,0.037037037,0.555555556,0,0.018059873
14256,140,22377,5,3,10,0,0,18,3,10,3,9,0,25,nowin,win,dlbust,bust,20,0,8,210,0.466666667,0.023809524,0.604761905,3,0.915293335
14257,58,22377,10,10,0,0,0,20,3,10,3,9,0,25,nowin,win,dlbust,bust,20,0,20,195,0.430769231,0.041025641,0.584615385,2,0.580497586
14258,21,22377,4,9,0,0,0,13,3,10,3,9,0,25,nowin,win,dlbust,bust,20,0,13,214,0.359813084,0.042056075,0.626168224,0,0.025263474
14259,26,22377,5,4,7,0,0,16,3,10,3,9,0,25,nowin,win,dlbust,bust,20,0,9,203,0.463054187,0.0591133,0.541871921,1,0.306802864
14260,63,22377,3,2,10,0,0,15,3,10,3,9,0,25,nowin,win,dlbust,bust,20,0,5,216,0.467592593,0.037037037,0.62037037,3,0.931690496
14261,112,22377,10,2,0,1,0,13,3,10,3,9,0,25,nowin,win,dlbust,bust,20,0,12,203,0.448275862,0.054187192,0.600985222,3,0.889576933
14262,67,22378,7,3,4,0,0,14,4,10,2,10,0,26,nowin,win,dlbust,bust,20,0,10,195,0.369230769,0.041025641,0.569230769,0,0.014139427
14263,60,22378,10,4,0,0,0,14,4,10,2,10,0,26,nowin,win,dlbust,bust,20,0,14,227,0.418502203,0.022026432,0.559471366,0,0.026496258
14264,51,22378,10,10,0,0,0,20,4,10,2,10,0,26,nowin,win,dlbust,bust,20,0,20,189,0.529100529,0.068783069,0.608465608,3,0.993665715
14265,45,22378,10,5,0,0,0,15,4,10,2,10,0,26,nowin,win,dlbust,bust,20,0,15,196,0.428571429,0.051020408,0.612244898,2,0.598821767
14266,77,22378,5,6,2,0,0,13,4,10,2,10,0,26,nowin,win,dlbust,bust,20,0,11,200,0.455,0.04,0.62,3,0.916252116
14267,120,22378,2,10,0,0,0,12,4,10,2,10,0,26,nowin,win,dlbust,bust,20,0,12,202,0.440594059,0.034653465,0.618811881,2,0.614441029
14268,103,22379,5,10,0,0,0,15,4,1,7,8,0,20,nowin,loss,beat,dlwin,0,10,15,203,0.379310345,0.064039409,0.551724138,0,0.012869209
14269,16,22379,5,7,0,0,0,12,4,1,7,8,0,20,nowin,loss,beat,dlwin,0,10,12,220,0.427272727,0.081818182,0.6,2,0.588660176
14270,25,22379,10,10,0,0,0,20,4,1,7,8,0,20,nowin,push,push,push,10,0,20,190,0.463157895,0.063157895,0.536842105,1,0.304401563
14271,60,22379,10,10,0,0,0,20,4,1,7,8,0,20,nowin,push,push,push,10,0,20,227,0.418502203,0.022026432,0.559471366,0,0.026496258
14272,107,22379,10,10,0,0,0,20,4,1,7,8,0,20,nowin,push,push,push,10,0,20,218,0.444954128,0.073394495,0.600917431,2,0.605210014
14273,100,22379,5,6,10,0,0,21,4,1,7,8,0,20,nowin,win,plwin,beat,20,0,11,190,0.452631579,0.036842105,0.594736842,3,0.888671154
14274,36,22380,4,6,10,0,0,20,7,5,6,0,0,18,nowin,win,plwin,beat,20,0,10,229,0.445414847,0.056768559,0.655021834,2,0.645370571
14275,110,22380,10,6,0,10,0,26,7,5,6,0,0,18,nowin,loss,bust,plbust,0,10,16,192,0.416666667,0.046875,0.557291667,0,0.025413132
14276,30,22380,10,3,0,2,10,25,7,5,6,0,0,18,nowin,loss,bust,plbust,0,10,13,206,0.393203883,0.033980583,0.601941748,0,0.029324648
14277,119,22380,9,4,0,9,0,22,7,5,6,0,0,18,nowin,loss,bust,plbust,0,10,13,190,0.405263158,0.068421053,0.515789474,0,0.011837158
14278,81,22380,3,3,7,6,0,19,7,5,6,0,0,18,nowin,win,plwin,beat,20,0,6,182,0.395604396,0.043956044,0.60989011,2,0.567491261
14279,72,22380,11,4,1,8,0,24,7,5,6,0,0,18,nowin,loss,bust,plbust,0,10,15,185,0.394594595,0.032432432,0.508108108,0,0.006763115
14280,9,22381,8,8,0,8,0,24,10,10,0,0,0,20,nowin,loss,bust,plbust,0,10,16,194,0.37628866,0.015463918,0.541237113,0,0.009396796
14281,122,22381,7,10,0,0,0,17,10,10,0,0,0,20,nowin,loss,beat,dlwin,0,10,17,210,0.347619048,0.052380952,0.59047619,0,0.012873677
14282,36,22381,6,3,11,0,0,20,10,10,0,0,0,20,nowin,push,push,push,10,0,9,229,0.445414847,0.056768559,0.655021834,2,0.645370571
14283,35,22381,10,11,0,0,0,21,10,10,0,0,0,20,win,win,plwin,beat,25,0,21,202,0.410891089,0.044554455,0.633663366,2,0.598681573
14284,67,22381,4,11,3,0,0,18,10,10,0,0,0,20,nowin,loss,beat,dlwin,0,10,15,195,0.369230769,0.041025641,0.569230769,0,0.014139427
14285,130,22381,6,10,0,5,0,21,10,10,0,0,0,20,nowin,win,plwin,beat,20,0,16,219,0.410958904,0.03652968,0.566210046,0,0.025888739
14286,56,22382,10,2,0,0,0,12,6,10,4,0,0,20,nowin,loss,beat,dlwin,0,10,12,175,0.4,0.057142857,0.582857143,0,0.026685297
14287,35,22382,2,5,8,0,0,15,6,10,4,0,0,20,nowin,loss,beat,dlwin,0,10,7,202,0.410891089,0.044554455,0.633663366,2,0.598681573
14288,38,22382,9,11,0,0,0,20,6,10,4,0,0,20,nowin,push,push,push,10,0,20,202,0.361386139,0.03960396,0.564356436,0,0.010597953
14289,145,22382,10,3,0,0,0,13,6,10,4,0,0,20,nowin,loss,beat,dlwin,0,10,13,188,0.441489362,0.031914894,0.622340426,2,0.617837093
14290,92,22382,10,10,0,0,0,20,6,10,4,0,0,20,nowin,push,push,push,10,0,20,186,0.446236559,0.059139785,0.564516129,1,0.307826125
14291,71,22382,10,10,0,0,0,20,6,10,4,0,0,20,nowin,push,push,push,10,0,20,193,0.352331606,0.046632124,0.585492228,0,0.013063661
14292,131,22383,9,10,0,0,0,19,6,7,8,0,0,21,nowin,loss,beat,dlwin,0,10,19,217,0.410138249,0.069124424,0.543778802,0,0.02015021
14293,86,22383,3,6,10,0,0,19,6,7,8,0,0,21,nowin,loss,beat,dlwin,0,10,9,196,0.454081633,0.040816327,0.591836735,3,0.887566443
14294,116,22383,1,4,10,0,0,15,6,7,8,0,0,21,nowin,loss,beat,dlwin,0,10,5,195,0.425641026,0.056410256,0.538461538,1,0.28273747
14295,93,22383,10,8,0,0,0,18,6,7,8,0,0,21,nowin,loss,beat,dlwin,0,10,18,175,0.485714286,0.051428571,0.548571429,1,0.323648091
14296,125,22383,5,5,3,0,0,13,6,7,8,0,0,21,nowin,loss,beat,dlwin,0,10,10,219,0.438356164,0.050228311,0.575342466,1,0.308411257
14297,129,22383,11,10,0,0,0,21,6,7,8,0,0,21,win,push,push,push,10,0,21,201,0.422885572,0.064676617,0.55721393,0,0.027255383
14298,25,22384,2,2,3,10,0,17,10,10,0,0,0,20,nowin,loss,beat,dlwin,0,10,4,190,0.463157895,0.063157895,0.536842105,1,0.304401563
14299,64,22384,8,5,0,2,2,17,10,10,0,0,0,20,nowin,loss,beat,dlwin,0,10,13,187,0.363636364,0.048128342,0.631016043,0,0.027594885
14300,87,22384,11,10,0,0,0,21,10,10,0,0,0,20,win,win,plwin,beat,25,0,21,202,0.405940594,0.054455446,0.628712871,2,0.590599801
14301,34,22384,8,10,0,0,0,18,10,10,0,0,0,20,nowin,loss,beat,dlwin,0,10,18,202,0.5,0.079207921,0.618811881,3,0.968961434
14302,108,22384,9,10,0,0,0,19,10,10,0,0,0,20,nowin,loss,beat,dlwin,0,10,19,193,0.435233161,0.056994819,0.559585492,1,0.298824795
14303,40,22384,4,10,0,2,6,22,10,10,0,0,0,20,nowin,loss,bust,plbust,0,10,14,196,0.367346939,0.030612245,0.617346939,0,0.025358183
14304,124,22385,6,10,0,9,0,25,9,10,0,0,0,19,nowin,loss,bust,plbust,0,10,16,202,0.47029703,0.064356436,0.584158416,3,0.899458193
14305,32,22385,2,10,0,1,10,23,9,10,0,0,0,19,nowin,loss,bust,plbust,0,10,12,189,0.391534392,0.037037037,0.53968254,0,0.013579086
14306,104,22385,6,1,10,0,0,17,9,10,0,0,0,19,nowin,loss,beat,dlwin,0,10,7,209,0.363636364,0.052631579,0.593301435,0,0.018359419
14307,141,22385,5,10,0,8,0,23,9,10,0,0,0,19,nowin,loss,bust,plbust,0,10,15,202,0.420792079,0.074257426,0.564356436,0,0.028377851
14308,42,22385,5,10,0,7,0,22,9,10,0,0,0,19,nowin,loss,bust,plbust,0,10,15,212,0.443396226,0.051886792,0.570754717,1,0.309181312
14309,23,22385,10,2,0,2,8,22,9,10,0,0,0,19,nowin,loss,bust,plbust,0,10,12,208,0.427884615,0.0625,0.552884615,1,0.29114424
14310,85,22386,10,8,0,0,0,18,7,11,0,0,0,18,nowin,push,push,push,10,0,18,195,0.41025641,0.066666667,0.594871795,0,0.03269711
14311,38,22386,10,6,0,4,0,20,7,11,0,0,0,18,nowin,win,plwin,beat,20,0,16,202,0.361386139,0.03960396,0.564356436,0,0.010597953
14312,139,22386,8,10,0,0,0,18,7,11,0,0,0,18,nowin,push,push,push,10,0,18,192,0.380208333,0.036458333,0.59375,0,0.023429169
14313,129,22386,10,2,0,10,0,22,7,11,0,0,0,18,nowin,loss,bust,plbust,0,10,12,201,0.422885572,0.064676617,0.55721393,0,0.027255383
14314,144,22386,11,5,4,0,0,20,7,11,0,0,0,18,nowin,win,plwin,beat,20,0,16,202,0.386138614,0.054455446,0.564356436,0,0.018006244
14315,87,22386,11,10,0,0,0,21,7,11,0,0,0,18,win,win,plwin,beat,25,0,21,202,0.405940594,0.054455446,0.628712871,2,0.590599801
14316,114,22387,6,7,0,8,0,21,11,4,3,0,0,18,nowin,win,plwin,beat,20,0,13,198,0.47979798,0.025252525,0.611111111,3,0.937232995
14317,38,22387,1,5,9,6,0,21,11,4,3,0,0,18,nowin,win,plwin,beat,20,0,6,202,0.361386139,0.03960396,0.564356436,0,0.010597953
14318,105,22387,10,4,0,4,0,18,11,4,3,0,0,18,nowin,push,push,push,10,0,14,198,0.414141414,0.070707071,0.590909091,0,0.032889494
14319,65,22387,11,10,0,0,0,21,11,4,3,0,0,18,win,win,plwin,beat,25,0,21,203,0.492610837,0.054187192,0.571428571,3,0.913702814
14320,29,22387,4,10,0,4,0,18,11,4,3,0,0,18,nowin,push,push,push,10,0,14,189,0.44973545,0.058201058,0.544973545,1,0.300349439
14321,25,22387,4,10,0,7,0,21,11,4,3,0,0,18,nowin,win,plwin,beat,20,0,14,190,0.463157895,0.063157895,0.536842105,1,0.304401563
14322,47,22388,6,7,0,2,2,17,9,4,6,0,0,19,nowin,loss,beat,dlwin,0,10,13,210,0.438095238,0.057142857,0.623809524,2,0.615868808
14323,143,22388,10,4,0,8,0,22,9,4,6,0,0,19,nowin,loss,bust,plbust,0,10,14,203,0.463054187,0.044334975,0.57635468,3,0.883143365
14324,100,22388,10,3,0,5,0,18,9,4,6,0,0,19,nowin,loss,beat,dlwin,0,10,13,190,0.452631579,0.036842105,0.594736842,3,0.888671154
14325,140,22388,1,2,10,2,5,20,9,4,6,0,0,19,nowin,win,plwin,beat,20,0,3,210,0.466666667,0.023809524,0.604761905,3,0.915293335
14326,137,22388,7,10,0,0,0,17,9,4,6,0,0,19,nowin,loss,beat,dlwin,0,10,17,194,0.417525773,0.046391753,0.536082474,1,0.276714602
14327,47,22388,3,6,5,1,3,18,9,4,6,0,0,19,nowin,loss,beat,dlwin,0,10,9,210,0.438095238,0.057142857,0.623809524,2,0.615868808
14328,132,22389,10,9,0,0,0,19,10,9,0,0,0,19,nowin,push,push,push,10,0,19,194,0.412371134,0.036082474,0.649484536,2,0.611633238
14329,72,22389,10,4,0,1,10,25,10,9,0,0,0,19,nowin,loss,bust,plbust,0,10,14,185,0.394594595,0.032432432,0.508108108,0,0.006763115
14330,4,22389,2,7,10,0,0,19,10,9,0,0,0,19,nowin,push,push,push,10,0,9,217,0.460829493,0.036866359,0.562211982,1,0.315432839
14331,49,22389,10,2,0,1,1,14,10,9,0,0,0,19,nowin,loss,beat,dlwin,0,10,12,207,0.396135266,0.053140097,0.594202899,0,0.028306925
14332,21,22389,10,10,0,0,0,20,10,9,0,0,0,19,nowin,win,plwin,beat,20,0,20,214,0.359813084,0.042056075,0.626168224,0,0.025263474
14333,98,22389,10,2,0,8,0,20,10,9,0,0,0,19,nowin,win,plwin,beat,20,0,12,220,0.422727273,0.054545455,0.55,1,0.28664435
14334,43,22390,5,7,0,10,0,22,10,3,6,0,0,19,nowin,loss,bust,plbust,0,10,12,192,0.40625,0.041666667,0.609375,2,0.576671372
14335,105,22390,8,9,0,0,0,17,10,3,6,0,0,19,nowin,loss,beat,dlwin,0,10,17,198,0.414141414,0.070707071,0.590909091,0,0.032889494
14336,136,22390,10,3,0,1,5,19,10,3,6,0,0,19,nowin,push,push,push,10,0,13,194,0.396907216,0.025773196,0.597938144,0,0.029452644
14337,46,22390,5,2,10,0,0,17,10,3,6,0,0,19,nowin,loss,beat,dlwin,0,10,7,186,0.403225806,0.048387097,0.591397849,0,0.029742194
14338,110,22390,3,4,2,1,9,19,10,3,6,0,0,19,nowin,push,push,push,10,0,7,192,0.416666667,0.046875,0.557291667,0,0.025413132
14339,89,22390,10,11,0,0,0,21,10,3,6,0,0,19,win,win,plwin,beat,25,0,21,212,0.537735849,0.047169811,0.594339623,3,0.990167191
14340,63,22391,11,8,0,0,0,19,9,4,10,0,0,23,nowin,win,dlbust,bust,20,0,19,216,0.467592593,0.037037037,0.62037037,3,0.931690496
14341,96,22391,11,1,1,4,0,17,9,4,10,0,0,23,nowin,win,dlbust,bust,20,0,12,190,0.468421053,0.057894737,0.584210526,3,0.897263354
14342,34,22391,5,3,3,10,0,21,9,4,10,0,0,23,nowin,win,dlbust,bust,20,0,8,202,0.5,0.079207921,0.618811881,3,0.968961434
14343,13,22391,10,11,0,0,0,21,9,4,10,0,0,23,win,win,dlbust,bust,25,0,21,206,0.417475728,0.063106796,0.621359223,2,0.59555479
14344,85,22391,10,2,0,4,5,21,9,4,10,0,0,23,nowin,win,dlbust,bust,20,0,12,195,0.41025641,0.066666667,0.594871795,0,0.03269711
14345,43,22391,4,11,2,0,0,17,9,4,10,0,0,23,nowin,win,dlbust,bust,20,0,15,192,0.40625,0.041666667,0.609375,2,0.576671372
14346,66,22392,5,9,0,7,0,21,9,5,1,1,4,20,nowin,win,plwin,beat,20,0,14,217,0.456221198,0.064516129,0.626728111,3,0.924304367
14347,16,22392,9,4,0,4,0,17,9,5,1,1,4,20,nowin,loss,beat,dlwin,0,10,13,220,0.427272727,0.081818182,0.6,2,0.588660176
14348,17,22392,11,10,0,0,0,21,9,5,1,1,4,20,win,win,plwin,beat,25,0,21,171,0.444444444,0.070175439,0.555555556,1,0.302364894
14349,44,22392,7,6,0,6,0,19,9,5,1,1,4,20,nowin,loss,beat,dlwin,0,10,13,219,0.433789954,0.050228311,0.534246575,1,0.285551035
14350,47,22392,3,10,0,1,4,18,9,5,1,1,4,20,nowin,loss,beat,dlwin,0,10,13,210,0.438095238,0.057142857,0.623809524,2,0.615868808
14351,90,22392,10,3,0,1,7,21,9,5,1,1,4,20,nowin,win,plwin,beat,20,0,13,201,0.447761194,0.049751244,0.60199005,3,0.889945023
14352,128,22393,10,10,0,0,0,20,7,5,7,0,0,19,nowin,win,plwin,beat,20,0,20,227,0.356828194,0.052863436,0.577092511,0,0.012352564
14353,24,22393,4,7,8,0,0,19,7,5,7,0,0,19,nowin,push,push,push,10,0,11,207,0.458937198,0.048309179,0.570048309,1,0.318138014
14354,55,22393,11,10,0,0,0,21,7,5,7,0,0,19,win,win,plwin,beat,25,0,21,191,0.371727749,0.057591623,0.54973822,0,0.01011347
14355,10,22393,8,11,0,0,0,19,7,5,7,0,0,19,nowin,push,push,push,10,0,19,191,0.413612565,0.057591623,0.596858639,2,0.574087175
14356,29,22393,5,10,0,10,0,25,7,5,7,0,0,19,nowin,loss,bust,plbust,0,10,15,189,0.44973545,0.058201058,0.544973545,1,0.300349439
14357,8,22393,2,4,6,10,0,22,7,5,7,0,0,19,nowin,loss,bust,plbust,0,10,6,181,0.44198895,0.071823204,0.596685083,2,0.599438402
14358,39,22394,3,10,0,0,0,13,6,10,2,0,0,18,nowin,loss,beat,dlwin,0,10,13,191,0.429319372,0.062827225,0.57591623,0,0.033760763
14359,89,22394,10,6,0,0,0,16,6,10,2,0,0,18,nowin,loss,beat,dlwin,0,10,16,212,0.537735849,0.047169811,0.594339623,3,0.990167191
14360,8,22394,11,10,0,0,0,21,6,10,2,0,0,18,win,win,plwin,beat,25,0,21,181,0.44198895,0.071823204,0.596685083,2,0.599438402
14361,19,22394,5,2,6,0,0,13,6,10,2,0,0,18,nowin,loss,beat,dlwin,0,10,7,237,0.41350211,0.054852321,0.628691983,2,0.597373826
14362,25,22394,7,10,0,0,0,17,6,10,2,0,0,18,nowin,loss,beat,dlwin,0,10,17,190,0.463157895,0.063157895,0.536842105,1,0.304401563
14363,109,22394,10,10,0,0,0,20,6,10,2,0,0,18,nowin,win,plwin,beat,20,0,20,221,0.461538462,0.058823529,0.597285068,3,0.901830309
14364,150,22395,9,8,0,0,0,17,10,4,10,0,0,24,nowin,win,dlbust,bust,20,0,17,192,0.401041667,0.036458333,0.567708333,0,0.023287458
14365,53,22395,10,4,0,6,0,20,10,4,10,0,0,24,nowin,win,dlbust,bust,20,0,14,250,0.372,0.064,0.564,0,0.013687345
14366,8,22395,10,10,0,0,0,20,10,4,10,0,0,24,nowin,win,dlbust,bust,20,0,20,181,0.44198895,0.071823204,0.596685083,2,0.599438402
14367,32,22395,5,3,10,0,0,18,10,4,10,0,0,24,nowin,win,dlbust,bust,20,0,8,189,0.391534392,0.037037037,0.53968254,0,0.013579086
14368,36,22395,3,8,4,5,0,20,10,4,10,0,0,24,nowin,win,dlbust,bust,20,0,11,229,0.445414847,0.056768559,0.655021834,2,0.645370571
14369,74,22395,4,10,0,10,0,24,10,4,10,0,0,24,nowin,loss,bust,plbust,0,10,14,209,0.411483254,0.04784689,0.531100478,0,0.017448125
14370,128,22396,11,10,0,0,0,21,5,7,4,5,0,21,win,push,push,push,10,0,21,227,0.356828194,0.052863436,0.577092511,0,0.012352564
14371,34,22396,10,10,0,0,0,20,5,7,4,5,0,21,nowin,loss,beat,dlwin,0,10,20,202,0.5,0.079207921,0.618811881,3,0.968961434
14372,26,22396,11,10,0,0,0,21,5,7,4,5,0,21,win,push,push,push,10,0,21,203,0.463054187,0.0591133,0.541871921,1,0.306802864
14373,77,22396,11,8,0,0,0,19,5,7,4,5,0,21,nowin,loss,beat,dlwin,0,10,19,200,0.455,0.04,0.62,3,0.916252116
14374,61,22396,11,2,7,0,0,20,5,7,4,5,0,21,nowin,loss,beat,dlwin,0,10,13,194,0.427835052,0.077319588,0.603092784,2,0.591437139
14375,127,22396,6,2,10,0,0,18,5,7,4,5,0,21,nowin,loss,beat,dlwin,0,10,8,201,0.402985075,0.029850746,0.60199005,0,0.032263937
14376,116,22397,7,5,0,3,0,15,2,4,2,2,2,12,nowin,win,plwin,beat,20,0,12,195,0.425641026,0.056410256,0.538461538,1,0.28273747
14377,34,22397,7,6,0,0,0,13,2,4,2,2,2,12,nowin,win,plwin,beat,20,0,13,202,0.5,0.079207921,0.618811881,3,0.968961434
14378,29,22397,10,9,0,0,0,19,2,4,2,2,2,12,nowin,win,plwin,beat,20,0,19,189,0.44973545,0.058201058,0.544973545,1,0.300349439
14379,39,22397,5,5,3,0,0,13,2,4,2,2,2,12,nowin,win,plwin,beat,20,0,10,191,0.429319372,0.062827225,0.57591623,0,0.033760763
14380,75,22397,10,2,0,7,0,19,2,4,2,2,2,12,nowin,win,plwin,beat,20,0,12,191,0.418848168,0.052356021,0.570680628,0,0.029344702
14381,52,22397,8,10,0,0,0,18,2,4,2,2,2,12,nowin,win,plwin,beat,20,0,18,217,0.414746544,0.02764977,0.599078341,2,0.576736024
14382,86,22398,2,3,10,4,0,19,10,10,0,0,0,20,nowin,loss,beat,dlwin,0,10,5,196,0.454081633,0.040816327,0.591836735,3,0.887566443
14383,120,22398,9,10,0,0,0,19,10,10,0,0,0,20,nowin,loss,beat,dlwin,0,10,19,202,0.440594059,0.034653465,0.618811881,2,0.614441029
14384,15,22398,11,10,0,0,0,21,10,10,0,0,0,20,win,win,plwin,beat,25,0,21,212,0.410377358,0.051886792,0.561320755,0,0.024517408
14385,59,22398,10,9,0,0,0,19,10,10,0,0,0,20,nowin,loss,beat,dlwin,0,10,19,228,0.429824561,0.048245614,0.543859649,1,0.287885446
14386,15,22398,10,4,0,9,0,23,10,10,0,0,0,20,nowin,loss,bust,plbust,0,10,14,212,0.410377358,0.051886792,0.561320755,0,0.024517408
14387,31,22398,10,10,0,0,0,20,10,10,0,0,0,20,nowin,push,push,push,10,0,20,188,0.473404255,0.058510638,0.515957447,1,0.300306557
14388,86,22399,9,3,0,10,0,22,10,3,1,4,0,18,nowin,loss,bust,plbust,0,10,12,196,0.454081633,0.040816327,0.591836735,3,0.887566443
14389,58,22399,10,3,0,10,0,23,10,3,1,4,0,18,nowin,loss,bust,plbust,0,10,13,195,0.430769231,0.041025641,0.584615385,2,0.580497586
14390,144,22399,10,6,0,10,0,26,10,3,1,4,0,18,nowin,loss,bust,plbust,0,10,16,202,0.386138614,0.054455446,0.564356436,0,0.018006244
14391,42,22399,10,8,0,0,0,18,10,3,1,4,0,18,nowin,push,push,push,10,0,18,212,0.443396226,0.051886792,0.570754717,1,0.309181312
14392,54,22399,8,10,0,0,0,18,10,3,1,4,0,18,nowin,push,push,push,10,0,18,185,0.437837838,0.032432432,0.556756757,1,0.29899854
14393,79,22399,10,10,0,0,0,20,10,3,1,4,0,18,nowin,win,plwin,beat,20,0,20,211,0.436018957,0.028436019,0.672985782,2,0.650131054
14394,74,22400,4,10,0,0,0,14,3,10,4,0,0,17,nowin,loss,beat,dlwin,0,10,14,209,0.411483254,0.04784689,0.531100478,0,0.017448125
14395,146,22400,10,10,0,0,0,20,3,10,4,0,0,17,nowin,win,plwin,beat,20,0,20,221,0.43438914,0.040723982,0.542986425,1,0.290190091
14396,108,22400,8,9,0,0,0,17,3,10,4,0,0,17,nowin,push,push,push,10,0,17,193,0.435233161,0.056994819,0.559585492,1,0.298824795
14397,14,22400,3,9,0,10,0,22,3,10,4,0,0,17,nowin,loss,bust,plbust,0,10,12,202,0.391089109,0.01980198,0.628712871,2,0.577264877
14398,27,22400,4,11,6,0,0,21,3,10,4,0,0,17,nowin,win,plwin,beat,20,0,15,178,0.370786517,0.016853933,0.573033708,0,0.015536309
14399,133,22400,3,9,0,4,0,16,3,10,4,0,0,17,nowin,loss,beat,dlwin,0,10,12,201,0.47761194,0.064676617,0.611940299,3,0.935428111
14400,3,22401,10,9,0,0,0,19,10,3,9,0,0,22,nowin,win,dlbust,bust,20,0,19,190,0.431578947,0.026315789,0.542105263,1,0.288076384
14401,61,22401,6,10,0,9,0,25,10,3,9,0,0,22,nowin,loss,bust,plbust,0,10,16,194,0.427835052,0.077319588,0.603092784,2,0.591437139
14402,58,22401,2,10,0,4,10,26,10,3,9,0,0,22,nowin,loss,bust,plbust,0,10,12,195,0.430769231,0.041025641,0.584615385,2,0.580497586
14403,35,22401,4,10,0,1,5,20,10,3,9,0,0,22,nowin,win,dlbust,bust,20,0,14,202,0.410891089,0.044554455,0.633663366,2,0.598681573
14404,13,22401,3,1,9,10,0,23,10,3,9,0,0,22,nowin,loss,bust,plbust,0,10,4,206,0.417475728,0.063106796,0.621359223,2,0.59555479
14405,47,22401,11,10,0,0,0,21,10,3,9,0,0,22,win,win,dlbust,bust,25,0,21,210,0.438095238,0.057142857,0.623809524,2,0.615868808
14406,43,22402,2,8,10,0,0,20,9,2,8,0,0,19,nowin,win,plwin,beat,20,0,10,192,0.40625,0.041666667,0.609375,2,0.576671372
14407,89,22402,8,11,0,0,0,19,9,2,8,0,0,19,nowin,push,push,push,10,0,19,212,0.537735849,0.047169811,0.594339623,3,0.990167191
14408,47,22402,9,10,0,0,0,19,9,2,8,0,0,19,nowin,push,push,push,10,0,19,210,0.438095238,0.057142857,0.623809524,2,0.615868808
14409,26,22402,4,10,0,5,0,19,9,2,8,0,0,19,nowin,push,push,push,10,0,14,203,0.463054187,0.0591133,0.541871921,1,0.306802864
14410,133,22402,10,10,0,0,0,20,9,2,8,0,0,19,nowin,win,plwin,beat,20,0,20,201,0.47761194,0.064676617,0.611940299,3,0.935428111
14411,72,22402,10,9,0,0,0,19,9,2,8,0,0,19,nowin,push,push,push,10,0,19,185,0.394594595,0.032432432,0.508108108,0,0.006763115
14412,137,22403,8,11,0,0,0,19,10,10,0,0,0,20,nowin,loss,beat,dlwin,0,10,19,194,0.417525773,0.046391753,0.536082474,1,0.276714602
14413,128,22403,10,6,0,4,0,20,10,10,0,0,0,20,nowin,push,push,push,10,0,16,227,0.356828194,0.052863436,0.577092511,0,0.012352564
14414,103,22403,10,2,0,10,0,22,10,10,0,0,0,20,nowin,loss,bust,plbust,0,10,12,203,0.379310345,0.064039409,0.551724138,0,0.012869209
14415,102,22403,9,2,10,0,0,21,10,10,0,0,0,20,nowin,win,plwin,beat,20,0,11,192,0.338541667,0.046875,0.5625,0,0.003306118
14416,148,22403,10,10,0,0,0,20,10,10,0,0,0,20,nowin,push,push,push,10,0,20,204,0.401960784,0.078431373,0.593137255,0,0.029789521
14417,31,22403,3,4,5,5,0,17,10,10,0,0,0,20,nowin,loss,beat,dlwin,0,10,7,188,0.473404255,0.058510638,0.515957447,1,0.300306557
14418,13,22404,10,10,0,0,0,20,4,8,10,0,0,22,nowin,win,dlbust,bust,20,0,20,206,0.417475728,0.063106796,0.621359223,2,0.59555479
14419,101,22404,2,2,2,2,9,17,4,8,10,0,0,22,nowin,win,dlbust,bust,20,0,4,205,0.424390244,0.068292683,0.63902439,2,0.614740646
14420,71,22404,10,10,0,0,0,20,4,8,10,0,0,22,nowin,win,dlbust,bust,20,0,20,193,0.352331606,0.046632124,0.585492228,0,0.013063661
14421,98,22404,10,2,0,0,0,12,4,8,10,0,0,22,nowin,win,dlbust,bust,20,0,12,220,0.422727273,0.054545455,0.55,1,0.28664435
14422,142,22404,5,10,0,0,0,15,4,8,10,0,0,22,nowin,win,dlbust,bust,20,0,15,211,0.417061611,0.047393365,0.526066351,1,0.271531309
14423,36,22404,8,10,0,0,0,18,4,8,10,0,0,22,nowin,win,dlbust,bust,20,0,18,229,0.445414847,0.056768559,0.655021834,2,0.645370571
14424,146,22405,4,11,1,0,0,16,5,9,1,10,0,25,nowin,win,dlbust,bust,20,0,15,221,0.43438914,0.040723982,0.542986425,1,0.290190091
14425,137,22405,10,8,0,0,0,18,5,9,1,10,0,25,nowin,win,dlbust,bust,20,0,18,194,0.417525773,0.046391753,0.536082474,1,0.276714602
14426,140,22405,2,9,10,0,0,21,5,9,1,10,0,25,nowin,win,dlbust,bust,20,0,11,210,0.466666667,0.023809524,0.604761905,3,0.915293335
14427,110,22405,7,10,0,0,0,17,5,9,1,10,0,25,nowin,win,dlbust,bust,20,0,17,192,0.416666667,0.046875,0.557291667,0,0.025413132
14428,31,22405,6,10,0,0,0,16,5,9,1,10,0,25,nowin,win,dlbust,bust,20,0,16,188,0.473404255,0.058510638,0.515957447,1,0.300306557
14429,85,22405,7,10,0,0,0,17,5,9,1,10,0,25,nowin,win,dlbust,bust,20,0,17,195,0.41025641,0.066666667,0.594871795,0,0.03269711
14430,47,22406,3,10,0,3,10,26,9,11,0,0,0,20,nowin,loss,bust,plbust,0,10,13,210,0.438095238,0.057142857,0.623809524,2,0.615868808
14431,20,22406,10,9,0,0,0,19,9,11,0,0,0,20,nowin,loss,beat,dlwin,0,10,19,186,0.456989247,0.037634409,0.537634409,1,0.301097108
14432,61,22406,11,3,2,7,0,23,9,11,0,0,0,20,nowin,loss,bust,plbust,0,10,14,194,0.427835052,0.077319588,0.603092784,2,0.591437139
14433,15,22406,5,10,0,10,0,25,9,11,0,0,0,20,nowin,loss,bust,plbust,0,10,15,212,0.410377358,0.051886792,0.561320755,0,0.024517408
14434,24,22406,2,6,2,5,4,19,9,11,0,0,0,20,nowin,loss,beat,dlwin,0,10,8,207,0.458937198,0.048309179,0.570048309,1,0.318138014
14435,119,22406,6,2,2,7,0,17,9,11,0,0,0,20,nowin,loss,beat,dlwin,0,10,8,190,0.405263158,0.068421053,0.515789474,0,0.011837158
14436,4,22407,2,3,2,1,8,16,10,10,0,0,0,20,nowin,loss,beat,dlwin,0,10,5,217,0.460829493,0.036866359,0.562211982,1,0.315432839
14437,150,22407,3,10,0,9,0,22,10,10,0,0,0,20,nowin,loss,bust,plbust,0,10,13,192,0.401041667,0.036458333,0.567708333,0,0.023287458
14438,103,22407,10,5,0,10,0,25,10,10,0,0,0,20,nowin,loss,bust,plbust,0,10,15,203,0.379310345,0.064039409,0.551724138,0,0.012869209
14439,71,22407,7,10,0,0,0,17,10,10,0,0,0,20,nowin,loss,beat,dlwin,0,10,17,193,0.352331606,0.046632124,0.585492228,0,0.013063661
14440,38,22407,6,1,10,0,0,17,10,10,0,0,0,20,nowin,loss,beat,dlwin,0,10,7,202,0.361386139,0.03960396,0.564356436,0,0.010597953
14441,56,22407,8,10,0,0,0,18,10,10,0,0,0,20,nowin,loss,beat,dlwin,0,10,18,175,0.4,0.057142857,0.582857143,0,0.026685297
14442,78,22408,8,10,0,0,0,18,2,6,8,7,0,23,nowin,win,dlbust,bust,20,0,18,201,0.517412935,0.034825871,0.587064677,3,0.95871112
14443,7,22408,8,10,0,0,0,18,2,6,8,7,0,23,nowin,win,dlbust,bust,20,0,18,183,0.442622951,0.06010929,0.62295082,2,0.619303341
14444,76,22408,10,2,0,2,0,14,2,6,8,7,0,23,nowin,win,dlbust,bust,20,0,12,189,0.534391534,0.079365079,0.608465608,3,1
14445,8,22408,4,10,0,0,0,14,2,6,8,7,0,23,nowin,win,dlbust,bust,20,0,14,181,0.44198895,0.071823204,0.596685083,2,0.599438402
14446,54,22408,9,3,0,4,0,16,2,6,8,7,0,23,nowin,win,dlbust,bust,20,0,12,185,0.437837838,0.032432432,0.556756757,1,0.29899854
14447,149,22408,10,10,0,0,0,20,2,6,8,7,0,23,nowin,win,dlbust,bust,20,0,20,225,0.457777778,0.057777778,0.648888889,2,0.651965595
14448,64,22409,11,5,1,0,0,17,10,10,0,0,0,20,nowin,loss,beat,dlwin,0,10,16,187,0.363636364,0.048128342,0.631016043,0,0.027594885
14449,128,22409,10,10,0,0,0,20,10,10,0,0,0,20,nowin,push,push,push,10,0,20,227,0.356828194,0.052863436,0.577092511,0,0.012352564
14450,114,22409,2,10,0,4,7,23,10,10,0,0,0,20,nowin,loss,bust,plbust,0,10,12,198,0.47979798,0.025252525,0.611111111,3,0.937232995
14451,6,22409,7,3,11,0,0,21,10,10,0,0,0,20,nowin,win,plwin,beat,20,0,10,191,0.439790576,0.047120419,0.581151832,1,0.31211505
14452,113,22409,8,9,0,0,0,17,10,10,0,0,0,20,nowin,loss,beat,dlwin,0,10,17,199,0.407035176,0.055276382,0.668341709,2,0.620695264
14453,73,22409,8,11,0,0,0,19,10,10,0,0,0,20,nowin,loss,beat,dlwin,0,10,19,181,0.375690608,0.011049724,0.596685083,0,0.022795773
14454,143,22410,3,6,7,10,0,26,10,10,0,0,0,20,nowin,loss,bust,plbust,0,10,9,203,0.463054187,0.044334975,0.57635468,3,0.883143365
14455,43,22410,7,9,0,10,0,26,10,10,0,0,0,20,nowin,loss,bust,plbust,0,10,16,192,0.40625,0.041666667,0.609375,2,0.576671372
14456,9,22410,10,4,0,10,0,24,10,10,0,0,0,20,nowin,loss,bust,plbust,0,10,14,194,0.37628866,0.015463918,0.541237113,0,0.009396796
14457,123,22410,10,3,0,7,0,20,10,10,0,0,0,20,nowin,push,push,push,10,0,13,205,0.43902439,0.034146341,0.614634146,2,0.609962544
14458,92,22410,3,8,5,1,0,17,10,10,0,0,0,20,nowin,loss,beat,dlwin,0,10,11,186,0.446236559,0.059139785,0.564516129,1,0.307826125
14459,62,22410,6,10,0,6,0,22,10,10,0,0,0,20,nowin,loss,bust,plbust,0,10,16,178,0.370786517,0.028089888,0.54494382,0,0.008657722
14460,135,22411,10,2,0,9,0,21,9,6,9,0,0,24,nowin,win,dlbust,bust,20,0,12,179,0.391061453,0.067039106,0.586592179,0,0.024924662
14461,117,22411,6,10,0,3,0,19,9,6,9,0,0,24,nowin,win,dlbust,bust,20,0,16,173,0.410404624,0.069364162,0.606936416,2,0.578610282
14462,33,22411,10,5,0,5,0,20,9,6,9,0,0,24,nowin,win,dlbust,bust,20,0,15,192,0.4375,0.057291667,0.625,2,0.616208916
14463,11,22411,10,4,0,10,0,24,9,6,9,0,0,24,nowin,loss,bust,plbust,0,10,14,236,0.457627119,0.016949153,0.588983051,3,0.889015813
14464,11,22411,5,4,7,5,0,21,9,6,9,0,0,24,nowin,win,dlbust,bust,20,0,9,236,0.457627119,0.016949153,0.588983051,3,0.889015813
14465,44,22411,2,10,0,8,0,20,9,6,9,0,0,24,nowin,win,dlbust,bust,20,0,12,219,0.433789954,0.050228311,0.534246575,1,0.285551035
14466,71,22412,4,3,3,10,0,20,5,10,4,0,0,19,nowin,win,plwin,beat,20,0,7,193,0.352331606,0.046632124,0.585492228,0,0.013063661
14467,145,22412,10,10,0,0,0,20,5,10,4,0,0,19,nowin,win,plwin,beat,20,0,20,188,0.441489362,0.031914894,0.622340426,2,0.617837093
14468,98,22412,10,3,0,0,0,13,5,10,4,0,0,19,nowin,loss,beat,dlwin,0,10,13,220,0.422727273,0.054545455,0.55,1,0.28664435
14469,122,22412,3,9,0,0,0,12,5,10,4,0,0,19,nowin,loss,beat,dlwin,0,10,12,210,0.347619048,0.052380952,0.59047619,0,0.012873677
14470,52,22412,10,7,0,0,0,17,5,10,4,0,0,19,nowin,loss,beat,dlwin,0,10,17,217,0.414746544,0.02764977,0.599078341,2,0.576736024
14471,15,22412,10,2,0,0,0,12,5,10,4,0,0,19,nowin,loss,beat,dlwin,0,10,12,212,0.410377358,0.051886792,0.561320755,0,0.024517408
14472,137,22413,6,4,9,0,0,19,10,10,0,0,0,20,nowin,loss,beat,dlwin,0,10,10,194,0.417525773,0.046391753,0.536082474,1,0.276714602
14473,61,22413,3,6,4,1,10,24,10,10,0,0,0,20,nowin,loss,bust,plbust,0,10,9,194,0.427835052,0.077319588,0.603092784,2,0.591437139
14474,89,22413,8,10,0,0,0,18,10,10,0,0,0,20,nowin,loss,beat,dlwin,0,10,18,212,0.537735849,0.047169811,0.594339623,3,0.990167191
14475,32,22413,6,3,6,4,0,19,10,10,0,0,0,20,nowin,loss,beat,dlwin,0,10,9,189,0.391534392,0.037037037,0.53968254,0,0.013579086
14476,141,22413,5,2,9,10,0,26,10,10,0,0,0,20,nowin,loss,bust,plbust,0,10,7,202,0.420792079,0.074257426,0.564356436,0,0.028377851
14477,143,22413,5,3,5,7,0,20,10,10,0,0,0,20,nowin,push,push,push,10,0,8,203,0.463054187,0.044334975,0.57635468,3,0.883143365
14478,60,22414,10,10,0,0,0,20,10,2,7,0,0,19,nowin,win,plwin,beat,20,0,20,227,0.418502203,0.022026432,0.559471366,0,0.026496258
14479,67,22414,1,2,10,9,0,22,10,2,7,0,0,19,nowin,loss,bust,plbust,0,10,3,195,0.369230769,0.041025641,0.569230769,0,0.014139427
14480,114,22414,1,3,10,10,0,24,10,2,7,0,0,19,nowin,loss,bust,plbust,0,10,4,198,0.47979798,0.025252525,0.611111111,3,0.937232995
14481,44,22414,10,10,0,0,0,20,10,2,7,0,0,19,nowin,win,plwin,beat,20,0,20,219,0.433789954,0.050228311,0.534246575,1,0.285551035
14482,63,22414,11,8,0,0,0,19,10,2,7,0,0,19,nowin,push,push,push,10,0,19,216,0.467592593,0.037037037,0.62037037,3,0.931690496
14483,4,22414,10,7,0,0,0,17,10,2,7,0,0,19,nowin,loss,beat,dlwin,0,10,17,217,0.460829493,0.036866359,0.562211982,1,0.315432839
14484,115,22415,11,1,5,0,0,17,4,2,4,10,0,20,nowin,loss,beat,dlwin,0,10,12,194,0.427835052,0.041237113,0.592783505,2,0.583863602
14485,137,22415,11,1,7,0,0,19,4,2,4,10,0,20,nowin,loss,beat,dlwin,0,10,12,194,0.417525773,0.046391753,0.536082474,1,0.276714602
14486,148,22415,9,4,0,0,0,13,4,2,4,10,0,20,nowin,loss,beat,dlwin,0,10,13,204,0.401960784,0.078431373,0.593137255,0,0.029789521
14487,119,22415,8,4,0,0,0,12,4,2,4,10,0,20,nowin,loss,beat,dlwin,0,10,12,190,0.405263158,0.068421053,0.515789474,0,0.011837158
14488,4,22415,10,5,0,0,0,15,4,2,4,10,0,20,nowin,loss,beat,dlwin,0,10,15,217,0.460829493,0.036866359,0.562211982,1,0.315432839
14489,78,22415,2,2,3,3,5,15,4,2,4,10,0,20,nowin,loss,beat,dlwin,0,10,4,201,0.517412935,0.034825871,0.587064677,3,0.95871112
14490,19,22416,8,4,0,1,0,13,3,3,9,2,0,17,nowin,loss,beat,dlwin,0,10,12,237,0.41350211,0.054852321,0.628691983,2,0.597373826
14491,57,22416,9,6,0,0,0,15,3,3,9,2,0,17,nowin,loss,beat,dlwin,0,10,15,192,0.46875,0.052083333,0.59375,3,0.907001181
14492,135,22416,10,7,0,0,0,17,3,3,9,2,0,17,nowin,push,push,push,10,0,17,179,0.391061453,0.067039106,0.586592179,0,0.024924662
14493,44,22416,4,3,10,0,0,17,3,3,9,2,0,17,nowin,push,push,push,10,0,7,219,0.433789954,0.050228311,0.534246575,1,0.285551035
14494,98,22416,1,5,8,0,0,14,3,3,9,2,0,17,nowin,loss,beat,dlwin,0,10,6,220,0.422727273,0.054545455,0.55,1,0.28664435
14495,63,22416,3,2,2,4,5,16,3,3,9,2,0,17,nowin,loss,beat,dlwin,0,10,5,216,0.467592593,0.037037037,0.62037037,3,0.931690496
14496,37,22417,10,5,0,4,0,19,9,7,9,0,0,25,nowin,win,dlbust,bust,20,0,15,208,0.394230769,0.038461538,0.581730769,0,0.024682772
14497,126,22417,11,8,0,0,0,19,9,7,9,0,0,25,nowin,win,dlbust,bust,20,0,19,188,0.457446809,0.074468085,0.60106383,3,0.900633203
14498,7,22417,8,6,0,1,10,25,9,7,9,0,0,25,nowin,loss,bust,plbust,0,10,14,183,0.442622951,0.06010929,0.62295082,2,0.619303341
14499,67,22417,9,11,0,0,0,20,9,7,9,0,0,25,nowin,win,dlbust,bust,20,0,20,195,0.369230769,0.041025641,0.569230769,0,0.014139427
14500,134,22417,11,9,0,0,0,20,9,7,9,0,0,25,nowin,win,dlbust,bust,20,0,20,185,0.443243243,0.021621622,0.545945946,1,0.296939509
14501,59,22417,11,10,0,0,0,21,9,7,9,0,0,25,win,win,dlbust,bust,25,0,21,228,0.429824561,0.048245614,0.543859649,1,0.287885446
14502,53,22418,11,10,0,0,0,21,4,5,8,0,0,17,win,win,plwin,beat,25,0,21,250,0.372,0.064,0.564,0,0.013687345
14503,30,22418,3,10,0,0,0,13,4,5,8,0,0,17,nowin,loss,beat,dlwin,0,10,13,206,0.393203883,0.033980583,0.601941748,0,0.029324648
14504,57,22418,10,11,0,0,0,21,4,5,8,0,0,17,win,win,plwin,beat,25,0,21,192,0.46875,0.052083333,0.59375,3,0.907001181
14505,97,22418,4,5,7,0,0,16,4,5,8,0,0,17,nowin,loss,beat,dlwin,0,10,9,182,0.450549451,0.06043956,0.692307692,2,0.677372279
14506,5,22418,7,7,0,0,0,14,4,5,8,0,0,17,nowin,loss,beat,dlwin,0,10,14,203,0.42364532,0.02955665,0.596059113,2,0.582508076
14507,38,22418,10,7,0,0,0,17,4,5,8,0,0,17,nowin,push,push,push,10,0,17,202,0.361386139,0.03960396,0.564356436,0,0.010597953
14508,38,22419,11,10,0,0,0,21,8,10,0,0,0,18,win,win,plwin,beat,25,0,21,202,0.361386139,0.03960396,0.564356436,0,0.010597953
14509,47,22419,4,9,0,10,0,23,8,10,0,0,0,18,nowin,loss,bust,plbust,0,10,13,210,0.438095238,0.057142857,0.623809524,2,0.615868808
14510,11,22419,4,5,11,0,0,20,8,10,0,0,0,18,nowin,win,plwin,beat,20,0,9,236,0.457627119,0.016949153,0.588983051,3,0.889015813
14511,18,22419,7,10,0,0,0,17,8,10,0,0,0,18,nowin,loss,beat,dlwin,0,10,17,182,0.461538462,0.043956044,0.587912088,3,0.892649374
14512,2,22419,5,10,0,10,0,25,8,10,0,0,0,18,nowin,loss,bust,plbust,0,10,15,200,0.445,0.035,0.64,2,0.633962549
14513,114,22419,10,10,0,0,0,20,8,10,0,0,0,18,nowin,win,plwin,beat,20,0,20,198,0.47979798,0.025252525,0.611111111,3,0.937232995
14514,47,22420,2,10,0,0,0,12,4,3,11,0,0,18,nowin,loss,beat,dlwin,0,10,12,210,0.438095238,0.057142857,0.623809524,2,0.615868808
14515,60,22420,2,10,0,0,0,12,4,3,11,0,0,18,nowin,loss,beat,dlwin,0,10,12,227,0.418502203,0.022026432,0.559471366,0,0.026496258
14516,70,22420,11,10,0,0,0,21,4,3,11,0,0,18,win,win,plwin,beat,25,0,21,228,0.385964912,0.039473684,0.557017544,0,0.016157125
14517,11,22420,4,2,5,10,0,21,4,3,11,0,0,18,nowin,win,plwin,beat,20,0,6,236,0.457627119,0.016949153,0.588983051,3,0.889015813
14518,89,22420,3,10,0,0,0,13,4,3,11,0,0,18,nowin,loss,beat,dlwin,0,10,13,212,0.537735849,0.047169811,0.594339623,3,0.990167191
14519,28,22420,10,10,0,0,0,20,4,3,11,0,0,18,nowin,win,plwin,beat,20,0,20,199,0.422110553,0.045226131,0.542713568,1,0.282706618
14520,67,22421,11,10,0,0,0,21,4,6,7,0,0,17,win,win,plwin,beat,25,0,21,195,0.369230769,0.041025641,0.569230769,0,0.014139427
14521,102,22421,3,4,11,0,0,18,4,6,7,0,0,17,nowin,win,plwin,beat,20,0,7,192,0.338541667,0.046875,0.5625,0,0.003306118
14522,95,22421,9,5,0,0,0,14,4,6,7,0,0,17,nowin,loss,beat,dlwin,0,10,14,218,0.412844037,0.04587156,0.559633028,0,0.024842385
14523,14,22421,10,7,0,0,0,17,4,6,7,0,0,17,nowin,push,push,push,10,0,17,202,0.391089109,0.01980198,0.628712871,2,0.577264877
14524,16,22421,2,9,5,0,0,16,4,6,7,0,0,17,nowin,loss,beat,dlwin,0,10,11,220,0.427272727,0.081818182,0.6,2,0.588660176
14525,9,22421,10,5,0,0,0,15,4,6,7,0,0,17,nowin,loss,beat,dlwin,0,10,15,194,0.37628866,0.015463918,0.541237113,0,0.009396796
14526,35,22422,4,11,6,0,0,21,5,11,1,0,0,17,nowin,win,plwin,beat,20,0,15,202,0.410891089,0.044554455,0.633663366,2,0.598681573
14527,109,22422,11,2,3,0,0,16,5,11,1,0,0,17,nowin,loss,beat,dlwin,0,10,13,221,0.461538462,0.058823529,0.597285068,3,0.901830309
14528,140,22422,3,9,0,0,0,12,5,11,1,0,0,17,nowin,loss,beat,dlwin,0,10,12,210,0.466666667,0.023809524,0.604761905,3,0.915293335
14529,25,22422,10,11,0,0,0,21,5,11,1,0,0,17,win,win,plwin,beat,25,0,21,190,0.463157895,0.063157895,0.536842105,1,0.304401563
14530,91,22422,3,10,0,0,0,13,5,11,1,0,0,17,nowin,loss,beat,dlwin,0,10,13,194,0.417525773,0.046391753,0.515463918,1,0.266616552
14531,77,22422,9,2,7,0,0,18,5,11,1,0,0,17,nowin,win,plwin,beat,20,0,11,200,0.455,0.04,0.62,3,0.916252116
14532,50,22423,6,9,0,10,0,25,10,10,0,0,0,20,nowin,loss,bust,plbust,0,10,15,202,0.405940594,0.04950495,0.54950495,0,0.020296079
14533,44,22423,4,10,0,10,0,24,10,10,0,0,0,20,nowin,loss,bust,plbust,0,10,14,219,0.433789954,0.050228311,0.534246575,1,0.285551035
14534,77,22423,6,10,0,2,0,18,10,10,0,0,0,20,nowin,loss,beat,dlwin,0,10,16,200,0.455,0.04,0.62,3,0.916252116
14535,140,22423,6,4,7,0,0,17,10,10,0,0,0,20,nowin,loss,beat,dlwin,0,10,10,210,0.466666667,0.023809524,0.604761905,3,0.915293335
14536,146,22423,10,10,0,0,0,20,10,10,0,0,0,20,nowin,push,push,push,10,0,20,221,0.43438914,0.040723982,0.542986425,1,0.290190091
14537,25,22423,4,10,0,4,0,18,10,10,0,0,0,20,nowin,loss,beat,dlwin,0,10,14,190,0.463157895,0.063157895,0.536842105,1,0.304401563
14538,104,22424,2,6,8,0,0,16,3,9,1,10,0,23,nowin,win,dlbust,bust,20,0,8,209,0.363636364,0.052631579,0.593301435,0,0.018359419
14539,150,22424,11,6,4,0,0,21,3,9,1,10,0,23,nowin,win,dlbust,bust,20,0,17,192,0.401041667,0.036458333,0.567708333,0,0.023287458
14540,48,22424,4,4,2,5,0,15,3,9,1,10,0,23,nowin,win,dlbust,bust,20,0,8,203,0.413793103,0.019704433,0.600985222,2,0.577280801
14541,135,22424,8,7,0,0,0,15,3,9,1,10,0,23,nowin,win,dlbust,bust,20,0,15,179,0.391061453,0.067039106,0.586592179,0,0.024924662
14542,4,22424,5,5,10,0,0,20,3,9,1,10,0,23,nowin,win,dlbust,bust,20,0,10,217,0.460829493,0.036866359,0.562211982,1,0.315432839
14543,49,22424,9,2,4,0,0,15,3,9,1,10,0,23,nowin,win,dlbust,bust,20,0,11,207,0.396135266,0.053140097,0.594202899,0,0.028306925
14544,58,22425,2,10,0,9,0,21,11,8,0,0,0,19,nowin,win,plwin,beat,20,0,12,195,0.430769231,0.041025641,0.584615385,2,0.580497586
14545,149,22425,10,11,0,0,0,21,11,8,0,0,0,19,win,win,plwin,beat,25,0,21,225,0.457777778,0.057777778,0.648888889,2,0.651965595
14546,52,22425,10,10,0,0,0,20,11,8,0,0,0,19,nowin,win,plwin,beat,20,0,20,217,0.414746544,0.02764977,0.599078341,2,0.576736024
14547,17,22425,3,2,10,8,0,23,11,8,0,0,0,19,nowin,loss,bust,plbust,0,10,5,171,0.444444444,0.070175439,0.555555556,1,0.302364894
14548,35,22425,5,7,0,10,0,22,11,8,0,0,0,19,nowin,loss,bust,plbust,0,10,12,202,0.410891089,0.044554455,0.633663366,2,0.598681573
14549,144,22425,2,4,11,0,0,17,11,8,0,0,0,19,nowin,loss,beat,dlwin,0,10,6,202,0.386138614,0.054455446,0.564356436,0,0.018006244
14550,117,22426,2,5,8,9,0,24,10,10,0,0,0,20,nowin,loss,bust,plbust,0,10,7,173,0.410404624,0.069364162,0.606936416,2,0.578610282
14551,28,22426,10,3,0,10,0,23,10,10,0,0,0,20,nowin,loss,bust,plbust,0,10,13,199,0.422110553,0.045226131,0.542713568,1,0.282706618
14552,99,22426,10,10,0,0,0,20,10,10,0,0,0,20,nowin,push,push,push,10,0,20,207,0.47826087,0.062801932,0.637681159,3,0.961418446
14553,150,22426,10,2,0,10,0,22,10,10,0,0,0,20,nowin,loss,bust,plbust,0,10,12,192,0.401041667,0.036458333,0.567708333,0,0.023287458
14554,90,22426,10,4,0,10,0,24,10,10,0,0,0,20,nowin,loss,bust,plbust,0,10,14,201,0.447761194,0.049751244,0.60199005,3,0.889945023
14555,66,22426,9,10,0,0,0,19,10,10,0,0,0,20,nowin,loss,beat,dlwin,0,10,19,217,0.456221198,0.064516129,0.626728111,3,0.924304367
14556,40,22427,6,4,10,0,0,20,2,5,10,0,0,17,nowin,win,plwin,beat,20,0,10,196,0.367346939,0.030612245,0.617346939,0,0.025358183
14557,50,22427,2,10,0,4,0,16,2,5,10,0,0,17,nowin,loss,beat,dlwin,0,10,12,202,0.405940594,0.04950495,0.54950495,0,0.020296079
14558,14,22427,5,7,0,10,0,22,2,5,10,0,0,17,nowin,loss,bust,plbust,0,10,12,202,0.391089109,0.01980198,0.628712871,2,0.577264877
14559,44,22427,6,2,10,0,0,18,2,5,10,0,0,17,nowin,win,plwin,beat,20,0,8,219,0.433789954,0.050228311,0.534246575,1,0.285551035
14560,93,22427,5,7,0,10,0,22,2,5,10,0,0,17,nowin,loss,bust,plbust,0,10,12,175,0.485714286,0.051428571,0.548571429,1,0.323648091
14561,88,22427,2,10,0,7,0,19,2,5,10,0,0,17,nowin,win,plwin,beat,20,0,12,206,0.466019417,0.033980583,0.54368932,1,0.309467903
14562,14,22428,10,9,0,0,0,19,9,8,0,0,0,17,nowin,win,plwin,beat,20,0,19,202,0.391089109,0.01980198,0.628712871,2,0.577264877
14563,118,22428,7,10,0,0,0,17,9,8,0,0,0,17,nowin,push,push,push,10,0,17,216,0.393518519,0.037037037,0.555555556,0,0.018059873
14564,118,22428,6,9,0,10,0,25,9,8,0,0,0,17,nowin,loss,bust,plbust,0,10,15,216,0.393518519,0.037037037,0.555555556,0,0.018059873
14565,61,22428,9,10,0,0,0,19,9,8,0,0,0,17,nowin,win,plwin,beat,20,0,19,194,0.427835052,0.077319588,0.603092784,2,0.591437139
14566,140,22428,10,9,0,0,0,19,9,8,0,0,0,17,nowin,win,plwin,beat,20,0,19,210,0.466666667,0.023809524,0.604761905,3,0.915293335
14567,75,22428,6,4,10,0,0,20,9,8,0,0,0,17,nowin,win,plwin,beat,20,0,10,191,0.418848168,0.052356021,0.570680628,0,0.029344702
14568,130,22429,10,8,0,0,0,18,10,5,7,0,0,22,nowin,win,dlbust,bust,20,0,18,219,0.410958904,0.03652968,0.566210046,0,0.025888739
14569,85,22429,10,5,0,10,0,25,10,5,7,0,0,22,nowin,loss,bust,plbust,0,10,15,195,0.41025641,0.066666667,0.594871795,0,0.03269711
14570,78,22429,6,5,10,0,0,21,10,5,7,0,0,22,nowin,win,dlbust,bust,20,0,11,201,0.517412935,0.034825871,0.587064677,3,0.95871112
14571,140,22429,7,10,0,0,0,17,10,5,7,0,0,22,nowin,win,dlbust,bust,20,0,17,210,0.466666667,0.023809524,0.604761905,3,0.915293335
14572,19,22429,10,2,0,10,0,22,10,5,7,0,0,22,nowin,loss,bust,plbust,0,10,12,237,0.41350211,0.054852321,0.628691983,2,0.597373826
14573,137,22429,11,8,0,0,0,19,10,5,7,0,0,22,nowin,win,dlbust,bust,20,0,19,194,0.417525773,0.046391753,0.536082474,1,0.276714602
14574,15,22430,4,2,8,5,0,19,7,9,10,0,0,26,nowin,win,dlbust,bust,20,0,6,212,0.410377358,0.051886792,0.561320755,0,0.024517408
14575,58,22430,10,11,0,0,0,21,7,9,10,0,0,26,win,win,dlbust,bust,25,0,21,195,0.430769231,0.041025641,0.584615385,2,0.580497586
14576,74,22430,3,10,0,1,10,24,7,9,10,0,0,26,nowin,loss,bust,plbust,0,10,13,209,0.411483254,0.04784689,0.531100478,0,0.017448125
14577,1,22430,9,9,0,0,0,18,7,9,10,0,0,26,nowin,win,dlbust,bust,20,0,18,197,0.406091371,0.025380711,0.649746193,2,0.606186955
14578,92,22430,5,10,0,5,0,20,7,9,10,0,0,26,nowin,win,dlbust,bust,20,0,15,186,0.446236559,0.059139785,0.564516129,1,0.307826125
14579,86,22430,10,10,0,0,0,20,7,9,10,0,0,26,nowin,win,dlbust,bust,20,0,20,196,0.454081633,0.040816327,0.591836735,3,0.887566443
14580,69,22431,10,6,0,10,0,26,9,4,4,0,0,17,nowin,loss,bust,plbust,0,10,16,194,0.365979381,0.030927835,0.515463918,0,0
14581,127,22431,10,10,0,0,0,20,9,4,4,0,0,17,nowin,win,plwin,beat,20,0,20,201,0.402985075,0.029850746,0.60199005,0,0.032263937
14582,15,22431,3,2,4,9,0,18,9,4,4,0,0,17,nowin,win,plwin,beat,20,0,5,212,0.410377358,0.051886792,0.561320755,0,0.024517408
14583,118,22431,5,2,10,0,0,17,9,4,4,0,0,17,nowin,push,push,push,10,0,7,216,0.393518519,0.037037037,0.555555556,0,0.018059873
14584,90,22431,9,9,0,0,0,18,9,4,4,0,0,17,nowin,win,plwin,beat,20,0,18,201,0.447761194,0.049751244,0.60199005,3,0.889945023
14585,126,22431,3,6,7,4,0,20,9,4,4,0,0,17,nowin,win,plwin,beat,20,0,9,188,0.457446809,0.074468085,0.60106383,3,0.900633203
14586,90,22432,7,10,0,0,0,17,3,10,6,0,0,19,nowin,loss,beat,dlwin,0,10,17,201,0.447761194,0.049751244,0.60199005,3,0.889945023
14587,137,22432,3,8,1,8,0,20,3,10,6,0,0,19,nowin,win,plwin,beat,20,0,11,194,0.417525773,0.046391753,0.536082474,1,0.276714602
14588,5,22432,5,10,0,0,0,15,3,10,6,0,0,19,nowin,loss,beat,dlwin,0,10,15,203,0.42364532,0.02955665,0.596059113,2,0.582508076
14589,144,22432,10,6,0,0,0,16,3,10,6,0,0,19,nowin,loss,beat,dlwin,0,10,16,202,0.386138614,0.054455446,0.564356436,0,0.018006244
14590,17,22432,9,10,0,0,0,19,3,10,6,0,0,19,nowin,push,push,push,10,0,19,171,0.444444444,0.070175439,0.555555556,1,0.302364894
14591,18,22432,8,9,0,0,0,17,3,10,6,0,0,19,nowin,loss,beat,dlwin,0,10,17,182,0.461538462,0.043956044,0.587912088,3,0.892649374
14592,52,22433,10,6,0,8,0,24,8,6,10,0,0,24,nowin,loss,bust,plbust,0,10,16,217,0.414746544,0.02764977,0.599078341,2,0.576736024
14593,108,22433,11,9,0,0,0,20,8,6,10,0,0,24,nowin,win,dlbust,bust,20,0,20,193,0.435233161,0.056994819,0.559585492,1,0.298824795
14594,109,22433,5,9,0,7,0,21,8,6,10,0,0,24,nowin,win,dlbust,bust,20,0,14,221,0.461538462,0.058823529,0.597285068,3,0.901830309
14595,19,22433,7,3,4,2,10,26,8,6,10,0,0,24,nowin,loss,bust,plbust,0,10,10,237,0.41350211,0.054852321,0.628691983,2,0.597373826
14596,5,22433,8,11,0,0,0,19,8,6,10,0,0,24,nowin,win,dlbust,bust,20,0,19,203,0.42364532,0.02955665,0.596059113,2,0.582508076
14597,45,22433,10,10,0,0,0,20,8,6,10,0,0,24,nowin,win,dlbust,bust,20,0,20,196,0.428571429,0.051020408,0.612244898,2,0.598821767
14598,51,22434,8,10,0,0,0,18,10,6,6,0,0,22,nowin,win,dlbust,bust,20,0,18,189,0.529100529,0.068783069,0.608465608,3,0.993665715
14599,114,22434,11,9,0,0,0,20,10,6,6,0,0,22,nowin,win,dlbust,bust,20,0,20,198,0.47979798,0.025252525,0.611111111,3,0.937232995
14600,87,22434,6,1,10,0,0,17,10,6,6,0,0,22,nowin,win,dlbust,bust,20,0,7,202,0.405940594,0.054455446,0.628712871,2,0.590599801
14601,53,22434,6,7,0,10,0,23,10,6,6,0,0,22,nowin,loss,bust,plbust,0,10,13,250,0.372,0.064,0.564,0,0.013687345
14602,67,22434,5,9,0,10,0,24,10,6,6,0,0,22,nowin,loss,bust,plbust,0,10,14,195,0.369230769,0.041025641,0.569230769,0,0.014139427
14603,10,22434,10,5,0,5,0,20,10,6,6,0,0,22,nowin,win,dlbust,bust,20,0,15,191,0.413612565,0.057591623,0.596858639,2,0.574087175
14604,23,22435,3,4,6,0,0,13,2,10,10,0,0,22,nowin,win,dlbust,bust,20,0,7,208,0.427884615,0.0625,0.552884615,1,0.29114424
14605,90,22435,6,10,0,0,0,16,2,10,10,0,0,22,nowin,win,dlbust,bust,20,0,16,201,0.447761194,0.049751244,0.60199005,3,0.889945023
14606,74,22435,10,6,0,0,0,16,2,10,10,0,0,22,nowin,win,dlbust,bust,20,0,16,209,0.411483254,0.04784689,0.531100478,0,0.017448125
14607,33,22435,4,10,0,0,0,14,2,10,10,0,0,22,nowin,win,dlbust,bust,20,0,14,192,0.4375,0.057291667,0.625,2,0.616208916
14608,87,22435,4,10,0,0,0,14,2,10,10,0,0,22,nowin,win,dlbust,bust,20,0,14,202,0.405940594,0.054455446,0.628712871,2,0.590599801
14609,146,22435,6,3,10,0,0,19,2,10,10,0,0,22,nowin,win,dlbust,bust,20,0,9,221,0.43438914,0.040723982,0.542986425,1,0.290190091
14610,17,22436,2,9,8,0,0,19,8,10,0,0,0,18,nowin,win,plwin,beat,20,0,11,171,0.444444444,0.070175439,0.555555556,1,0.302364894
14611,21,22436,10,10,0,0,0,20,8,10,0,0,0,18,nowin,win,plwin,beat,20,0,20,214,0.359813084,0.042056075,0.626168224,0,0.025263474
14612,114,22436,8,5,0,8,0,21,8,10,0,0,0,18,nowin,win,plwin,beat,20,0,13,198,0.47979798,0.025252525,0.611111111,3,0.937232995
14613,132,22436,10,6,0,10,0,26,8,10,0,0,0,18,nowin,loss,bust,plbust,0,10,16,194,0.412371134,0.036082474,0.649484536,2,0.611633238
14614,99,22436,4,5,3,10,0,22,8,10,0,0,0,18,nowin,loss,bust,plbust,0,10,9,207,0.47826087,0.062801932,0.637681159,3,0.961418446
14615,19,22436,10,11,0,0,0,21,8,10,0,0,0,18,win,win,plwin,beat,25,0,21,237,0.41350211,0.054852321,0.628691983,2,0.597373826
14616,10,22437,11,2,5,0,0,18,10,6,4,0,0,20,nowin,loss,beat,dlwin,0,10,13,191,0.413612565,0.057591623,0.596858639,2,0.574087175
14617,22,22437,10,6,0,7,0,23,10,6,4,0,0,20,nowin,loss,bust,plbust,0,10,16,187,0.481283422,0.042780749,0.577540107,3,0.906128176
14618,104,22437,10,10,0,0,0,20,10,6,4,0,0,20,nowin,push,push,push,10,0,20,209,0.363636364,0.052631579,0.593301435,0,0.018359419
14619,135,22437,8,7,0,1,10,26,10,6,4,0,0,20,nowin,loss,bust,plbust,0,10,15,179,0.391061453,0.067039106,0.586592179,0,0.024924662
14620,96,22437,10,6,0,6,0,22,10,6,4,0,0,20,nowin,loss,bust,plbust,0,10,16,190,0.468421053,0.057894737,0.584210526,3,0.897263354
14621,38,22437,6,10,0,5,0,21,10,6,4,0,0,20,nowin,win,plwin,beat,20,0,16,202,0.361386139,0.03960396,0.564356436,0,0.010597953
14622,25,22438,10,11,0,0,0,21,4,7,8,0,0,19,win,win,plwin,beat,25,0,21,190,0.463157895,0.063157895,0.536842105,1,0.304401563
14623,35,22438,10,9,0,0,0,19,4,7,8,0,0,19,nowin,push,push,push,10,0,19,202,0.410891089,0.044554455,0.633663366,2,0.598681573
14624,85,22438,9,11,0,0,0,20,4,7,8,0,0,19,nowin,win,plwin,beat,20,0,20,195,0.41025641,0.066666667,0.594871795,0,0.03269711
14625,18,22438,6,1,7,0,0,14,4,7,8,0,0,19,nowin,loss,beat,dlwin,0,10,7,182,0.461538462,0.043956044,0.587912088,3,0.892649374
14626,87,22438,10,10,0,0,0,20,4,7,8,0,0,19,nowin,win,plwin,beat,20,0,20,202,0.405940594,0.054455446,0.628712871,2,0.590599801
14627,15,22438,4,2,4,8,0,18,4,7,8,0,0,19,nowin,loss,beat,dlwin,0,10,6,212,0.410377358,0.051886792,0.561320755,0,0.024517408
14628,56,22439,4,10,0,3,0,17,10,7,0,0,0,17,nowin,push,push,push,10,0,14,175,0.4,0.057142857,0.582857143,0,0.026685297
14629,111,22439,4,10,0,1,2,17,10,7,0,0,0,17,nowin,push,push,push,10,0,14,180,0.433333333,0.055555556,0.611111111,2,0.602264492
14630,120,22439,8,10,0,0,0,18,10,7,0,0,0,17,nowin,win,plwin,beat,20,0,18,202,0.440594059,0.034653465,0.618811881,2,0.614441029
14631,117,22439,3,7,10,0,0,20,10,7,0,0,0,17,nowin,win,plwin,beat,20,0,10,173,0.410404624,0.069364162,0.606936416,2,0.578610282
14632,71,22439,3,7,10,0,0,20,10,7,0,0,0,17,nowin,win,plwin,beat,20,0,10,193,0.352331606,0.046632124,0.585492228,0,0.013063661
14633,75,22439,7,5,0,5,0,17,10,7,0,0,0,17,nowin,push,push,push,10,0,12,191,0.418848168,0.052356021,0.570680628,0,0.029344702
14634,4,22440,10,4,0,5,0,19,10,3,10,0,0,23,nowin,win,dlbust,bust,20,0,14,217,0.460829493,0.036866359,0.562211982,1,0.315432839
14635,45,22440,4,9,0,10,0,23,10,3,10,0,0,23,nowin,loss,bust,plbust,0,10,13,196,0.428571429,0.051020408,0.612244898,2,0.598821767
14636,9,22440,1,3,10,2,3,19,10,3,10,0,0,23,nowin,win,dlbust,bust,20,0,4,194,0.37628866,0.015463918,0.541237113,0,0.009396796
14637,149,22440,9,6,0,6,0,21,10,3,10,0,0,23,nowin,win,dlbust,bust,20,0,15,225,0.457777778,0.057777778,0.648888889,2,0.651965595
14638,71,22440,2,8,10,0,0,20,10,3,10,0,0,23,nowin,win,dlbust,bust,20,0,10,193,0.352331606,0.046632124,0.585492228,0,0.013063661
14639,2,22440,3,10,0,10,0,23,10,3,10,0,0,23,nowin,loss,bust,plbust,0,10,13,200,0.445,0.035,0.64,2,0.633962549
14640,54,22441,8,4,0,0,0,12,6,10,1,0,0,17,nowin,loss,beat,dlwin,0,10,12,185,0.437837838,0.032432432,0.556756757,1,0.29899854
14641,101,22441,11,5,4,0,0,20,6,10,1,0,0,17,nowin,win,plwin,beat,20,0,16,205,0.424390244,0.068292683,0.63902439,2,0.614740646
14642,26,22441,3,10,0,0,0,13,6,10,1,0,0,17,nowin,loss,beat,dlwin,0,10,13,203,0.463054187,0.0591133,0.541871921,1,0.306802864
14643,120,22441,8,10,0,0,0,18,6,10,1,0,0,17,nowin,win,plwin,beat,20,0,18,202,0.440594059,0.034653465,0.618811881,2,0.614441029
14644,65,22441,2,6,7,0,0,15,6,10,1,0,0,17,nowin,loss,beat,dlwin,0,10,8,203,0.492610837,0.054187192,0.571428571,3,0.913702814
14645,29,22441,10,2,0,0,0,12,6,10,1,0,0,17,nowin,loss,beat,dlwin,0,10,12,189,0.44973545,0.058201058,0.544973545,1,0.300349439
14646,98,22442,8,10,0,0,0,18,8,11,0,0,0,19,nowin,loss,beat,dlwin,0,10,18,220,0.422727273,0.054545455,0.55,1,0.28664435
14647,149,22442,8,6,0,7,0,21,8,11,0,0,0,19,nowin,win,plwin,beat,20,0,14,225,0.457777778,0.057777778,0.648888889,2,0.651965595
14648,98,22442,4,4,10,0,0,18,8,11,0,0,0,19,nowin,loss,beat,dlwin,0,10,8,220,0.422727273,0.054545455,0.55,1,0.28664435
14649,119,22442,6,8,0,10,0,24,8,11,0,0,0,19,nowin,loss,bust,plbust,0,10,14,190,0.405263158,0.068421053,0.515789474,0,0.011837158
14650,44,22442,9,5,0,10,0,24,8,11,0,0,0,19,nowin,loss,bust,plbust,0,10,14,219,0.433789954,0.050228311,0.534246575,1,0.285551035
14651,105,22442,11,4,2,0,0,17,8,11,0,0,0,19,nowin,loss,beat,dlwin,0,10,15,198,0.414141414,0.070707071,0.590909091,0,0.032889494
14652,75,22443,4,6,10,0,0,20,10,6,6,0,0,22,nowin,win,dlbust,bust,20,0,10,191,0.418848168,0.052356021,0.570680628,0,0.029344702
14653,43,22443,10,5,0,10,0,25,10,6,6,0,0,22,nowin,loss,bust,plbust,0,10,15,192,0.40625,0.041666667,0.609375,2,0.576671372
14654,1,22443,2,2,9,4,0,17,10,6,6,0,0,22,nowin,win,dlbust,bust,20,0,4,197,0.406091371,0.025380711,0.649746193,2,0.606186955
14655,68,22443,3,3,9,10,0,25,10,6,6,0,0,22,nowin,loss,bust,plbust,0,10,6,205,0.434146341,0.029268293,0.6,2,0.59483189
14656,149,22443,5,10,0,8,0,23,10,6,6,0,0,22,nowin,loss,bust,plbust,0,10,15,225,0.457777778,0.057777778,0.648888889,2,0.651965595
14657,133,22443,10,5,0,10,0,25,10,6,6,0,0,22,nowin,loss,bust,plbust,0,10,15,201,0.47761194,0.064676617,0.611940299,3,0.935428111
14658,129,22444,3,7,3,1,9,23,1,2,10,2,8,23,nowin,loss,bust,plbust,0,10,10,201,0.422885572,0.064676617,0.55721393,0,0.027255383
14659,44,22444,8,7,0,8,0,23,1,2,10,2,8,23,nowin,loss,bust,plbust,0,10,15,219,0.433789954,0.050228311,0.534246575,1,0.285551035
14660,13,22444,8,3,7,0,0,18,1,2,10,2,8,23,nowin,win,dlbust,bust,20,0,11,206,0.417475728,0.063106796,0.621359223,2,0.59555479
14661,65,22444,3,5,10,0,0,18,1,2,10,2,8,23,nowin,win,dlbust,bust,20,0,8,203,0.492610837,0.054187192,0.571428571,3,0.913702814
14662,121,22444,5,2,7,6,0,20,1,2,10,2,8,23,nowin,win,dlbust,bust,20,0,7,195,0.456410256,0.025641026,0.512820513,1,0.288597791
14663,108,22444,11,3,6,0,0,20,1,2,10,2,8,23,nowin,win,dlbust,bust,20,0,14,193,0.435233161,0.056994819,0.559585492,1,0.298824795
14664,82,22445,10,2,0,10,0,22,9,11,0,0,0,20,nowin,loss,bust,plbust,0,10,12,225,0.408888889,0.075555556,0.577777778,0,0.028101874
14665,93,22445,7,8,0,9,0,24,9,11,0,0,0,20,nowin,loss,bust,plbust,0,10,15,175,0.485714286,0.051428571,0.548571429,1,0.323648091
14666,14,22445,10,10,0,0,0,20,9,11,0,0,0,20,nowin,push,push,push,10,0,20,202,0.391089109,0.01980198,0.628712871,2,0.577264877
14667,120,22445,4,8,0,6,0,18,9,11,0,0,0,20,nowin,loss,beat,dlwin,0,10,12,202,0.440594059,0.034653465,0.618811881,2,0.614441029
14668,150,22445,10,11,0,0,0,21,9,11,0,0,0,20,win,win,plwin,beat,25,0,21,192,0.401041667,0.036458333,0.567708333,0,0.023287458
14669,138,22445,9,5,0,10,0,24,9,11,0,0,0,20,nowin,loss,bust,plbust,0,10,14,190,0.442105263,0.047368421,0.610526316,2,0.609711065
14670,112,22446,6,10,0,0,0,16,6,7,10,0,0,23,nowin,win,dlbust,bust,20,0,16,203,0.448275862,0.054187192,0.600985222,3,0.889576933
14671,66,22446,2,6,10,0,0,18,6,7,10,0,0,23,nowin,win,dlbust,bust,20,0,8,217,0.456221198,0.064516129,0.626728111,3,0.924304367
14672,85,22446,11,3,7,0,0,21,6,7,10,0,0,23,nowin,win,dlbust,bust,20,0,14,195,0.41025641,0.066666667,0.594871795,0,0.03269711
14673,126,22446,8,7,0,0,0,15,6,7,10,0,0,23,nowin,win,dlbust,bust,20,0,15,188,0.457446809,0.074468085,0.60106383,3,0.900633203
14674,47,22446,10,10,0,0,0,20,6,7,10,0,0,23,nowin,win,dlbust,bust,20,0,20,210,0.438095238,0.057142857,0.623809524,2,0.615868808
14675,3,22446,10,10,0,0,0,20,6,7,10,0,0,23,nowin,win,dlbust,bust,20,0,20,190,0.431578947,0.026315789,0.542105263,1,0.288076384
14676,30,22447,5,5,4,0,0,14,4,9,5,0,0,18,nowin,loss,beat,dlwin,0,10,10,206,0.393203883,0.033980583,0.601941748,0,0.029324648
14677,16,22447,8,2,10,0,0,20,4,9,5,0,0,18,nowin,win,plwin,beat,20,0,10,220,0.427272727,0.081818182,0.6,2,0.588660176
14678,133,22447,4,10,0,0,0,14,4,9,5,0,0,18,nowin,loss,beat,dlwin,0,10,14,201,0.47761194,0.064676617,0.611940299,3,0.935428111
14679,36,22447,5,4,7,0,0,16,4,9,5,0,0,18,nowin,loss,beat,dlwin,0,10,9,229,0.445414847,0.056768559,0.655021834,2,0.645370571
14680,96,22447,8,11,0,0,0,19,4,9,5,0,0,18,nowin,win,plwin,beat,20,0,19,190,0.468421053,0.057894737,0.584210526,3,0.897263354
14681,130,22447,7,10,0,0,0,17,4,9,5,0,0,18,nowin,loss,beat,dlwin,0,10,17,219,0.410958904,0.03652968,0.566210046,0,0.025888739
14682,37,22448,10,10,0,0,0,20,9,11,0,0,0,20,nowin,push,push,push,10,0,20,208,0.394230769,0.038461538,0.581730769,0,0.024682772
14683,61,22448,10,9,0,0,0,19,9,11,0,0,0,20,nowin,loss,beat,dlwin,0,10,19,194,0.427835052,0.077319588,0.603092784,2,0.591437139
14684,42,22448,6,10,0,3,0,19,9,11,0,0,0,20,nowin,loss,beat,dlwin,0,10,16,212,0.443396226,0.051886792,0.570754717,1,0.309181312
14685,83,22448,10,11,0,0,0,21,9,11,0,0,0,20,win,win,plwin,beat,25,0,21,193,0.424870466,0.051813472,0.678756477,2,0.644360335
14686,117,22448,3,9,0,10,0,22,9,11,0,0,0,20,nowin,loss,bust,plbust,0,10,12,173,0.410404624,0.069364162,0.606936416,2,0.578610282
14687,32,22448,10,3,0,9,0,22,9,11,0,0,0,20,nowin,loss,bust,plbust,0,10,13,189,0.391534392,0.037037037,0.53968254,0,0.013579086
14688,140,22449,2,7,10,0,0,19,10,2,4,4,0,20,nowin,loss,beat,dlwin,0,10,9,210,0.466666667,0.023809524,0.604761905,3,0.915293335
14689,11,22449,10,10,0,0,0,20,10,2,4,4,0,20,nowin,push,push,push,10,0,20,236,0.457627119,0.016949153,0.588983051,3,0.889015813
14690,23,22449,6,10,0,9,0,25,10,2,4,4,0,20,nowin,loss,bust,plbust,0,10,16,208,0.427884615,0.0625,0.552884615,1,0.29114424
14691,62,22449,5,7,0,10,0,22,10,2,4,4,0,20,nowin,loss,bust,plbust,0,10,12,178,0.370786517,0.028089888,0.54494382,0,0.008657722
14692,136,22449,10,7,0,0,0,17,10,2,4,4,0,20,nowin,loss,beat,dlwin,0,10,17,194,0.396907216,0.025773196,0.597938144,0,0.029452644
14693,141,22449,8,3,5,10,0,26,10,2,4,4,0,20,nowin,loss,bust,plbust,0,10,11,202,0.420792079,0.074257426,0.564356436,0,0.028377851
14694,51,22450,4,10,0,2,7,23,11,1,6,0,0,18,nowin,loss,bust,plbust,0,10,14,189,0.529100529,0.068783069,0.608465608,3,0.993665715
14695,113,22450,10,10,0,0,0,20,11,1,6,0,0,18,nowin,win,plwin,beat,20,0,20,199,0.407035176,0.055276382,0.668341709,2,0.620695264
14696,20,22450,5,6,3,10,0,24,11,1,6,0,0,18,nowin,loss,bust,plbust,0,10,11,186,0.456989247,0.037634409,0.537634409,1,0.301097108
14697,115,22450,3,6,10,0,0,19,11,1,6,0,0,18,nowin,win,plwin,beat,20,0,9,194,0.427835052,0.041237113,0.592783505,2,0.583863602
14698,105,22450,7,9,0,9,0,25,11,1,6,0,0,18,nowin,loss,bust,plbust,0,10,16,198,0.414141414,0.070707071,0.590909091,0,0.032889494
14699,144,22450,10,6,0,10,0,26,11,1,6,0,0,18,nowin,loss,bust,plbust,0,10,16,202,0.386138614,0.054455446,0.564356436,0,0.018006244
14700,76,22451,10,7,0,0,0,17,10,9,0,0,0,19,nowin,loss,beat,dlwin,0,10,17,189,0.534391534,0.079365079,0.608465608,3,1
14701,39,22451,7,4,10,0,0,21,10,9,0,0,0,19,nowin,win,plwin,beat,20,0,11,191,0.429319372,0.062827225,0.57591623,0,0.033760763
14702,114,22451,9,4,0,7,0,20,10,9,0,0,0,19,nowin,win,plwin,beat,20,0,13,198,0.47979798,0.025252525,0.611111111,3,0.937232995
14703,53,22451,10,4,0,2,9,25,10,9,0,0,0,19,nowin,loss,bust,plbust,0,10,14,250,0.372,0.064,0.564,0,0.013687345
14704,122,22451,8,10,0,0,0,18,10,9,0,0,0,19,nowin,loss,beat,dlwin,0,10,18,210,0.347619048,0.052380952,0.59047619,0,0.012873677
14705,76,22451,9,4,0,1,10,24,10,9,0,0,0,19,nowin,loss,bust,plbust,0,10,13,189,0.534391534,0.079365079,0.608465608,3,1
14706,67,22452,2,4,11,0,0,17,9,10,0,0,0,19,nowin,loss,beat,dlwin,0,10,6,195,0.369230769,0.041025641,0.569230769,0,0.014139427
14707,28,22452,10,4,0,10,0,24,9,10,0,0,0,19,nowin,loss,bust,plbust,0,10,14,199,0.422110553,0.045226131,0.542713568,1,0.282706618
14708,1,22452,10,10,0,0,0,20,9,10,0,0,0,19,nowin,win,plwin,beat,20,0,20,197,0.406091371,0.025380711,0.649746193,2,0.606186955
14709,1,22452,11,9,0,0,0,20,9,10,0,0,0,19,nowin,win,plwin,beat,20,0,20,197,0.406091371,0.025380711,0.649746193,2,0.606186955
14710,26,22452,10,9,0,0,0,19,9,10,0,0,0,19,nowin,push,push,push,10,0,19,203,0.463054187,0.0591133,0.541871921,1,0.306802864
14711,38,22452,10,9,0,0,0,19,9,10,0,0,0,19,nowin,push,push,push,10,0,19,202,0.361386139,0.03960396,0.564356436,0,0.010597953
14712,73,22453,10,2,0,10,0,22,11,10,0,0,0,21,nowin,loss,bust,plbust,0,10,12,181,0.375690608,0.011049724,0.596685083,0,0.022795773
14713,66,22453,6,10,0,10,0,26,11,10,0,0,0,21,nowin,loss,bust,plbust,0,10,16,217,0.456221198,0.064516129,0.626728111,3,0.924304367
14714,11,22453,11,10,0,0,0,21,11,10,0,0,0,21,win,push,push,push,10,0,21,236,0.457627119,0.016949153,0.588983051,3,0.889015813
14715,83,22453,9,10,0,0,0,19,11,10,0,0,0,21,nowin,loss,beat,dlwin,0,10,19,193,0.424870466,0.051813472,0.678756477,2,0.644360335
14716,113,22453,2,10,0,9,0,21,11,10,0,0,0,21,nowin,push,push,push,10,0,12,199,0.407035176,0.055276382,0.668341709,2,0.620695264
14717,59,22453,1,3,10,6,0,20,11,10,0,0,0,21,nowin,loss,beat,dlwin,0,10,4,228,0.429824561,0.048245614,0.543859649,1,0.287885446
14718,112,22454,10,10,0,0,0,20,6,10,7,0,0,23,nowin,win,dlbust,bust,20,0,20,203,0.448275862,0.054187192,0.600985222,3,0.889576933
14719,91,22454,3,7,10,0,0,20,6,10,7,0,0,23,nowin,win,dlbust,bust,20,0,10,194,0.417525773,0.046391753,0.515463918,1,0.266616552
14720,86,22454,7,6,0,0,0,13,6,10,7,0,0,23,nowin,win,dlbust,bust,20,0,13,196,0.454081633,0.040816327,0.591836735,3,0.887566443
14721,23,22454,7,10,0,0,0,17,6,10,7,0,0,23,nowin,win,dlbust,bust,20,0,17,208,0.427884615,0.0625,0.552884615,1,0.29114424
14722,86,22454,10,2,0,0,0,12,6,10,7,0,0,23,nowin,win,dlbust,bust,20,0,12,196,0.454081633,0.040816327,0.591836735,3,0.887566443
14723,99,22454,10,9,0,0,0,19,6,10,7,0,0,23,nowin,win,dlbust,bust,20,0,19,207,0.47826087,0.062801932,0.637681159,3,0.961418446
14724,6,22455,4,2,10,6,0,22,10,2,10,0,0,22,nowin,loss,bust,plbust,0,10,6,191,0.439790576,0.047120419,0.581151832,1,0.31211505
14725,65,22455,9,5,0,3,0,17,10,2,10,0,0,22,nowin,win,dlbust,bust,20,0,14,203,0.492610837,0.054187192,0.571428571,3,0.913702814
14726,52,22455,10,9,0,0,0,19,10,2,10,0,0,22,nowin,win,dlbust,bust,20,0,19,217,0.414746544,0.02764977,0.599078341,2,0.576736024
14727,34,22455,10,11,0,0,0,21,10,2,10,0,0,22,win,win,dlbust,bust,25,0,21,202,0.5,0.079207921,0.618811881,3,0.968961434
14728,135,22455,10,11,0,0,0,21,10,2,10,0,0,22,win,win,dlbust,bust,25,0,21,179,0.391061453,0.067039106,0.586592179,0,0.024924662
14729,81,22455,10,5,0,10,0,25,10,2,10,0,0,22,nowin,loss,bust,plbust,0,10,15,182,0.395604396,0.043956044,0.60989011,2,0.567491261
14730,108,22456,5,6,3,2,10,26,8,6,1,6,0,21,nowin,loss,bust,plbust,0,10,11,193,0.435233161,0.056994819,0.559585492,1,0.298824795
14731,40,22456,9,10,0,0,0,19,8,6,1,6,0,21,nowin,loss,beat,dlwin,0,10,19,196,0.367346939,0.030612245,0.617346939,0,0.025358183
14732,123,22456,8,5,0,10,0,23,8,6,1,6,0,21,nowin,loss,bust,plbust,0,10,13,205,0.43902439,0.034146341,0.614634146,2,0.609962544
14733,64,22456,7,8,0,3,0,18,8,6,1,6,0,21,nowin,loss,beat,dlwin,0,10,15,187,0.363636364,0.048128342,0.631016043,0,0.027594885
14734,94,22456,8,7,0,8,0,23,8,6,1,6,0,21,nowin,loss,bust,plbust,0,10,15,183,0.43715847,0.043715847,0.540983607,1,0.290866892
14735,116,22456,8,6,0,10,0,24,8,6,1,6,0,21,nowin,loss,bust,plbust,0,10,14,195,0.425641026,0.056410256,0.538461538,1,0.28273747
14736,38,22457,5,10,0,0,0,15,6,5,6,0,0,17,nowin,loss,beat,dlwin,0,10,15,202,0.361386139,0.03960396,0.564356436,0,0.010597953
14737,134,22457,4,10,0,0,0,14,6,5,6,0,0,17,nowin,loss,beat,dlwin,0,10,14,185,0.443243243,0.021621622,0.545945946,1,0.296939509
14738,128,22457,10,9,0,0,0,19,6,5,6,0,0,17,nowin,win,plwin,beat,20,0,19,227,0.356828194,0.052863436,0.577092511,0,0.012352564
14739,78,22457,7,4,7,0,0,18,6,5,6,0,0,17,nowin,win,plwin,beat,20,0,11,201,0.517412935,0.034825871,0.587064677,3,0.95871112
14740,84,22457,4,8,0,0,0,12,6,5,6,0,0,17,nowin,loss,beat,dlwin,0,10,12,195,0.379487179,0.056410256,0.569230769,0,0.017209119
14741,44,22457,10,10,0,0,0,20,6,5,6,0,0,17,nowin,win,plwin,beat,20,0,20,219,0.433789954,0.050228311,0.534246575,1,0.285551035
14742,146,22458,9,11,0,0,0,20,2,8,11,0,0,21,nowin,loss,beat,dlwin,0,10,20,221,0.43438914,0.040723982,0.542986425,1,0.290190091
14743,13,22458,6,8,0,0,0,14,2,8,11,0,0,21,nowin,loss,beat,dlwin,0,10,14,206,0.417475728,0.063106796,0.621359223,2,0.59555479
14744,60,22458,1,3,10,0,0,14,2,8,11,0,0,21,nowin,loss,beat,dlwin,0,10,4,227,0.418502203,0.022026432,0.559471366,0,0.026496258
14745,43,22458,2,4,3,9,0,18,2,8,11,0,0,21,nowin,loss,beat,dlwin,0,10,6,192,0.40625,0.041666667,0.609375,2,0.576671372
14746,68,22458,10,7,0,0,0,17,2,8,11,0,0,21,nowin,loss,beat,dlwin,0,10,17,205,0.434146341,0.029268293,0.6,2,0.59483189
14747,120,22458,3,4,3,10,0,20,2,8,11,0,0,21,nowin,loss,beat,dlwin,0,10,7,202,0.440594059,0.034653465,0.618811881,2,0.614441029
14748,92,22459,6,4,2,3,10,25,10,10,0,0,0,20,nowin,loss,bust,plbust,0,10,10,186,0.446236559,0.059139785,0.564516129,1,0.307826125
14749,46,22459,10,3,0,7,0,20,10,10,0,0,0,20,nowin,push,push,push,10,0,13,186,0.403225806,0.048387097,0.591397849,0,0.029742194
14750,94,22459,10,2,0,6,0,18,10,10,0,0,0,20,nowin,loss,beat,dlwin,0,10,12,183,0.43715847,0.043715847,0.540983607,1,0.290866892
14751,133,22459,7,2,4,6,0,19,10,10,0,0,0,20,nowin,loss,beat,dlwin,0,10,9,201,0.47761194,0.064676617,0.611940299,3,0.935428111
14752,145,22459,9,10,0,0,0,19,10,10,0,0,0,20,nowin,loss,beat,dlwin,0,10,19,188,0.441489362,0.031914894,0.622340426,2,0.617837093
14753,141,22459,10,9,0,0,0,19,10,10,0,0,0,20,nowin,loss,beat,dlwin,0,10,19,202,0.420792079,0.074257426,0.564356436,0,0.028377851
14754,25,22460,7,9,0,10,0,26,7,10,0,0,0,17,nowin,loss,bust,plbust,0,10,16,190,0.463157895,0.063157895,0.536842105,1,0.304401563
14755,6,22460,8,10,0,0,0,18,7,10,0,0,0,17,nowin,win,plwin,beat,20,0,18,191,0.439790576,0.047120419,0.581151832,1,0.31211505
14756,80,22460,10,11,0,0,0,21,7,10,0,0,0,17,win,win,plwin,beat,25,0,21,186,0.419354839,0.059139785,0.623655914,2,0.59892924
14757,90,22460,10,4,0,6,0,20,7,10,0,0,0,17,nowin,win,plwin,beat,20,0,14,201,0.447761194,0.049751244,0.60199005,3,0.889945023
14758,12,22460,6,9,0,10,0,25,7,10,0,0,0,17,nowin,loss,bust,plbust,0,10,15,189,0.470899471,0.015873016,0.613756614,3,0.929171178
14759,75,22460,8,3,5,10,0,26,7,10,0,0,0,17,nowin,loss,bust,plbust,0,10,11,191,0.418848168,0.052356021,0.570680628,0,0.029344702
14760,110,22461,4,6,10,0,0,20,7,2,11,0,0,20,nowin,push,push,push,10,0,10,192,0.416666667,0.046875,0.557291667,0,0.025413132
14761,83,22461,9,10,0,0,0,19,7,2,11,0,0,20,nowin,loss,beat,dlwin,0,10,19,193,0.424870466,0.051813472,0.678756477,2,0.644360335
14762,105,22461,2,5,10,0,0,17,7,2,11,0,0,20,nowin,loss,beat,dlwin,0,10,7,198,0.414141414,0.070707071,0.590909091,0,0.032889494
14763,54,22461,9,10,0,0,0,19,7,2,11,0,0,20,nowin,loss,beat,dlwin,0,10,19,185,0.437837838,0.032432432,0.556756757,1,0.29899854
14764,47,22461,5,3,11,0,0,19,7,2,11,0,0,20,nowin,loss,beat,dlwin,0,10,8,210,0.438095238,0.057142857,0.623809524,2,0.615868808
14765,133,22461,7,6,0,6,0,19,7,2,11,0,0,20,nowin,loss,beat,dlwin,0,10,13,201,0.47761194,0.064676617,0.611940299,3,0.935428111
14766,118,22462,2,10,0,10,0,22,10,7,0,0,0,17,nowin,loss,bust,plbust,0,10,12,216,0.393518519,0.037037037,0.555555556,0,0.018059873
14767,17,22462,10,10,0,0,0,20,10,7,0,0,0,17,nowin,win,plwin,beat,20,0,20,171,0.444444444,0.070175439,0.555555556,1,0.302364894
14768,58,22462,9,5,0,2,10,26,10,7,0,0,0,17,nowin,loss,bust,plbust,0,10,14,195,0.430769231,0.041025641,0.584615385,2,0.580497586
14769,148,22462,4,9,0,4,0,17,10,7,0,0,0,17,nowin,push,push,push,10,0,13,204,0.401960784,0.078431373,0.593137255,0,0.029789521
14770,147,22462,9,6,0,10,0,25,10,7,0,0,0,17,nowin,loss,bust,plbust,0,10,15,205,0.380487805,0.014634146,0.536585366,0,0.00951447
14771,16,22462,7,4,3,5,0,19,10,7,0,0,0,17,nowin,win,plwin,beat,20,0,11,220,0.427272727,0.081818182,0.6,2,0.588660176
14772,37,22463,7,8,0,0,0,15,3,3,8,10,0,24,nowin,win,dlbust,bust,20,0,15,208,0.394230769,0.038461538,0.581730769,0,0.024682772
14773,110,22463,11,7,0,0,0,18,3,3,8,10,0,24,nowin,win,dlbust,bust,20,0,18,192,0.416666667,0.046875,0.557291667,0,0.025413132
14774,23,22463,3,10,0,0,0,13,3,3,8,10,0,24,nowin,win,dlbust,bust,20,0,13,208,0.427884615,0.0625,0.552884615,1,0.29114424
14775,89,22463,9,6,0,0,0,15,3,3,8,10,0,24,nowin,win,dlbust,bust,20,0,15,212,0.537735849,0.047169811,0.594339623,3,0.990167191
14776,92,22463,4,1,7,3,0,15,3,3,8,10,0,24,nowin,win,dlbust,bust,20,0,5,186,0.446236559,0.059139785,0.564516129,1,0.307826125
14777,7,22463,10,5,0,0,0,15,3,3,8,10,0,24,nowin,win,dlbust,bust,20,0,15,183,0.442622951,0.06010929,0.62295082,2,0.619303341
14778,143,22464,10,11,0,0,0,21,8,2,3,10,0,23,win,win,dlbust,bust,25,0,21,203,0.463054187,0.044334975,0.57635468,3,0.883143365
14779,15,22464,5,3,4,3,4,19,8,2,3,10,0,23,nowin,win,dlbust,bust,20,0,8,212,0.410377358,0.051886792,0.561320755,0,0.024517408
14780,86,22464,10,10,0,0,0,20,8,2,3,10,0,23,nowin,win,dlbust,bust,20,0,20,196,0.454081633,0.040816327,0.591836735,3,0.887566443
14781,39,22464,10,11,0,0,0,21,8,2,3,10,0,23,win,win,dlbust,bust,25,0,21,191,0.429319372,0.062827225,0.57591623,0,0.033760763
14782,46,22464,2,9,8,0,0,19,8,2,3,10,0,23,nowin,win,dlbust,bust,20,0,11,186,0.403225806,0.048387097,0.591397849,0,0.029742194
14783,89,22464,6,2,7,4,0,19,8,2,3,10,0,23,nowin,win,dlbust,bust,20,0,8,212,0.537735849,0.047169811,0.594339623,3,0.990167191
14784,45,22465,2,10,0,0,0,12,6,5,10,0,0,21,nowin,loss,beat,dlwin,0,10,12,196,0.428571429,0.051020408,0.612244898,2,0.598821767
14785,122,22465,10,10,0,0,0,20,6,5,10,0,0,21,nowin,loss,beat,dlwin,0,10,20,210,0.347619048,0.052380952,0.59047619,0,0.012873677
14786,119,22465,10,11,0,0,0,21,6,5,10,0,0,21,win,push,push,push,10,0,21,190,0.405263158,0.068421053,0.515789474,0,0.011837158
14787,66,22465,5,10,0,0,0,15,6,5,10,0,0,21,nowin,loss,beat,dlwin,0,10,15,217,0.456221198,0.064516129,0.626728111,3,0.924304367
14788,101,22465,4,9,0,0,0,13,6,5,10,0,0,21,nowin,loss,beat,dlwin,0,10,13,205,0.424390244,0.068292683,0.63902439,2,0.614740646
14789,124,22465,3,10,0,0,0,13,6,5,10,0,0,21,nowin,loss,beat,dlwin,0,10,13,202,0.47029703,0.064356436,0.584158416,3,0.899458193
14790,52,22466,2,10,0,8,0,20,7,7,7,0,0,21,nowin,loss,beat,dlwin,0,10,12,217,0.414746544,0.02764977,0.599078341,2,0.576736024
14791,108,22466,7,2,10,0,0,19,7,7,7,0,0,21,nowin,loss,beat,dlwin,0,10,9,193,0.435233161,0.056994819,0.559585492,1,0.298824795
14792,119,22466,2,10,0,10,0,22,7,7,7,0,0,21,nowin,loss,bust,plbust,0,10,12,190,0.405263158,0.068421053,0.515789474,0,0.011837158
14793,30,22466,2,10,0,10,0,22,7,7,7,0,0,21,nowin,loss,bust,plbust,0,10,12,206,0.393203883,0.033980583,0.601941748,0,0.029324648
14794,110,22466,9,10,0,0,0,19,7,7,7,0,0,21,nowin,loss,beat,dlwin,0,10,19,192,0.416666667,0.046875,0.557291667,0,0.025413132
14795,104,22466,6,10,0,9,0,25,7,7,7,0,0,21,nowin,loss,bust,plbust,0,10,16,209,0.363636364,0.052631579,0.593301435,0,0.018359419
14796,8,22467,11,8,0,0,0,19,9,9,0,0,0,18,nowin,win,plwin,beat,20,0,19,181,0.44198895,0.071823204,0.596685083,2,0.599438402
14797,33,22467,9,5,0,5,0,19,9,9,0,0,0,18,nowin,win,plwin,beat,20,0,14,192,0.4375,0.057291667,0.625,2,0.616208916
14798,33,22467,10,11,0,0,0,21,9,9,0,0,0,18,win,win,plwin,beat,25,0,21,192,0.4375,0.057291667,0.625,2,0.616208916
14799,63,22467,7,10,0,0,0,17,9,9,0,0,0,18,nowin,loss,beat,dlwin,0,10,17,216,0.467592593,0.037037037,0.62037037,3,0.931690496
14800,88,22467,7,3,3,1,10,24,9,9,0,0,0,18,nowin,loss,bust,plbust,0,10,10,206,0.466019417,0.033980583,0.54368932,1,0.309467903
14801,100,22467,10,6,0,1,0,17,9,9,0,0,0,18,nowin,loss,beat,dlwin,0,10,16,190,0.452631579,0.036842105,0.594736842,3,0.888671154
14802,87,22468,8,6,0,5,0,19,10,10,0,0,0,20,nowin,loss,beat,dlwin,0,10,14,202,0.405940594,0.054455446,0.628712871,2,0.590599801
14803,104,22468,10,6,0,9,0,25,10,10,0,0,0,20,nowin,loss,bust,plbust,0,10,16,209,0.363636364,0.052631579,0.593301435,0,0.018359419
14804,135,22468,2,7,7,7,0,23,10,10,0,0,0,20,nowin,loss,bust,plbust,0,10,9,179,0.391061453,0.067039106,0.586592179,0,0.024924662
14805,20,22468,5,4,8,0,0,17,10,10,0,0,0,20,nowin,loss,beat,dlwin,0,10,9,186,0.456989247,0.037634409,0.537634409,1,0.301097108
14806,79,22468,5,10,0,10,0,25,10,10,0,0,0,20,nowin,loss,bust,plbust,0,10,15,211,0.436018957,0.028436019,0.672985782,2,0.650131054
14807,117,22468,11,3,4,0,0,18,10,10,0,0,0,20,nowin,loss,beat,dlwin,0,10,14,173,0.410404624,0.069364162,0.606936416,2,0.578610282
14808,149,22469,7,7,0,9,0,23,10,3,10,0,0,23,nowin,loss,bust,plbust,0,10,14,225,0.457777778,0.057777778,0.648888889,2,0.651965595
14809,141,22469,7,9,0,9,0,25,10,3,10,0,0,23,nowin,loss,bust,plbust,0,10,16,202,0.420792079,0.074257426,0.564356436,0,0.028377851
14810,141,22469,3,10,0,10,0,23,10,3,10,0,0,23,nowin,loss,bust,plbust,0,10,13,202,0.420792079,0.074257426,0.564356436,0,0.028377851
14811,35,22469,2,9,10,0,0,21,10,3,10,0,0,23,nowin,win,dlbust,bust,20,0,11,202,0.410891089,0.044554455,0.633663366,2,0.598681573
14812,68,22469,2,4,10,10,0,26,10,3,10,0,0,23,nowin,loss,bust,plbust,0,10,6,205,0.434146341,0.029268293,0.6,2,0.59483189
14813,29,22469,5,3,7,3,0,18,10,3,10,0,0,23,nowin,win,dlbust,bust,20,0,8,189,0.44973545,0.058201058,0.544973545,1,0.300349439
14814,60,22470,10,10,0,0,0,20,6,6,7,0,0,19,nowin,win,plwin,beat,20,0,20,227,0.418502203,0.022026432,0.559471366,0,0.026496258
14815,53,22470,10,10,0,0,0,20,6,6,7,0,0,19,nowin,win,plwin,beat,20,0,20,250,0.372,0.064,0.564,0,0.013687345
14816,107,22470,7,4,6,0,0,17,6,6,7,0,0,19,nowin,loss,beat,dlwin,0,10,11,218,0.444954128,0.073394495,0.600917431,2,0.605210014
14817,91,22470,10,2,0,0,0,12,6,6,7,0,0,19,nowin,loss,beat,dlwin,0,10,12,194,0.417525773,0.046391753,0.515463918,1,0.266616552
14818,46,22470,2,9,10,0,0,21,6,6,7,0,0,19,nowin,win,plwin,beat,20,0,11,186,0.403225806,0.048387097,0.591397849,0,0.029742194
14819,42,22470,11,7,0,0,0,18,6,6,7,0,0,19,nowin,loss,beat,dlwin,0,10,18,212,0.443396226,0.051886792,0.570754717,1,0.309181312
14820,60,22471,2,8,4,0,0,14,2,10,10,0,0,22,nowin,win,dlbust,bust,20,0,10,227,0.418502203,0.022026432,0.559471366,0,0.026496258
14821,126,22471,2,11,8,0,0,21,2,10,10,0,0,22,nowin,win,dlbust,bust,20,0,13,188,0.457446809,0.074468085,0.60106383,3,0.900633203
14822,63,22471,4,5,4,0,0,13,2,10,10,0,0,22,nowin,win,dlbust,bust,20,0,9,216,0.467592593,0.037037037,0.62037037,3,0.931690496
14823,77,22471,5,3,6,0,0,14,2,10,10,0,0,22,nowin,win,dlbust,bust,20,0,8,200,0.455,0.04,0.62,3,0.916252116
14824,86,22471,10,3,0,0,0,13,2,10,10,0,0,22,nowin,win,dlbust,bust,20,0,13,196,0.454081633,0.040816327,0.591836735,3,0.887566443
14825,138,22471,10,7,0,0,0,17,2,10,10,0,0,22,nowin,win,dlbust,bust,20,0,17,190,0.442105263,0.047368421,0.610526316,2,0.609711065
14826,113,22472,10,10,0,0,0,20,3,5,11,0,0,19,nowin,win,plwin,beat,20,0,20,199,0.407035176,0.055276382,0.668341709,2,0.620695264
14827,32,22472,4,6,4,0,0,14,3,5,11,0,0,19,nowin,loss,beat,dlwin,0,10,10,189,0.391534392,0.037037037,0.53968254,0,0.013579086
14828,58,22472,10,10,0,0,0,20,3,5,11,0,0,19,nowin,win,plwin,beat,20,0,20,195,0.430769231,0.041025641,0.584615385,2,0.580497586
14829,86,22472,2,7,2,9,0,20,3,5,11,0,0,19,nowin,win,plwin,beat,20,0,9,196,0.454081633,0.040816327,0.591836735,3,0.887566443
14830,53,22472,11,10,0,0,0,21,3,5,11,0,0,19,win,win,plwin,beat,25,0,21,250,0.372,0.064,0.564,0,0.013687345
14831,87,22472,8,10,0,0,0,18,3,5,11,0,0,19,nowin,loss,beat,dlwin,0,10,18,202,0.405940594,0.054455446,0.628712871,2,0.590599801
14832,112,22473,5,10,0,4,0,19,10,10,0,0,0,20,nowin,loss,beat,dlwin,0,10,15,203,0.448275862,0.054187192,0.600985222,3,0.889576933
14833,11,22473,10,5,0,3,0,18,10,10,0,0,0,20,nowin,loss,beat,dlwin,0,10,15,236,0.457627119,0.016949153,0.588983051,3,0.889015813
14834,143,22473,8,2,10,0,0,20,10,10,0,0,0,20,nowin,push,push,push,10,0,10,203,0.463054187,0.044334975,0.57635468,3,0.883143365
14835,101,22473,7,10,0,0,0,17,10,10,0,0,0,20,nowin,loss,beat,dlwin,0,10,17,205,0.424390244,0.068292683,0.63902439,2,0.614740646
14836,59,22473,10,10,0,0,0,20,10,10,0,0,0,20,nowin,push,push,push,10,0,20,228,0.429824561,0.048245614,0.543859649,1,0.287885446
14837,104,22473,7,4,6,0,0,17,10,10,0,0,0,20,nowin,loss,beat,dlwin,0,10,11,209,0.363636364,0.052631579,0.593301435,0,0.018359419
14838,139,22474,10,10,0,0,0,20,10,11,0,0,0,21,nowin,loss,beat,dlwin,0,10,20,192,0.380208333,0.036458333,0.59375,0,0.023429169
14839,16,22474,9,10,0,0,0,19,10,11,0,0,0,21,nowin,loss,beat,dlwin,0,10,19,220,0.427272727,0.081818182,0.6,2,0.588660176
14840,103,22474,10,3,0,9,0,22,10,11,0,0,0,21,nowin,loss,bust,plbust,0,10,13,203,0.379310345,0.064039409,0.551724138,0,0.012869209
14841,71,22474,3,7,10,0,0,20,10,11,0,0,0,21,nowin,loss,beat,dlwin,0,10,10,193,0.352331606,0.046632124,0.585492228,0,0.013063661
14842,53,22474,11,10,0,0,0,21,10,11,0,0,0,21,win,push,push,push,10,0,21,250,0.372,0.064,0.564,0,0.013687345
14843,39,22474,1,3,8,2,4,18,10,11,0,0,0,21,nowin,loss,beat,dlwin,0,10,4,191,0.429319372,0.062827225,0.57591623,0,0.033760763
14844,57,22475,4,5,10,0,0,19,6,7,6,0,0,19,nowin,push,push,push,10,0,9,192,0.46875,0.052083333,0.59375,3,0.907001181
14845,7,22475,3,8,10,0,0,21,6,7,6,0,0,19,nowin,win,plwin,beat,20,0,11,183,0.442622951,0.06010929,0.62295082,2,0.619303341
14846,9,22475,6,1,7,0,0,14,6,7,6,0,0,19,nowin,loss,beat,dlwin,0,10,7,194,0.37628866,0.015463918,0.541237113,0,0.009396796
14847,16,22475,11,10,0,0,0,21,6,7,6,0,0,19,win,win,plwin,beat,25,0,21,220,0.427272727,0.081818182,0.6,2,0.588660176
14848,126,22475,8,9,0,0,0,17,6,7,6,0,0,19,nowin,loss,beat,dlwin,0,10,17,188,0.457446809,0.074468085,0.60106383,3,0.900633203
14849,77,22475,7,9,0,0,0,16,6,7,6,0,0,19,nowin,loss,beat,dlwin,0,10,16,200,0.455,0.04,0.62,3,0.916252116
14850,58,22476,9,8,0,0,0,17,6,5,5,10,0,26,nowin,win,dlbust,bust,20,0,17,195,0.430769231,0.041025641,0.584615385,2,0.580497586
14851,129,22476,2,10,0,0,0,12,6,5,5,10,0,26,nowin,win,dlbust,bust,20,0,12,201,0.422885572,0.064676617,0.55721393,0,0.027255383
14852,141,22476,6,4,10,0,0,20,6,5,5,10,0,26,nowin,win,dlbust,bust,20,0,10,202,0.420792079,0.074257426,0.564356436,0,0.028377851
14853,132,22476,5,10,0,0,0,15,6,5,5,10,0,26,nowin,win,dlbust,bust,20,0,15,194,0.412371134,0.036082474,0.649484536,2,0.611633238
14854,48,22476,6,10,0,0,0,16,6,5,5,10,0,26,nowin,win,dlbust,bust,20,0,16,203,0.413793103,0.019704433,0.600985222,2,0.577280801
14855,47,22476,10,2,0,0,0,12,6,5,5,10,0,26,nowin,win,dlbust,bust,20,0,12,210,0.438095238,0.057142857,0.623809524,2,0.615868808
14856,31,22477,10,4,0,0,0,14,3,2,7,7,0,19,nowin,loss,beat,dlwin,0,10,14,188,0.473404255,0.058510638,0.515957447,1,0.300306557
14857,66,22477,6,4,10,0,0,20,3,2,7,7,0,19,nowin,win,plwin,beat,20,0,10,217,0.456221198,0.064516129,0.626728111,3,0.924304367
14858,35,22477,3,10,0,0,0,13,3,2,7,7,0,19,nowin,loss,beat,dlwin,0,10,13,202,0.410891089,0.044554455,0.633663366,2,0.598681573
14859,40,22477,8,4,0,9,0,21,3,2,7,7,0,19,nowin,win,plwin,beat,20,0,12,196,0.367346939,0.030612245,0.617346939,0,0.025358183
14860,2,22477,10,8,0,0,0,18,3,2,7,7,0,19,nowin,loss,beat,dlwin,0,10,18,200,0.445,0.035,0.64,2,0.633962549
14861,73,22477,5,5,4,0,0,14,3,2,7,7,0,19,nowin,loss,beat,dlwin,0,10,10,181,0.375690608,0.011049724,0.596685083,0,0.022795773
14862,139,22478,10,7,0,0,0,17,10,10,0,0,0,20,nowin,loss,beat,dlwin,0,10,17,192,0.380208333,0.036458333,0.59375,0,0.023429169
14863,56,22478,7,10,0,0,0,17,10,10,0,0,0,20,nowin,loss,beat,dlwin,0,10,17,175,0.4,0.057142857,0.582857143,0,0.026685297
14864,120,22478,10,6,0,10,0,26,10,10,0,0,0,20,nowin,loss,bust,plbust,0,10,16,202,0.440594059,0.034653465,0.618811881,2,0.614441029
14865,115,22478,10,4,0,4,0,18,10,10,0,0,0,20,nowin,loss,beat,dlwin,0,10,14,194,0.427835052,0.041237113,0.592783505,2,0.583863602
14866,47,22478,4,4,5,2,5,20,10,10,0,0,0,20,nowin,push,push,push,10,0,8,210,0.438095238,0.057142857,0.623809524,2,0.615868808
14867,133,22478,7,2,9,0,0,18,10,10,0,0,0,20,nowin,loss,beat,dlwin,0,10,9,201,0.47761194,0.064676617,0.611940299,3,0.935428111
14868,18,22479,4,7,10,0,0,21,8,6,7,0,0,21,nowin,push,push,push,10,0,11,182,0.461538462,0.043956044,0.587912088,3,0.892649374
14869,57,22479,10,8,0,0,0,18,8,6,7,0,0,21,nowin,loss,beat,dlwin,0,10,18,192,0.46875,0.052083333,0.59375,3,0.907001181
14870,96,22479,5,4,6,8,0,23,8,6,7,0,0,21,nowin,loss,bust,plbust,0,10,9,190,0.468421053,0.057894737,0.584210526,3,0.897263354
14871,60,22479,8,2,2,10,0,22,8,6,7,0,0,21,nowin,loss,bust,plbust,0,10,10,227,0.418502203,0.022026432,0.559471366,0,0.026496258
14872,30,22479,10,10,0,0,0,20,8,6,7,0,0,21,nowin,loss,beat,dlwin,0,10,20,206,0.393203883,0.033980583,0.601941748,0,0.029324648
14873,9,22479,2,6,10,0,0,18,8,6,7,0,0,21,nowin,loss,beat,dlwin,0,10,8,194,0.37628866,0.015463918,0.541237113,0,0.009396796
14874,58,22480,10,10,0,0,0,20,2,7,10,0,0,19,nowin,win,plwin,beat,20,0,20,195,0.430769231,0.041025641,0.584615385,2,0.580497586
14875,148,22480,11,2,4,0,0,17,2,7,10,0,0,19,nowin,loss,beat,dlwin,0,10,13,204,0.401960784,0.078431373,0.593137255,0,0.029789521
14876,53,22480,7,2,4,0,0,13,2,7,10,0,0,19,nowin,loss,beat,dlwin,0,10,9,250,0.372,0.064,0.564,0,0.013687345
14877,22,22480,2,2,10,0,0,14,2,7,10,0,0,19,nowin,loss,beat,dlwin,0,10,4,187,0.481283422,0.042780749,0.577540107,3,0.906128176
14878,20,22480,4,6,11,0,0,21,2,7,10,0,0,19,nowin,win,plwin,beat,20,0,10,186,0.456989247,0.037634409,0.537634409,1,0.301097108
14879,113,22480,8,3,9,0,0,20,2,7,10,0,0,19,nowin,win,plwin,beat,20,0,11,199,0.407035176,0.055276382,0.668341709,2,0.620695264
14880,63,22481,10,8,0,0,0,18,10,10,0,0,0,20,nowin,loss,beat,dlwin,0,10,18,216,0.467592593,0.037037037,0.62037037,3,0.931690496
14881,136,22481,8,10,0,0,0,18,10,10,0,0,0,20,nowin,loss,beat,dlwin,0,10,18,194,0.396907216,0.025773196,0.597938144,0,0.029452644
14882,39,22481,9,5,0,7,0,21,10,10,0,0,0,20,nowin,win,plwin,beat,20,0,14,191,0.429319372,0.062827225,0.57591623,0,0.033760763
14883,145,22481,3,5,6,3,0,17,10,10,0,0,0,20,nowin,loss,beat,dlwin,0,10,8,188,0.441489362,0.031914894,0.622340426,2,0.617837093
14884,33,22481,7,10,0,0,0,17,10,10,0,0,0,20,nowin,loss,beat,dlwin,0,10,17,192,0.4375,0.057291667,0.625,2,0.616208916
14885,129,22481,8,10,0,0,0,18,10,10,0,0,0,20,nowin,loss,beat,dlwin,0,10,18,201,0.422885572,0.064676617,0.55721393,0,0.027255383
14886,53,22482,8,5,0,10,0,23,9,10,0,0,0,19,nowin,loss,bust,plbust,0,10,13,250,0.372,0.064,0.564,0,0.013687345
14887,27,22482,8,10,0,0,0,18,9,10,0,0,0,19,nowin,loss,beat,dlwin,0,10,18,178,0.370786517,0.016853933,0.573033708,0,0.015536309
14888,64,22482,9,2,2,1,5,19,9,10,0,0,0,19,nowin,push,push,push,10,0,11,187,0.363636364,0.048128342,0.631016043,0,0.027594885
14889,81,22482,8,10,0,0,0,18,9,10,0,0,0,19,nowin,loss,beat,dlwin,0,10,18,182,0.395604396,0.043956044,0.60989011,2,0.567491261
14890,77,22482,4,10,0,10,0,24,9,10,0,0,0,19,nowin,loss,bust,plbust,0,10,14,200,0.455,0.04,0.62,3,0.916252116
14891,5,22482,6,10,0,5,0,21,9,10,0,0,0,19,nowin,win,plwin,beat,20,0,16,203,0.42364532,0.02955665,0.596059113,2,0.582508076
14892,92,22483,10,11,0,0,0,21,10,10,0,0,0,20,win,win,plwin,beat,25,0,21,186,0.446236559,0.059139785,0.564516129,1,0.307826125
14893,114,22483,10,8,0,0,0,18,10,10,0,0,0,20,nowin,loss,beat,dlwin,0,10,18,198,0.47979798,0.025252525,0.611111111,3,0.937232995
14894,96,22483,10,9,0,0,0,19,10,10,0,0,0,20,nowin,loss,beat,dlwin,0,10,19,190,0.468421053,0.057894737,0.584210526,3,0.897263354
14895,43,22483,6,10,0,4,0,20,10,10,0,0,0,20,nowin,push,push,push,10,0,16,192,0.40625,0.041666667,0.609375,2,0.576671372
14896,111,22483,10,5,0,3,0,18,10,10,0,0,0,20,nowin,loss,beat,dlwin,0,10,15,180,0.433333333,0.055555556,0.611111111,2,0.602264492
14897,18,22483,7,8,0,2,0,17,10,10,0,0,0,20,nowin,loss,beat,dlwin,0,10,15,182,0.461538462,0.043956044,0.587912088,3,0.892649374
14898,92,22484,8,6,0,0,0,14,4,5,8,0,0,17,nowin,loss,beat,dlwin,0,10,14,186,0.446236559,0.059139785,0.564516129,1,0.307826125
14899,39,22484,10,5,0,0,0,15,4,5,8,0,0,17,nowin,loss,beat,dlwin,0,10,15,191,0.429319372,0.062827225,0.57591623,0,0.033760763
14900,139,22484,11,7,0,0,0,18,4,5,8,0,0,17,nowin,win,plwin,beat,20,0,18,192,0.380208333,0.036458333,0.59375,0,0.023429169
14901,106,22484,6,2,7,0,0,15,4,5,8,0,0,17,nowin,loss,beat,dlwin,0,10,8,192,0.411458333,0.026041667,0.557291667,0,0.023854304
14902,98,22484,10,4,0,0,0,14,4,5,8,0,0,17,nowin,loss,beat,dlwin,0,10,14,220,0.422727273,0.054545455,0.55,1,0.28664435
14903,95,22484,2,10,0,0,0,12,4,5,8,0,0,17,nowin,loss,beat,dlwin,0,10,12,218,0.412844037,0.04587156,0.559633028,0,0.024842385
14904,105,22485,10,2,0,0,0,12,6,10,10,0,0,26,nowin,win,dlbust,bust,20,0,12,198,0.414141414,0.070707071,0.590909091,0,0.032889494
14905,68,22485,9,10,0,0,0,19,6,10,10,0,0,26,nowin,win,dlbust,bust,20,0,19,205,0.434146341,0.029268293,0.6,2,0.59483189
14906,76,22485,10,10,0,0,0,20,6,10,10,0,0,26,nowin,win,dlbust,bust,20,0,20,189,0.534391534,0.079365079,0.608465608,3,1
14907,93,22485,2,10,0,0,0,12,6,10,10,0,0,26,nowin,win,dlbust,bust,20,0,12,175,0.485714286,0.051428571,0.548571429,1,0.323648091
14908,148,22485,3,2,11,0,0,16,6,10,10,0,0,26,nowin,win,dlbust,bust,20,0,5,204,0.401960784,0.078431373,0.593137255,0,0.029789521
14909,108,22485,6,10,0,0,0,16,6,10,10,0,0,26,nowin,win,dlbust,bust,20,0,16,193,0.435233161,0.056994819,0.559585492,1,0.298824795
14910,69,22486,7,10,0,0,0,17,10,10,0,0,0,20,nowin,loss,beat,dlwin,0,10,17,194,0.365979381,0.030927835,0.515463918,0,0
14911,63,22486,10,8,0,0,0,18,10,10,0,0,0,20,nowin,loss,beat,dlwin,0,10,18,216,0.467592593,0.037037037,0.62037037,3,0.931690496
14912,15,22486,3,11,2,4,0,20,10,10,0,0,0,20,nowin,push,push,push,10,0,14,212,0.410377358,0.051886792,0.561320755,0,0.024517408
14913,38,22486,6,5,9,0,0,20,10,10,0,0,0,20,nowin,push,push,push,10,0,11,202,0.361386139,0.03960396,0.564356436,0,0.010597953
14914,20,22486,6,7,0,9,0,22,10,10,0,0,0,20,nowin,loss,bust,plbust,0,10,13,186,0.456989247,0.037634409,0.537634409,1,0.301097108
14915,37,22486,10,11,0,0,0,21,10,10,0,0,0,20,win,win,plwin,beat,25,0,21,208,0.394230769,0.038461538,0.581730769,0,0.024682772
14916,53,22487,3,11,6,0,0,20,11,10,0,0,0,21,nowin,loss,beat,dlwin,0,10,14,250,0.372,0.064,0.564,0,0.013687345
14917,85,22487,6,6,0,10,0,22,11,10,0,0,0,21,nowin,loss,bust,plbust,0,10,12,195,0.41025641,0.066666667,0.594871795,0,0.03269711
14918,86,22487,2,7,10,0,0,19,11,10,0,0,0,21,nowin,loss,beat,dlwin,0,10,9,196,0.454081633,0.040816327,0.591836735,3,0.887566443
14919,10,22487,7,9,0,1,0,17,11,10,0,0,0,21,nowin,loss,beat,dlwin,0,10,16,191,0.413612565,0.057591623,0.596858639,2,0.574087175
14920,68,22487,4,10,0,10,0,24,11,10,0,0,0,21,nowin,loss,bust,plbust,0,10,14,205,0.434146341,0.029268293,0.6,2,0.59483189
14921,15,22487,9,5,0,8,0,22,11,10,0,0,0,21,nowin,loss,bust,plbust,0,10,14,212,0.410377358,0.051886792,0.561320755,0,0.024517408
14922,61,22488,10,7,0,0,0,17,10,8,0,0,0,18,nowin,loss,beat,dlwin,0,10,17,194,0.427835052,0.077319588,0.603092784,2,0.591437139
14923,57,22488,10,2,0,2,6,20,10,8,0,0,0,18,nowin,win,plwin,beat,20,0,12,192,0.46875,0.052083333,0.59375,3,0.907001181
14924,44,22488,6,10,0,2,0,18,10,8,0,0,0,18,nowin,push,push,push,10,0,16,219,0.433789954,0.050228311,0.534246575,1,0.285551035
14925,142,22488,11,8,0,0,0,19,10,8,0,0,0,18,nowin,win,plwin,beat,20,0,19,211,0.417061611,0.047393365,0.526066351,1,0.271531309
14926,78,22488,5,1,8,1,7,22,10,8,0,0,0,18,nowin,loss,bust,plbust,0,10,6,201,0.517412935,0.034825871,0.587064677,3,0.95871112
14927,138,22488,10,8,0,0,0,18,10,8,0,0,0,18,nowin,push,push,push,10,0,18,190,0.442105263,0.047368421,0.610526316,2,0.609711065
14928,20,22489,10,8,0,0,0,18,9,5,5,0,0,19,nowin,loss,beat,dlwin,0,10,18,186,0.456989247,0.037634409,0.537634409,1,0.301097108
14929,35,22489,9,8,0,0,0,17,9,5,5,0,0,19,nowin,loss,beat,dlwin,0,10,17,202,0.410891089,0.044554455,0.633663366,2,0.598681573
14930,98,22489,6,10,0,10,0,26,9,5,5,0,0,19,nowin,loss,bust,plbust,0,10,16,220,0.422727273,0.054545455,0.55,1,0.28664435
14931,134,22489,3,6,10,0,0,19,9,5,5,0,0,19,nowin,push,push,push,10,0,9,185,0.443243243,0.021621622,0.545945946,1,0.296939509
14932,120,22489,3,5,9,0,0,17,9,5,5,0,0,19,nowin,loss,beat,dlwin,0,10,8,202,0.440594059,0.034653465,0.618811881,2,0.614441029
14933,10,22489,10,2,0,10,0,22,9,5,5,0,0,19,nowin,loss,bust,plbust,0,10,12,191,0.413612565,0.057591623,0.596858639,2,0.574087175
14934,110,22490,2,4,10,2,0,18,9,6,5,0,0,20,nowin,loss,beat,dlwin,0,10,6,192,0.416666667,0.046875,0.557291667,0,0.025413132
14935,38,22490,8,2,11,0,0,21,9,6,5,0,0,20,nowin,win,plwin,beat,20,0,10,202,0.361386139,0.03960396,0.564356436,0,0.010597953
14936,3,22490,2,2,10,5,0,19,9,6,5,0,0,20,nowin,loss,beat,dlwin,0,10,4,190,0.431578947,0.026315789,0.542105263,1,0.288076384
14937,146,22490,10,4,0,2,5,21,9,6,5,0,0,20,nowin,win,plwin,beat,20,0,14,221,0.43438914,0.040723982,0.542986425,1,0.290190091
14938,21,22490,10,8,0,0,0,18,9,6,5,0,0,20,nowin,loss,beat,dlwin,0,10,18,214,0.359813084,0.042056075,0.626168224,0,0.025263474
14939,22,22490,10,3,0,5,0,18,9,6,5,0,0,20,nowin,loss,beat,dlwin,0,10,13,187,0.481283422,0.042780749,0.577540107,3,0.906128176
14940,111,22491,10,9,0,0,0,19,2,10,10,0,0,22,nowin,win,dlbust,bust,20,0,19,180,0.433333333,0.055555556,0.611111111,2,0.602264492
14941,98,22491,10,7,0,0,0,17,2,10,10,0,0,22,nowin,win,dlbust,bust,20,0,17,220,0.422727273,0.054545455,0.55,1,0.28664435
14942,98,22491,10,11,0,0,0,21,2,10,10,0,0,22,win,win,dlbust,bust,25,0,21,220,0.422727273,0.054545455,0.55,1,0.28664435
14943,83,22491,5,3,8,0,0,16,2,10,10,0,0,22,nowin,win,dlbust,bust,20,0,8,193,0.424870466,0.051813472,0.678756477,2,0.644360335
14944,69,22491,4,10,0,0,0,14,2,10,10,0,0,22,nowin,win,dlbust,bust,20,0,14,194,0.365979381,0.030927835,0.515463918,0,0
14945,128,22491,3,10,0,0,0,13,2,10,10,0,0,22,nowin,win,dlbust,bust,20,0,13,227,0.356828194,0.052863436,0.577092511,0,0.012352564
14946,106,22492,2,3,4,8,0,17,8,7,4,0,0,19,nowin,loss,beat,dlwin,0,10,5,192,0.411458333,0.026041667,0.557291667,0,0.023854304
14947,11,22492,10,9,0,0,0,19,8,7,4,0,0,19,nowin,push,push,push,10,0,19,236,0.457627119,0.016949153,0.588983051,3,0.889015813
14948,67,22492,7,5,0,5,0,17,8,7,4,0,0,19,nowin,loss,beat,dlwin,0,10,12,195,0.369230769,0.041025641,0.569230769,0,0.014139427
14949,49,22492,10,3,0,10,0,23,8,7,4,0,0,19,nowin,loss,bust,plbust,0,10,13,207,0.396135266,0.053140097,0.594202899,0,0.028306925
14950,81,22492,6,6,0,5,0,17,8,7,4,0,0,19,nowin,loss,beat,dlwin,0,10,12,182,0.395604396,0.043956044,0.60989011,2,0.567491261
14951,2,22492,10,10,0,0,0,20,8,7,4,0,0,19,nowin,win,plwin,beat,20,0,20,200,0.445,0.035,0.64,2,0.633962549
14952,2,22493,4,10,0,0,0,14,2,1,10,4,0,17,nowin,loss,beat,dlwin,0,10,14,200,0.445,0.035,0.64,2,0.633962549
14953,126,22493,10,10,0,0,0,20,2,1,10,4,0,17,nowin,win,plwin,beat,20,0,20,188,0.457446809,0.074468085,0.60106383,3,0.900633203
14954,90,22493,2,6,8,0,0,16,2,1,10,4,0,17,nowin,loss,beat,dlwin,0,10,8,201,0.447761194,0.049751244,0.60199005,3,0.889945023
14955,47,22493,6,6,0,7,0,19,2,1,10,4,0,17,nowin,win,plwin,beat,20,0,12,210,0.438095238,0.057142857,0.623809524,2,0.615868808
14956,40,22493,3,10,0,0,0,13,2,1,10,4,0,17,nowin,loss,beat,dlwin,0,10,13,196,0.367346939,0.030612245,0.617346939,0,0.025358183
14957,150,22493,10,8,0,0,0,18,2,1,10,4,0,17,nowin,win,plwin,beat,20,0,18,192,0.401041667,0.036458333,0.567708333,0,0.023287458
14958,149,22494,4,2,2,7,1,16,9,11,0,0,0,20,nowin,loss,beat,dlwin,0,10,6,225,0.457777778,0.057777778,0.648888889,2,0.651965595
14959,41,22494,10,6,0,9,0,25,9,11,0,0,0,20,nowin,loss,bust,plbust,0,10,16,192,0.364583333,0.036458333,0.520833333,0,0.00089702
14960,53,22494,8,11,0,0,0,19,9,11,0,0,0,20,nowin,loss,beat,dlwin,0,10,19,250,0.372,0.064,0.564,0,0.013687345
14961,109,22494,10,6,0,9,0,25,9,11,0,0,0,20,nowin,loss,bust,plbust,0,10,16,221,0.461538462,0.058823529,0.597285068,3,0.901830309
14962,28,22494,10,5,0,10,0,25,9,11,0,0,0,20,nowin,loss,bust,plbust,0,10,15,199,0.422110553,0.045226131,0.542713568,1,0.282706618
14963,12,22494,8,10,0,0,0,18,9,11,0,0,0,20,nowin,loss,beat,dlwin,0,10,18,189,0.470899471,0.015873016,0.613756614,3,0.929171178
14964,96,22495,10,8,0,0,0,18,3,2,10,9,0,24,nowin,win,dlbust,bust,20,0,18,190,0.468421053,0.057894737,0.584210526,3,0.897263354
14965,64,22495,10,9,0,0,0,19,3,2,10,9,0,24,nowin,win,dlbust,bust,20,0,19,187,0.363636364,0.048128342,0.631016043,0,0.027594885
14966,141,22495,5,7,0,7,0,19,3,2,10,9,0,24,nowin,win,dlbust,bust,20,0,12,202,0.420792079,0.074257426,0.564356436,0,0.028377851
14967,106,22495,2,4,10,0,0,16,3,2,10,9,0,24,nowin,win,dlbust,bust,20,0,6,192,0.411458333,0.026041667,0.557291667,0,0.023854304
14968,7,22495,7,10,0,0,0,17,3,2,10,9,0,24,nowin,win,dlbust,bust,20,0,17,183,0.442622951,0.06010929,0.62295082,2,0.619303341
14969,125,22495,9,10,0,0,0,19,3,2,10,9,0,24,nowin,win,dlbust,bust,20,0,19,219,0.438356164,0.050228311,0.575342466,1,0.308411257
14970,62,22496,10,9,0,0,0,19,10,10,0,0,0,20,nowin,loss,beat,dlwin,0,10,19,178,0.370786517,0.028089888,0.54494382,0,0.008657722
14971,44,22496,9,10,0,0,0,19,10,10,0,0,0,20,nowin,loss,beat,dlwin,0,10,19,219,0.433789954,0.050228311,0.534246575,1,0.285551035
14972,95,22496,10,11,0,0,0,21,10,10,0,0,0,20,win,win,plwin,beat,25,0,21,218,0.412844037,0.04587156,0.559633028,0,0.024842385
14973,149,22496,9,10,0,0,0,19,10,10,0,0,0,20,nowin,loss,beat,dlwin,0,10,19,225,0.457777778,0.057777778,0.648888889,2,0.651965595
14974,52,22496,4,2,11,0,0,17,10,10,0,0,0,20,nowin,loss,beat,dlwin,0,10,6,217,0.414746544,0.02764977,0.599078341,2,0.576736024
14975,149,22496,10,6,0,3,0,19,10,10,0,0,0,20,nowin,loss,beat,dlwin,0,10,16,225,0.457777778,0.057777778,0.648888889,2,0.651965595
14976,142,22497,3,10,0,0,0,13,2,10,2,3,0,17,nowin,loss,beat,dlwin,0,10,13,211,0.417061611,0.047393365,0.526066351,1,0.271531309
14977,68,22497,10,5,0,0,0,15,2,10,2,3,0,17,nowin,loss,beat,dlwin,0,10,15,205,0.434146341,0.029268293,0.6,2,0.59483189
14978,119,22497,9,2,9,0,0,20,2,10,2,3,0,17,nowin,win,plwin,beat,20,0,11,190,0.405263158,0.068421053,0.515789474,0,0.011837158
14979,6,22497,10,8,0,0,0,18,2,10,2,3,0,17,nowin,win,plwin,beat,20,0,18,191,0.439790576,0.047120419,0.581151832,1,0.31211505
14980,92,22497,4,10,0,0,0,14,2,10,2,3,0,17,nowin,loss,beat,dlwin,0,10,14,186,0.446236559,0.059139785,0.564516129,1,0.307826125
14981,44,22497,8,11,0,0,0,19,2,10,2,3,0,17,nowin,win,plwin,beat,20,0,19,219,0.433789954,0.050228311,0.534246575,1,0.285551035
14982,14,22498,5,2,10,0,0,17,6,10,10,0,0,26,nowin,win,dlbust,bust,20,0,7,202,0.391089109,0.01980198,0.628712871,2,0.577264877
14983,80,22498,7,11,0,0,0,18,6,10,10,0,0,26,nowin,win,dlbust,bust,20,0,18,186,0.419354839,0.059139785,0.623655914,2,0.59892924
14984,32,22498,7,5,0,0,0,12,6,10,10,0,0,26,nowin,win,dlbust,bust,20,0,12,189,0.391534392,0.037037037,0.53968254,0,0.013579086
14985,69,22498,2,10,0,0,0,12,6,10,10,0,0,26,nowin,win,dlbust,bust,20,0,12,194,0.365979381,0.030927835,0.515463918,0,0
14986,79,22498,1,4,10,0,0,15,6,10,10,0,0,26,nowin,win,dlbust,bust,20,0,5,211,0.436018957,0.028436019,0.672985782,2,0.650131054
14987,111,22498,10,11,0,0,0,21,6,10,10,0,0,26,win,win,dlbust,bust,25,0,21,180,0.433333333,0.055555556,0.611111111,2,0.602264492
14988,33,22499,8,2,10,0,0,20,10,10,0,0,0,20,nowin,push,push,push,10,0,10,192,0.4375,0.057291667,0.625,2,0.616208916
14989,71,22499,10,9,0,0,0,19,10,10,0,0,0,20,nowin,loss,beat,dlwin,0,10,19,193,0.352331606,0.046632124,0.585492228,0,0.013063661
14990,41,22499,9,5,0,9,0,23,10,10,0,0,0,20,nowin,loss,bust,plbust,0,10,14,192,0.364583333,0.036458333,0.520833333,0,0.00089702
14991,127,22499,5,4,4,5,0,18,10,10,0,0,0,20,nowin,loss,beat,dlwin,0,10,9,201,0.402985075,0.029850746,0.60199005,0,0.032263937
14992,131,22499,4,10,0,2,1,17,10,10,0,0,0,20,nowin,loss,beat,dlwin,0,10,14,217,0.410138249,0.069124424,0.543778802,0,0.02015021
14993,117,22499,8,4,0,9,0,21,10,10,0,0,0,20,nowin,win,plwin,beat,20,0,12,173,0.410404624,0.069364162,0.606936416,2,0.578610282
14994,62,22500,11,7,0,0,0,18,11,8,0,0,0,19,nowin,loss,beat,dlwin,0,10,18,178,0.370786517,0.028089888,0.54494382,0,0.008657722
14995,111,22500,7,3,7,0,0,17,11,8,0,0,0,19,nowin,loss,beat,dlwin,0,10,10,180,0.433333333,0.055555556,0.611111111,2,0.602264492
14996,14,22500,3,4,10,0,0,17,11,8,0,0,0,19,nowin,loss,beat,dlwin,0,10,7,202,0.391089109,0.01980198,0.628712871,2,0.577264877
14997,42,22500,7,10,0,0,0,17,11,8,0,0,0,19,nowin,loss,beat,dlwin,0,10,17,212,0.443396226,0.051886792,0.570754717,1,0.309181312
14998,150,22500,10,6,0,10,0,26,11,8,0,0,0,19,nowin,loss,bust,plbust,0,10,16,192,0.401041667,0.036458333,0.567708333,0,0.023287458
14999,123,22500,4,4,8,3,0,19,11,8,0,0,0,19,nowin,push,push,push,10,0,8,205,0.43902439,0.034146341,0.614634146,2,0.609962544
15000,90,22501,6,6,0,2,0,14,2,3,10,9,0,24,nowin,win,dlbust,bust,20,0,12,201,0.447761194,0.049751244,0.60199005,3,0.889945023
15001,51,22501,3,10,0,0,0,13,2,3,10,9,0,24,nowin,win,dlbust,bust,20,0,13,189,0.529100529,0.068783069,0.608465608,3,0.993665715
15002,108,22501,8,5,0,0,0,13,2,3,10,9,0,24,nowin,win,dlbust,bust,20,0,13,193,0.435233161,0.056994819,0.559585492,1,0.298824795
15003,69,22501,5,6,1,1,0,13,2,3,10,9,0,24,nowin,win,dlbust,bust,20,0,11,194,0.365979381,0.030927835,0.515463918,0,0
15004,101,22501,10,3,0,0,0,13,2,3,10,9,0,24,nowin,win,dlbust,bust,20,0,13,205,0.424390244,0.068292683,0.63902439,2,0.614740646
15005,1,22501,2,6,10,0,0,18,2,3,10,9,0,24,nowin,win,dlbust,bust,20,0,8,197,0.406091371,0.025380711,0.649746193,2,0.606186955
15006,96,22502,9,5,0,0,0,14,2,10,8,0,0,20,nowin,loss,beat,dlwin,0,10,14,190,0.468421053,0.057894737,0.584210526,3,0.897263354
15007,65,22502,8,6,0,0,0,14,2,10,8,0,0,20,nowin,loss,beat,dlwin,0,10,14,203,0.492610837,0.054187192,0.571428571,3,0.913702814
15008,14,22502,3,9,0,10,0,22,2,10,8,0,0,20,nowin,loss,bust,plbust,0,10,12,202,0.391089109,0.01980198,0.628712871,2,0.577264877
15009,125,22502,6,4,8,0,0,18,2,10,8,0,0,20,nowin,loss,beat,dlwin,0,10,10,219,0.438356164,0.050228311,0.575342466,1,0.308411257
15010,32,22502,10,7,0,0,0,17,2,10,8,0,0,20,nowin,loss,beat,dlwin,0,10,17,189,0.391534392,0.037037037,0.53968254,0,0.013579086
15011,52,22502,6,10,0,0,0,16,2,10,8,0,0,20,nowin,loss,beat,dlwin,0,10,16,217,0.414746544,0.02764977,0.599078341,2,0.576736024
15012,34,22503,10,11,0,0,0,21,3,10,10,0,0,23,win,win,dlbust,bust,25,0,21,202,0.5,0.079207921,0.618811881,3,0.968961434
15013,76,22503,5,3,8,0,0,16,3,10,10,0,0,23,nowin,win,dlbust,bust,20,0,8,189,0.534391534,0.079365079,0.608465608,3,1
15014,108,22503,10,5,0,0,0,15,3,10,10,0,0,23,nowin,win,dlbust,bust,20,0,15,193,0.435233161,0.056994819,0.559585492,1,0.298824795
15015,120,22503,5,7,0,5,0,17,3,10,10,0,0,23,nowin,win,dlbust,bust,20,0,12,202,0.440594059,0.034653465,0.618811881,2,0.614441029
15016,42,22503,3,9,0,5,0,17,3,10,10,0,0,23,nowin,win,dlbust,bust,20,0,12,212,0.443396226,0.051886792,0.570754717,1,0.309181312
15017,51,22503,3,1,10,0,0,14,3,10,10,0,0,23,nowin,win,dlbust,bust,20,0,4,189,0.529100529,0.068783069,0.608465608,3,0.993665715
15018,36,22504,6,11,3,0,0,20,9,2,10,0,0,21,nowin,loss,beat,dlwin,0,10,17,229,0.445414847,0.056768559,0.655021834,2,0.645370571
15019,36,22504,10,10,0,0,0,20,9,2,10,0,0,21,nowin,loss,beat,dlwin,0,10,20,229,0.445414847,0.056768559,0.655021834,2,0.645370571
15020,8,22504,8,7,0,1,10,26,9,2,10,0,0,21,nowin,loss,bust,plbust,0,10,15,181,0.44198895,0.071823204,0.596685083,2,0.599438402
15021,42,22504,4,9,0,10,0,23,9,2,10,0,0,21,nowin,loss,bust,plbust,0,10,13,212,0.443396226,0.051886792,0.570754717,1,0.309181312
15022,19,22504,7,9,0,10,0,26,9,2,10,0,0,21,nowin,loss,bust,plbust,0,10,16,237,0.41350211,0.054852321,0.628691983,2,0.597373826
15023,23,22504,11,10,0,0,0,21,9,2,10,0,0,21,win,push,push,push,10,0,21,208,0.427884615,0.0625,0.552884615,1,0.29114424
15024,102,22505,11,10,0,0,0,21,8,5,6,0,0,19,win,win,plwin,beat,25,0,21,192,0.338541667,0.046875,0.5625,0,0.003306118
15025,121,22505,9,6,0,2,0,17,8,5,6,0,0,19,nowin,loss,beat,dlwin,0,10,15,195,0.456410256,0.025641026,0.512820513,1,0.288597791
15026,65,22505,5,11,5,0,0,21,8,5,6,0,0,19,nowin,win,plwin,beat,20,0,16,203,0.492610837,0.054187192,0.571428571,3,0.913702814
15027,64,22505,6,10,0,10,0,26,8,5,6,0,0,19,nowin,loss,bust,plbust,0,10,16,187,0.363636364,0.048128342,0.631016043,0,0.027594885
15028,135,22505,8,3,10,0,0,21,8,5,6,0,0,19,nowin,win,plwin,beat,20,0,11,179,0.391061453,0.067039106,0.586592179,0,0.024924662
15029,20,22505,2,8,10,0,0,20,8,5,6,0,0,19,nowin,win,plwin,beat,20,0,10,186,0.456989247,0.037634409,0.537634409,1,0.301097108
15030,118,22506,9,8,0,0,0,17,4,9,10,0,0,23,nowin,win,dlbust,bust,20,0,17,216,0.393518519,0.037037037,0.555555556,0,0.018059873
15031,51,22506,3,11,2,0,0,16,4,9,10,0,0,23,nowin,win,dlbust,bust,20,0,14,189,0.529100529,0.068783069,0.608465608,3,0.993665715
15032,101,22506,7,10,0,0,0,17,4,9,10,0,0,23,nowin,win,dlbust,bust,20,0,17,205,0.424390244,0.068292683,0.63902439,2,0.614740646
15033,127,22506,10,10,0,0,0,20,4,9,10,0,0,23,nowin,win,dlbust,bust,20,0,20,201,0.402985075,0.029850746,0.60199005,0,0.032263937
15034,91,22506,11,10,0,0,0,21,4,9,10,0,0,23,win,win,dlbust,bust,25,0,21,194,0.417525773,0.046391753,0.515463918,1,0.266616552
15035,71,22506,6,2,7,0,0,15,4,9,10,0,0,23,nowin,win,dlbust,bust,20,0,8,193,0.352331606,0.046632124,0.585492228,0,0.013063661
15036,11,22507,2,5,10,0,0,17,11,10,0,0,0,21,nowin,loss,beat,dlwin,0,10,7,236,0.457627119,0.016949153,0.588983051,3,0.889015813
15037,41,22507,3,10,0,4,0,17,11,10,0,0,0,21,nowin,loss,beat,dlwin,0,10,13,192,0.364583333,0.036458333,0.520833333,0,0.00089702
15038,89,22507,11,10,0,0,0,21,11,10,0,0,0,21,win,push,push,push,10,0,21,212,0.537735849,0.047169811,0.594339623,3,0.990167191
15039,73,22507,10,7,0,0,0,17,11,10,0,0,0,21,nowin,loss,beat,dlwin,0,10,17,181,0.375690608,0.011049724,0.596685083,0,0.022795773
15040,143,22507,10,8,0,0,0,18,11,10,0,0,0,21,nowin,loss,beat,dlwin,0,10,18,203,0.463054187,0.044334975,0.57635468,3,0.883143365
15041,64,22507,8,6,0,7,0,21,11,10,0,0,0,21,nowin,push,push,push,10,0,14,187,0.363636364,0.048128342,0.631016043,0,0.027594885
15042,148,22508,4,11,2,0,0,17,5,3,9,0,0,17,nowin,push,push,push,10,0,15,204,0.401960784,0.078431373,0.593137255,0,0.029789521
15043,1,22508,2,11,3,0,0,16,5,3,9,0,0,17,nowin,loss,beat,dlwin,0,10,13,197,0.406091371,0.025380711,0.649746193,2,0.606186955
15044,59,22508,4,10,0,0,0,14,5,3,9,0,0,17,nowin,loss,beat,dlwin,0,10,14,228,0.429824561,0.048245614,0.543859649,1,0.287885446
15045,69,22508,10,5,0,0,0,15,5,3,9,0,0,17,nowin,loss,beat,dlwin,0,10,15,194,0.365979381,0.030927835,0.515463918,0,0
15046,73,22508,6,10,0,0,0,16,5,3,9,0,0,17,nowin,loss,beat,dlwin,0,10,16,181,0.375690608,0.011049724,0.596685083,0,0.022795773
15047,70,22508,4,2,6,0,0,12,5,3,9,0,0,17,nowin,loss,beat,dlwin,0,10,6,228,0.385964912,0.039473684,0.557017544,0,0.016157125
15048,106,22509,4,10,0,6,0,20,10,7,0,0,0,17,nowin,win,plwin,beat,20,0,14,192,0.411458333,0.026041667,0.557291667,0,0.023854304
15049,91,22509,4,9,0,10,0,23,10,7,0,0,0,17,nowin,loss,bust,plbust,0,10,13,194,0.417525773,0.046391753,0.515463918,1,0.266616552
15050,133,22509,10,6,0,2,0,18,10,7,0,0,0,17,nowin,win,plwin,beat,20,0,16,201,0.47761194,0.064676617,0.611940299,3,0.935428111
15051,126,22509,3,10,0,8,0,21,10,7,0,0,0,17,nowin,win,plwin,beat,20,0,13,188,0.457446809,0.074468085,0.60106383,3,0.900633203
15052,146,22509,2,10,0,10,0,22,10,7,0,0,0,17,nowin,loss,bust,plbust,0,10,12,221,0.43438914,0.040723982,0.542986425,1,0.290190091
15053,87,22509,5,8,0,6,0,19,10,7,0,0,0,17,nowin,win,plwin,beat,20,0,13,202,0.405940594,0.054455446,0.628712871,2,0.590599801
15054,37,22510,10,5,0,0,0,15,4,4,10,0,0,18,nowin,loss,beat,dlwin,0,10,15,208,0.394230769,0.038461538,0.581730769,0,0.024682772
15055,41,22510,2,8,10,0,0,20,4,4,10,0,0,18,nowin,win,plwin,beat,20,0,10,192,0.364583333,0.036458333,0.520833333,0,0.00089702
15056,109,22510,8,6,0,0,0,14,4,4,10,0,0,18,nowin,loss,beat,dlwin,0,10,14,221,0.461538462,0.058823529,0.597285068,3,0.901830309
15057,41,22510,10,6,0,0,0,16,4,4,10,0,0,18,nowin,loss,beat,dlwin,0,10,16,192,0.364583333,0.036458333,0.520833333,0,0.00089702
15058,140,22510,10,10,0,0,0,20,4,4,10,0,0,18,nowin,win,plwin,beat,20,0,20,210,0.466666667,0.023809524,0.604761905,3,0.915293335
15059,120,22510,7,10,0,0,0,17,4,4,10,0,0,18,nowin,loss,beat,dlwin,0,10,17,202,0.440594059,0.034653465,0.618811881,2,0.614441029
15060,46,22511,10,2,0,7,0,19,10,3,8,0,0,21,nowin,loss,beat,dlwin,0,10,12,186,0.403225806,0.048387097,0.591397849,0,0.029742194
15061,39,22511,8,10,0,0,0,18,10,3,8,0,0,21,nowin,loss,beat,dlwin,0,10,18,191,0.429319372,0.062827225,0.57591623,0,0.033760763
15062,87,22511,3,4,10,0,0,17,10,3,8,0,0,21,nowin,loss,beat,dlwin,0,10,7,202,0.405940594,0.054455446,0.628712871,2,0.590599801
15063,70,22511,10,7,0,0,0,17,10,3,8,0,0,21,nowin,loss,beat,dlwin,0,10,17,228,0.385964912,0.039473684,0.557017544,0,0.016157125
15064,66,22511,6,3,5,1,10,25,10,3,8,0,0,21,nowin,loss,bust,plbust,0,10,9,217,0.456221198,0.064516129,0.626728111,3,0.924304367
15065,18,22511,6,6,0,9,0,21,10,3,8,0,0,21,nowin,push,push,push,10,0,12,182,0.461538462,0.043956044,0.587912088,3,0.892649374
15066,14,22512,6,10,0,6,0,22,10,4,5,0,0,19,nowin,loss,bust,plbust,0,10,16,202,0.391089109,0.01980198,0.628712871,2,0.577264877
15067,124,22512,10,4,0,6,0,20,10,4,5,0,0,19,nowin,win,plwin,beat,20,0,14,202,0.47029703,0.064356436,0.584158416,3,0.899458193
15068,105,22512,11,7,0,0,0,18,10,4,5,0,0,19,nowin,loss,beat,dlwin,0,10,18,198,0.414141414,0.070707071,0.590909091,0,0.032889494
15069,83,22512,10,10,0,0,0,20,10,4,5,0,0,19,nowin,win,plwin,beat,20,0,20,193,0.424870466,0.051813472,0.678756477,2,0.644360335
15070,122,22512,4,10,0,10,0,24,10,4,5,0,0,19,nowin,loss,bust,plbust,0,10,14,210,0.347619048,0.052380952,0.59047619,0,0.012873677
15071,34,22512,8,10,0,0,0,18,10,4,5,0,0,19,nowin,loss,beat,dlwin,0,10,18,202,0.5,0.079207921,0.618811881,3,0.968961434
15072,78,22513,10,3,0,9,0,22,10,10,0,0,0,20,nowin,loss,bust,plbust,0,10,13,201,0.517412935,0.034825871,0.587064677,3,0.95871112
15073,30,22513,7,2,10,0,0,19,10,10,0,0,0,20,nowin,loss,beat,dlwin,0,10,9,206,0.393203883,0.033980583,0.601941748,0,0.029324648
15074,15,22513,10,8,0,0,0,18,10,10,0,0,0,20,nowin,loss,beat,dlwin,0,10,18,212,0.410377358,0.051886792,0.561320755,0,0.024517408
15075,52,22513,10,11,0,0,0,21,10,10,0,0,0,20,win,win,plwin,beat,25,0,21,217,0.414746544,0.02764977,0.599078341,2,0.576736024
15076,37,22513,8,10,0,0,0,18,10,10,0,0,0,20,nowin,loss,beat,dlwin,0,10,18,208,0.394230769,0.038461538,0.581730769,0,0.024682772
15077,124,22513,7,9,0,7,0,23,10,10,0,0,0,20,nowin,loss,bust,plbust,0,10,16,202,0.47029703,0.064356436,0.584158416,3,0.899458193
15078,138,22514,4,10,0,0,0,14,5,2,4,5,7,23,nowin,win,dlbust,bust,20,0,14,190,0.442105263,0.047368421,0.610526316,2,0.609711065
15079,14,22514,4,10,0,0,0,14,5,2,4,5,7,23,nowin,win,dlbust,bust,20,0,14,202,0.391089109,0.01980198,0.628712871,2,0.577264877
15080,100,22514,5,10,0,0,0,15,5,2,4,5,7,23,nowin,win,dlbust,bust,20,0,15,190,0.452631579,0.036842105,0.594736842,3,0.888671154
15081,103,22514,6,2,10,0,0,18,5,2,4,5,7,23,nowin,win,dlbust,bust,20,0,8,203,0.379310345,0.064039409,0.551724138,0,0.012869209
15082,115,22514,4,10,0,0,0,14,5,2,4,5,7,23,nowin,win,dlbust,bust,20,0,14,194,0.427835052,0.041237113,0.592783505,2,0.583863602
15083,112,22514,10,4,0,0,0,14,5,2,4,5,7,23,nowin,win,dlbust,bust,20,0,14,203,0.448275862,0.054187192,0.600985222,3,0.889576933
15084,106,22515,5,2,4,4,3,18,10,6,1,0,0,17,nowin,win,plwin,beat,20,0,7,192,0.411458333,0.026041667,0.557291667,0,0.023854304
15085,65,22515,10,2,0,3,9,24,10,6,1,0,0,17,nowin,loss,bust,plbust,0,10,12,203,0.492610837,0.054187192,0.571428571,3,0.913702814
15086,52,22515,3,10,0,10,0,23,10,6,1,0,0,17,nowin,loss,bust,plbust,0,10,13,217,0.414746544,0.02764977,0.599078341,2,0.576736024
15087,99,22515,7,10,0,0,0,17,10,6,1,0,0,17,nowin,push,push,push,10,0,17,207,0.47826087,0.062801932,0.637681159,3,0.961418446
15088,129,22515,8,6,0,10,0,24,10,6,1,0,0,17,nowin,loss,bust,plbust,0,10,14,201,0.422885572,0.064676617,0.55721393,0,0.027255383
15089,35,22515,8,10,0,0,0,18,10,6,1,0,0,17,nowin,win,plwin,beat,20,0,18,202,0.410891089,0.044554455,0.633663366,2,0.598681573
15090,96,22516,5,1,10,1,0,17,10,2,5,0,0,17,nowin,push,push,push,10,0,6,190,0.468421053,0.057894737,0.584210526,3,0.897263354
15091,96,22516,11,9,0,0,0,20,10,2,5,0,0,17,nowin,win,plwin,beat,20,0,20,190,0.468421053,0.057894737,0.584210526,3,0.897263354
15092,80,22516,8,2,7,0,0,17,10,2,5,0,0,17,nowin,push,push,push,10,0,10,186,0.419354839,0.059139785,0.623655914,2,0.59892924
15093,126,22516,10,8,0,0,0,18,10,2,5,0,0,17,nowin,win,plwin,beat,20,0,18,188,0.457446809,0.074468085,0.60106383,3,0.900633203
15094,44,22516,10,9,0,0,0,19,10,2,5,0,0,17,nowin,win,plwin,beat,20,0,19,219,0.433789954,0.050228311,0.534246575,1,0.285551035
15095,22,22516,7,10,0,0,0,17,10,2,5,0,0,17,nowin,push,push,push,10,0,17,187,0.481283422,0.042780749,0.577540107,3,0.906128176
15096,129,22517,3,10,0,0,0,13,4,4,10,0,0,18,nowin,loss,beat,dlwin,0,10,13,201,0.422885572,0.064676617,0.55721393,0,0.027255383
15097,105,22517,7,5,0,0,0,12,4,4,10,0,0,18,nowin,loss,beat,dlwin,0,10,12,198,0.414141414,0.070707071,0.590909091,0,0.032889494
15098,40,22517,5,11,4,0,0,20,4,4,10,0,0,18,nowin,win,plwin,beat,20,0,16,196,0.367346939,0.030612245,0.617346939,0,0.025358183
15099,60,22517,10,7,0,0,0,17,4,4,10,0,0,18,nowin,loss,beat,dlwin,0,10,17,227,0.418502203,0.022026432,0.559471366,0,0.026496258
15100,125,22517,1,1,10,0,0,12,4,4,10,0,0,18,nowin,loss,beat,dlwin,0,10,2,219,0.438356164,0.050228311,0.575342466,1,0.308411257
15101,40,22517,11,10,0,0,0,21,4,4,10,0,0,18,win,win,plwin,beat,25,0,21,196,0.367346939,0.030612245,0.617346939,0,0.025358183
15102,22,22518,6,3,9,0,0,18,4,10,3,0,0,17,nowin,win,plwin,beat,20,0,9,187,0.481283422,0.042780749,0.577540107,3,0.906128176
15103,52,22518,7,10,0,0,0,17,4,10,3,0,0,17,nowin,push,push,push,10,0,17,217,0.414746544,0.02764977,0.599078341,2,0.576736024
15104,1,22518,9,6,0,0,0,15,4,10,3,0,0,17,nowin,loss,beat,dlwin,0,10,15,197,0.406091371,0.025380711,0.649746193,2,0.606186955
15105,8,22518,10,8,0,0,0,18,4,10,3,0,0,17,nowin,win,plwin,beat,20,0,18,181,0.44198895,0.071823204,0.596685083,2,0.599438402
15106,147,22518,2,10,0,0,0,12,4,10,3,0,0,17,nowin,loss,beat,dlwin,0,10,12,205,0.380487805,0.014634146,0.536585366,0,0.00951447
15107,117,22518,1,6,5,0,0,12,4,10,3,0,0,17,nowin,loss,beat,dlwin,0,10,7,173,0.410404624,0.069364162,0.606936416,2,0.578610282
15108,44,22519,7,9,0,0,0,16,4,5,6,10,0,25,nowin,win,dlbust,bust,20,0,16,219,0.433789954,0.050228311,0.534246575,1,0.285551035
15109,70,22519,6,3,7,0,0,16,4,5,6,10,0,25,nowin,win,dlbust,bust,20,0,9,228,0.385964912,0.039473684,0.557017544,0,0.016157125
15110,89,22519,2,9,4,0,0,15,4,5,6,10,0,25,nowin,win,dlbust,bust,20,0,11,212,0.537735849,0.047169811,0.594339623,3,0.990167191
15111,36,22519,10,9,0,0,0,19,4,5,6,10,0,25,nowin,win,dlbust,bust,20,0,19,229,0.445414847,0.056768559,0.655021834,2,0.645370571
15112,2,22519,10,9,0,0,0,19,4,5,6,10,0,25,nowin,win,dlbust,bust,20,0,19,200,0.445,0.035,0.64,2,0.633962549
15113,24,22519,10,3,0,0,0,13,4,5,6,10,0,25,nowin,win,dlbust,bust,20,0,13,207,0.458937198,0.048309179,0.570048309,1,0.318138014
15114,106,22520,10,5,0,1,10,26,9,10,0,0,0,19,nowin,loss,bust,plbust,0,10,15,192,0.411458333,0.026041667,0.557291667,0,0.023854304
15115,146,22520,9,3,0,3,1,16,9,10,0,0,0,19,nowin,loss,beat,dlwin,0,10,12,221,0.43438914,0.040723982,0.542986425,1,0.290190091
15116,37,22520,10,6,0,4,0,20,9,10,0,0,0,19,nowin,win,plwin,beat,20,0,16,208,0.394230769,0.038461538,0.581730769,0,0.024682772
15117,75,22520,5,6,4,5,0,20,9,10,0,0,0,19,nowin,win,plwin,beat,20,0,11,191,0.418848168,0.052356021,0.570680628,0,0.029344702
15118,59,22520,8,10,0,0,0,18,9,10,0,0,0,19,nowin,loss,beat,dlwin,0,10,18,228,0.429824561,0.048245614,0.543859649,1,0.287885446
15119,94,22520,6,5,4,4,0,19,9,10,0,0,0,19,nowin,push,push,push,10,0,11,183,0.43715847,0.043715847,0.540983607,1,0.290866892
15120,19,22521,9,7,0,2,0,18,10,9,0,0,0,19,nowin,loss,beat,dlwin,0,10,16,237,0.41350211,0.054852321,0.628691983,2,0.597373826
15121,58,22521,7,3,10,0,0,20,10,9,0,0,0,19,nowin,win,plwin,beat,20,0,10,195,0.430769231,0.041025641,0.584615385,2,0.580497586
15122,141,22521,10,11,0,0,0,21,10,9,0,0,0,19,win,win,plwin,beat,25,0,21,202,0.420792079,0.074257426,0.564356436,0,0.028377851
15123,109,22521,10,11,0,0,0,21,10,9,0,0,0,19,win,win,plwin,beat,25,0,21,221,0.461538462,0.058823529,0.597285068,3,0.901830309
15124,10,22521,1,1,10,2,3,17,10,9,0,0,0,19,nowin,loss,beat,dlwin,0,10,2,191,0.413612565,0.057591623,0.596858639,2,0.574087175
15125,7,22521,1,1,10,5,0,17,10,9,0,0,0,19,nowin,loss,beat,dlwin,0,10,2,183,0.442622951,0.06010929,0.62295082,2,0.619303341
15126,22,22522,3,4,8,0,0,15,4,5,4,1,9,23,nowin,win,dlbust,bust,20,0,7,187,0.481283422,0.042780749,0.577540107,3,0.906128176
15127,4,22522,7,3,6,0,0,16,4,5,4,1,9,23,nowin,win,dlbust,bust,20,0,10,217,0.460829493,0.036866359,0.562211982,1,0.315432839
15128,113,22522,10,7,0,0,0,17,4,5,4,1,9,23,nowin,win,dlbust,bust,20,0,17,199,0.407035176,0.055276382,0.668341709,2,0.620695264
15129,18,22522,5,10,0,0,0,15,4,5,4,1,9,23,nowin,win,dlbust,bust,20,0,15,182,0.461538462,0.043956044,0.587912088,3,0.892649374
15130,33,22522,11,8,0,0,0,19,4,5,4,1,9,23,nowin,win,dlbust,bust,20,0,19,192,0.4375,0.057291667,0.625,2,0.616208916
15131,24,22522,9,7,0,0,0,16,4,5,4,1,9,23,nowin,win,dlbust,bust,20,0,16,207,0.458937198,0.048309179,0.570048309,1,0.318138014
15132,59,22523,5,10,0,0,0,15,5,9,2,5,0,21,nowin,loss,beat,dlwin,0,10,15,228,0.429824561,0.048245614,0.543859649,1,0.287885446
15133,54,22523,10,10,0,0,0,20,5,9,2,5,0,21,nowin,loss,beat,dlwin,0,10,20,185,0.437837838,0.032432432,0.556756757,1,0.29899854
15134,91,22523,9,7,0,0,0,16,5,9,2,5,0,21,nowin,loss,beat,dlwin,0,10,16,194,0.417525773,0.046391753,0.515463918,1,0.266616552
15135,55,22523,10,8,0,0,0,18,5,9,2,5,0,21,nowin,loss,beat,dlwin,0,10,18,191,0.371727749,0.057591623,0.54973822,0,0.01011347
15136,73,22523,4,9,0,0,0,13,5,9,2,5,0,21,nowin,loss,beat,dlwin,0,10,13,181,0.375690608,0.011049724,0.596685083,0,0.022795773
15137,4,22523,10,11,0,0,0,21,5,9,2,5,0,21,win,push,push,push,10,0,21,217,0.460829493,0.036866359,0.562211982,1,0.315432839
15138,137,22524,2,10,0,2,10,24,11,8,0,0,0,19,nowin,loss,bust,plbust,0,10,12,194,0.417525773,0.046391753,0.536082474,1,0.276714602
15139,141,22524,4,3,3,3,8,21,11,8,0,0,0,19,nowin,win,plwin,beat,20,0,7,202,0.420792079,0.074257426,0.564356436,0,0.028377851
15140,114,22524,10,9,0,0,0,19,11,8,0,0,0,19,nowin,push,push,push,10,0,19,198,0.47979798,0.025252525,0.611111111,3,0.937232995
15141,116,22524,6,4,2,10,0,22,11,8,0,0,0,19,nowin,loss,bust,plbust,0,10,10,195,0.425641026,0.056410256,0.538461538,1,0.28273747
15142,118,22524,2,10,0,8,0,20,11,8,0,0,0,19,nowin,win,plwin,beat,20,0,12,216,0.393518519,0.037037037,0.555555556,0,0.018059873
15143,45,22524,7,6,0,10,0,23,11,8,0,0,0,19,nowin,loss,bust,plbust,0,10,13,196,0.428571429,0.051020408,0.612244898,2,0.598821767
15144,110,22525,8,6,0,0,0,14,4,2,10,6,0,22,nowin,win,dlbust,bust,20,0,14,192,0.416666667,0.046875,0.557291667,0,0.025413132
15145,68,22525,10,10,0,0,0,20,4,2,10,6,0,22,nowin,win,dlbust,bust,20,0,20,205,0.434146341,0.029268293,0.6,2,0.59483189
15146,143,22525,4,3,2,9,0,18,4,2,10,6,0,22,nowin,win,dlbust,bust,20,0,7,203,0.463054187,0.044334975,0.57635468,3,0.883143365
15147,110,22525,10,10,0,0,0,20,4,2,10,6,0,22,nowin,win,dlbust,bust,20,0,20,192,0.416666667,0.046875,0.557291667,0,0.025413132
15148,71,22525,4,7,7,0,0,18,4,2,10,6,0,22,nowin,win,dlbust,bust,20,0,11,193,0.352331606,0.046632124,0.585492228,0,0.013063661
15149,11,22525,8,9,0,0,0,17,4,2,10,6,0,22,nowin,win,dlbust,bust,20,0,17,236,0.457627119,0.016949153,0.588983051,3,0.889015813
15150,77,22526,6,4,5,0,0,15,5,6,3,6,0,20,nowin,loss,beat,dlwin,0,10,10,200,0.455,0.04,0.62,3,0.916252116
15151,27,22526,10,8,0,0,0,18,5,6,3,6,0,20,nowin,loss,beat,dlwin,0,10,18,178,0.370786517,0.016853933,0.573033708,0,0.015536309
15152,100,22526,3,2,8,0,0,13,5,6,3,6,0,20,nowin,loss,beat,dlwin,0,10,5,190,0.452631579,0.036842105,0.594736842,3,0.888671154
15153,141,22526,4,7,10,0,0,21,5,6,3,6,0,20,nowin,win,plwin,beat,20,0,11,202,0.420792079,0.074257426,0.564356436,0,0.028377851
15154,100,22526,1,3,10,0,0,14,5,6,3,6,0,20,nowin,loss,beat,dlwin,0,10,4,190,0.452631579,0.036842105,0.594736842,3,0.888671154
15155,125,22526,5,10,0,0,0,15,5,6,3,6,0,20,nowin,loss,beat,dlwin,0,10,15,219,0.438356164,0.050228311,0.575342466,1,0.308411257
15156,127,22527,7,10,0,0,0,17,10,8,0,0,0,18,nowin,loss,beat,dlwin,0,10,17,201,0.402985075,0.029850746,0.60199005,0,0.032263937
15157,87,22527,4,5,5,2,1,17,10,8,0,0,0,18,nowin,loss,beat,dlwin,0,10,9,202,0.405940594,0.054455446,0.628712871,2,0.590599801
15158,39,22527,8,7,0,10,0,25,10,8,0,0,0,18,nowin,loss,bust,plbust,0,10,15,191,0.429319372,0.062827225,0.57591623,0,0.033760763
15159,57,22527,10,10,0,0,0,20,10,8,0,0,0,18,nowin,win,plwin,beat,20,0,20,192,0.46875,0.052083333,0.59375,3,0.907001181
15160,46,22527,10,10,0,0,0,20,10,8,0,0,0,18,nowin,win,plwin,beat,20,0,20,186,0.403225806,0.048387097,0.591397849,0,0.029742194
15161,94,22527,4,9,0,10,0,23,10,8,0,0,0,18,nowin,loss,bust,plbust,0,10,13,183,0.43715847,0.043715847,0.540983607,1,0.290866892
15162,94,22528,10,10,0,0,0,20,10,5,5,0,0,20,nowin,push,push,push,10,0,20,183,0.43715847,0.043715847,0.540983607,1,0.290866892
15163,99,22528,9,5,0,2,1,17,10,5,5,0,0,20,nowin,loss,beat,dlwin,0,10,14,207,0.47826087,0.062801932,0.637681159,3,0.961418446
15164,7,22528,4,6,4,10,0,24,10,5,5,0,0,20,nowin,loss,bust,plbust,0,10,10,183,0.442622951,0.06010929,0.62295082,2,0.619303341
15165,124,22528,6,10,0,10,0,26,10,5,5,0,0,20,nowin,loss,bust,plbust,0,10,16,202,0.47029703,0.064356436,0.584158416,3,0.899458193
15166,37,22528,3,4,2,5,6,20,10,5,5,0,0,20,nowin,push,push,push,10,0,7,208,0.394230769,0.038461538,0.581730769,0,0.024682772
15167,25,22528,11,4,1,9,0,25,10,5,5,0,0,20,nowin,loss,bust,plbust,0,10,15,190,0.463157895,0.063157895,0.536842105,1,0.304401563
15168,19,22529,10,2,0,10,0,22,8,3,10,0,0,21,nowin,loss,bust,plbust,0,10,12,237,0.41350211,0.054852321,0.628691983,2,0.597373826
15169,123,22529,7,6,0,10,0,23,8,3,10,0,0,21,nowin,loss,bust,plbust,0,10,13,205,0.43902439,0.034146341,0.614634146,2,0.609962544
15170,48,22529,6,8,0,5,0,19,8,3,10,0,0,21,nowin,loss,beat,dlwin,0,10,14,203,0.413793103,0.019704433,0.600985222,2,0.577280801
15171,70,22529,11,10,0,0,0,21,8,3,10,0,0,21,win,push,push,push,10,0,21,228,0.385964912,0.039473684,0.557017544,0,0.016157125
15172,3,22529,8,10,0,0,0,18,8,3,10,0,0,21,nowin,loss,beat,dlwin,0,10,18,190,0.431578947,0.026315789,0.542105263,1,0.288076384
15173,53,22529,2,3,9,9,0,23,8,3,10,0,0,21,nowin,loss,bust,plbust,0,10,5,250,0.372,0.064,0.564,0,0.013687345
15174,28,22530,10,4,0,0,0,14,3,1,10,3,0,17,nowin,loss,beat,dlwin,0,10,14,199,0.422110553,0.045226131,0.542713568,1,0.282706618
15175,15,22530,8,11,0,0,0,19,3,1,10,3,0,17,nowin,win,plwin,beat,20,0,19,212,0.410377358,0.051886792,0.561320755,0,0.024517408
15176,49,22530,1,6,10,0,0,17,3,1,10,3,0,17,nowin,push,push,push,10,0,7,207,0.396135266,0.053140097,0.594202899,0,0.028306925
15177,139,22530,3,7,10,0,0,20,3,1,10,3,0,17,nowin,win,plwin,beat,20,0,10,192,0.380208333,0.036458333,0.59375,0,0.023429169
15178,11,22530,4,8,0,10,0,22,3,1,10,3,0,17,nowin,loss,bust,plbust,0,10,12,236,0.457627119,0.016949153,0.588983051,3,0.889015813
15179,82,22530,6,9,0,0,0,15,3,1,10,3,0,17,nowin,loss,beat,dlwin,0,10,15,225,0.408888889,0.075555556,0.577777778,0,0.028101874
15180,17,22531,10,10,0,0,0,20,8,10,0,0,0,18,nowin,win,plwin,beat,20,0,20,171,0.444444444,0.070175439,0.555555556,1,0.302364894
15181,138,22531,1,6,10,0,0,17,8,10,0,0,0,18,nowin,loss,beat,dlwin,0,10,7,190,0.442105263,0.047368421,0.610526316,2,0.609711065
15182,82,22531,2,6,5,3,4,20,8,10,0,0,0,18,nowin,win,plwin,beat,20,0,8,225,0.408888889,0.075555556,0.577777778,0,0.028101874
15183,147,22531,8,6,0,3,0,17,8,10,0,0,0,18,nowin,loss,beat,dlwin,0,10,14,205,0.380487805,0.014634146,0.536585366,0,0.00951447
15184,109,22531,4,10,0,7,0,21,8,10,0,0,0,18,nowin,win,plwin,beat,20,0,14,221,0.461538462,0.058823529,0.597285068,3,0.901830309
15185,51,22531,10,4,0,2,4,20,8,10,0,0,0,18,nowin,win,plwin,beat,20,0,14,189,0.529100529,0.068783069,0.608465608,3,0.993665715
15186,120,22532,9,10,0,0,0,19,10,10,0,0,0,20,nowin,loss,beat,dlwin,0,10,19,202,0.440594059,0.034653465,0.618811881,2,0.614441029
15187,5,22532,10,10,0,0,0,20,10,10,0,0,0,20,nowin,push,push,push,10,0,20,203,0.42364532,0.02955665,0.596059113,2,0.582508076
15188,3,22532,10,10,0,0,0,20,10,10,0,0,0,20,nowin,push,push,push,10,0,20,190,0.431578947,0.026315789,0.542105263,1,0.288076384
15189,72,22532,7,9,0,10,0,26,10,10,0,0,0,20,nowin,loss,bust,plbust,0,10,16,185,0.394594595,0.032432432,0.508108108,0,0.006763115
15190,115,22532,4,6,7,0,0,17,10,10,0,0,0,20,nowin,loss,beat,dlwin,0,10,10,194,0.427835052,0.041237113,0.592783505,2,0.583863602
15191,13,22532,10,2,0,5,0,17,10,10,0,0,0,20,nowin,loss,beat,dlwin,0,10,12,206,0.417475728,0.063106796,0.621359223,2,0.59555479
15192,8,22533,5,1,9,4,0,19,8,10,0,0,0,18,nowin,win,plwin,beat,20,0,6,181,0.44198895,0.071823204,0.596685083,2,0.599438402
15193,19,22533,10,11,0,0,0,21,8,10,0,0,0,18,win,win,plwin,beat,25,0,21,237,0.41350211,0.054852321,0.628691983,2,0.597373826
15194,88,22533,10,5,0,8,0,23,8,10,0,0,0,18,nowin,loss,bust,plbust,0,10,15,206,0.466019417,0.033980583,0.54368932,1,0.309467903
15195,37,22533,9,4,0,7,0,20,8,10,0,0,0,18,nowin,win,plwin,beat,20,0,13,208,0.394230769,0.038461538,0.581730769,0,0.024682772
15196,66,22533,11,8,0,0,0,19,8,10,0,0,0,18,nowin,win,plwin,beat,20,0,19,217,0.456221198,0.064516129,0.626728111,3,0.924304367
15197,23,22533,10,4,0,4,0,18,8,10,0,0,0,18,nowin,push,push,push,10,0,14,208,0.427884615,0.0625,0.552884615,1,0.29114424
15198,137,22534,6,10,0,10,0,26,9,10,0,0,0,19,nowin,loss,bust,plbust,0,10,16,194,0.417525773,0.046391753,0.536082474,1,0.276714602
15199,131,22534,2,10,0,9,0,21,9,10,0,0,0,19,nowin,win,plwin,beat,20,0,12,217,0.410138249,0.069124424,0.543778802,0,0.02015021
15200,119,22534,10,5,0,4,0,19,9,10,0,0,0,19,nowin,push,push,push,10,0,15,190,0.405263158,0.068421053,0.515789474,0,0.011837158
15201,36,22534,9,11,0,0,0,20,9,10,0,0,0,19,nowin,win,plwin,beat,20,0,20,229,0.445414847,0.056768559,0.655021834,2,0.645370571
15202,57,22534,11,4,2,0,0,17,9,10,0,0,0,19,nowin,loss,beat,dlwin,0,10,15,192,0.46875,0.052083333,0.59375,3,0.907001181
15203,95,22534,10,5,0,10,0,25,9,10,0,0,0,19,nowin,loss,bust,plbust,0,10,15,218,0.412844037,0.04587156,0.559633028,0,0.024842385
15204,23,22535,10,7,0,0,0,17,10,7,0,0,0,17,nowin,push,push,push,10,0,17,208,0.427884615,0.0625,0.552884615,1,0.29114424
15205,33,22535,7,11,0,0,0,18,10,7,0,0,0,17,nowin,win,plwin,beat,20,0,18,192,0.4375,0.057291667,0.625,2,0.616208916
15206,130,22535,10,4,0,3,0,17,10,7,0,0,0,17,nowin,push,push,push,10,0,14,219,0.410958904,0.03652968,0.566210046,0,0.025888739
15207,28,22535,6,8,0,10,0,24,10,7,0,0,0,17,nowin,loss,bust,plbust,0,10,14,199,0.422110553,0.045226131,0.542713568,1,0.282706618
15208,48,22535,7,7,0,3,0,17,10,7,0,0,0,17,nowin,push,push,push,10,0,14,203,0.413793103,0.019704433,0.600985222,2,0.577280801
15209,27,22535,3,6,6,10,0,25,10,7,0,0,0,17,nowin,loss,bust,plbust,0,10,9,178,0.370786517,0.016853933,0.573033708,0,0.015536309
15210,97,22536,6,10,0,10,0,26,10,9,0,0,0,19,nowin,loss,bust,plbust,0,10,16,182,0.450549451,0.06043956,0.692307692,2,0.677372279
15211,9,22536,10,10,0,0,0,20,10,9,0,0,0,19,nowin,win,plwin,beat,20,0,20,194,0.37628866,0.015463918,0.541237113,0,0.009396796
15212,71,22536,4,11,2,0,0,17,10,9,0,0,0,19,nowin,loss,beat,dlwin,0,10,15,193,0.352331606,0.046632124,0.585492228,0,0.013063661
15213,122,22536,5,3,10,0,0,18,10,9,0,0,0,19,nowin,loss,beat,dlwin,0,10,8,210,0.347619048,0.052380952,0.59047619,0,0.012873677
15214,37,22536,1,3,10,3,0,17,10,9,0,0,0,19,nowin,loss,beat,dlwin,0,10,4,208,0.394230769,0.038461538,0.581730769,0,0.024682772
15215,16,22536,10,2,0,2,1,15,10,9,0,0,0,19,nowin,loss,beat,dlwin,0,10,12,220,0.427272727,0.081818182,0.6,2,0.588660176
15216,35,22537,10,4,0,6,0,20,7,4,9,0,0,20,nowin,push,push,push,10,0,14,202,0.410891089,0.044554455,0.633663366,2,0.598681573
15217,1,22537,2,7,3,8,0,20,7,4,9,0,0,20,nowin,push,push,push,10,0,9,197,0.406091371,0.025380711,0.649746193,2,0.606186955
15218,127,22537,7,9,0,5,0,21,7,4,9,0,0,20,nowin,win,plwin,beat,20,0,16,201,0.402985075,0.029850746,0.60199005,0,0.032263937
15219,53,22537,10,10,0,0,0,20,7,4,9,0,0,20,nowin,push,push,push,10,0,20,250,0.372,0.064,0.564,0,0.013687345
15220,137,22537,4,8,0,4,1,17,7,4,9,0,0,20,nowin,loss,beat,dlwin,0,10,12,194,0.417525773,0.046391753,0.536082474,1,0.276714602
15221,20,22537,10,10,0,0,0,20,7,4,9,0,0,20,nowin,push,push,push,10,0,20,186,0.456989247,0.037634409,0.537634409,1,0.301097108
15222,94,22538,10,4,0,0,0,14,6,3,7,6,0,22,nowin,win,dlbust,bust,20,0,14,183,0.43715847,0.043715847,0.540983607,1,0.290866892
15223,99,22538,2,10,0,0,0,12,6,3,7,6,0,22,nowin,win,dlbust,bust,20,0,12,207,0.47826087,0.062801932,0.637681159,3,0.961418446
15224,23,22538,10,5,0,0,0,15,6,3,7,6,0,22,nowin,win,dlbust,bust,20,0,15,208,0.427884615,0.0625,0.552884615,1,0.29114424
15225,130,22538,6,8,0,0,0,14,6,3,7,6,0,22,nowin,win,dlbust,bust,20,0,14,219,0.410958904,0.03652968,0.566210046,0,0.025888739
15226,116,22538,11,10,0,0,0,21,6,3,7,6,0,22,win,win,dlbust,bust,25,0,21,195,0.425641026,0.056410256,0.538461538,1,0.28273747
15227,112,22538,4,2,4,10,0,20,6,3,7,6,0,22,nowin,win,dlbust,bust,20,0,6,203,0.448275862,0.054187192,0.600985222,3,0.889576933
15228,130,22539,10,4,0,3,0,17,10,2,10,0,0,22,nowin,win,dlbust,bust,20,0,14,219,0.410958904,0.03652968,0.566210046,0,0.025888739
15229,79,22539,2,10,0,2,6,20,10,2,10,0,0,22,nowin,win,dlbust,bust,20,0,12,211,0.436018957,0.028436019,0.672985782,2,0.650131054
15230,5,22539,10,5,0,7,0,22,10,2,10,0,0,22,nowin,loss,bust,plbust,0,10,15,203,0.42364532,0.02955665,0.596059113,2,0.582508076
15231,4,22539,2,2,10,10,0,24,10,2,10,0,0,22,nowin,loss,bust,plbust,0,10,4,217,0.460829493,0.036866359,0.562211982,1,0.315432839
15232,8,22539,10,11,0,0,0,21,10,2,10,0,0,22,win,win,dlbust,bust,25,0,21,181,0.44198895,0.071823204,0.596685083,2,0.599438402
15233,19,22539,10,10,0,0,0,20,10,2,10,0,0,22,nowin,win,dlbust,bust,20,0,20,237,0.41350211,0.054852321,0.628691983,2,0.597373826
15234,14,22540,8,10,0,0,0,18,10,10,0,0,0,20,nowin,loss,beat,dlwin,0,10,18,202,0.391089109,0.01980198,0.628712871,2,0.577264877
15235,118,22540,10,7,0,0,0,17,10,10,0,0,0,20,nowin,loss,beat,dlwin,0,10,17,216,0.393518519,0.037037037,0.555555556,0,0.018059873
15236,70,22540,5,9,0,10,0,24,10,10,0,0,0,20,nowin,loss,bust,plbust,0,10,14,228,0.385964912,0.039473684,0.557017544,0,0.016157125
15237,91,22540,4,8,0,10,0,22,10,10,0,0,0,20,nowin,loss,bust,plbust,0,10,12,194,0.417525773,0.046391753,0.515463918,1,0.266616552
15238,66,22540,10,10,0,0,0,20,10,10,0,0,0,20,nowin,push,push,push,10,0,20,217,0.456221198,0.064516129,0.626728111,3,0.924304367
15239,81,22540,11,10,0,0,0,21,10,10,0,0,0,20,win,win,plwin,beat,25,0,21,182,0.395604396,0.043956044,0.60989011,2,0.567491261
15240,78,22541,6,3,10,0,0,19,8,10,0,0,0,18,nowin,win,plwin,beat,20,0,9,201,0.517412935,0.034825871,0.587064677,3,0.95871112
15241,107,22541,11,10,0,0,0,21,8,10,0,0,0,18,win,win,plwin,beat,25,0,21,218,0.444954128,0.073394495,0.600917431,2,0.605210014
15242,101,22541,8,2,2,10,0,22,8,10,0,0,0,18,nowin,loss,bust,plbust,0,10,10,205,0.424390244,0.068292683,0.63902439,2,0.614740646
15243,9,22541,8,9,0,0,0,17,8,10,0,0,0,18,nowin,loss,beat,dlwin,0,10,17,194,0.37628866,0.015463918,0.541237113,0,0.009396796
15244,92,22541,10,10,0,0,0,20,8,10,0,0,0,18,nowin,win,plwin,beat,20,0,20,186,0.446236559,0.059139785,0.564516129,1,0.307826125
15245,134,22541,10,5,0,10,0,25,8,10,0,0,0,18,nowin,loss,bust,plbust,0,10,15,185,0.443243243,0.021621622,0.545945946,1,0.296939509
15246,11,22542,10,10,0,0,0,20,2,5,4,7,0,18,nowin,win,plwin,beat,20,0,20,236,0.457627119,0.016949153,0.588983051,3,0.889015813
15247,124,22542,10,10,0,0,0,20,2,5,4,7,0,18,nowin,win,plwin,beat,20,0,20,202,0.47029703,0.064356436,0.584158416,3,0.899458193
15248,49,22542,9,11,0,0,0,20,2,5,4,7,0,18,nowin,win,plwin,beat,20,0,20,207,0.396135266,0.053140097,0.594202899,0,0.028306925
15249,37,22542,7,8,0,0,0,15,2,5,4,7,0,18,nowin,loss,beat,dlwin,0,10,15,208,0.394230769,0.038461538,0.581730769,0,0.024682772
15250,55,22542,10,11,0,0,0,21,2,5,4,7,0,18,win,win,plwin,beat,25,0,21,191,0.371727749,0.057591623,0.54973822,0,0.01011347
15251,137,22542,4,10,0,0,0,14,2,5,4,7,0,18,nowin,loss,beat,dlwin,0,10,14,194,0.417525773,0.046391753,0.536082474,1,0.276714602
15252,51,22543,2,10,0,1,10,23,10,9,0,0,0,19,nowin,loss,bust,plbust,0,10,12,189,0.529100529,0.068783069,0.608465608,3,0.993665715
15253,4,22543,7,4,8,0,0,19,10,9,0,0,0,19,nowin,push,push,push,10,0,11,217,0.460829493,0.036866359,0.562211982,1,0.315432839
15254,65,22543,6,7,0,8,0,21,10,9,0,0,0,19,nowin,win,plwin,beat,20,0,13,203,0.492610837,0.054187192,0.571428571,3,0.913702814
15255,22,22543,5,10,0,7,0,22,10,9,0,0,0,19,nowin,loss,bust,plbust,0,10,15,187,0.481283422,0.042780749,0.577540107,3,0.906128176
15256,143,22543,11,9,0,0,0,20,10,9,0,0,0,19,nowin,win,plwin,beat,20,0,20,203,0.463054187,0.044334975,0.57635468,3,0.883143365
15257,58,22543,11,4,3,0,0,18,10,9,0,0,0,19,nowin,loss,beat,dlwin,0,10,15,195,0.430769231,0.041025641,0.584615385,2,0.580497586
15258,66,22544,2,10,0,6,0,18,10,10,0,0,0,20,nowin,loss,beat,dlwin,0,10,12,217,0.456221198,0.064516129,0.626728111,3,0.924304367
15259,71,22544,10,3,0,7,0,20,10,10,0,0,0,20,nowin,push,push,push,10,0,13,193,0.352331606,0.046632124,0.585492228,0,0.013063661
15260,31,22544,11,6,2,0,0,19,10,10,0,0,0,20,nowin,loss,beat,dlwin,0,10,17,188,0.473404255,0.058510638,0.515957447,1,0.300306557
15261,23,22544,4,10,0,2,3,19,10,10,0,0,0,20,nowin,loss,beat,dlwin,0,10,14,208,0.427884615,0.0625,0.552884615,1,0.29114424
15262,30,22544,10,10,0,0,0,20,10,10,0,0,0,20,nowin,push,push,push,10,0,20,206,0.393203883,0.033980583,0.601941748,0,0.029324648
15263,120,22544,5,8,0,9,0,22,10,10,0,0,0,20,nowin,loss,bust,plbust,0,10,13,202,0.440594059,0.034653465,0.618811881,2,0.614441029
15264,82,22545,10,2,0,0,0,12,6,7,8,0,0,21,nowin,loss,beat,dlwin,0,10,12,225,0.408888889,0.075555556,0.577777778,0,0.028101874
15265,71,22545,9,4,0,0,0,13,6,7,8,0,0,21,nowin,loss,beat,dlwin,0,10,13,193,0.352331606,0.046632124,0.585492228,0,0.013063661
15266,83,22545,11,10,0,0,0,21,6,7,8,0,0,21,win,push,push,push,10,0,21,193,0.424870466,0.051813472,0.678756477,2,0.644360335
15267,31,22545,10,6,0,0,0,16,6,7,8,0,0,21,nowin,loss,beat,dlwin,0,10,16,188,0.473404255,0.058510638,0.515957447,1,0.300306557
15268,21,22545,6,8,0,0,0,14,6,7,8,0,0,21,nowin,loss,beat,dlwin,0,10,14,214,0.359813084,0.042056075,0.626168224,0,0.025263474
15269,118,22545,9,5,0,0,0,14,6,7,8,0,0,21,nowin,loss,beat,dlwin,0,10,14,216,0.393518519,0.037037037,0.555555556,0,0.018059873
15270,70,22546,11,1,6,0,0,18,10,4,10,0,0,24,nowin,win,dlbust,bust,20,0,12,228,0.385964912,0.039473684,0.557017544,0,0.016157125
15271,120,22546,4,1,9,10,0,24,10,4,10,0,0,24,nowin,loss,bust,plbust,0,10,5,202,0.440594059,0.034653465,0.618811881,2,0.614441029
15272,35,22546,6,4,2,2,1,15,10,4,10,0,0,24,nowin,win,dlbust,bust,20,0,10,202,0.410891089,0.044554455,0.633663366,2,0.598681573
15273,99,22546,7,9,0,1,0,17,10,4,10,0,0,24,nowin,win,dlbust,bust,20,0,16,207,0.47826087,0.062801932,0.637681159,3,0.961418446
15274,95,22546,4,8,0,10,0,22,10,4,10,0,0,24,nowin,loss,bust,plbust,0,10,12,218,0.412844037,0.04587156,0.559633028,0,0.024842385
15275,73,22546,8,10,0,0,0,18,10,4,10,0,0,24,nowin,win,dlbust,bust,20,0,18,181,0.375690608,0.011049724,0.596685083,0,0.022795773
15276,94,22547,10,10,0,0,0,20,4,7,10,0,0,21,nowin,loss,beat,dlwin,0,10,20,183,0.43715847,0.043715847,0.540983607,1,0.290866892
15277,83,22547,10,6,0,0,0,16,4,7,10,0,0,21,nowin,loss,beat,dlwin,0,10,16,193,0.424870466,0.051813472,0.678756477,2,0.644360335
15278,14,22547,4,3,7,0,0,14,4,7,10,0,0,21,nowin,loss,beat,dlwin,0,10,7,202,0.391089109,0.01980198,0.628712871,2,0.577264877
15279,86,22547,10,10,0,0,0,20,4,7,10,0,0,21,nowin,loss,beat,dlwin,0,10,20,196,0.454081633,0.040816327,0.591836735,3,0.887566443
15280,65,22547,10,2,0,0,0,12,4,7,10,0,0,21,nowin,loss,beat,dlwin,0,10,12,203,0.492610837,0.054187192,0.571428571,3,0.913702814
15281,120,22547,6,4,9,0,0,19,4,7,10,0,0,21,nowin,loss,beat,dlwin,0,10,10,202,0.440594059,0.034653465,0.618811881,2,0.614441029
15282,41,22548,10,4,0,0,0,14,4,10,10,0,0,24,nowin,win,dlbust,bust,20,0,14,192,0.364583333,0.036458333,0.520833333,0,0.00089702
15283,68,22548,10,2,0,0,0,12,4,10,10,0,0,24,nowin,win,dlbust,bust,20,0,12,205,0.434146341,0.029268293,0.6,2,0.59483189
15284,87,22548,8,11,0,0,0,19,4,10,10,0,0,24,nowin,win,dlbust,bust,20,0,19,202,0.405940594,0.054455446,0.628712871,2,0.590599801
15285,15,22548,8,9,0,0,0,17,4,10,10,0,0,24,nowin,win,dlbust,bust,20,0,17,212,0.410377358,0.051886792,0.561320755,0,0.024517408
15286,95,22548,9,7,0,0,0,16,4,10,10,0,0,24,nowin,win,dlbust,bust,20,0,16,218,0.412844037,0.04587156,0.559633028,0,0.024842385
15287,27,22548,2,4,10,0,0,16,4,10,10,0,0,24,nowin,win,dlbust,bust,20,0,6,178,0.370786517,0.016853933,0.573033708,0,0.015536309
15288,57,22549,3,8,8,0,0,19,10,7,0,0,0,17,nowin,win,plwin,beat,20,0,11,192,0.46875,0.052083333,0.59375,3,0.907001181
15289,141,22549,11,5,3,0,0,19,10,7,0,0,0,17,nowin,win,plwin,beat,20,0,16,202,0.420792079,0.074257426,0.564356436,0,0.028377851
15290,138,22549,5,8,0,9,0,22,10,7,0,0,0,17,nowin,loss,bust,plbust,0,10,13,190,0.442105263,0.047368421,0.610526316,2,0.609711065
15291,90,22549,9,10,0,0,0,19,10,7,0,0,0,17,nowin,win,plwin,beat,20,0,19,201,0.447761194,0.049751244,0.60199005,3,0.889945023
15292,130,22549,2,6,10,0,0,18,10,7,0,0,0,17,nowin,win,plwin,beat,20,0,8,219,0.410958904,0.03652968,0.566210046,0,0.025888739
15293,43,22549,6,5,7,0,0,18,10,7,0,0,0,17,nowin,win,plwin,beat,20,0,11,192,0.40625,0.041666667,0.609375,2,0.576671372
15294,3,22550,7,11,0,0,0,18,4,10,10,0,0,24,nowin,win,dlbust,bust,20,0,18,190,0.431578947,0.026315789,0.542105263,1,0.288076384
15295,112,22550,9,10,0,0,0,19,4,10,10,0,0,24,nowin,win,dlbust,bust,20,0,19,203,0.448275862,0.054187192,0.600985222,3,0.889576933
15296,26,22550,10,4,0,0,0,14,4,10,10,0,0,24,nowin,win,dlbust,bust,20,0,14,203,0.463054187,0.0591133,0.541871921,1,0.306802864
15297,111,22550,5,10,0,0,0,15,4,10,10,0,0,24,nowin,win,dlbust,bust,20,0,15,180,0.433333333,0.055555556,0.611111111,2,0.602264492
15298,11,22550,9,5,0,0,0,14,4,10,10,0,0,24,nowin,win,dlbust,bust,20,0,14,236,0.457627119,0.016949153,0.588983051,3,0.889015813
15299,104,22550,2,2,2,10,0,16,4,10,10,0,0,24,nowin,win,dlbust,bust,20,0,4,209,0.363636364,0.052631579,0.593301435,0,0.018359419
15300,89,22551,5,9,0,10,0,24,8,10,0,0,0,18,nowin,loss,bust,plbust,0,10,14,212,0.537735849,0.047169811,0.594339623,3,0.990167191
15301,19,22551,10,11,0,0,0,21,8,10,0,0,0,18,win,win,plwin,beat,25,0,21,237,0.41350211,0.054852321,0.628691983,2,0.597373826
15302,143,22551,4,5,4,8,0,21,8,10,0,0,0,18,nowin,win,plwin,beat,20,0,9,203,0.463054187,0.044334975,0.57635468,3,0.883143365
15303,70,22551,7,9,0,5,0,21,8,10,0,0,0,18,nowin,win,plwin,beat,20,0,16,228,0.385964912,0.039473684,0.557017544,0,0.016157125
15304,91,22551,10,3,0,10,0,23,8,10,0,0,0,18,nowin,loss,bust,plbust,0,10,13,194,0.417525773,0.046391753,0.515463918,1,0.266616552
15305,16,22551,2,2,9,10,0,23,8,10,0,0,0,18,nowin,loss,bust,plbust,0,10,4,220,0.427272727,0.081818182,0.6,2,0.588660176
15306,115,22552,5,10,0,0,0,15,6,6,4,10,0,26,nowin,win,dlbust,bust,20,0,15,194,0.427835052,0.041237113,0.592783505,2,0.583863602
15307,80,22552,9,6,0,0,0,15,6,6,4,10,0,26,nowin,win,dlbust,bust,20,0,15,186,0.419354839,0.059139785,0.623655914,2,0.59892924
15308,5,22552,10,3,0,0,0,13,6,6,4,10,0,26,nowin,win,dlbust,bust,20,0,13,203,0.42364532,0.02955665,0.596059113,2,0.582508076
15309,121,22552,10,10,0,0,0,20,6,6,4,10,0,26,nowin,win,dlbust,bust,20,0,20,195,0.456410256,0.025641026,0.512820513,1,0.288597791
15310,66,22552,11,10,0,0,0,21,6,6,4,10,0,26,win,win,dlbust,bust,25,0,21,217,0.456221198,0.064516129,0.626728111,3,0.924304367
15311,11,22552,5,7,0,0,0,12,6,6,4,10,0,26,nowin,win,dlbust,bust,20,0,12,236,0.457627119,0.016949153,0.588983051,3,0.889015813
15312,122,22553,7,6,0,6,0,19,11,8,0,0,0,19,nowin,push,push,push,10,0,13,210,0.347619048,0.052380952,0.59047619,0,0.012873677
15313,141,22553,5,2,7,5,0,19,11,8,0,0,0,19,nowin,push,push,push,10,0,7,202,0.420792079,0.074257426,0.564356436,0,0.028377851
15314,119,22553,2,10,0,5,0,17,11,8,0,0,0,19,nowin,loss,beat,dlwin,0,10,12,190,0.405263158,0.068421053,0.515789474,0,0.011837158
15315,64,22553,10,7,0,0,0,17,11,8,0,0,0,19,nowin,loss,beat,dlwin,0,10,17,187,0.363636364,0.048128342,0.631016043,0,0.027594885
15316,107,22553,10,7,0,0,0,17,11,8,0,0,0,19,nowin,loss,beat,dlwin,0,10,17,218,0.444954128,0.073394495,0.600917431,2,0.605210014
15317,83,22553,10,5,0,10,0,25,11,8,0,0,0,19,nowin,loss,bust,plbust,0,10,15,193,0.424870466,0.051813472,0.678756477,2,0.644360335
15318,62,22554,4,5,9,0,0,18,10,11,0,0,0,21,nowin,loss,beat,dlwin,0,10,9,178,0.370786517,0.028089888,0.54494382,0,0.008657722
15319,1,22554,10,10,0,0,0,20,10,11,0,0,0,21,nowin,loss,beat,dlwin,0,10,20,197,0.406091371,0.025380711,0.649746193,2,0.606186955
15320,146,22554,10,5,0,10,0,25,10,11,0,0,0,21,nowin,loss,bust,plbust,0,10,15,221,0.43438914,0.040723982,0.542986425,1,0.290190091
15321,88,22554,10,6,0,10,0,26,10,11,0,0,0,21,nowin,loss,bust,plbust,0,10,16,206,0.466019417,0.033980583,0.54368932,1,0.309467903
15322,41,22554,10,2,0,6,0,18,10,11,0,0,0,21,nowin,loss,beat,dlwin,0,10,12,192,0.364583333,0.036458333,0.520833333,0,0.00089702
15323,9,22554,5,10,0,1,2,18,10,11,0,0,0,21,nowin,loss,beat,dlwin,0,10,15,194,0.37628866,0.015463918,0.541237113,0,0.009396796
15324,60,22555,2,8,7,0,0,17,8,5,1,2,10,26,nowin,win,dlbust,bust,20,0,10,227,0.418502203,0.022026432,0.559471366,0,0.026496258
15325,54,22555,10,5,0,6,0,21,8,5,1,2,10,26,nowin,win,dlbust,bust,20,0,15,185,0.437837838,0.032432432,0.556756757,1,0.29899854
15326,11,22555,3,10,0,5,0,18,8,5,1,2,10,26,nowin,win,dlbust,bust,20,0,13,236,0.457627119,0.016949153,0.588983051,3,0.889015813
15327,15,22555,3,10,0,4,0,17,8,5,1,2,10,26,nowin,win,dlbust,bust,20,0,13,212,0.410377358,0.051886792,0.561320755,0,0.024517408
15328,31,22555,10,7,0,0,0,17,8,5,1,2,10,26,nowin,win,dlbust,bust,20,0,17,188,0.473404255,0.058510638,0.515957447,1,0.300306557
15329,98,22555,10,4,0,7,0,21,8,5,1,2,10,26,nowin,win,dlbust,bust,20,0,14,220,0.422727273,0.054545455,0.55,1,0.28664435
15330,91,22556,10,10,0,0,0,20,10,8,0,0,0,18,nowin,win,plwin,beat,20,0,20,194,0.417525773,0.046391753,0.515463918,1,0.266616552
15331,81,22556,6,3,7,1,0,17,10,8,0,0,0,18,nowin,loss,beat,dlwin,0,10,9,182,0.395604396,0.043956044,0.60989011,2,0.567491261
15332,12,22556,9,3,0,6,0,18,10,8,0,0,0,18,nowin,push,push,push,10,0,12,189,0.470899471,0.015873016,0.613756614,3,0.929171178
15333,33,22556,5,10,0,10,0,25,10,8,0,0,0,18,nowin,loss,bust,plbust,0,10,15,192,0.4375,0.057291667,0.625,2,0.616208916
15334,94,22556,2,8,6,10,0,26,10,8,0,0,0,18,nowin,loss,bust,plbust,0,10,10,183,0.43715847,0.043715847,0.540983607,1,0.290866892
15335,146,22556,10,6,0,10,0,26,10,8,0,0,0,18,nowin,loss,bust,plbust,0,10,16,221,0.43438914,0.040723982,0.542986425,1,0.290190091
15336,78,22557,8,9,0,0,0,17,2,10,10,0,0,22,nowin,win,dlbust,bust,20,0,17,201,0.517412935,0.034825871,0.587064677,3,0.95871112
15337,50,22557,2,2,10,0,0,14,2,10,10,0,0,22,nowin,win,dlbust,bust,20,0,4,202,0.405940594,0.04950495,0.54950495,0,0.020296079
15338,22,22557,4,4,10,0,0,18,2,10,10,0,0,22,nowin,win,dlbust,bust,20,0,8,187,0.481283422,0.042780749,0.577540107,3,0.906128176
15339,81,22557,7,5,0,10,0,22,2,10,10,0,0,22,nowin,loss,bust,plbust,0,10,12,182,0.395604396,0.043956044,0.60989011,2,0.567491261
15340,148,22557,10,11,0,0,0,21,2,10,10,0,0,22,win,win,dlbust,bust,25,0,21,204,0.401960784,0.078431373,0.593137255,0,0.029789521
15341,28,22557,7,6,0,0,0,13,2,10,10,0,0,22,nowin,win,dlbust,bust,20,0,13,199,0.422110553,0.045226131,0.542713568,1,0.282706618
15342,48,22558,10,4,0,3,0,17,10,2,3,8,0,23,nowin,win,dlbust,bust,20,0,14,203,0.413793103,0.019704433,0.600985222,2,0.577280801
15343,59,22558,3,3,5,4,7,22,10,2,3,8,0,23,nowin,loss,bust,plbust,0,10,6,228,0.429824561,0.048245614,0.543859649,1,0.287885446
15344,82,22558,9,11,0,0,0,20,10,2,3,8,0,23,nowin,win,dlbust,bust,20,0,20,225,0.408888889,0.075555556,0.577777778,0,0.028101874
15345,139,22558,7,2,9,0,0,18,10,2,3,8,0,23,nowin,win,dlbust,bust,20,0,9,192,0.380208333,0.036458333,0.59375,0,0.023429169
15346,132,22558,10,10,0,0,0,20,10,2,3,8,0,23,nowin,win,dlbust,bust,20,0,20,194,0.412371134,0.036082474,0.649484536,2,0.611633238
15347,22,22558,2,9,6,0,0,17,10,2,3,8,0,23,nowin,win,dlbust,bust,20,0,11,187,0.481283422,0.042780749,0.577540107,3,0.906128176
15348,94,22559,10,6,0,7,0,23,9,2,1,4,9,25,nowin,loss,bust,plbust,0,10,16,183,0.43715847,0.043715847,0.540983607,1,0.290866892
15349,52,22559,10,10,0,0,0,20,9,2,1,4,9,25,nowin,win,dlbust,bust,20,0,20,217,0.414746544,0.02764977,0.599078341,2,0.576736024
15350,57,22559,11,10,0,0,0,21,9,2,1,4,9,25,win,win,dlbust,bust,25,0,21,192,0.46875,0.052083333,0.59375,3,0.907001181
15351,27,22559,10,5,0,6,0,21,9,2,1,4,9,25,nowin,win,dlbust,bust,20,0,15,178,0.370786517,0.016853933,0.573033708,0,0.015536309
15352,4,22559,1,6,6,10,0,23,9,2,1,4,9,25,nowin,loss,bust,plbust,0,10,7,217,0.460829493,0.036866359,0.562211982,1,0.315432839
15353,144,22559,8,10,0,0,0,18,9,2,1,4,9,25,nowin,win,dlbust,bust,20,0,18,202,0.386138614,0.054455446,0.564356436,0,0.018006244
15354,61,22560,2,10,0,3,6,21,10,9,0,0,0,19,nowin,win,plwin,beat,20,0,12,194,0.427835052,0.077319588,0.603092784,2,0.591437139
15355,113,22560,7,9,0,3,0,19,10,9,0,0,0,19,nowin,push,push,push,10,0,16,199,0.407035176,0.055276382,0.668341709,2,0.620695264
15356,70,22560,5,4,8,0,0,17,10,9,0,0,0,19,nowin,loss,beat,dlwin,0,10,9,228,0.385964912,0.039473684,0.557017544,0,0.016157125
15357,74,22560,6,2,8,9,0,25,10,9,0,0,0,19,nowin,loss,bust,plbust,0,10,8,209,0.411483254,0.04784689,0.531100478,0,0.017448125
15358,1,22560,10,2,0,8,0,20,10,9,0,0,0,19,nowin,win,plwin,beat,20,0,12,197,0.406091371,0.025380711,0.649746193,2,0.606186955
15359,29,22560,10,10,0,0,0,20,10,9,0,0,0,19,nowin,win,plwin,beat,20,0,20,189,0.44973545,0.058201058,0.544973545,1,0.300349439
15360,95,22561,8,10,0,0,0,18,6,2,2,2,6,18,nowin,push,push,push,10,0,18,218,0.412844037,0.04587156,0.559633028,0,0.024842385
15361,103,22561,5,5,4,0,0,14,6,2,2,2,6,18,nowin,loss,beat,dlwin,0,10,10,203,0.379310345,0.064039409,0.551724138,0,0.012869209
15362,99,22561,10,10,0,0,0,20,6,2,2,2,6,18,nowin,win,plwin,beat,20,0,20,207,0.47826087,0.062801932,0.637681159,3,0.961418446
15363,14,22561,10,4,0,0,0,14,6,2,2,2,6,18,nowin,loss,beat,dlwin,0,10,14,202,0.391089109,0.01980198,0.628712871,2,0.577264877
15364,3,22561,10,10,0,0,0,20,6,2,2,2,6,18,nowin,win,plwin,beat,20,0,20,190,0.431578947,0.026315789,0.542105263,1,0.288076384
15365,84,22561,3,8,10,0,0,21,6,2,2,2,6,18,nowin,win,plwin,beat,20,0,11,195,0.379487179,0.056410256,0.569230769,0,0.017209119
15366,27,22562,10,3,0,2,9,24,7,3,2,8,0,20,nowin,loss,bust,plbust,0,10,13,178,0.370786517,0.016853933,0.573033708,0,0.015536309
15367,16,22562,11,10,0,0,0,21,7,3,2,8,0,20,win,win,plwin,beat,25,0,21,220,0.427272727,0.081818182,0.6,2,0.588660176
15368,22,22562,10,10,0,0,0,20,7,3,2,8,0,20,nowin,push,push,push,10,0,20,187,0.481283422,0.042780749,0.577540107,3,0.906128176
15369,101,22562,8,11,0,0,0,19,7,3,2,8,0,20,nowin,loss,beat,dlwin,0,10,19,205,0.424390244,0.068292683,0.63902439,2,0.614740646
15370,133,22562,3,9,0,10,0,22,7,3,2,8,0,20,nowin,loss,bust,plbust,0,10,12,201,0.47761194,0.064676617,0.611940299,3,0.935428111
15371,127,22562,8,7,0,4,0,19,7,3,2,8,0,20,nowin,loss,beat,dlwin,0,10,15,201,0.402985075,0.029850746,0.60199005,0,0.032263937
15372,87,22563,2,10,0,4,0,16,2,2,2,5,6,17,nowin,loss,beat,dlwin,0,10,12,202,0.405940594,0.054455446,0.628712871,2,0.590599801
15373,21,22563,9,11,0,0,0,20,2,2,2,5,6,17,nowin,win,plwin,beat,20,0,20,214,0.359813084,0.042056075,0.626168224,0,0.025263474
15374,92,22563,1,1,10,4,0,16,2,2,2,5,6,17,nowin,loss,beat,dlwin,0,10,2,186,0.446236559,0.059139785,0.564516129,1,0.307826125
15375,52,22563,10,10,0,0,0,20,2,2,2,5,6,17,nowin,win,plwin,beat,20,0,20,217,0.414746544,0.02764977,0.599078341,2,0.576736024
15376,138,22563,8,9,0,0,0,17,2,2,2,5,6,17,nowin,push,push,push,10,0,17,190,0.442105263,0.047368421,0.610526316,2,0.609711065
15377,120,22563,10,2,0,3,0,15,2,2,2,5,6,17,nowin,loss,beat,dlwin,0,10,12,202,0.440594059,0.034653465,0.618811881,2,0.614441029
15378,124,22564,11,9,0,0,0,20,9,10,0,0,0,19,nowin,win,plwin,beat,20,0,20,202,0.47029703,0.064356436,0.584158416,3,0.899458193
15379,130,22564,10,2,0,10,0,22,9,10,0,0,0,19,nowin,loss,bust,plbust,0,10,12,219,0.410958904,0.03652968,0.566210046,0,0.025888739
15380,101,22564,10,7,0,0,0,17,9,10,0,0,0,19,nowin,loss,beat,dlwin,0,10,17,205,0.424390244,0.068292683,0.63902439,2,0.614740646
15381,61,22564,9,3,0,1,10,23,9,10,0,0,0,19,nowin,loss,bust,plbust,0,10,12,194,0.427835052,0.077319588,0.603092784,2,0.591437139
15382,32,22564,10,7,0,0,0,17,9,10,0,0,0,19,nowin,loss,beat,dlwin,0,10,17,189,0.391534392,0.037037037,0.53968254,0,0.013579086
15383,6,22564,8,11,0,0,0,19,9,10,0,0,0,19,nowin,push,push,push,10,0,19,191,0.439790576,0.047120419,0.581151832,1,0.31211505
15384,64,22565,5,3,11,0,0,19,3,10,7,0,0,20,nowin,loss,beat,dlwin,0,10,8,187,0.363636364,0.048128342,0.631016043,0,0.027594885
15385,116,22565,3,10,0,0,0,13,3,10,7,0,0,20,nowin,loss,beat,dlwin,0,10,13,195,0.425641026,0.056410256,0.538461538,1,0.28273747
15386,63,22565,4,4,9,0,0,17,3,10,7,0,0,20,nowin,loss,beat,dlwin,0,10,8,216,0.467592593,0.037037037,0.62037037,3,0.931690496
15387,103,22565,11,10,0,0,0,21,3,10,7,0,0,20,win,win,plwin,beat,25,0,21,203,0.379310345,0.064039409,0.551724138,0,0.012869209
15388,77,22565,10,10,0,0,0,20,3,10,7,0,0,20,nowin,push,push,push,10,0,20,200,0.455,0.04,0.62,3,0.916252116
15389,63,22565,8,6,0,0,0,14,3,10,7,0,0,20,nowin,loss,beat,dlwin,0,10,14,216,0.467592593,0.037037037,0.62037037,3,0.931690496
15390,116,22566,10,6,0,5,0,21,10,10,0,0,0,20,nowin,win,plwin,beat,20,0,16,195,0.425641026,0.056410256,0.538461538,1,0.28273747
15391,120,22566,8,7,0,5,0,20,10,10,0,0,0,20,nowin,push,push,push,10,0,15,202,0.440594059,0.034653465,0.618811881,2,0.614441029
15392,11,22566,8,10,0,0,0,18,10,10,0,0,0,20,nowin,loss,beat,dlwin,0,10,18,236,0.457627119,0.016949153,0.588983051,3,0.889015813
15393,8,22566,10,10,0,0,0,20,10,10,0,0,0,20,nowin,push,push,push,10,0,20,181,0.44198895,0.071823204,0.596685083,2,0.599438402
15394,132,22566,10,9,0,0,0,19,10,10,0,0,0,20,nowin,loss,beat,dlwin,0,10,19,194,0.412371134,0.036082474,0.649484536,2,0.611633238
15395,139,22566,3,6,6,3,0,18,10,10,0,0,0,20,nowin,loss,beat,dlwin,0,10,9,192,0.380208333,0.036458333,0.59375,0,0.023429169
15396,91,22567,5,10,0,10,0,25,10,3,3,10,0,26,nowin,loss,bust,plbust,0,10,15,194,0.417525773,0.046391753,0.515463918,1,0.266616552
15397,97,22567,7,10,0,0,0,17,10,3,3,10,0,26,nowin,win,dlbust,bust,20,0,17,182,0.450549451,0.06043956,0.692307692,2,0.677372279
15398,79,22567,11,3,1,10,0,25,10,3,3,10,0,26,nowin,loss,bust,plbust,0,10,14,211,0.436018957,0.028436019,0.672985782,2,0.650131054
15399,107,22567,2,10,0,10,0,22,10,3,3,10,0,26,nowin,loss,bust,plbust,0,10,12,218,0.444954128,0.073394495,0.600917431,2,0.605210014
15400,21,22567,10,3,0,3,4,20,10,3,3,10,0,26,nowin,win,dlbust,bust,20,0,13,214,0.359813084,0.042056075,0.626168224,0,0.025263474
15401,69,22567,5,9,0,9,0,23,10,3,3,10,0,26,nowin,loss,bust,plbust,0,10,14,194,0.365979381,0.030927835,0.515463918,0,0
15402,115,22568,1,6,7,0,0,14,5,3,10,0,0,18,nowin,loss,beat,dlwin,0,10,7,194,0.427835052,0.041237113,0.592783505,2,0.583863602
15403,68,22568,2,6,11,0,0,19,5,3,10,0,0,18,nowin,win,plwin,beat,20,0,8,205,0.434146341,0.029268293,0.6,2,0.59483189
15404,84,22568,10,9,0,0,0,19,5,3,10,0,0,18,nowin,win,plwin,beat,20,0,19,195,0.379487179,0.056410256,0.569230769,0,0.017209119
15405,57,22568,6,3,9,0,0,18,5,3,10,0,0,18,nowin,push,push,push,10,0,9,192,0.46875,0.052083333,0.59375,3,0.907001181
15406,74,22568,10,8,0,0,0,18,5,3,10,0,0,18,nowin,push,push,push,10,0,18,209,0.411483254,0.04784689,0.531100478,0,0.017448125
15407,46,22568,10,10,0,0,0,20,5,3,10,0,0,18,nowin,win,plwin,beat,20,0,20,186,0.403225806,0.048387097,0.591397849,0,0.029742194
15408,41,22569,6,10,0,0,0,16,3,9,1,6,0,19,nowin,loss,beat,dlwin,0,10,16,192,0.364583333,0.036458333,0.520833333,0,0.00089702
15409,72,22569,4,4,2,2,10,22,3,9,1,6,0,19,nowin,loss,bust,plbust,0,10,8,185,0.394594595,0.032432432,0.508108108,0,0.006763115
15410,110,22569,10,3,0,0,0,13,3,9,1,6,0,19,nowin,loss,beat,dlwin,0,10,13,192,0.416666667,0.046875,0.557291667,0,0.025413132
15411,91,22569,4,6,10,0,0,20,3,9,1,6,0,19,nowin,win,plwin,beat,20,0,10,194,0.417525773,0.046391753,0.515463918,1,0.266616552
15412,149,22569,10,10,0,0,0,20,3,9,1,6,0,19,nowin,win,plwin,beat,20,0,20,225,0.457777778,0.057777778,0.648888889,2,0.651965595
15413,30,22569,10,5,0,0,0,15,3,9,1,6,0,19,nowin,loss,beat,dlwin,0,10,15,206,0.393203883,0.033980583,0.601941748,0,0.029324648
15414,53,22570,2,11,8,0,0,21,11,7,0,0,0,18,nowin,win,plwin,beat,20,0,13,250,0.372,0.064,0.564,0,0.013687345
15415,120,22570,8,10,0,0,0,18,11,7,0,0,0,18,nowin,push,push,push,10,0,18,202,0.440594059,0.034653465,0.618811881,2,0.614441029
15416,46,22570,6,10,0,5,0,21,11,7,0,0,0,18,nowin,win,plwin,beat,20,0,16,186,0.403225806,0.048387097,0.591397849,0,0.029742194
15417,146,22570,11,7,0,0,0,18,11,7,0,0,0,18,nowin,push,push,push,10,0,18,221,0.43438914,0.040723982,0.542986425,1,0.290190091
15418,33,22570,5,8,0,10,0,23,11,7,0,0,0,18,nowin,loss,bust,plbust,0,10,13,192,0.4375,0.057291667,0.625,2,0.616208916
15419,16,22570,4,7,6,0,0,17,11,7,0,0,0,18,nowin,loss,beat,dlwin,0,10,11,220,0.427272727,0.081818182,0.6,2,0.588660176
15420,15,22571,9,6,0,0,0,15,2,4,10,1,0,17,nowin,loss,beat,dlwin,0,10,15,212,0.410377358,0.051886792,0.561320755,0,0.024517408
15421,56,22571,10,4,0,0,0,14,2,4,10,1,0,17,nowin,loss,beat,dlwin,0,10,14,175,0.4,0.057142857,0.582857143,0,0.026685297
15422,137,22571,5,11,2,0,0,18,2,4,10,1,0,17,nowin,win,plwin,beat,20,0,16,194,0.417525773,0.046391753,0.536082474,1,0.276714602
15423,9,22571,8,6,0,0,0,14,2,4,10,1,0,17,nowin,loss,beat,dlwin,0,10,14,194,0.37628866,0.015463918,0.541237113,0,0.009396796
15424,142,22571,10,6,0,0,0,16,2,4,10,1,0,17,nowin,loss,beat,dlwin,0,10,16,211,0.417061611,0.047393365,0.526066351,1,0.271531309
15425,38,22571,6,3,9,0,0,18,2,4,10,1,0,17,nowin,win,plwin,beat,20,0,9,202,0.361386139,0.03960396,0.564356436,0,0.010597953
15426,80,22572,10,5,0,10,0,25,8,4,2,6,0,20,nowin,loss,bust,plbust,0,10,15,186,0.419354839,0.059139785,0.623655914,2,0.59892924
15427,102,22572,10,10,0,0,0,20,8,4,2,6,0,20,nowin,push,push,push,10,0,20,192,0.338541667,0.046875,0.5625,0,0.003306118
15428,14,22572,2,2,9,3,4,20,8,4,2,6,0,20,nowin,push,push,push,10,0,4,202,0.391089109,0.01980198,0.628712871,2,0.577264877
15429,32,22572,10,10,0,0,0,20,8,4,2,6,0,20,nowin,push,push,push,10,0,20,189,0.391534392,0.037037037,0.53968254,0,0.013579086
15430,90,22572,3,10,0,6,0,19,8,4,2,6,0,20,nowin,loss,beat,dlwin,0,10,13,201,0.447761194,0.049751244,0.60199005,3,0.889945023
15431,7,22572,8,5,0,2,9,24,8,4,2,6,0,20,nowin,loss,bust,plbust,0,10,13,183,0.442622951,0.06010929,0.62295082,2,0.619303341
15432,130,22573,8,10,0,0,0,18,4,8,1,4,0,17,nowin,win,plwin,beat,20,0,18,219,0.410958904,0.03652968,0.566210046,0,0.025888739
15433,66,22573,10,7,0,0,0,17,4,8,1,4,0,17,nowin,push,push,push,10,0,17,217,0.456221198,0.064516129,0.626728111,3,0.924304367
15434,71,22573,10,10,0,0,0,20,4,8,1,4,0,17,nowin,win,plwin,beat,20,0,20,193,0.352331606,0.046632124,0.585492228,0,0.013063661
15435,33,22573,5,2,10,0,0,17,4,8,1,4,0,17,nowin,push,push,push,10,0,7,192,0.4375,0.057291667,0.625,2,0.616208916
15436,7,22573,10,11,0,0,0,21,4,8,1,4,0,17,win,win,plwin,beat,25,0,21,183,0.442622951,0.06010929,0.62295082,2,0.619303341
15437,27,22573,11,9,0,0,0,20,4,8,1,4,0,17,nowin,win,plwin,beat,20,0,20,178,0.370786517,0.016853933,0.573033708,0,0.015536309
15438,104,22574,9,7,0,0,0,16,3,8,2,3,6,22,nowin,win,dlbust,bust,20,0,16,209,0.363636364,0.052631579,0.593301435,0,0.018359419
15439,61,22574,11,10,0,0,0,21,3,8,2,3,6,22,win,win,dlbust,bust,25,0,21,194,0.427835052,0.077319588,0.603092784,2,0.591437139
15440,49,22574,11,10,0,0,0,21,3,8,2,3,6,22,win,win,dlbust,bust,25,0,21,207,0.396135266,0.053140097,0.594202899,0,0.028306925
15441,75,22574,4,5,2,10,0,21,3,8,2,3,6,22,nowin,win,dlbust,bust,20,0,9,191,0.418848168,0.052356021,0.570680628,0,0.029344702
15442,100,22574,10,10,0,0,0,20,3,8,2,3,6,22,nowin,win,dlbust,bust,20,0,20,190,0.452631579,0.036842105,0.594736842,3,0.888671154
15443,105,22574,4,7,6,0,0,17,3,8,2,3,6,22,nowin,win,dlbust,bust,20,0,11,198,0.414141414,0.070707071,0.590909091,0,0.032889494
15444,100,22575,8,10,0,0,0,18,3,10,10,0,0,23,nowin,win,dlbust,bust,20,0,18,190,0.452631579,0.036842105,0.594736842,3,0.888671154
15445,137,22575,10,10,0,0,0,20,3,10,10,0,0,23,nowin,win,dlbust,bust,20,0,20,194,0.417525773,0.046391753,0.536082474,1,0.276714602
15446,109,22575,4,11,5,0,0,20,3,10,10,0,0,23,nowin,win,dlbust,bust,20,0,15,221,0.461538462,0.058823529,0.597285068,3,0.901830309
15447,130,22575,4,2,2,2,9,19,3,10,10,0,0,23,nowin,win,dlbust,bust,20,0,6,219,0.410958904,0.03652968,0.566210046,0,0.025888739
15448,140,22575,10,7,0,0,0,17,3,10,10,0,0,23,nowin,win,dlbust,bust,20,0,17,210,0.466666667,0.023809524,0.604761905,3,0.915293335
15449,33,22575,11,10,0,0,0,21,3,10,10,0,0,23,win,win,dlbust,bust,25,0,21,192,0.4375,0.057291667,0.625,2,0.616208916
15450,103,22576,10,11,0,0,0,21,10,11,0,0,0,21,win,push,push,push,10,0,21,203,0.379310345,0.064039409,0.551724138,0,0.012869209
15451,133,22576,10,5,0,10,0,25,10,11,0,0,0,21,nowin,loss,bust,plbust,0,10,15,201,0.47761194,0.064676617,0.611940299,3,0.935428111
15452,35,22576,8,2,3,10,0,23,10,11,0,0,0,21,nowin,loss,bust,plbust,0,10,10,202,0.410891089,0.044554455,0.633663366,2,0.598681573
15453,6,22576,9,6,0,1,10,26,10,11,0,0,0,21,nowin,loss,bust,plbust,0,10,15,191,0.439790576,0.047120419,0.581151832,1,0.31211505
15454,35,22576,8,3,1,10,0,22,10,11,0,0,0,21,nowin,loss,bust,plbust,0,10,11,202,0.410891089,0.044554455,0.633663366,2,0.598681573
15455,23,22576,2,10,0,6,0,18,10,11,0,0,0,21,nowin,loss,beat,dlwin,0,10,12,208,0.427884615,0.0625,0.552884615,1,0.29114424
15456,60,22577,5,10,0,3,0,18,10,10,0,0,0,20,nowin,loss,beat,dlwin,0,10,15,227,0.418502203,0.022026432,0.559471366,0,0.026496258
15457,30,22577,10,9,0,0,0,19,10,10,0,0,0,20,nowin,loss,beat,dlwin,0,10,19,206,0.393203883,0.033980583,0.601941748,0,0.029324648
15458,102,22577,11,10,0,0,0,21,10,10,0,0,0,20,win,win,plwin,beat,25,0,21,192,0.338541667,0.046875,0.5625,0,0.003306118
15459,142,22577,1,1,10,2,10,24,10,10,0,0,0,20,nowin,loss,bust,plbust,0,10,2,211,0.417061611,0.047393365,0.526066351,1,0.271531309
15460,96,22577,10,9,0,0,0,19,10,10,0,0,0,20,nowin,loss,beat,dlwin,0,10,19,190,0.468421053,0.057894737,0.584210526,3,0.897263354
15461,1,22577,3,5,10,0,0,18,10,10,0,0,0,20,nowin,loss,beat,dlwin,0,10,8,197,0.406091371,0.025380711,0.649746193,2,0.606186955
15462,29,22578,4,10,0,4,0,18,7,6,10,0,0,23,nowin,win,dlbust,bust,20,0,14,189,0.44973545,0.058201058,0.544973545,1,0.300349439
15463,99,22578,7,10,0,0,0,17,7,6,10,0,0,23,nowin,win,dlbust,bust,20,0,17,207,0.47826087,0.062801932,0.637681159,3,0.961418446
15464,76,22578,2,2,10,2,2,18,7,6,10,0,0,23,nowin,win,dlbust,bust,20,0,4,189,0.534391534,0.079365079,0.608465608,3,1
15465,95,22578,7,10,0,0,0,17,7,6,10,0,0,23,nowin,win,dlbust,bust,20,0,17,218,0.412844037,0.04587156,0.559633028,0,0.024842385
15466,76,22578,8,10,0,0,0,18,7,6,10,0,0,23,nowin,win,dlbust,bust,20,0,18,189,0.534391534,0.079365079,0.608465608,3,1
15467,41,22578,2,8,10,0,0,20,7,6,10,0,0,23,nowin,win,dlbust,bust,20,0,10,192,0.364583333,0.036458333,0.520833333,0,0.00089702
15468,149,22579,10,7,0,0,0,17,6,4,5,1,10,26,nowin,win,dlbust,bust,20,0,17,225,0.457777778,0.057777778,0.648888889,2,0.651965595
15469,127,22579,2,3,7,0,0,12,6,4,5,1,10,26,nowin,win,dlbust,bust,20,0,5,201,0.402985075,0.029850746,0.60199005,0,0.032263937
15470,120,22579,9,10,0,0,0,19,6,4,5,1,10,26,nowin,win,dlbust,bust,20,0,19,202,0.440594059,0.034653465,0.618811881,2,0.614441029
15471,106,22579,3,7,5,0,0,15,6,4,5,1,10,26,nowin,win,dlbust,bust,20,0,10,192,0.411458333,0.026041667,0.557291667,0,0.023854304
15472,89,22579,10,10,0,0,0,20,6,4,5,1,10,26,nowin,win,dlbust,bust,20,0,20,212,0.537735849,0.047169811,0.594339623,3,0.990167191
15473,123,22579,10,10,0,0,0,20,6,4,5,1,10,26,nowin,win,dlbust,bust,20,0,20,205,0.43902439,0.034146341,0.614634146,2,0.609962544
15474,75,22580,3,11,5,0,0,19,7,3,10,0,0,20,nowin,loss,beat,dlwin,0,10,14,191,0.418848168,0.052356021,0.570680628,0,0.029344702
15475,58,22580,10,5,0,4,0,19,7,3,10,0,0,20,nowin,loss,beat,dlwin,0,10,15,195,0.430769231,0.041025641,0.584615385,2,0.580497586
15476,116,22580,8,6,0,9,0,23,7,3,10,0,0,20,nowin,loss,bust,plbust,0,10,14,195,0.425641026,0.056410256,0.538461538,1,0.28273747
15477,36,22580,10,10,0,0,0,20,7,3,10,0,0,20,nowin,push,push,push,10,0,20,229,0.445414847,0.056768559,0.655021834,2,0.645370571
15478,90,22580,10,6,0,9,0,25,7,3,10,0,0,20,nowin,loss,bust,plbust,0,10,16,201,0.447761194,0.049751244,0.60199005,3,0.889945023
15479,66,22580,2,7,7,4,0,20,7,3,10,0,0,20,nowin,push,push,push,10,0,9,217,0.456221198,0.064516129,0.626728111,3,0.924304367
15480,123,22581,10,6,0,0,0,16,2,3,10,10,0,25,nowin,win,dlbust,bust,20,0,16,205,0.43902439,0.034146341,0.614634146,2,0.609962544
15481,80,22581,2,6,9,0,0,17,2,3,10,10,0,25,nowin,win,dlbust,bust,20,0,8,186,0.419354839,0.059139785,0.623655914,2,0.59892924
15482,139,22581,7,10,0,0,0,17,2,3,10,10,0,25,nowin,win,dlbust,bust,20,0,17,192,0.380208333,0.036458333,0.59375,0,0.023429169
15483,101,22581,9,10,0,0,0,19,2,3,10,10,0,25,nowin,win,dlbust,bust,20,0,19,205,0.424390244,0.068292683,0.63902439,2,0.614740646
15484,101,22581,10,3,0,0,0,13,2,3,10,10,0,25,nowin,win,dlbust,bust,20,0,13,205,0.424390244,0.068292683,0.63902439,2,0.614740646
15485,145,22581,10,10,0,0,0,20,2,3,10,10,0,25,nowin,win,dlbust,bust,20,0,20,188,0.441489362,0.031914894,0.622340426,2,0.617837093
15486,83,22582,3,8,10,0,0,21,5,8,8,0,0,21,nowin,push,push,push,10,0,11,193,0.424870466,0.051813472,0.678756477,2,0.644360335
15487,109,22582,9,11,0,0,0,20,5,8,8,0,0,21,nowin,loss,beat,dlwin,0,10,20,221,0.461538462,0.058823529,0.597285068,3,0.901830309
15488,30,22582,9,11,0,0,0,20,5,8,8,0,0,21,nowin,loss,beat,dlwin,0,10,20,206,0.393203883,0.033980583,0.601941748,0,0.029324648
15489,141,22582,10,11,0,0,0,21,5,8,8,0,0,21,win,push,push,push,10,0,21,202,0.420792079,0.074257426,0.564356436,0,0.028377851
15490,109,22582,5,8,0,0,0,13,5,8,8,0,0,21,nowin,loss,beat,dlwin,0,10,13,221,0.461538462,0.058823529,0.597285068,3,0.901830309
15491,27,22582,9,3,0,0,0,12,5,8,8,0,0,21,nowin,loss,beat,dlwin,0,10,12,178,0.370786517,0.016853933,0.573033708,0,0.015536309
15492,53,22583,2,10,0,5,0,17,9,5,5,0,0,19,nowin,loss,beat,dlwin,0,10,12,250,0.372,0.064,0.564,0,0.013687345
15493,148,22583,10,10,0,0,0,20,9,5,5,0,0,19,nowin,win,plwin,beat,20,0,20,204,0.401960784,0.078431373,0.593137255,0,0.029789521
15494,60,22583,2,5,3,10,0,20,9,5,5,0,0,19,nowin,win,plwin,beat,20,0,7,227,0.418502203,0.022026432,0.559471366,0,0.026496258
15495,113,22583,9,8,0,0,0,17,9,5,5,0,0,19,nowin,loss,beat,dlwin,0,10,17,199,0.407035176,0.055276382,0.668341709,2,0.620695264
15496,34,22583,6,7,0,8,0,21,9,5,5,0,0,19,nowin,win,plwin,beat,20,0,13,202,0.5,0.079207921,0.618811881,3,0.968961434
15497,78,22583,6,10,0,4,0,20,9,5,5,0,0,19,nowin,win,plwin,beat,20,0,16,201,0.517412935,0.034825871,0.587064677,3,0.95871112
15498,107,22584,1,3,8,10,0,22,3,6,10,0,0,19,nowin,loss,bust,plbust,0,10,4,218,0.444954128,0.073394495,0.600917431,2,0.605210014
15499,92,22584,10,2,0,10,0,22,3,6,10,0,0,19,nowin,loss,bust,plbust,0,10,12,186,0.446236559,0.059139785,0.564516129,1,0.307826125
15500,145,22584,2,3,9,0,0,14,3,6,10,0,0,19,nowin,loss,beat,dlwin,0,10,5,188,0.441489362,0.031914894,0.622340426,2,0.617837093
15501,3,22584,7,10,0,0,0,17,3,6,10,0,0,19,nowin,loss,beat,dlwin,0,10,17,190,0.431578947,0.026315789,0.542105263,1,0.288076384
15502,77,22584,8,10,0,0,0,18,3,6,10,0,0,19,nowin,loss,beat,dlwin,0,10,18,200,0.455,0.04,0.62,3,0.916252116
15503,7,22584,5,10,0,0,0,15,3,6,10,0,0,19,nowin,loss,beat,dlwin,0,10,15,183,0.442622951,0.06010929,0.62295082,2,0.619303341
15504,45,22585,3,8,10,0,0,21,7,2,11,0,0,20,nowin,win,plwin,beat,20,0,11,196,0.428571429,0.051020408,0.612244898,2,0.598821767
15505,18,22585,9,10,0,0,0,19,7,2,11,0,0,20,nowin,loss,beat,dlwin,0,10,19,182,0.461538462,0.043956044,0.587912088,3,0.892649374
15506,136,22585,9,8,0,0,0,17,7,2,11,0,0,20,nowin,loss,beat,dlwin,0,10,17,194,0.396907216,0.025773196,0.597938144,0,0.029452644
15507,14,22585,3,10,0,4,0,17,7,2,11,0,0,20,nowin,loss,beat,dlwin,0,10,13,202,0.391089109,0.01980198,0.628712871,2,0.577264877
15508,120,22585,8,8,0,5,0,21,7,2,11,0,0,20,nowin,win,plwin,beat,20,0,16,202,0.440594059,0.034653465,0.618811881,2,0.614441029
15509,28,22585,10,10,0,0,0,20,7,2,11,0,0,20,nowin,push,push,push,10,0,20,199,0.422110553,0.045226131,0.542713568,1,0.282706618
15510,106,22586,7,3,4,6,0,20,9,11,0,0,0,20,nowin,push,push,push,10,0,10,192,0.411458333,0.026041667,0.557291667,0,0.023854304
15511,14,22586,5,10,0,3,0,18,9,11,0,0,0,20,nowin,loss,beat,dlwin,0,10,15,202,0.391089109,0.01980198,0.628712871,2,0.577264877
15512,56,22586,11,2,1,9,0,23,9,11,0,0,0,20,nowin,loss,bust,plbust,0,10,13,175,0.4,0.057142857,0.582857143,0,0.026685297
15513,67,22586,4,9,0,10,0,23,9,11,0,0,0,20,nowin,loss,bust,plbust,0,10,13,195,0.369230769,0.041025641,0.569230769,0,0.014139427
15514,76,22586,9,4,0,10,0,23,9,11,0,0,0,20,nowin,loss,bust,plbust,0,10,13,189,0.534391534,0.079365079,0.608465608,3,1
15515,70,22586,4,4,10,0,0,18,9,11,0,0,0,20,nowin,loss,beat,dlwin,0,10,8,228,0.385964912,0.039473684,0.557017544,0,0.016157125
15516,46,22587,3,8,3,8,0,22,7,9,6,0,0,22,nowin,loss,bust,plbust,0,10,11,186,0.403225806,0.048387097,0.591397849,0,0.029742194
15517,68,22587,11,2,5,0,0,18,7,9,6,0,0,22,nowin,win,dlbust,bust,20,0,13,205,0.434146341,0.029268293,0.6,2,0.59483189
15518,112,22587,5,2,2,8,0,17,7,9,6,0,0,22,nowin,win,dlbust,bust,20,0,7,203,0.448275862,0.054187192,0.600985222,3,0.889576933
15519,34,22587,7,4,1,8,0,20,7,9,6,0,0,22,nowin,win,dlbust,bust,20,0,11,202,0.5,0.079207921,0.618811881,3,0.968961434
15520,50,22587,10,2,0,6,0,18,7,9,6,0,0,22,nowin,win,dlbust,bust,20,0,12,202,0.405940594,0.04950495,0.54950495,0,0.020296079
15521,89,22587,6,7,0,1,2,16,7,9,6,0,0,22,nowin,win,dlbust,bust,20,0,13,212,0.537735849,0.047169811,0.594339623,3,0.990167191
15522,88,22588,9,7,0,1,0,17,10,7,0,0,0,17,nowin,push,push,push,10,0,16,206,0.466019417,0.033980583,0.54368932,1,0.309467903
15523,78,22588,8,9,0,0,0,17,10,7,0,0,0,17,nowin,push,push,push,10,0,17,201,0.517412935,0.034825871,0.587064677,3,0.95871112
15524,72,22588,4,9,0,10,0,23,10,7,0,0,0,17,nowin,loss,bust,plbust,0,10,13,185,0.394594595,0.032432432,0.508108108,0,0.006763115
15525,15,22588,5,10,0,9,0,24,10,7,0,0,0,17,nowin,loss,bust,plbust,0,10,15,212,0.410377358,0.051886792,0.561320755,0,0.024517408
15526,119,22588,8,10,0,0,0,18,10,7,0,0,0,17,nowin,win,plwin,beat,20,0,18,190,0.405263158,0.068421053,0.515789474,0,0.011837158
15527,124,22588,4,10,0,10,0,24,10,7,0,0,0,17,nowin,loss,bust,plbust,0,10,14,202,0.47029703,0.064356436,0.584158416,3,0.899458193
15528,84,22589,6,6,0,10,0,22,9,6,10,0,0,25,nowin,loss,bust,plbust,0,10,12,195,0.379487179,0.056410256,0.569230769,0,0.017209119
15529,122,22589,2,1,10,1,10,24,9,6,10,0,0,25,nowin,loss,bust,plbust,0,10,3,210,0.347619048,0.052380952,0.59047619,0,0.012873677
15530,124,22589,10,10,0,0,0,20,9,6,10,0,0,25,nowin,win,dlbust,bust,20,0,20,202,0.47029703,0.064356436,0.584158416,3,0.899458193
15531,57,22589,10,5,0,7,0,22,9,6,10,0,0,25,nowin,loss,bust,plbust,0,10,15,192,0.46875,0.052083333,0.59375,3,0.907001181
15532,82,22589,10,10,0,0,0,20,9,6,10,0,0,25,nowin,win,dlbust,bust,20,0,20,225,0.408888889,0.075555556,0.577777778,0,0.028101874
15533,96,22589,2,7,10,0,0,19,9,6,10,0,0,25,nowin,win,dlbust,bust,20,0,9,190,0.468421053,0.057894737,0.584210526,3,0.897263354
15534,142,22590,11,8,0,0,0,19,3,5,3,7,0,18,nowin,win,plwin,beat,20,0,19,211,0.417061611,0.047393365,0.526066351,1,0.271531309
15535,1,22590,10,9,0,0,0,19,3,5,3,7,0,18,nowin,win,plwin,beat,20,0,19,197,0.406091371,0.025380711,0.649746193,2,0.606186955
15536,82,22590,10,3,0,0,0,13,3,5,3,7,0,18,nowin,loss,beat,dlwin,0,10,13,225,0.408888889,0.075555556,0.577777778,0,0.028101874
15537,134,22590,8,10,0,0,0,18,3,5,3,7,0,18,nowin,push,push,push,10,0,18,185,0.443243243,0.021621622,0.545945946,1,0.296939509
15538,27,22590,10,6,0,0,0,16,3,5,3,7,0,18,nowin,loss,beat,dlwin,0,10,16,178,0.370786517,0.016853933,0.573033708,0,0.015536309
15539,77,22590,2,4,8,0,0,14,3,5,3,7,0,18,nowin,loss,beat,dlwin,0,10,6,200,0.455,0.04,0.62,3,0.916252116
15540,36,22591,4,10,0,0,0,14,5,3,5,7,0,20,nowin,loss,beat,dlwin,0,10,14,229,0.445414847,0.056768559,0.655021834,2,0.645370571
15541,147,22591,10,8,0,0,0,18,5,3,5,7,0,20,nowin,loss,beat,dlwin,0,10,18,205,0.380487805,0.014634146,0.536585366,0,0.00951447
15542,64,22591,10,10,0,0,0,20,5,3,5,7,0,20,nowin,push,push,push,10,0,20,187,0.363636364,0.048128342,0.631016043,0,0.027594885
15543,146,22591,10,3,0,0,0,13,5,3,5,7,0,20,nowin,loss,beat,dlwin,0,10,13,221,0.43438914,0.040723982,0.542986425,1,0.290190091
15544,38,22591,3,8,10,0,0,21,5,3,5,7,0,20,nowin,win,plwin,beat,20,0,11,202,0.361386139,0.03960396,0.564356436,0,0.010597953
15545,66,22591,6,10,0,0,0,16,5,3,5,7,0,20,nowin,loss,beat,dlwin,0,10,16,217,0.456221198,0.064516129,0.626728111,3,0.924304367
15546,20,22592,1,6,8,0,0,15,3,10,10,0,0,23,nowin,win,dlbust,bust,20,0,7,186,0.456989247,0.037634409,0.537634409,1,0.301097108
15547,77,22592,9,10,0,0,0,19,3,10,10,0,0,23,nowin,win,dlbust,bust,20,0,19,200,0.455,0.04,0.62,3,0.916252116
15548,94,22592,10,10,0,0,0,20,3,10,10,0,0,23,nowin,win,dlbust,bust,20,0,20,183,0.43715847,0.043715847,0.540983607,1,0.290866892
15549,27,22592,5,3,10,0,0,18,3,10,10,0,0,23,nowin,win,dlbust,bust,20,0,8,178,0.370786517,0.016853933,0.573033708,0,0.015536309
15550,72,22592,4,2,3,10,0,19,3,10,10,0,0,23,nowin,win,dlbust,bust,20,0,6,185,0.394594595,0.032432432,0.508108108,0,0.006763115
15551,140,22592,10,2,0,5,0,17,3,10,10,0,0,23,nowin,win,dlbust,bust,20,0,12,210,0.466666667,0.023809524,0.604761905,3,0.915293335
15552,69,22593,2,9,9,0,0,20,10,2,10,0,0,22,nowin,win,dlbust,bust,20,0,11,194,0.365979381,0.030927835,0.515463918,0,0
15553,132,22593,6,9,0,10,0,25,10,2,10,0,0,22,nowin,loss,bust,plbust,0,10,15,194,0.412371134,0.036082474,0.649484536,2,0.611633238
15554,104,22593,10,10,0,0,0,20,10,2,10,0,0,22,nowin,win,dlbust,bust,20,0,20,209,0.363636364,0.052631579,0.593301435,0,0.018359419
15555,39,22593,10,7,0,0,0,17,10,2,10,0,0,22,nowin,win,dlbust,bust,20,0,17,191,0.429319372,0.062827225,0.57591623,0,0.033760763
15556,68,22593,3,10,0,8,0,21,10,2,10,0,0,22,nowin,win,dlbust,bust,20,0,13,205,0.434146341,0.029268293,0.6,2,0.59483189
15557,107,22593,11,4,1,2,0,18,10,2,10,0,0,22,nowin,win,dlbust,bust,20,0,15,218,0.444954128,0.073394495,0.600917431,2,0.605210014
15558,144,22594,10,11,0,0,0,21,11,6,0,0,0,17,win,win,plwin,beat,25,0,21,202,0.386138614,0.054455446,0.564356436,0,0.018006244
15559,12,22594,5,10,0,6,0,21,11,6,0,0,0,17,nowin,win,plwin,beat,20,0,15,189,0.470899471,0.015873016,0.613756614,3,0.929171178
15560,140,22594,3,7,4,8,0,22,11,6,0,0,0,17,nowin,loss,bust,plbust,0,10,10,210,0.466666667,0.023809524,0.604761905,3,0.915293335
15561,130,22594,10,2,0,7,0,19,11,6,0,0,0,17,nowin,win,plwin,beat,20,0,12,219,0.410958904,0.03652968,0.566210046,0,0.025888739
15562,20,22594,8,10,0,0,0,18,11,6,0,0,0,17,nowin,win,plwin,beat,20,0,18,186,0.456989247,0.037634409,0.537634409,1,0.301097108
15563,77,22594,9,11,0,0,0,20,11,6,0,0,0,17,nowin,win,plwin,beat,20,0,20,200,0.455,0.04,0.62,3,0.916252116
15564,147,22595,4,2,7,3,9,25,10,10,0,0,0,20,nowin,loss,bust,plbust,0,10,6,205,0.380487805,0.014634146,0.536585366,0,0.00951447
15565,125,22595,10,11,0,0,0,21,10,10,0,0,0,20,win,win,plwin,beat,25,0,21,219,0.438356164,0.050228311,0.575342466,1,0.308411257
15566,20,22595,1,6,10,0,0,17,10,10,0,0,0,20,nowin,loss,beat,dlwin,0,10,7,186,0.456989247,0.037634409,0.537634409,1,0.301097108
15567,21,22595,10,5,0,9,0,24,10,10,0,0,0,20,nowin,loss,bust,plbust,0,10,15,214,0.359813084,0.042056075,0.626168224,0,0.025263474
15568,144,22595,10,8,0,0,0,18,10,10,0,0,0,20,nowin,loss,beat,dlwin,0,10,18,202,0.386138614,0.054455446,0.564356436,0,0.018006244
15569,64,22595,11,2,5,0,0,18,10,10,0,0,0,20,nowin,loss,beat,dlwin,0,10,13,187,0.363636364,0.048128342,0.631016043,0,0.027594885
15570,98,22596,5,4,10,0,0,19,9,11,0,0,0,20,nowin,loss,beat,dlwin,0,10,9,220,0.422727273,0.054545455,0.55,1,0.28664435
15571,38,22596,3,5,10,0,0,18,9,11,0,0,0,20,nowin,loss,beat,dlwin,0,10,8,202,0.361386139,0.03960396,0.564356436,0,0.010597953
15572,23,22596,10,2,0,7,0,19,9,11,0,0,0,20,nowin,loss,beat,dlwin,0,10,12,208,0.427884615,0.0625,0.552884615,1,0.29114424
15573,146,22596,8,4,0,3,10,25,9,11,0,0,0,20,nowin,loss,bust,plbust,0,10,12,221,0.43438914,0.040723982,0.542986425,1,0.290190091
15574,72,22596,8,4,0,5,0,17,9,11,0,0,0,20,nowin,loss,beat,dlwin,0,10,12,185,0.394594595,0.032432432,0.508108108,0,0.006763115
15575,89,22596,5,6,9,0,0,20,9,11,0,0,0,20,nowin,push,push,push,10,0,11,212,0.537735849,0.047169811,0.594339623,3,0.990167191
15576,14,22597,6,5,1,0,0,12,4,4,10,0,0,18,nowin,loss,beat,dlwin,0,10,11,202,0.391089109,0.01980198,0.628712871,2,0.577264877
15577,11,22597,3,11,3,0,0,17,4,4,10,0,0,18,nowin,loss,beat,dlwin,0,10,14,236,0.457627119,0.016949153,0.588983051,3,0.889015813
15578,57,22597,10,5,0,0,0,15,4,4,10,0,0,18,nowin,loss,beat,dlwin,0,10,15,192,0.46875,0.052083333,0.59375,3,0.907001181
15579,7,22597,3,10,0,0,0,13,4,4,10,0,0,18,nowin,loss,beat,dlwin,0,10,13,183,0.442622951,0.06010929,0.62295082,2,0.619303341
15580,21,22597,1,5,7,0,0,13,4,4,10,0,0,18,nowin,loss,beat,dlwin,0,10,6,214,0.359813084,0.042056075,0.626168224,0,0.025263474
15581,82,22597,9,5,0,0,0,14,4,4,10,0,0,18,nowin,loss,beat,dlwin,0,10,14,225,0.408888889,0.075555556,0.577777778,0,0.028101874
15582,63,22598,7,9,0,5,0,21,7,9,4,0,0,20,nowin,win,plwin,beat,20,0,16,216,0.467592593,0.037037037,0.62037037,3,0.931690496
15583,135,22598,11,10,0,0,0,21,7,9,4,0,0,20,win,win,plwin,beat,25,0,21,179,0.391061453,0.067039106,0.586592179,0,0.024924662
15584,139,22598,10,8,0,0,0,18,7,9,4,0,0,20,nowin,loss,beat,dlwin,0,10,18,192,0.380208333,0.036458333,0.59375,0,0.023429169
15585,55,22598,5,6,3,3,0,17,7,9,4,0,0,20,nowin,loss,beat,dlwin,0,10,11,191,0.371727749,0.057591623,0.54973822,0,0.01011347
15586,103,22598,9,6,0,10,0,25,7,9,4,0,0,20,nowin,loss,bust,plbust,0,10,15,203,0.379310345,0.064039409,0.551724138,0,0.012869209
15587,59,22598,10,4,0,10,0,24,7,9,4,0,0,20,nowin,loss,bust,plbust,0,10,14,228,0.429824561,0.048245614,0.543859649,1,0.287885446
15588,38,22599,10,6,0,0,0,16,5,1,10,9,0,25,nowin,win,dlbust,bust,20,0,16,202,0.361386139,0.03960396,0.564356436,0,0.010597953
15589,128,22599,3,10,0,0,0,13,5,1,10,9,0,25,nowin,win,dlbust,bust,20,0,13,227,0.356828194,0.052863436,0.577092511,0,0.012352564
15590,105,22599,7,4,6,0,0,17,5,1,10,9,0,25,nowin,win,dlbust,bust,20,0,11,198,0.414141414,0.070707071,0.590909091,0,0.032889494
15591,50,22599,4,5,9,0,0,18,5,1,10,9,0,25,nowin,win,dlbust,bust,20,0,9,202,0.405940594,0.04950495,0.54950495,0,0.020296079
15592,34,22599,3,10,0,0,0,13,5,1,10,9,0,25,nowin,win,dlbust,bust,20,0,13,202,0.5,0.079207921,0.618811881,3,0.968961434
15593,23,22599,11,9,0,0,0,20,5,1,10,9,0,25,nowin,win,dlbust,bust,20,0,20,208,0.427884615,0.0625,0.552884615,1,0.29114424
15594,32,22600,2,6,10,0,0,18,10,10,0,0,0,20,nowin,loss,beat,dlwin,0,10,8,189,0.391534392,0.037037037,0.53968254,0,0.013579086
15595,85,22600,4,11,3,0,0,18,10,10,0,0,0,20,nowin,loss,beat,dlwin,0,10,15,195,0.41025641,0.066666667,0.594871795,0,0.03269711
15596,14,22600,10,4,0,5,0,19,10,10,0,0,0,20,nowin,loss,beat,dlwin,0,10,14,202,0.391089109,0.01980198,0.628712871,2,0.577264877
15597,45,22600,11,10,0,0,0,21,10,10,0,0,0,20,win,win,plwin,beat,25,0,21,196,0.428571429,0.051020408,0.612244898,2,0.598821767
15598,72,22600,8,9,0,0,0,17,10,10,0,0,0,20,nowin,loss,beat,dlwin,0,10,17,185,0.394594595,0.032432432,0.508108108,0,0.006763115
15599,59,22600,10,5,0,7,0,22,10,10,0,0,0,20,nowin,loss,bust,plbust,0,10,15,228,0.429824561,0.048245614,0.543859649,1,0.287885446
15600,143,22601,10,11,0,0,0,21,10,6,9,0,0,25,win,win,dlbust,bust,25,0,21,203,0.463054187,0.044334975,0.57635468,3,0.883143365
15601,59,22601,5,3,9,0,0,17,10,6,9,0,0,25,nowin,win,dlbust,bust,20,0,8,228,0.429824561,0.048245614,0.543859649,1,0.287885446
15602,49,22601,1,1,10,5,0,17,10,6,9,0,0,25,nowin,win,dlbust,bust,20,0,2,207,0.396135266,0.053140097,0.594202899,0,0.028306925
15603,113,22601,8,6,0,8,0,22,10,6,9,0,0,25,nowin,loss,bust,plbust,0,10,14,199,0.407035176,0.055276382,0.668341709,2,0.620695264
15604,104,22601,2,10,0,9,0,21,10,6,9,0,0,25,nowin,win,dlbust,bust,20,0,12,209,0.363636364,0.052631579,0.593301435,0,0.018359419
15605,22,22601,3,4,11,0,0,18,10,6,9,0,0,25,nowin,win,dlbust,bust,20,0,7,187,0.481283422,0.042780749,0.577540107,3,0.906128176
15606,5,22602,8,11,0,0,0,19,4,4,6,4,0,18,nowin,win,plwin,beat,20,0,19,203,0.42364532,0.02955665,0.596059113,2,0.582508076
15607,131,22602,5,7,0,0,0,12,4,4,6,4,0,18,nowin,loss,beat,dlwin,0,10,12,217,0.410138249,0.069124424,0.543778802,0,0.02015021
15608,20,22602,10,6,0,0,0,16,4,4,6,4,0,18,nowin,loss,beat,dlwin,0,10,16,186,0.456989247,0.037634409,0.537634409,1,0.301097108
15609,7,22602,9,9,0,0,0,18,4,4,6,4,0,18,nowin,push,push,push,10,0,18,183,0.442622951,0.06010929,0.62295082,2,0.619303341
15610,136,22602,1,2,9,0,0,12,4,4,6,4,0,18,nowin,loss,beat,dlwin,0,10,3,194,0.396907216,0.025773196,0.597938144,0,0.029452644
15611,138,22602,10,10,0,0,0,20,4,4,6,4,0,18,nowin,win,plwin,beat,20,0,20,190,0.442105263,0.047368421,0.610526316,2,0.609711065
15612,62,22603,10,2,0,7,0,19,10,8,0,0,0,18,nowin,win,plwin,beat,20,0,12,178,0.370786517,0.028089888,0.54494382,0,0.008657722
15613,143,22603,10,5,0,4,0,19,10,8,0,0,0,18,nowin,win,plwin,beat,20,0,15,203,0.463054187,0.044334975,0.57635468,3,0.883143365
15614,136,22603,9,10,0,0,0,19,10,8,0,0,0,18,nowin,win,plwin,beat,20,0,19,194,0.396907216,0.025773196,0.597938144,0,0.029452644
15615,142,22603,6,5,3,1,3,18,10,8,0,0,0,18,nowin,push,push,push,10,0,11,211,0.417061611,0.047393365,0.526066351,1,0.271531309
15616,94,22603,4,10,0,4,0,18,10,8,0,0,0,18,nowin,push,push,push,10,0,14,183,0.43715847,0.043715847,0.540983607,1,0.290866892
15617,43,22603,10,10,0,0,0,20,10,8,0,0,0,18,nowin,win,plwin,beat,20,0,20,192,0.40625,0.041666667,0.609375,2,0.576671372
15618,131,22604,10,8,0,0,0,18,4,5,10,0,0,19,nowin,loss,beat,dlwin,0,10,18,217,0.410138249,0.069124424,0.543778802,0,0.02015021
15619,76,22604,11,9,0,0,0,20,4,5,10,0,0,19,nowin,win,plwin,beat,20,0,20,189,0.534391534,0.079365079,0.608465608,3,1
15620,148,22604,10,11,0,0,0,21,4,5,10,0,0,19,win,win,plwin,beat,25,0,21,204,0.401960784,0.078431373,0.593137255,0,0.029789521
15621,23,22604,10,10,0,0,0,20,4,5,10,0,0,19,nowin,win,plwin,beat,20,0,20,208,0.427884615,0.0625,0.552884615,1,0.29114424
15622,135,22604,10,11,0,0,0,21,4,5,10,0,0,19,win,win,plwin,beat,25,0,21,179,0.391061453,0.067039106,0.586592179,0,0.024924662
15623,49,22604,6,9,0,0,0,15,4,5,10,0,0,19,nowin,loss,beat,dlwin,0,10,15,207,0.396135266,0.053140097,0.594202899,0,0.028306925
15624,64,22605,1,6,7,8,0,22,9,11,0,0,0,20,nowin,loss,bust,plbust,0,10,7,187,0.363636364,0.048128342,0.631016043,0,0.027594885
15625,1,22605,4,10,0,10,0,24,9,11,0,0,0,20,nowin,loss,bust,plbust,0,10,14,197,0.406091371,0.025380711,0.649746193,2,0.606186955
15626,82,22605,7,8,0,8,0,23,9,11,0,0,0,20,nowin,loss,bust,plbust,0,10,15,225,0.408888889,0.075555556,0.577777778,0,0.028101874
15627,101,22605,4,10,0,9,0,23,9,11,0,0,0,20,nowin,loss,bust,plbust,0,10,14,205,0.424390244,0.068292683,0.63902439,2,0.614740646
15628,72,22605,11,7,0,0,0,18,9,11,0,0,0,20,nowin,loss,beat,dlwin,0,10,18,185,0.394594595,0.032432432,0.508108108,0,0.006763115
15629,72,22605,5,5,10,0,0,20,9,11,0,0,0,20,nowin,push,push,push,10,0,10,185,0.394594595,0.032432432,0.508108108,0,0.006763115
15630,95,22606,10,8,0,0,0,18,10,11,0,0,0,21,nowin,loss,beat,dlwin,0,10,18,218,0.412844037,0.04587156,0.559633028,0,0.024842385
15631,116,22606,5,8,0,10,0,23,10,11,0,0,0,21,nowin,loss,bust,plbust,0,10,13,195,0.425641026,0.056410256,0.538461538,1,0.28273747
15632,145,22606,10,4,0,6,0,20,10,11,0,0,0,21,nowin,loss,beat,dlwin,0,10,14,188,0.441489362,0.031914894,0.622340426,2,0.617837093
15633,87,22606,11,10,0,0,0,21,10,11,0,0,0,21,win,push,push,push,10,0,21,202,0.405940594,0.054455446,0.628712871,2,0.590599801
15634,63,22606,4,6,8,0,0,18,10,11,0,0,0,21,nowin,loss,beat,dlwin,0,10,10,216,0.467592593,0.037037037,0.62037037,3,0.931690496
15635,70,22606,10,7,0,0,0,17,10,11,0,0,0,21,nowin,loss,beat,dlwin,0,10,17,228,0.385964912,0.039473684,0.557017544,0,0.016157125
15636,49,22607,10,9,0,0,0,19,10,2,7,0,0,19,nowin,push,push,push,10,0,19,207,0.396135266,0.053140097,0.594202899,0,0.028306925
15637,88,22607,5,6,3,7,0,21,10,2,7,0,0,19,nowin,win,plwin,beat,20,0,11,206,0.466019417,0.033980583,0.54368932,1,0.309467903
15638,24,22607,4,10,0,9,0,23,10,2,7,0,0,19,nowin,loss,bust,plbust,0,10,14,207,0.458937198,0.048309179,0.570048309,1,0.318138014
15639,102,22607,6,2,9,0,0,17,10,2,7,0,0,19,nowin,loss,beat,dlwin,0,10,8,192,0.338541667,0.046875,0.5625,0,0.003306118
15640,92,22607,10,5,0,1,7,23,10,2,7,0,0,19,nowin,loss,bust,plbust,0,10,15,186,0.446236559,0.059139785,0.564516129,1,0.307826125
15641,86,22607,9,3,0,4,8,24,10,2,7,0,0,19,nowin,loss,bust,plbust,0,10,12,196,0.454081633,0.040816327,0.591836735,3,0.887566443
15642,52,22608,10,9,0,0,0,19,11,9,0,0,0,20,nowin,loss,beat,dlwin,0,10,19,217,0.414746544,0.02764977,0.599078341,2,0.576736024
15643,61,22608,10,9,0,0,0,19,11,9,0,0,0,20,nowin,loss,beat,dlwin,0,10,19,194,0.427835052,0.077319588,0.603092784,2,0.591437139
15644,141,22608,8,4,0,9,0,21,11,9,0,0,0,20,nowin,win,plwin,beat,20,0,12,202,0.420792079,0.074257426,0.564356436,0,0.028377851
15645,126,22608,10,3,0,3,7,23,11,9,0,0,0,20,nowin,loss,bust,plbust,0,10,13,188,0.457446809,0.074468085,0.60106383,3,0.900633203
15646,21,22608,10,3,0,1,9,23,11,9,0,0,0,20,nowin,loss,bust,plbust,0,10,13,214,0.359813084,0.042056075,0.626168224,0,0.025263474
15647,123,22608,2,6,3,9,0,20,11,9,0,0,0,20,nowin,push,push,push,10,0,8,205,0.43902439,0.034146341,0.614634146,2,0.609962544
15648,125,22609,5,10,0,0,0,15,2,1,9,10,0,22,nowin,win,dlbust,bust,20,0,15,219,0.438356164,0.050228311,0.575342466,1,0.308411257
15649,6,22609,7,9,0,0,0,16,2,1,9,10,0,22,nowin,win,dlbust,bust,20,0,16,191,0.439790576,0.047120419,0.581151832,1,0.31211505
15650,37,22609,9,7,0,0,0,16,2,1,9,10,0,22,nowin,win,dlbust,bust,20,0,16,208,0.394230769,0.038461538,0.581730769,0,0.024682772
15651,142,22609,6,7,0,0,0,13,2,1,9,10,0,22,nowin,win,dlbust,bust,20,0,13,211,0.417061611,0.047393365,0.526066351,1,0.271531309
15652,37,22609,9,11,0,0,0,20,2,1,9,10,0,22,nowin,win,dlbust,bust,20,0,20,208,0.394230769,0.038461538,0.581730769,0,0.024682772
15653,130,22609,8,8,0,0,0,16,2,1,9,10,0,22,nowin,win,dlbust,bust,20,0,16,219,0.410958904,0.03652968,0.566210046,0,0.025888739
15654,81,22610,3,10,0,0,0,13,3,10,10,0,0,23,nowin,win,dlbust,bust,20,0,13,182,0.395604396,0.043956044,0.60989011,2,0.567491261
15655,122,22610,10,8,0,0,0,18,3,10,10,0,0,23,nowin,win,dlbust,bust,20,0,18,210,0.347619048,0.052380952,0.59047619,0,0.012873677
15656,36,22610,9,10,0,0,0,19,3,10,10,0,0,23,nowin,win,dlbust,bust,20,0,19,229,0.445414847,0.056768559,0.655021834,2,0.645370571
15657,40,22610,7,11,0,0,0,18,3,10,10,0,0,23,nowin,win,dlbust,bust,20,0,18,196,0.367346939,0.030612245,0.617346939,0,0.025358183
15658,49,22610,9,10,0,0,0,19,3,10,10,0,0,23,nowin,win,dlbust,bust,20,0,19,207,0.396135266,0.053140097,0.594202899,0,0.028306925
15659,75,22610,5,2,10,0,0,17,3,10,10,0,0,23,nowin,win,dlbust,bust,20,0,7,191,0.418848168,0.052356021,0.570680628,0,0.029344702
15660,149,22611,10,7,0,0,0,17,3,3,10,7,0,23,nowin,win,dlbust,bust,20,0,17,225,0.457777778,0.057777778,0.648888889,2,0.651965595
15661,40,22611,10,8,0,0,0,18,3,3,10,7,0,23,nowin,win,dlbust,bust,20,0,18,196,0.367346939,0.030612245,0.617346939,0,0.025358183
15662,18,22611,5,3,5,0,0,13,3,3,10,7,0,23,nowin,win,dlbust,bust,20,0,8,182,0.461538462,0.043956044,0.587912088,3,0.892649374
15663,9,22611,7,9,0,0,0,16,3,3,10,7,0,23,nowin,win,dlbust,bust,20,0,16,194,0.37628866,0.015463918,0.541237113,0,0.009396796
15664,87,22611,10,10,0,0,0,20,3,3,10,7,0,23,nowin,win,dlbust,bust,20,0,20,202,0.405940594,0.054455446,0.628712871,2,0.590599801
15665,76,22611,10,9,0,0,0,19,3,3,10,7,0,23,nowin,win,dlbust,bust,20,0,19,189,0.534391534,0.079365079,0.608465608,3,1
15666,75,22612,10,4,0,2,6,22,10,9,0,0,0,19,nowin,loss,bust,plbust,0,10,14,191,0.418848168,0.052356021,0.570680628,0,0.029344702
15667,49,22612,2,11,6,0,0,19,10,9,0,0,0,19,nowin,push,push,push,10,0,13,207,0.396135266,0.053140097,0.594202899,0,0.028306925
15668,1,22612,4,10,0,7,0,21,10,9,0,0,0,19,nowin,win,plwin,beat,20,0,14,197,0.406091371,0.025380711,0.649746193,2,0.606186955
15669,133,22612,9,3,0,10,0,22,10,9,0,0,0,19,nowin,loss,bust,plbust,0,10,12,201,0.47761194,0.064676617,0.611940299,3,0.935428111
15670,16,22612,11,10,0,0,0,21,10,9,0,0,0,19,win,win,plwin,beat,25,0,21,220,0.427272727,0.081818182,0.6,2,0.588660176
15671,78,22612,8,3,6,0,0,17,10,9,0,0,0,19,nowin,loss,beat,dlwin,0,10,11,201,0.517412935,0.034825871,0.587064677,3,0.95871112
15672,144,22613,10,6,0,0,0,16,3,3,10,8,0,24,nowin,win,dlbust,bust,20,0,16,202,0.386138614,0.054455446,0.564356436,0,0.018006244
15673,22,22613,4,10,0,0,0,14,3,3,10,8,0,24,nowin,win,dlbust,bust,20,0,14,187,0.481283422,0.042780749,0.577540107,3,0.906128176
15674,17,22613,8,9,0,0,0,17,3,3,10,8,0,24,nowin,win,dlbust,bust,20,0,17,171,0.444444444,0.070175439,0.555555556,1,0.302364894
15675,21,22613,3,10,0,0,0,13,3,3,10,8,0,24,nowin,win,dlbust,bust,20,0,13,214,0.359813084,0.042056075,0.626168224,0,0.025263474
15676,35,22613,5,8,0,0,0,13,3,3,10,8,0,24,nowin,win,dlbust,bust,20,0,13,202,0.410891089,0.044554455,0.633663366,2,0.598681573
15677,130,22613,3,6,10,0,0,19,3,3,10,8,0,24,nowin,win,dlbust,bust,20,0,9,219,0.410958904,0.03652968,0.566210046,0,0.025888739
15678,13,22614,6,10,0,0,0,16,4,4,5,10,0,23,nowin,win,dlbust,bust,20,0,16,206,0.417475728,0.063106796,0.621359223,2,0.59555479
15679,149,22614,4,9,0,0,0,13,4,4,5,10,0,23,nowin,win,dlbust,bust,20,0,13,225,0.457777778,0.057777778,0.648888889,2,0.651965595
15680,100,22614,8,8,0,0,0,16,4,4,5,10,0,23,nowin,win,dlbust,bust,20,0,16,190,0.452631579,0.036842105,0.594736842,3,0.888671154
15681,7,22614,5,10,0,0,0,15,4,4,5,10,0,23,nowin,win,dlbust,bust,20,0,15,183,0.442622951,0.06010929,0.62295082,2,0.619303341
15682,5,22614,6,9,0,0,0,15,4,4,5,10,0,23,nowin,win,dlbust,bust,20,0,15,203,0.42364532,0.02955665,0.596059113,2,0.582508076
15683,22,22614,4,2,9,0,0,15,4,4,5,10,0,23,nowin,win,dlbust,bust,20,0,6,187,0.481283422,0.042780749,0.577540107,3,0.906128176
15684,137,22615,5,10,0,0,0,15,5,10,6,0,0,21,nowin,loss,beat,dlwin,0,10,15,194,0.417525773,0.046391753,0.536082474,1,0.276714602
15685,115,22615,4,10,0,0,0,14,5,10,6,0,0,21,nowin,loss,beat,dlwin,0,10,14,194,0.427835052,0.041237113,0.592783505,2,0.583863602
15686,58,22615,2,9,3,0,0,14,5,10,6,0,0,21,nowin,loss,beat,dlwin,0,10,11,195,0.430769231,0.041025641,0.584615385,2,0.580497586
15687,64,22615,10,10,0,0,0,20,5,10,6,0,0,21,nowin,loss,beat,dlwin,0,10,20,187,0.363636364,0.048128342,0.631016043,0,0.027594885
15688,92,22615,10,10,0,0,0,20,5,10,6,0,0,21,nowin,loss,beat,dlwin,0,10,20,186,0.446236559,0.059139785,0.564516129,1,0.307826125
15689,87,22615,10,11,0,0,0,21,5,10,6,0,0,21,win,push,push,push,10,0,21,202,0.405940594,0.054455446,0.628712871,2,0.590599801
15690,4,22616,5,10,0,10,0,25,7,10,0,0,0,17,nowin,loss,bust,plbust,0,10,15,217,0.460829493,0.036866359,0.562211982,1,0.315432839
15691,111,22616,2,4,8,10,0,24,7,10,0,0,0,17,nowin,loss,bust,plbust,0,10,6,180,0.433333333,0.055555556,0.611111111,2,0.602264492
15692,129,22616,10,3,0,10,0,23,7,10,0,0,0,17,nowin,loss,bust,plbust,0,10,13,201,0.422885572,0.064676617,0.55721393,0,0.027255383
15693,59,22616,4,10,0,1,6,21,7,10,0,0,0,17,nowin,win,plwin,beat,20,0,14,228,0.429824561,0.048245614,0.543859649,1,0.287885446
15694,23,22616,10,4,0,3,0,17,7,10,0,0,0,17,nowin,push,push,push,10,0,14,208,0.427884615,0.0625,0.552884615,1,0.29114424
15695,85,22616,2,3,10,10,0,25,7,10,0,0,0,17,nowin,loss,bust,plbust,0,10,5,195,0.41025641,0.066666667,0.594871795,0,0.03269711
15696,94,22617,7,5,0,10,0,22,10,10,0,0,0,20,nowin,loss,bust,plbust,0,10,12,183,0.43715847,0.043715847,0.540983607,1,0.290866892
15697,1,22617,9,10,0,0,0,19,10,10,0,0,0,20,nowin,loss,beat,dlwin,0,10,19,197,0.406091371,0.025380711,0.649746193,2,0.606186955
15698,32,22617,8,10,0,0,0,18,10,10,0,0,0,20,nowin,loss,beat,dlwin,0,10,18,189,0.391534392,0.037037037,0.53968254,0,0.013579086
15699,91,22617,7,10,0,0,0,17,10,10,0,0,0,20,nowin,loss,beat,dlwin,0,10,17,194,0.417525773,0.046391753,0.515463918,1,0.266616552
15700,107,22617,10,8,0,0,0,18,10,10,0,0,0,20,nowin,loss,beat,dlwin,0,10,18,218,0.444954128,0.073394495,0.600917431,2,0.605210014
15701,108,22617,10,3,0,2,10,25,10,10,0,0,0,20,nowin,loss,bust,plbust,0,10,13,193,0.435233161,0.056994819,0.559585492,1,0.298824795
15702,139,22618,11,9,0,0,0,20,9,4,6,0,0,19,nowin,win,plwin,beat,20,0,20,192,0.380208333,0.036458333,0.59375,0,0.023429169
15703,45,22618,2,6,9,0,0,17,9,4,6,0,0,19,nowin,loss,beat,dlwin,0,10,8,196,0.428571429,0.051020408,0.612244898,2,0.598821767
15704,44,22618,11,7,0,0,0,18,9,4,6,0,0,19,nowin,loss,beat,dlwin,0,10,18,219,0.433789954,0.050228311,0.534246575,1,0.285551035
15705,54,22618,8,11,0,0,0,19,9,4,6,0,0,19,nowin,push,push,push,10,0,19,185,0.437837838,0.032432432,0.556756757,1,0.29899854
15706,80,22618,3,8,2,10,0,23,9,4,6,0,0,19,nowin,loss,bust,plbust,0,10,11,186,0.419354839,0.059139785,0.623655914,2,0.59892924
15707,125,22618,6,9,0,2,0,17,9,4,6,0,0,19,nowin,loss,beat,dlwin,0,10,15,219,0.438356164,0.050228311,0.575342466,1,0.308411257
15708,122,22619,2,7,10,0,0,19,10,6,4,0,0,20,nowin,loss,beat,dlwin,0,10,9,210,0.347619048,0.052380952,0.59047619,0,0.012873677
15709,146,22619,1,6,5,2,1,15,10,6,4,0,0,20,nowin,loss,beat,dlwin,0,10,7,221,0.43438914,0.040723982,0.542986425,1,0.290190091
15710,52,22619,10,8,0,0,0,18,10,6,4,0,0,20,nowin,loss,beat,dlwin,0,10,18,217,0.414746544,0.02764977,0.599078341,2,0.576736024
15711,146,22619,7,10,0,0,0,17,10,6,4,0,0,20,nowin,loss,beat,dlwin,0,10,17,221,0.43438914,0.040723982,0.542986425,1,0.290190091
15712,149,22619,2,10,0,7,0,19,10,6,4,0,0,20,nowin,loss,beat,dlwin,0,10,12,225,0.457777778,0.057777778,0.648888889,2,0.651965595
15713,64,22619,3,9,0,10,0,22,10,6,4,0,0,20,nowin,loss,bust,plbust,0,10,12,187,0.363636364,0.048128342,0.631016043,0,0.027594885
15714,61,22620,3,8,10,0,0,21,10,8,0,0,0,18,nowin,win,plwin,beat,20,0,11,194,0.427835052,0.077319588,0.603092784,2,0.591437139
15715,25,22620,9,9,0,0,0,18,10,8,0,0,0,18,nowin,push,push,push,10,0,18,190,0.463157895,0.063157895,0.536842105,1,0.304401563
15716,45,22620,10,5,0,3,0,18,10,8,0,0,0,18,nowin,push,push,push,10,0,15,196,0.428571429,0.051020408,0.612244898,2,0.598821767
15717,23,22620,7,11,0,0,0,18,10,8,0,0,0,18,nowin,push,push,push,10,0,18,208,0.427884615,0.0625,0.552884615,1,0.29114424
15718,72,22620,9,10,0,0,0,19,10,8,0,0,0,18,nowin,win,plwin,beat,20,0,19,185,0.394594595,0.032432432,0.508108108,0,0.006763115
15719,146,22620,5,1,6,8,0,20,10,8,0,0,0,18,nowin,win,plwin,beat,20,0,6,221,0.43438914,0.040723982,0.542986425,1,0.290190091
15720,128,22621,10,9,0,0,0,19,10,10,0,0,0,20,nowin,loss,beat,dlwin,0,10,19,227,0.356828194,0.052863436,0.577092511,0,0.012352564
15721,142,22621,10,8,0,0,0,18,10,10,0,0,0,20,nowin,loss,beat,dlwin,0,10,18,211,0.417061611,0.047393365,0.526066351,1,0.271531309
15722,136,22621,5,10,0,10,0,25,10,10,0,0,0,20,nowin,loss,bust,plbust,0,10,15,194,0.396907216,0.025773196,0.597938144,0,0.029452644
15723,113,22621,7,8,0,6,0,21,10,10,0,0,0,20,nowin,win,plwin,beat,20,0,15,199,0.407035176,0.055276382,0.668341709,2,0.620695264
15724,106,22621,4,6,10,0,0,20,10,10,0,0,0,20,nowin,push,push,push,10,0,10,192,0.411458333,0.026041667,0.557291667,0,0.023854304
15725,27,22621,9,10,0,0,0,19,10,10,0,0,0,20,nowin,loss,beat,dlwin,0,10,19,178,0.370786517,0.016853933,0.573033708,0,0.015536309
15726,23,22622,10,10,0,0,0,20,2,6,7,10,0,25,nowin,win,dlbust,bust,20,0,20,208,0.427884615,0.0625,0.552884615,1,0.29114424
15727,37,22622,11,5,3,0,0,19,2,6,7,10,0,25,nowin,win,dlbust,bust,20,0,16,208,0.394230769,0.038461538,0.581730769,0,0.024682772
15728,42,22622,10,10,0,0,0,20,2,6,7,10,0,25,nowin,win,dlbust,bust,20,0,20,212,0.443396226,0.051886792,0.570754717,1,0.309181312
15729,37,22622,10,10,0,0,0,20,2,6,7,10,0,25,nowin,win,dlbust,bust,20,0,20,208,0.394230769,0.038461538,0.581730769,0,0.024682772
15730,46,22622,4,3,5,10,0,22,2,6,7,10,0,25,nowin,loss,bust,plbust,0,10,7,186,0.403225806,0.048387097,0.591397849,0,0.029742194
15731,100,22622,10,10,0,0,0,20,2,6,7,10,0,25,nowin,win,dlbust,bust,20,0,20,190,0.452631579,0.036842105,0.594736842,3,0.888671154
15732,3,22623,5,9,0,0,0,14,6,3,10,0,0,19,nowin,loss,beat,dlwin,0,10,14,190,0.431578947,0.026315789,0.542105263,1,0.288076384
15733,114,22623,9,6,0,0,0,15,6,3,10,0,0,19,nowin,loss,beat,dlwin,0,10,15,198,0.47979798,0.025252525,0.611111111,3,0.937232995
15734,142,22623,7,10,0,0,0,17,6,3,10,0,0,19,nowin,loss,beat,dlwin,0,10,17,211,0.417061611,0.047393365,0.526066351,1,0.271531309
15735,67,22623,10,10,0,0,0,20,6,3,10,0,0,19,nowin,win,plwin,beat,20,0,20,195,0.369230769,0.041025641,0.569230769,0,0.014139427
15736,38,22623,4,11,1,0,0,16,6,3,10,0,0,19,nowin,loss,beat,dlwin,0,10,15,202,0.361386139,0.03960396,0.564356436,0,0.010597953
15737,13,22623,9,2,5,0,0,16,6,3,10,0,0,19,nowin,loss,beat,dlwin,0,10,11,206,0.417475728,0.063106796,0.621359223,2,0.59555479
15738,70,22624,7,10,0,0,0,17,6,3,9,0,0,18,nowin,loss,beat,dlwin,0,10,17,228,0.385964912,0.039473684,0.557017544,0,0.016157125
15739,79,22624,1,2,10,0,0,13,6,3,9,0,0,18,nowin,loss,beat,dlwin,0,10,3,211,0.436018957,0.028436019,0.672985782,2,0.650131054
15740,32,22624,9,10,0,0,0,19,6,3,9,0,0,18,nowin,win,plwin,beat,20,0,19,189,0.391534392,0.037037037,0.53968254,0,0.013579086
15741,120,22624,2,3,4,1,9,19,6,3,9,0,0,18,nowin,win,plwin,beat,20,0,5,202,0.440594059,0.034653465,0.618811881,2,0.614441029
15742,147,22624,6,6,0,0,0,12,6,3,9,0,0,18,nowin,loss,beat,dlwin,0,10,12,205,0.380487805,0.014634146,0.536585366,0,0.00951447
15743,135,22624,1,6,8,0,0,15,6,3,9,0,0,18,nowin,loss,beat,dlwin,0,10,7,179,0.391061453,0.067039106,0.586592179,0,0.024924662
15744,108,22625,10,8,0,0,0,18,4,9,3,5,0,21,nowin,loss,beat,dlwin,0,10,18,193,0.435233161,0.056994819,0.559585492,1,0.298824795
15745,76,22625,9,9,0,0,0,18,4,9,3,5,0,21,nowin,loss,beat,dlwin,0,10,18,189,0.534391534,0.079365079,0.608465608,3,1
15746,93,22625,10,6,0,0,0,16,4,9,3,5,0,21,nowin,loss,beat,dlwin,0,10,16,175,0.485714286,0.051428571,0.548571429,1,0.323648091
15747,123,22625,8,7,0,0,0,15,4,9,3,5,0,21,nowin,loss,beat,dlwin,0,10,15,205,0.43902439,0.034146341,0.614634146,2,0.609962544
15748,92,22625,9,11,0,0,0,20,4,9,3,5,0,21,nowin,loss,beat,dlwin,0,10,20,186,0.446236559,0.059139785,0.564516129,1,0.307826125
15749,21,22625,10,10,0,0,0,20,4,9,3,5,0,21,nowin,loss,beat,dlwin,0,10,20,214,0.359813084,0.042056075,0.626168224,0,0.025263474
15750,139,22626,10,4,0,0,0,14,2,6,10,0,0,18,nowin,loss,beat,dlwin,0,10,14,192,0.380208333,0.036458333,0.59375,0,0.023429169
15751,37,22626,6,5,7,0,0,18,2,6,10,0,0,18,nowin,push,push,push,10,0,11,208,0.394230769,0.038461538,0.581730769,0,0.024682772
15752,126,22626,6,1,5,9,0,21,2,6,10,0,0,18,nowin,win,plwin,beat,20,0,7,188,0.457446809,0.074468085,0.60106383,3,0.900633203
15753,127,22626,11,8,0,0,0,19,2,6,10,0,0,18,nowin,win,plwin,beat,20,0,19,201,0.402985075,0.029850746,0.60199005,0,0.032263937
15754,99,22626,9,10,0,0,0,19,2,6,10,0,0,18,nowin,win,plwin,beat,20,0,19,207,0.47826087,0.062801932,0.637681159,3,0.961418446
15755,40,22626,2,7,10,0,0,19,2,6,10,0,0,18,nowin,win,plwin,beat,20,0,9,196,0.367346939,0.030612245,0.617346939,0,0.025358183
15756,98,22627,10,2,0,4,0,16,2,10,1,3,5,21,nowin,loss,beat,dlwin,0,10,12,220,0.422727273,0.054545455,0.55,1,0.28664435
15757,109,22627,3,11,1,0,0,15,2,10,1,3,5,21,nowin,loss,beat,dlwin,0,10,14,221,0.461538462,0.058823529,0.597285068,3,0.901830309
15758,107,22627,10,5,0,0,0,15,2,10,1,3,5,21,nowin,loss,beat,dlwin,0,10,15,218,0.444954128,0.073394495,0.600917431,2,0.605210014
15759,72,22627,7,3,7,0,0,17,2,10,1,3,5,21,nowin,loss,beat,dlwin,0,10,10,185,0.394594595,0.032432432,0.508108108,0,0.006763115
15760,64,22627,10,6,0,0,0,16,2,10,1,3,5,21,nowin,loss,beat,dlwin,0,10,16,187,0.363636364,0.048128342,0.631016043,0,0.027594885
15761,68,22627,10,7,0,0,0,17,2,10,1,3,5,21,nowin,loss,beat,dlwin,0,10,17,205,0.434146341,0.029268293,0.6,2,0.59483189
15762,88,22628,8,7,0,0,0,15,4,4,7,10,0,25,nowin,win,dlbust,bust,20,0,15,206,0.466019417,0.033980583,0.54368932,1,0.309467903
15763,105,22628,11,3,1,0,0,15,4,4,7,10,0,25,nowin,win,dlbust,bust,20,0,14,198,0.414141414,0.070707071,0.590909091,0,0.032889494
15764,98,22628,9,8,0,0,0,17,4,4,7,10,0,25,nowin,win,dlbust,bust,20,0,17,220,0.422727273,0.054545455,0.55,1,0.28664435
15765,52,22628,9,10,0,0,0,19,4,4,7,10,0,25,nowin,win,dlbust,bust,20,0,19,217,0.414746544,0.02764977,0.599078341,2,0.576736024
15766,1,22628,3,10,0,0,0,13,4,4,7,10,0,25,nowin,win,dlbust,bust,20,0,13,197,0.406091371,0.025380711,0.649746193,2,0.606186955
15767,98,22628,10,6,0,0,0,16,4,4,7,10,0,25,nowin,win,dlbust,bust,20,0,16,220,0.422727273,0.054545455,0.55,1,0.28664435
15768,64,22629,9,10,0,0,0,19,5,10,6,0,0,21,nowin,loss,beat,dlwin,0,10,19,187,0.363636364,0.048128342,0.631016043,0,0.027594885
15769,127,22629,5,10,0,0,0,15,5,10,6,0,0,21,nowin,loss,beat,dlwin,0,10,15,201,0.402985075,0.029850746,0.60199005,0,0.032263937
15770,23,22629,5,10,0,0,0,15,5,10,6,0,0,21,nowin,loss,beat,dlwin,0,10,15,208,0.427884615,0.0625,0.552884615,1,0.29114424
15771,123,22629,4,10,0,0,0,14,5,10,6,0,0,21,nowin,loss,beat,dlwin,0,10,14,205,0.43902439,0.034146341,0.614634146,2,0.609962544
15772,147,22629,3,10,0,0,0,13,5,10,6,0,0,21,nowin,loss,beat,dlwin,0,10,13,205,0.380487805,0.014634146,0.536585366,0,0.00951447
15773,15,22629,4,8,0,0,0,12,5,10,6,0,0,21,nowin,loss,beat,dlwin,0,10,12,212,0.410377358,0.051886792,0.561320755,0,0.024517408
15774,9,22630,3,10,0,0,0,13,4,8,3,5,0,20,nowin,loss,beat,dlwin,0,10,13,194,0.37628866,0.015463918,0.541237113,0,0.009396796
15775,138,22630,11,8,0,0,0,19,4,8,3,5,0,20,nowin,loss,beat,dlwin,0,10,19,190,0.442105263,0.047368421,0.610526316,2,0.609711065
15776,92,22630,6,5,10,0,0,21,4,8,3,5,0,20,nowin,win,plwin,beat,20,0,11,186,0.446236559,0.059139785,0.564516129,1,0.307826125
15777,104,22630,10,10,0,0,0,20,4,8,3,5,0,20,nowin,push,push,push,10,0,20,209,0.363636364,0.052631579,0.593301435,0,0.018359419
15778,131,22630,4,3,4,2,0,13,4,8,3,5,0,20,nowin,loss,beat,dlwin,0,10,7,217,0.410138249,0.069124424,0.543778802,0,0.02015021
15779,80,22630,4,5,10,0,0,19,4,8,3,5,0,20,nowin,loss,beat,dlwin,0,10,9,186,0.419354839,0.059139785,0.623655914,2,0.59892924
15780,98,22631,11,2,4,0,0,17,10,7,0,0,0,17,nowin,push,push,push,10,0,13,220,0.422727273,0.054545455,0.55,1,0.28664435
15781,44,22631,8,3,2,6,0,19,10,7,0,0,0,17,nowin,win,plwin,beat,20,0,11,219,0.433789954,0.050228311,0.534246575,1,0.285551035
15782,7,22631,10,7,0,0,0,17,10,7,0,0,0,17,nowin,push,push,push,10,0,17,183,0.442622951,0.06010929,0.62295082,2,0.619303341
15783,112,22631,4,6,10,0,0,20,10,7,0,0,0,17,nowin,win,plwin,beat,20,0,10,203,0.448275862,0.054187192,0.600985222,3,0.889576933
15784,91,22631,6,8,0,8,0,22,10,7,0,0,0,17,nowin,loss,bust,plbust,0,10,14,194,0.417525773,0.046391753,0.515463918,1,0.266616552
15785,67,22631,10,10,0,0,0,20,10,7,0,0,0,17,nowin,win,plwin,beat,20,0,20,195,0.369230769,0.041025641,0.569230769,0,0.014139427
15786,41,22632,6,9,0,0,0,15,5,3,2,9,0,19,nowin,loss,beat,dlwin,0,10,15,192,0.364583333,0.036458333,0.520833333,0,0.00089702
15787,133,22632,2,6,2,8,0,18,5,3,2,9,0,19,nowin,loss,beat,dlwin,0,10,8,201,0.47761194,0.064676617,0.611940299,3,0.935428111
15788,53,22632,7,10,0,0,0,17,5,3,2,9,0,19,nowin,loss,beat,dlwin,0,10,17,250,0.372,0.064,0.564,0,0.013687345
15789,51,22632,2,8,10,0,0,20,5,3,2,9,0,19,nowin,win,plwin,beat,20,0,10,189,0.529100529,0.068783069,0.608465608,3,0.993665715
15790,43,22632,10,4,0,0,0,14,5,3,2,9,0,19,nowin,loss,beat,dlwin,0,10,14,192,0.40625,0.041666667,0.609375,2,0.576671372
15791,39,22632,6,9,0,0,0,15,5,3,2,9,0,19,nowin,loss,beat,dlwin,0,10,15,191,0.429319372,0.062827225,0.57591623,0,0.033760763
15792,8,22633,4,5,11,0,0,20,8,7,10,0,0,25,nowin,win,dlbust,bust,20,0,9,181,0.44198895,0.071823204,0.596685083,2,0.599438402
15793,20,22633,10,8,0,0,0,18,8,7,10,0,0,25,nowin,win,dlbust,bust,20,0,18,186,0.456989247,0.037634409,0.537634409,1,0.301097108
15794,114,22633,1,1,10,8,0,20,8,7,10,0,0,25,nowin,win,dlbust,bust,20,0,2,198,0.47979798,0.025252525,0.611111111,3,0.937232995
15795,108,22633,5,1,10,10,0,26,8,7,10,0,0,25,nowin,loss,bust,plbust,0,10,6,193,0.435233161,0.056994819,0.559585492,1,0.298824795
15796,44,22633,10,10,0,0,0,20,8,7,10,0,0,25,nowin,win,dlbust,bust,20,0,20,219,0.433789954,0.050228311,0.534246575,1,0.285551035
15797,142,22633,9,5,0,3,0,17,8,7,10,0,0,25,nowin,win,dlbust,bust,20,0,14,211,0.417061611,0.047393365,0.526066351,1,0.271531309
15798,96,22634,8,7,0,0,0,15,3,8,2,6,0,19,nowin,loss,beat,dlwin,0,10,15,190,0.468421053,0.057894737,0.584210526,3,0.897263354
15799,13,22634,9,4,0,0,0,13,3,8,2,6,0,19,nowin,loss,beat,dlwin,0,10,13,206,0.417475728,0.063106796,0.621359223,2,0.59555479
15800,148,22634,10,9,0,0,0,19,3,8,2,6,0,19,nowin,push,push,push,10,0,19,204,0.401960784,0.078431373,0.593137255,0,0.029789521
15801,136,22634,7,4,10,0,0,21,3,8,2,6,0,19,nowin,win,plwin,beat,20,0,11,194,0.396907216,0.025773196,0.597938144,0,0.029452644
15802,107,22634,10,10,0,0,0,20,3,8,2,6,0,19,nowin,win,plwin,beat,20,0,20,218,0.444954128,0.073394495,0.600917431,2,0.605210014
15803,35,22634,9,8,0,0,0,17,3,8,2,6,0,19,nowin,loss,beat,dlwin,0,10,17,202,0.410891089,0.044554455,0.633663366,2,0.598681573
15804,3,22635,1,5,7,0,0,13,2,5,2,8,0,17,nowin,loss,beat,dlwin,0,10,6,190,0.431578947,0.026315789,0.542105263,1,0.288076384
15805,116,22635,4,10,0,0,0,14,2,5,2,8,0,17,nowin,loss,beat,dlwin,0,10,14,195,0.425641026,0.056410256,0.538461538,1,0.28273747
15806,114,22635,10,2,0,10,0,22,2,5,2,8,0,17,nowin,loss,bust,plbust,0,10,12,198,0.47979798,0.025252525,0.611111111,3,0.937232995
15807,123,22635,3,6,4,0,0,13,2,5,2,8,0,17,nowin,loss,beat,dlwin,0,10,9,205,0.43902439,0.034146341,0.614634146,2,0.609962544
15808,88,22635,9,7,0,0,0,16,2,5,2,8,0,17,nowin,loss,beat,dlwin,0,10,16,206,0.466019417,0.033980583,0.54368932,1,0.309467903
15809,149,22635,2,6,10,0,0,18,2,5,2,8,0,17,nowin,win,plwin,beat,20,0,8,225,0.457777778,0.057777778,0.648888889,2,0.651965595
15810,78,22636,8,8,0,0,0,16,3,4,5,10,0,22,nowin,win,dlbust,bust,20,0,16,201,0.517412935,0.034825871,0.587064677,3,0.95871112
15811,7,22636,10,7,0,0,0,17,3,4,5,10,0,22,nowin,win,dlbust,bust,20,0,17,183,0.442622951,0.06010929,0.62295082,2,0.619303341
15812,99,22636,10,2,0,10,0,22,3,4,5,10,0,22,nowin,loss,bust,plbust,0,10,12,207,0.47826087,0.062801932,0.637681159,3,0.961418446
15813,69,22636,10,10,0,0,0,20,3,4,5,10,0,22,nowin,win,dlbust,bust,20,0,20,194,0.365979381,0.030927835,0.515463918,0,0
15814,62,22636,9,5,0,0,0,14,3,4,5,10,0,22,nowin,win,dlbust,bust,20,0,14,178,0.370786517,0.028089888,0.54494382,0,0.008657722
15815,144,22636,10,9,0,0,0,19,3,4,5,10,0,22,nowin,win,dlbust,bust,20,0,19,202,0.386138614,0.054455446,0.564356436,0,0.018006244
15816,68,22637,1,3,10,10,0,24,10,11,0,0,0,21,nowin,loss,bust,plbust,0,10,4,205,0.434146341,0.029268293,0.6,2,0.59483189
15817,120,22637,4,2,10,10,0,26,10,11,0,0,0,21,nowin,loss,bust,plbust,0,10,6,202,0.440594059,0.034653465,0.618811881,2,0.614441029
15818,54,22637,7,10,0,0,0,17,10,11,0,0,0,21,nowin,loss,beat,dlwin,0,10,17,185,0.437837838,0.032432432,0.556756757,1,0.29899854
15819,21,22637,5,4,10,0,0,19,10,11,0,0,0,21,nowin,loss,beat,dlwin,0,10,9,214,0.359813084,0.042056075,0.626168224,0,0.025263474
15820,40,22637,7,5,0,8,0,20,10,11,0,0,0,21,nowin,loss,beat,dlwin,0,10,12,196,0.367346939,0.030612245,0.617346939,0,0.025358183
15821,90,22637,6,5,3,10,0,24,10,11,0,0,0,21,nowin,loss,bust,plbust,0,10,11,201,0.447761194,0.049751244,0.60199005,3,0.889945023
15822,107,22638,6,10,0,0,0,16,3,9,1,9,0,22,nowin,win,dlbust,bust,20,0,16,218,0.444954128,0.073394495,0.600917431,2,0.605210014
15823,45,22638,10,10,0,0,0,20,3,9,1,9,0,22,nowin,win,dlbust,bust,20,0,20,196,0.428571429,0.051020408,0.612244898,2,0.598821767
15824,103,22638,7,9,0,0,0,16,3,9,1,9,0,22,nowin,win,dlbust,bust,20,0,16,203,0.379310345,0.064039409,0.551724138,0,0.012869209
15825,137,22638,6,7,0,0,0,13,3,9,1,9,0,22,nowin,win,dlbust,bust,20,0,13,194,0.417525773,0.046391753,0.536082474,1,0.276714602
15826,31,22638,9,10,0,0,0,19,3,9,1,9,0,22,nowin,win,dlbust,bust,20,0,19,188,0.473404255,0.058510638,0.515957447,1,0.300306557
15827,4,22638,10,6,0,0,0,16,3,9,1,9,0,22,nowin,win,dlbust,bust,20,0,16,217,0.460829493,0.036866359,0.562211982,1,0.315432839
15828,95,22639,10,10,0,0,0,20,3,5,4,5,0,17,nowin,win,plwin,beat,20,0,20,218,0.412844037,0.04587156,0.559633028,0,0.024842385
15829,55,22639,11,1,6,0,0,18,3,5,4,5,0,17,nowin,win,plwin,beat,20,0,12,191,0.371727749,0.057591623,0.54973822,0,0.01011347
15830,141,22639,5,10,0,0,0,15,3,5,4,5,0,17,nowin,loss,beat,dlwin,0,10,15,202,0.420792079,0.074257426,0.564356436,0,0.028377851
15831,110,22639,9,2,6,0,0,17,3,5,4,5,0,17,nowin,push,push,push,10,0,11,192,0.416666667,0.046875,0.557291667,0,0.025413132
15832,65,22639,8,5,0,0,0,13,3,5,4,5,0,17,nowin,loss,beat,dlwin,0,10,13,203,0.492610837,0.054187192,0.571428571,3,0.913702814
15833,48,22639,4,3,3,5,0,15,3,5,4,5,0,17,nowin,loss,beat,dlwin,0,10,7,203,0.413793103,0.019704433,0.600985222,2,0.577280801
15834,19,22640,10,2,0,0,0,12,6,10,7,0,0,23,nowin,win,dlbust,bust,20,0,12,237,0.41350211,0.054852321,0.628691983,2,0.597373826
15835,148,22640,2,6,7,0,0,15,6,10,7,0,0,23,nowin,win,dlbust,bust,20,0,8,204,0.401960784,0.078431373,0.593137255,0,0.029789521
15836,64,22640,8,11,0,0,0,19,6,10,7,0,0,23,nowin,win,dlbust,bust,20,0,19,187,0.363636364,0.048128342,0.631016043,0,0.027594885
15837,79,22640,8,3,9,0,0,20,6,10,7,0,0,23,nowin,win,dlbust,bust,20,0,11,211,0.436018957,0.028436019,0.672985782,2,0.650131054
15838,48,22640,11,3,1,0,0,15,6,10,7,0,0,23,nowin,win,dlbust,bust,20,0,14,203,0.413793103,0.019704433,0.600985222,2,0.577280801
15839,23,22640,5,6,7,0,0,18,6,10,7,0,0,23,nowin,win,dlbust,bust,20,0,11,208,0.427884615,0.0625,0.552884615,1,0.29114424
15840,84,22641,9,5,0,0,0,14,5,4,10,0,0,19,nowin,loss,beat,dlwin,0,10,14,195,0.379487179,0.056410256,0.569230769,0,0.017209119
15841,138,22641,2,3,5,1,9,20,5,4,10,0,0,19,nowin,win,plwin,beat,20,0,5,190,0.442105263,0.047368421,0.610526316,2,0.609711065
15842,99,22641,10,6,0,0,0,16,5,4,10,0,0,19,nowin,loss,beat,dlwin,0,10,16,207,0.47826087,0.062801932,0.637681159,3,0.961418446
15843,82,22641,11,10,0,0,0,21,5,4,10,0,0,19,win,win,plwin,beat,25,0,21,225,0.408888889,0.075555556,0.577777778,0,0.028101874
15844,87,22641,6,2,10,0,0,18,5,4,10,0,0,19,nowin,loss,beat,dlwin,0,10,8,202,0.405940594,0.054455446,0.628712871,2,0.590599801
15845,71,22641,6,1,8,0,0,15,5,4,10,0,0,19,nowin,loss,beat,dlwin,0,10,7,193,0.352331606,0.046632124,0.585492228,0,0.013063661
15846,27,22642,8,5,0,1,1,15,1,5,10,10,0,26,nowin,win,dlbust,bust,20,0,13,178,0.370786517,0.016853933,0.573033708,0,0.015536309
15847,52,22642,2,9,4,8,0,23,1,5,10,10,0,26,nowin,loss,bust,plbust,0,10,11,217,0.414746544,0.02764977,0.599078341,2,0.576736024
15848,81,22642,5,7,0,4,1,17,1,5,10,10,0,26,nowin,win,dlbust,bust,20,0,12,182,0.395604396,0.043956044,0.60989011,2,0.567491261
15849,145,22642,2,7,6,10,0,25,1,5,10,10,0,26,nowin,loss,bust,plbust,0,10,9,188,0.441489362,0.031914894,0.622340426,2,0.617837093
15850,11,22642,7,10,0,0,0,17,1,5,10,10,0,26,nowin,win,dlbust,bust,20,0,17,236,0.457627119,0.016949153,0.588983051,3,0.889015813
15851,24,22642,2,2,6,10,0,20,1,5,10,10,0,26,nowin,win,dlbust,bust,20,0,4,207,0.458937198,0.048309179,0.570048309,1,0.318138014
15852,149,22643,6,3,11,0,0,20,11,10,0,0,0,21,nowin,loss,beat,dlwin,0,10,9,225,0.457777778,0.057777778,0.648888889,2,0.651965595
15853,147,22643,8,8,0,3,0,19,11,10,0,0,0,21,nowin,loss,beat,dlwin,0,10,16,205,0.380487805,0.014634146,0.536585366,0,0.00951447
15854,111,22643,7,4,6,0,0,17,11,10,0,0,0,21,nowin,loss,beat,dlwin,0,10,11,180,0.433333333,0.055555556,0.611111111,2,0.602264492
15855,79,22643,4,3,10,0,0,17,11,10,0,0,0,21,nowin,loss,beat,dlwin,0,10,7,211,0.436018957,0.028436019,0.672985782,2,0.650131054
15856,83,22643,10,7,0,0,0,17,11,10,0,0,0,21,nowin,loss,beat,dlwin,0,10,17,193,0.424870466,0.051813472,0.678756477,2,0.644360335
15857,109,22643,8,7,0,3,0,18,11,10,0,0,0,21,nowin,loss,beat,dlwin,0,10,15,221,0.461538462,0.058823529,0.597285068,3,0.901830309
15858,131,22644,10,6,0,10,0,26,10,10,0,0,0,20,nowin,loss,bust,plbust,0,10,16,217,0.410138249,0.069124424,0.543778802,0,0.02015021
15859,124,22644,8,10,0,0,0,18,10,10,0,0,0,20,nowin,loss,beat,dlwin,0,10,18,202,0.47029703,0.064356436,0.584158416,3,0.899458193
15860,41,22644,7,10,0,0,0,17,10,10,0,0,0,20,nowin,loss,beat,dlwin,0,10,17,192,0.364583333,0.036458333,0.520833333,0,0.00089702
15861,71,22644,1,6,5,6,0,18,10,10,0,0,0,20,nowin,loss,beat,dlwin,0,10,7,193,0.352331606,0.046632124,0.585492228,0,0.013063661
15862,46,22644,10,9,0,0,0,19,10,10,0,0,0,20,nowin,loss,beat,dlwin,0,10,19,186,0.403225806,0.048387097,0.591397849,0,0.029742194
15863,26,22644,4,9,0,6,0,19,10,10,0,0,0,20,nowin,loss,beat,dlwin,0,10,13,203,0.463054187,0.0591133,0.541871921,1,0.306802864
15864,142,22645,10,10,0,0,0,20,5,6,10,0,0,21,nowin,loss,beat,dlwin,0,10,20,211,0.417061611,0.047393365,0.526066351,1,0.271531309
15865,112,22645,10,9,0,0,0,19,5,6,10,0,0,21,nowin,loss,beat,dlwin,0,10,19,203,0.448275862,0.054187192,0.600985222,3,0.889576933
15866,65,22645,6,3,4,0,0,13,5,6,10,0,0,21,nowin,loss,beat,dlwin,0,10,9,203,0.492610837,0.054187192,0.571428571,3,0.913702814
15867,116,22645,6,7,0,0,0,13,5,6,10,0,0,21,nowin,loss,beat,dlwin,0,10,13,195,0.425641026,0.056410256,0.538461538,1,0.28273747
15868,21,22645,3,7,9,0,0,19,5,6,10,0,0,21,nowin,loss,beat,dlwin,0,10,10,214,0.359813084,0.042056075,0.626168224,0,0.025263474
15869,46,22645,10,10,0,0,0,20,5,6,10,0,0,21,nowin,loss,beat,dlwin,0,10,20,186,0.403225806,0.048387097,0.591397849,0,0.029742194
15870,143,22646,10,10,0,0,0,20,9,5,1,3,0,18,nowin,win,plwin,beat,20,0,20,203,0.463054187,0.044334975,0.57635468,3,0.883143365
15871,118,22646,10,8,0,0,0,18,9,5,1,3,0,18,nowin,push,push,push,10,0,18,216,0.393518519,0.037037037,0.555555556,0,0.018059873
15872,93,22646,9,5,0,6,0,20,9,5,1,3,0,18,nowin,win,plwin,beat,20,0,14,175,0.485714286,0.051428571,0.548571429,1,0.323648091
15873,32,22646,9,7,0,8,0,24,9,5,1,3,0,18,nowin,loss,bust,plbust,0,10,16,189,0.391534392,0.037037037,0.53968254,0,0.013579086
15874,124,22646,11,8,0,0,0,19,9,5,1,3,0,18,nowin,win,plwin,beat,20,0,19,202,0.47029703,0.064356436,0.584158416,3,0.899458193
15875,38,22646,9,7,0,6,0,22,9,5,1,3,0,18,nowin,loss,bust,plbust,0,10,16,202,0.361386139,0.03960396,0.564356436,0,0.010597953
15876,46,22647,1,4,9,7,0,21,10,4,5,0,0,19,nowin,win,plwin,beat,20,0,5,186,0.403225806,0.048387097,0.591397849,0,0.029742194
15877,60,22647,2,4,8,8,0,22,10,4,5,0,0,19,nowin,loss,bust,plbust,0,10,6,227,0.418502203,0.022026432,0.559471366,0,0.026496258
15878,35,22647,9,3,0,10,0,22,10,4,5,0,0,19,nowin,loss,bust,plbust,0,10,12,202,0.410891089,0.044554455,0.633663366,2,0.598681573
15879,105,22647,6,10,0,8,0,24,10,4,5,0,0,19,nowin,loss,bust,plbust,0,10,16,198,0.414141414,0.070707071,0.590909091,0,0.032889494
15880,141,22647,10,10,0,0,0,20,10,4,5,0,0,19,nowin,win,plwin,beat,20,0,20,202,0.420792079,0.074257426,0.564356436,0,0.028377851
15881,34,22647,10,10,0,0,0,20,10,4,5,0,0,19,nowin,win,plwin,beat,20,0,20,202,0.5,0.079207921,0.618811881,3,0.968961434
15882,96,22648,9,2,10,0,0,21,3,3,11,0,0,17,nowin,win,plwin,beat,20,0,11,190,0.468421053,0.057894737,0.584210526,3,0.897263354
15883,104,22648,4,4,10,0,0,18,3,3,11,0,0,17,nowin,win,plwin,beat,20,0,8,209,0.363636364,0.052631579,0.593301435,0,0.018359419
15884,129,22648,3,10,0,0,0,13,3,3,11,0,0,17,nowin,loss,beat,dlwin,0,10,13,201,0.422885572,0.064676617,0.55721393,0,0.027255383
15885,72,22648,9,4,0,0,0,13,3,3,11,0,0,17,nowin,loss,beat,dlwin,0,10,13,185,0.394594595,0.032432432,0.508108108,0,0.006763115
15886,111,22648,10,2,0,10,0,22,3,3,11,0,0,17,nowin,loss,bust,plbust,0,10,12,180,0.433333333,0.055555556,0.611111111,2,0.602264492
15887,85,22648,10,7,0,0,0,17,3,3,11,0,0,17,nowin,push,push,push,10,0,17,195,0.41025641,0.066666667,0.594871795,0,0.03269711
15888,96,22649,10,2,0,0,0,12,5,8,4,0,0,17,nowin,loss,beat,dlwin,0,10,12,190,0.468421053,0.057894737,0.584210526,3,0.897263354
15889,143,22649,5,9,0,0,0,14,5,8,4,0,0,17,nowin,loss,beat,dlwin,0,10,14,203,0.463054187,0.044334975,0.57635468,3,0.883143365
15890,11,22649,3,5,10,0,0,18,5,8,4,0,0,17,nowin,win,plwin,beat,20,0,8,236,0.457627119,0.016949153,0.588983051,3,0.889015813
15891,60,22649,7,10,0,0,0,17,5,8,4,0,0,17,nowin,push,push,push,10,0,17,227,0.418502203,0.022026432,0.559471366,0,0.026496258
15892,67,22649,11,10,0,0,0,21,5,8,4,0,0,17,win,win,plwin,beat,25,0,21,195,0.369230769,0.041025641,0.569230769,0,0.014139427
15893,108,22649,7,8,0,0,0,15,5,8,4,0,0,17,nowin,loss,beat,dlwin,0,10,15,193,0.435233161,0.056994819,0.559585492,1,0.298824795
15894,15,22650,8,7,0,0,0,15,6,7,10,0,0,23,nowin,win,dlbust,bust,20,0,15,212,0.410377358,0.051886792,0.561320755,0,0.024517408
15895,50,22650,1,3,10,0,0,14,6,7,10,0,0,23,nowin,win,dlbust,bust,20,0,4,202,0.405940594,0.04950495,0.54950495,0,0.020296079
15896,124,22650,9,3,0,0,0,12,6,7,10,0,0,23,nowin,win,dlbust,bust,20,0,12,202,0.47029703,0.064356436,0.584158416,3,0.899458193
15897,18,22650,9,8,0,0,0,17,6,7,10,0,0,23,nowin,win,dlbust,bust,20,0,17,182,0.461538462,0.043956044,0.587912088,3,0.892649374
15898,145,22650,10,7,0,0,0,17,6,7,10,0,0,23,nowin,win,dlbust,bust,20,0,17,188,0.441489362,0.031914894,0.622340426,2,0.617837093
15899,31,22650,10,10,0,0,0,20,6,7,10,0,0,23,nowin,win,dlbust,bust,20,0,20,188,0.473404255,0.058510638,0.515957447,1,0.300306557
15900,133,22651,7,2,6,10,0,25,10,10,0,0,0,20,nowin,loss,bust,plbust,0,10,9,201,0.47761194,0.064676617,0.611940299,3,0.935428111
15901,41,22651,5,8,0,10,0,23,10,10,0,0,0,20,nowin,loss,bust,plbust,0,10,13,192,0.364583333,0.036458333,0.520833333,0,0.00089702
15902,110,22651,4,10,0,10,0,24,10,10,0,0,0,20,nowin,loss,bust,plbust,0,10,14,192,0.416666667,0.046875,0.557291667,0,0.025413132
15903,145,22651,10,9,0,0,0,19,10,10,0,0,0,20,nowin,loss,beat,dlwin,0,10,19,188,0.441489362,0.031914894,0.622340426,2,0.617837093
15904,90,22651,8,9,0,0,0,17,10,10,0,0,0,20,nowin,loss,beat,dlwin,0,10,17,201,0.447761194,0.049751244,0.60199005,3,0.889945023
15905,67,22651,9,10,0,0,0,19,10,10,0,0,0,20,nowin,loss,beat,dlwin,0,10,19,195,0.369230769,0.041025641,0.569230769,0,0.014139427
15906,122,22652,9,7,0,4,0,20,10,7,0,0,0,17,nowin,win,plwin,beat,20,0,16,210,0.347619048,0.052380952,0.59047619,0,0.012873677
15907,40,22652,7,10,0,0,0,17,10,7,0,0,0,17,nowin,push,push,push,10,0,17,196,0.367346939,0.030612245,0.617346939,0,0.025358183
15908,134,22652,4,10,0,1,9,24,10,7,0,0,0,17,nowin,loss,bust,plbust,0,10,14,185,0.443243243,0.021621622,0.545945946,1,0.296939509
15909,78,22652,10,4,0,5,0,19,10,7,0,0,0,17,nowin,win,plwin,beat,20,0,14,201,0.517412935,0.034825871,0.587064677,3,0.95871112
15910,21,22652,8,5,0,10,0,23,10,7,0,0,0,17,nowin,loss,bust,plbust,0,10,13,214,0.359813084,0.042056075,0.626168224,0,0.025263474
15911,46,22652,7,10,0,0,0,17,10,7,0,0,0,17,nowin,push,push,push,10,0,17,186,0.403225806,0.048387097,0.591397849,0,0.029742194
15912,114,22653,5,10,0,0,0,15,2,10,1,9,0,22,nowin,win,dlbust,bust,20,0,15,198,0.47979798,0.025252525,0.611111111,3,0.937232995
15913,120,22653,10,5,0,0,0,15,2,10,1,9,0,22,nowin,win,dlbust,bust,20,0,15,202,0.440594059,0.034653465,0.618811881,2,0.614441029
15914,125,22653,4,10,0,0,0,14,2,10,1,9,0,22,nowin,win,dlbust,bust,20,0,14,219,0.438356164,0.050228311,0.575342466,1,0.308411257
15915,86,22653,2,6,10,0,0,18,2,10,1,9,0,22,nowin,win,dlbust,bust,20,0,8,196,0.454081633,0.040816327,0.591836735,3,0.887566443
15916,71,22653,5,2,8,0,0,15,2,10,1,9,0,22,nowin,win,dlbust,bust,20,0,7,193,0.352331606,0.046632124,0.585492228,0,0.013063661
15917,106,22653,9,10,0,0,0,19,2,10,1,9,0,22,nowin,win,dlbust,bust,20,0,19,192,0.411458333,0.026041667,0.557291667,0,0.023854304
15918,82,22654,9,6,0,10,0,25,10,10,0,0,0,20,nowin,loss,bust,plbust,0,10,15,225,0.408888889,0.075555556,0.577777778,0,0.028101874
15919,53,22654,3,9,0,7,0,19,10,10,0,0,0,20,nowin,loss,beat,dlwin,0,10,12,250,0.372,0.064,0.564,0,0.013687345
15920,95,22654,10,2,0,10,0,22,10,10,0,0,0,20,nowin,loss,bust,plbust,0,10,12,218,0.412844037,0.04587156,0.559633028,0,0.024842385
15921,47,22654,10,3,0,4,0,17,10,10,0,0,0,20,nowin,loss,beat,dlwin,0,10,13,210,0.438095238,0.057142857,0.623809524,2,0.615868808
15922,3,22654,10,5,0,8,0,23,10,10,0,0,0,20,nowin,loss,bust,plbust,0,10,15,190,0.431578947,0.026315789,0.542105263,1,0.288076384
15923,98,22654,8,9,0,0,0,17,10,10,0,0,0,20,nowin,loss,beat,dlwin,0,10,17,220,0.422727273,0.054545455,0.55,1,0.28664435
15924,84,22655,10,9,0,0,0,19,3,8,8,0,0,19,nowin,push,push,push,10,0,19,195,0.379487179,0.056410256,0.569230769,0,0.017209119
15925,54,22655,3,8,3,0,0,14,3,8,8,0,0,19,nowin,loss,beat,dlwin,0,10,11,185,0.437837838,0.032432432,0.556756757,1,0.29899854
15926,47,22655,11,10,0,0,0,21,3,8,8,0,0,19,win,win,plwin,beat,25,0,21,210,0.438095238,0.057142857,0.623809524,2,0.615868808
15927,19,22655,9,10,0,0,0,19,3,8,8,0,0,19,nowin,push,push,push,10,0,19,237,0.41350211,0.054852321,0.628691983,2,0.597373826
15928,11,22655,3,4,5,10,0,22,3,8,8,0,0,19,nowin,loss,bust,plbust,0,10,7,236,0.457627119,0.016949153,0.588983051,3,0.889015813
15929,73,22655,5,4,5,0,0,14,3,8,8,0,0,19,nowin,loss,beat,dlwin,0,10,9,181,0.375690608,0.011049724,0.596685083,0,0.022795773
15930,85,22656,2,1,10,10,0,23,8,4,3,6,0,21,nowin,loss,bust,plbust,0,10,3,195,0.41025641,0.066666667,0.594871795,0,0.03269711
15931,71,22656,10,8,0,0,0,18,8,4,3,6,0,21,nowin,loss,beat,dlwin,0,10,18,193,0.352331606,0.046632124,0.585492228,0,0.013063661
15932,45,22656,10,3,0,3,6,22,8,4,3,6,0,21,nowin,loss,bust,plbust,0,10,13,196,0.428571429,0.051020408,0.612244898,2,0.598821767
15933,10,22656,10,7,0,0,0,17,8,4,3,6,0,21,nowin,loss,beat,dlwin,0,10,17,191,0.413612565,0.057591623,0.596858639,2,0.574087175
15934,97,22656,10,10,0,0,0,20,8,4,3,6,0,21,nowin,loss,beat,dlwin,0,10,20,182,0.450549451,0.06043956,0.692307692,2,0.677372279
15935,38,22656,4,10,0,10,0,24,8,4,3,6,0,21,nowin,loss,bust,plbust,0,10,14,202,0.361386139,0.03960396,0.564356436,0,0.010597953
15936,74,22657,10,3,0,0,0,13,3,8,6,0,0,17,nowin,loss,beat,dlwin,0,10,13,209,0.411483254,0.04784689,0.531100478,0,0.017448125
15937,136,22657,4,10,0,0,0,14,3,8,6,0,0,17,nowin,loss,beat,dlwin,0,10,14,194,0.396907216,0.025773196,0.597938144,0,0.029452644
15938,145,22657,5,9,0,0,0,14,3,8,6,0,0,17,nowin,loss,beat,dlwin,0,10,14,188,0.441489362,0.031914894,0.622340426,2,0.617837093
15939,38,22657,4,5,8,0,0,17,3,8,6,0,0,17,nowin,push,push,push,10,0,9,202,0.361386139,0.03960396,0.564356436,0,0.010597953
15940,53,22657,10,7,0,0,0,17,3,8,6,0,0,17,nowin,push,push,push,10,0,17,250,0.372,0.064,0.564,0,0.013687345
15941,12,22657,11,10,0,0,0,21,3,8,6,0,0,17,win,win,plwin,beat,25,0,21,189,0.470899471,0.015873016,0.613756614,3,0.929171178
15942,126,22658,11,7,0,0,0,18,4,10,5,0,0,19,nowin,loss,beat,dlwin,0,10,18,188,0.457446809,0.074468085,0.60106383,3,0.900633203
15943,146,22658,10,8,0,0,0,18,4,10,5,0,0,19,nowin,loss,beat,dlwin,0,10,18,221,0.43438914,0.040723982,0.542986425,1,0.290190091
15944,3,22658,6,2,9,0,0,17,4,10,5,0,0,19,nowin,loss,beat,dlwin,0,10,8,190,0.431578947,0.026315789,0.542105263,1,0.288076384
15945,64,22658,1,6,10,0,0,17,4,10,5,0,0,19,nowin,loss,beat,dlwin,0,10,7,187,0.363636364,0.048128342,0.631016043,0,0.027594885
15946,102,22658,2,10,0,0,0,12,4,10,5,0,0,19,nowin,loss,beat,dlwin,0,10,12,192,0.338541667,0.046875,0.5625,0,0.003306118
15947,21,22658,6,11,3,0,0,20,4,10,5,0,0,19,nowin,win,plwin,beat,20,0,17,214,0.359813084,0.042056075,0.626168224,0,0.025263474
15948,16,22659,8,6,0,3,0,17,10,10,0,0,0,20,nowin,loss,beat,dlwin,0,10,14,220,0.427272727,0.081818182,0.6,2,0.588660176
15949,2,22659,3,3,4,5,2,17,10,10,0,0,0,20,nowin,loss,beat,dlwin,0,10,6,200,0.445,0.035,0.64,2,0.633962549
15950,126,22659,2,10,0,10,0,22,10,10,0,0,0,20,nowin,loss,bust,plbust,0,10,12,188,0.457446809,0.074468085,0.60106383,3,0.900633203
15951,12,22659,10,6,0,10,0,26,10,10,0,0,0,20,nowin,loss,bust,plbust,0,10,16,189,0.470899471,0.015873016,0.613756614,3,0.929171178
15952,95,22659,5,10,0,10,0,25,10,10,0,0,0,20,nowin,loss,bust,plbust,0,10,15,218,0.412844037,0.04587156,0.559633028,0,0.024842385
15953,71,22659,11,1,7,0,0,19,10,10,0,0,0,20,nowin,loss,beat,dlwin,0,10,12,193,0.352331606,0.046632124,0.585492228,0,0.013063661
15954,36,22660,10,8,0,0,0,18,10,11,0,0,0,21,nowin,loss,beat,dlwin,0,10,18,229,0.445414847,0.056768559,0.655021834,2,0.645370571
15955,10,22660,5,3,10,0,0,18,10,11,0,0,0,21,nowin,loss,beat,dlwin,0,10,8,191,0.413612565,0.057591623,0.596858639,2,0.574087175
15956,121,22660,6,8,0,2,10,26,10,11,0,0,0,21,nowin,loss,bust,plbust,0,10,14,195,0.456410256,0.025641026,0.512820513,1,0.288597791
15957,94,22660,10,10,0,0,0,20,10,11,0,0,0,21,nowin,loss,beat,dlwin,0,10,20,183,0.43715847,0.043715847,0.540983607,1,0.290866892
15958,146,22660,10,8,0,0,0,18,10,11,0,0,0,21,nowin,loss,beat,dlwin,0,10,18,221,0.43438914,0.040723982,0.542986425,1,0.290190091
15959,118,22660,10,7,0,0,0,17,10,11,0,0,0,21,nowin,loss,beat,dlwin,0,10,17,216,0.393518519,0.037037037,0.555555556,0,0.018059873
15960,53,22661,4,7,2,1,10,24,10,11,0,0,0,21,nowin,loss,bust,plbust,0,10,11,250,0.372,0.064,0.564,0,0.013687345
15961,140,22661,2,8,6,7,0,23,10,11,0,0,0,21,nowin,loss,bust,plbust,0,10,10,210,0.466666667,0.023809524,0.604761905,3,0.915293335
15962,33,22661,3,6,10,0,0,19,10,11,0,0,0,21,nowin,loss,beat,dlwin,0,10,9,192,0.4375,0.057291667,0.625,2,0.616208916
15963,28,22661,8,10,0,0,0,18,10,11,0,0,0,21,nowin,loss,beat,dlwin,0,10,18,199,0.422110553,0.045226131,0.542713568,1,0.282706618
15964,122,22661,5,10,0,5,0,20,10,11,0,0,0,21,nowin,loss,beat,dlwin,0,10,15,210,0.347619048,0.052380952,0.59047619,0,0.012873677
15965,19,22661,4,2,4,8,0,18,10,11,0,0,0,21,nowin,loss,beat,dlwin,0,10,6,237,0.41350211,0.054852321,0.628691983,2,0.597373826
15966,128,22662,6,9,0,6,0,21,10,10,0,0,0,20,nowin,win,plwin,beat,20,0,15,227,0.356828194,0.052863436,0.577092511,0,0.012352564
15967,143,22662,10,9,0,0,0,19,10,10,0,0,0,20,nowin,loss,beat,dlwin,0,10,19,203,0.463054187,0.044334975,0.57635468,3,0.883143365
15968,59,22662,10,10,0,0,0,20,10,10,0,0,0,20,nowin,push,push,push,10,0,20,228,0.429824561,0.048245614,0.543859649,1,0.287885446
15969,129,22662,10,3,0,8,0,21,10,10,0,0,0,20,nowin,win,plwin,beat,20,0,13,201,0.422885572,0.064676617,0.55721393,0,0.027255383
15970,116,22662,5,10,0,8,0,23,10,10,0,0,0,20,nowin,loss,bust,plbust,0,10,15,195,0.425641026,0.056410256,0.538461538,1,0.28273747
15971,106,22662,2,2,10,3,0,17,10,10,0,0,0,20,nowin,loss,beat,dlwin,0,10,4,192,0.411458333,0.026041667,0.557291667,0,0.023854304
15972,25,22663,6,7,0,9,0,22,10,3,10,0,0,23,nowin,loss,bust,plbust,0,10,13,190,0.463157895,0.063157895,0.536842105,1,0.304401563
15973,87,22663,8,10,0,0,0,18,10,3,10,0,0,23,nowin,win,dlbust,bust,20,0,18,202,0.405940594,0.054455446,0.628712871,2,0.590599801
15974,86,22663,2,5,4,10,0,21,10,3,10,0,0,23,nowin,win,dlbust,bust,20,0,7,196,0.454081633,0.040816327,0.591836735,3,0.887566443
15975,83,22663,10,10,0,0,0,20,10,3,10,0,0,23,nowin,win,dlbust,bust,20,0,20,193,0.424870466,0.051813472,0.678756477,2,0.644360335
15976,68,22663,8,10,0,0,0,18,10,3,10,0,0,23,nowin,win,dlbust,bust,20,0,18,205,0.434146341,0.029268293,0.6,2,0.59483189
15977,132,22663,3,3,3,3,8,20,10,3,10,0,0,23,nowin,win,dlbust,bust,20,0,6,194,0.412371134,0.036082474,0.649484536,2,0.611633238
15978,104,22664,8,9,0,0,0,17,10,2,9,0,0,21,nowin,loss,beat,dlwin,0,10,17,209,0.363636364,0.052631579,0.593301435,0,0.018359419
15979,27,22664,2,6,4,2,10,24,10,2,9,0,0,21,nowin,loss,bust,plbust,0,10,8,178,0.370786517,0.016853933,0.573033708,0,0.015536309
15980,115,22664,5,4,8,0,0,17,10,2,9,0,0,21,nowin,loss,beat,dlwin,0,10,9,194,0.427835052,0.041237113,0.592783505,2,0.583863602
15981,97,22664,5,10,0,1,9,25,10,2,9,0,0,21,nowin,loss,bust,plbust,0,10,15,182,0.450549451,0.06043956,0.692307692,2,0.677372279
15982,100,22664,10,2,0,4,10,26,10,2,9,0,0,21,nowin,loss,bust,plbust,0,10,12,190,0.452631579,0.036842105,0.594736842,3,0.888671154
15983,136,22664,10,2,0,7,0,19,10,2,9,0,0,21,nowin,loss,beat,dlwin,0,10,12,194,0.396907216,0.025773196,0.597938144,0,0.029452644
15984,129,22665,9,5,0,0,0,14,6,8,10,0,0,24,nowin,win,dlbust,bust,20,0,14,201,0.422885572,0.064676617,0.55721393,0,0.027255383
15985,97,22665,10,7,0,0,0,17,6,8,10,0,0,24,nowin,win,dlbust,bust,20,0,17,182,0.450549451,0.06043956,0.692307692,2,0.677372279
15986,58,22665,8,10,0,0,0,18,6,8,10,0,0,24,nowin,win,dlbust,bust,20,0,18,195,0.430769231,0.041025641,0.584615385,2,0.580497586
15987,112,22665,10,5,0,0,0,15,6,8,10,0,0,24,nowin,win,dlbust,bust,20,0,15,203,0.448275862,0.054187192,0.600985222,3,0.889576933
15988,150,22665,5,8,0,0,0,13,6,8,10,0,0,24,nowin,win,dlbust,bust,20,0,13,192,0.401041667,0.036458333,0.567708333,0,0.023287458
15989,4,22665,10,9,0,0,0,19,6,8,10,0,0,24,nowin,win,dlbust,bust,20,0,19,217,0.460829493,0.036866359,0.562211982,1,0.315432839
15990,22,22666,2,5,11,0,0,18,7,4,5,5,0,21,nowin,loss,beat,dlwin,0,10,7,187,0.481283422,0.042780749,0.577540107,3,0.906128176
15991,146,22666,11,4,5,0,0,20,7,4,5,5,0,21,nowin,loss,beat,dlwin,0,10,15,221,0.43438914,0.040723982,0.542986425,1,0.290190091
15992,82,22666,10,8,0,0,0,18,7,4,5,5,0,21,nowin,loss,beat,dlwin,0,10,18,225,0.408888889,0.075555556,0.577777778,0,0.028101874
15993,56,22666,3,11,6,0,0,20,7,4,5,5,0,21,nowin,loss,beat,dlwin,0,10,14,175,0.4,0.057142857,0.582857143,0,0.026685297
15994,32,22666,9,10,0,0,0,19,7,4,5,5,0,21,nowin,loss,beat,dlwin,0,10,19,189,0.391534392,0.037037037,0.53968254,0,0.013579086
15995,17,22666,5,10,0,10,0,25,7,4,5,5,0,21,nowin,loss,bust,plbust,0,10,15,171,0.444444444,0.070175439,0.555555556,1,0.302364894
15996,131,22667,5,10,0,9,0,24,11,10,0,0,0,21,nowin,loss,bust,plbust,0,10,15,217,0.410138249,0.069124424,0.543778802,0,0.02015021
15997,112,22667,5,8,0,10,0,23,11,10,0,0,0,21,nowin,loss,bust,plbust,0,10,13,203,0.448275862,0.054187192,0.600985222,3,0.889576933
15998,19,22667,4,10,0,9,0,23,11,10,0,0,0,21,nowin,loss,bust,plbust,0,10,14,237,0.41350211,0.054852321,0.628691983,2,0.597373826
15999,46,22667,6,6,0,1,2,15,11,10,0,0,0,21,nowin,loss,beat,dlwin,0,10,12,186,0.403225806,0.048387097,0.591397849,0,0.029742194
16000,142,22667,10,8,0,0,0,18,11,10,0,0,0,21,nowin,loss,beat,dlwin,0,10,18,211,0.417061611,0.047393365,0.526066351,1,0.271531309
16001,52,22667,10,10,0,0,0,20,11,10,0,0,0,21,nowin,loss,beat,dlwin,0,10,20,217,0.414746544,0.02764977,0.599078341,2,0.576736024
16002,87,22668,3,6,6,5,0,20,11,7,0,0,0,18,nowin,win,plwin,beat,20,0,9,202,0.405940594,0.054455446,0.628712871,2,0.590599801
16003,134,22668,3,8,10,0,0,21,11,7,0,0,0,18,nowin,win,plwin,beat,20,0,11,185,0.443243243,0.021621622,0.545945946,1,0.296939509
16004,75,22668,6,2,2,1,10,21,11,7,0,0,0,18,nowin,win,plwin,beat,20,0,8,191,0.418848168,0.052356021,0.570680628,0,0.029344702
16005,16,22668,3,11,7,0,0,21,11,7,0,0,0,18,nowin,win,plwin,beat,20,0,14,220,0.427272727,0.081818182,0.6,2,0.588660176
16006,103,22668,9,2,7,0,0,18,11,7,0,0,0,18,nowin,push,push,push,10,0,11,203,0.379310345,0.064039409,0.551724138,0,0.012869209
16007,10,22668,5,2,9,9,0,25,11,7,0,0,0,18,nowin,loss,bust,plbust,0,10,7,191,0.413612565,0.057591623,0.596858639,2,0.574087175
16008,35,22669,3,10,0,0,0,13,4,10,6,0,0,20,nowin,loss,beat,dlwin,0,10,13,202,0.410891089,0.044554455,0.633663366,2,0.598681573
16009,98,22669,4,7,10,0,0,21,4,10,6,0,0,20,nowin,win,plwin,beat,20,0,11,220,0.422727273,0.054545455,0.55,1,0.28664435
16010,40,22669,5,10,0,0,0,15,4,10,6,0,0,20,nowin,loss,beat,dlwin,0,10,15,196,0.367346939,0.030612245,0.617346939,0,0.025358183
16011,25,22669,10,8,0,0,0,18,4,10,6,0,0,20,nowin,loss,beat,dlwin,0,10,18,190,0.463157895,0.063157895,0.536842105,1,0.304401563
16012,107,22669,10,9,0,0,0,19,4,10,6,0,0,20,nowin,loss,beat,dlwin,0,10,19,218,0.444954128,0.073394495,0.600917431,2,0.605210014
16013,53,22669,10,2,0,0,0,12,4,10,6,0,0,20,nowin,loss,beat,dlwin,0,10,12,250,0.372,0.064,0.564,0,0.013687345
16014,130,22670,9,9,0,0,0,18,10,10,0,0,0,20,nowin,loss,beat,dlwin,0,10,18,219,0.410958904,0.03652968,0.566210046,0,0.025888739
16015,19,22670,7,9,0,10,0,26,10,10,0,0,0,20,nowin,loss,bust,plbust,0,10,16,237,0.41350211,0.054852321,0.628691983,2,0.597373826
16016,98,22670,9,7,0,8,0,24,10,10,0,0,0,20,nowin,loss,bust,plbust,0,10,16,220,0.422727273,0.054545455,0.55,1,0.28664435
16017,6,22670,6,7,0,10,0,23,10,10,0,0,0,20,nowin,loss,bust,plbust,0,10,13,191,0.439790576,0.047120419,0.581151832,1,0.31211505
16018,50,22670,11,10,0,0,0,21,10,10,0,0,0,20,win,win,plwin,beat,25,0,21,202,0.405940594,0.04950495,0.54950495,0,0.020296079
16019,59,22670,10,10,0,0,0,20,10,10,0,0,0,20,nowin,push,push,push,10,0,20,228,0.429824561,0.048245614,0.543859649,1,0.287885446
16020,53,22671,3,9,0,3,5,20,10,7,0,0,0,17,nowin,win,plwin,beat,20,0,12,250,0.372,0.064,0.564,0,0.013687345
16021,29,22671,10,6,0,10,0,26,10,7,0,0,0,17,nowin,loss,bust,plbust,0,10,16,189,0.44973545,0.058201058,0.544973545,1,0.300349439
16022,17,22671,7,6,0,4,0,17,10,7,0,0,0,17,nowin,push,push,push,10,0,13,171,0.444444444,0.070175439,0.555555556,1,0.302364894
16023,57,22671,7,10,0,0,0,17,10,7,0,0,0,17,nowin,push,push,push,10,0,17,192,0.46875,0.052083333,0.59375,3,0.907001181
16024,107,22671,3,6,3,7,0,19,10,7,0,0,0,17,nowin,win,plwin,beat,20,0,9,218,0.444954128,0.073394495,0.600917431,2,0.605210014
16025,73,22671,4,10,0,7,0,21,10,7,0,0,0,17,nowin,win,plwin,beat,20,0,14,181,0.375690608,0.011049724,0.596685083,0,0.022795773
16026,69,22672,10,8,0,0,0,18,8,4,10,0,0,22,nowin,win,dlbust,bust,20,0,18,194,0.365979381,0.030927835,0.515463918,0,0
16027,24,22672,10,9,0,0,0,19,8,4,10,0,0,22,nowin,win,dlbust,bust,20,0,19,207,0.458937198,0.048309179,0.570048309,1,0.318138014
16028,29,22672,10,10,0,0,0,20,8,4,10,0,0,22,nowin,win,dlbust,bust,20,0,20,189,0.44973545,0.058201058,0.544973545,1,0.300349439
16029,4,22672,10,8,0,0,0,18,8,4,10,0,0,22,nowin,win,dlbust,bust,20,0,18,217,0.460829493,0.036866359,0.562211982,1,0.315432839
16030,103,22672,10,6,0,6,0,22,8,4,10,0,0,22,nowin,loss,bust,plbust,0,10,16,203,0.379310345,0.064039409,0.551724138,0,0.012869209
16031,30,22672,8,4,0,4,10,26,8,4,10,0,0,22,nowin,loss,bust,plbust,0,10,12,206,0.393203883,0.033980583,0.601941748,0,0.029324648
16032,146,22673,10,11,0,0,0,21,6,11,0,0,0,17,win,win,plwin,beat,25,0,21,221,0.43438914,0.040723982,0.542986425,1,0.290190091
16033,137,22673,10,3,0,0,0,13,6,11,0,0,0,17,nowin,loss,beat,dlwin,0,10,13,194,0.417525773,0.046391753,0.536082474,1,0.276714602
16034,147,22673,3,10,0,0,0,13,6,11,0,0,0,17,nowin,loss,beat,dlwin,0,10,13,205,0.380487805,0.014634146,0.536585366,0,0.00951447
16035,81,22673,4,4,7,0,0,15,6,11,0,0,0,17,nowin,loss,beat,dlwin,0,10,8,182,0.395604396,0.043956044,0.60989011,2,0.567491261
16036,131,22673,10,11,0,0,0,21,6,11,0,0,0,17,win,win,plwin,beat,25,0,21,217,0.410138249,0.069124424,0.543778802,0,0.02015021
16037,122,22673,7,10,0,0,0,17,6,11,0,0,0,17,nowin,push,push,push,10,0,17,210,0.347619048,0.052380952,0.59047619,0,0.012873677
16038,12,22674,3,4,7,8,0,22,7,10,0,0,0,17,nowin,loss,bust,plbust,0,10,7,189,0.470899471,0.015873016,0.613756614,3,0.929171178
16039,31,22674,5,4,10,0,0,19,7,10,0,0,0,17,nowin,win,plwin,beat,20,0,9,188,0.473404255,0.058510638,0.515957447,1,0.300306557
16040,125,22674,1,6,9,9,0,25,7,10,0,0,0,17,nowin,loss,bust,plbust,0,10,7,219,0.438356164,0.050228311,0.575342466,1,0.308411257
16041,67,22674,10,5,0,2,0,17,7,10,0,0,0,17,nowin,push,push,push,10,0,15,195,0.369230769,0.041025641,0.569230769,0,0.014139427
16042,30,22674,8,10,0,0,0,18,7,10,0,0,0,17,nowin,win,plwin,beat,20,0,18,206,0.393203883,0.033980583,0.601941748,0,0.029324648
16043,104,22674,2,7,9,0,0,18,7,10,0,0,0,17,nowin,win,plwin,beat,20,0,9,209,0.363636364,0.052631579,0.593301435,0,0.018359419
16044,1,22675,8,10,0,0,0,18,4,10,2,5,0,21,nowin,loss,beat,dlwin,0,10,18,197,0.406091371,0.025380711,0.649746193,2,0.606186955
16045,115,22675,10,2,0,0,0,12,4,10,2,5,0,21,nowin,loss,beat,dlwin,0,10,12,194,0.427835052,0.041237113,0.592783505,2,0.583863602
16046,120,22675,10,11,0,0,0,21,4,10,2,5,0,21,win,push,push,push,10,0,21,202,0.440594059,0.034653465,0.618811881,2,0.614441029
16047,115,22675,2,8,11,0,0,21,4,10,2,5,0,21,nowin,push,push,push,10,0,10,194,0.427835052,0.041237113,0.592783505,2,0.583863602
16048,121,22675,3,10,0,0,0,13,4,10,2,5,0,21,nowin,loss,beat,dlwin,0,10,13,195,0.456410256,0.025641026,0.512820513,1,0.288597791
16049,65,22675,3,6,10,0,0,19,4,10,2,5,0,21,nowin,loss,beat,dlwin,0,10,9,203,0.492610837,0.054187192,0.571428571,3,0.913702814
16050,49,22676,9,10,0,0,0,19,4,10,1,10,0,25,nowin,win,dlbust,bust,20,0,19,207,0.396135266,0.053140097,0.594202899,0,0.028306925
16051,17,22676,10,3,0,0,0,13,4,10,1,10,0,25,nowin,win,dlbust,bust,20,0,13,171,0.444444444,0.070175439,0.555555556,1,0.302364894
16052,31,22676,6,7,0,0,0,13,4,10,1,10,0,25,nowin,win,dlbust,bust,20,0,13,188,0.473404255,0.058510638,0.515957447,1,0.300306557
16053,114,22676,2,2,4,9,0,17,4,10,1,10,0,25,nowin,win,dlbust,bust,20,0,4,198,0.47979798,0.025252525,0.611111111,3,0.937232995
16054,120,22676,10,6,0,0,0,16,4,10,1,10,0,25,nowin,win,dlbust,bust,20,0,16,202,0.440594059,0.034653465,0.618811881,2,0.614441029
16055,148,22676,10,10,0,0,0,20,4,10,1,10,0,25,nowin,win,dlbust,bust,20,0,20,204,0.401960784,0.078431373,0.593137255,0,0.029789521
16056,88,22677,4,4,10,0,0,18,10,4,10,0,0,24,nowin,win,dlbust,bust,20,0,8,206,0.466019417,0.033980583,0.54368932,1,0.309467903
16057,4,22677,4,10,0,7,0,21,10,4,10,0,0,24,nowin,win,dlbust,bust,20,0,14,217,0.460829493,0.036866359,0.562211982,1,0.315432839
16058,140,22677,8,11,0,0,0,19,10,4,10,0,0,24,nowin,win,dlbust,bust,20,0,19,210,0.466666667,0.023809524,0.604761905,3,0.915293335
16059,82,22677,7,11,0,0,0,18,10,4,10,0,0,24,nowin,win,dlbust,bust,20,0,18,225,0.408888889,0.075555556,0.577777778,0,0.028101874
16060,60,22677,10,2,0,10,0,22,10,4,10,0,0,24,nowin,loss,bust,plbust,0,10,12,227,0.418502203,0.022026432,0.559471366,0,0.026496258
16061,134,22677,10,3,0,7,0,20,10,4,10,0,0,24,nowin,win,dlbust,bust,20,0,13,185,0.443243243,0.021621622,0.545945946,1,0.296939509
16062,76,22678,4,7,10,0,0,21,6,10,3,0,0,19,nowin,win,plwin,beat,20,0,11,189,0.534391534,0.079365079,0.608465608,3,1
16063,26,22678,9,11,0,0,0,20,6,10,3,0,0,19,nowin,win,plwin,beat,20,0,20,203,0.463054187,0.0591133,0.541871921,1,0.306802864
16064,58,22678,10,4,0,0,0,14,6,10,3,0,0,19,nowin,loss,beat,dlwin,0,10,14,195,0.430769231,0.041025641,0.584615385,2,0.580497586
16065,7,22678,10,10,0,0,0,20,6,10,3,0,0,19,nowin,win,plwin,beat,20,0,20,183,0.442622951,0.06010929,0.62295082,2,0.619303341
16066,25,22678,9,9,0,0,0,18,6,10,3,0,0,19,nowin,loss,beat,dlwin,0,10,18,190,0.463157895,0.063157895,0.536842105,1,0.304401563
16067,21,22678,8,9,0,0,0,17,6,10,3,0,0,19,nowin,loss,beat,dlwin,0,10,17,214,0.359813084,0.042056075,0.626168224,0,0.025263474
16068,109,22679,5,11,1,0,0,17,10,5,2,0,0,17,nowin,push,push,push,10,0,16,221,0.461538462,0.058823529,0.597285068,3,0.901830309
16069,39,22679,6,3,7,4,0,20,10,5,2,0,0,17,nowin,win,plwin,beat,20,0,9,191,0.429319372,0.062827225,0.57591623,0,0.033760763
16070,32,22679,11,8,0,0,0,19,10,5,2,0,0,17,nowin,win,plwin,beat,20,0,19,189,0.391534392,0.037037037,0.53968254,0,0.013579086
16071,111,22679,8,10,0,0,0,18,10,5,2,0,0,17,nowin,win,plwin,beat,20,0,18,180,0.433333333,0.055555556,0.611111111,2,0.602264492
16072,79,22679,10,8,0,0,0,18,10,5,2,0,0,17,nowin,win,plwin,beat,20,0,18,211,0.436018957,0.028436019,0.672985782,2,0.650131054
16073,36,22679,8,3,5,7,0,23,10,5,2,0,0,17,nowin,loss,bust,plbust,0,10,11,229,0.445414847,0.056768559,0.655021834,2,0.645370571
16074,28,22680,1,4,10,9,0,24,11,10,0,0,0,21,nowin,loss,bust,plbust,0,10,5,199,0.422110553,0.045226131,0.542713568,1,0.282706618
16075,43,22680,3,2,6,7,0,18,11,10,0,0,0,21,nowin,loss,beat,dlwin,0,10,5,192,0.40625,0.041666667,0.609375,2,0.576671372
16076,61,22680,10,11,0,0,0,21,11,10,0,0,0,21,win,push,push,push,10,0,21,194,0.427835052,0.077319588,0.603092784,2,0.591437139
16077,147,22680,10,2,0,10,0,22,11,10,0,0,0,21,nowin,loss,bust,plbust,0,10,12,205,0.380487805,0.014634146,0.536585366,0,0.00951447
16078,62,22680,6,10,0,10,0,26,11,10,0,0,0,21,nowin,loss,bust,plbust,0,10,16,178,0.370786517,0.028089888,0.54494382,0,0.008657722
16079,19,22680,6,4,11,0,0,21,11,10,0,0,0,21,nowin,push,push,push,10,0,10,237,0.41350211,0.054852321,0.628691983,2,0.597373826
16080,138,22681,8,8,0,0,0,16,5,2,7,7,0,21,nowin,loss,beat,dlwin,0,10,16,190,0.442105263,0.047368421,0.610526316,2,0.609711065
16081,136,22681,2,4,10,0,0,16,5,2,7,7,0,21,nowin,loss,beat,dlwin,0,10,6,194,0.396907216,0.025773196,0.597938144,0,0.029452644
16082,135,22681,7,5,0,0,0,12,5,2,7,7,0,21,nowin,loss,beat,dlwin,0,10,12,179,0.391061453,0.067039106,0.586592179,0,0.024924662
16083,144,22681,9,10,0,0,0,19,5,2,7,7,0,21,nowin,loss,beat,dlwin,0,10,19,202,0.386138614,0.054455446,0.564356436,0,0.018006244
16084,19,22681,10,9,0,0,0,19,5,2,7,7,0,21,nowin,loss,beat,dlwin,0,10,19,237,0.41350211,0.054852321,0.628691983,2,0.597373826
16085,87,22681,2,3,2,9,0,16,5,2,7,7,0,21,nowin,loss,beat,dlwin,0,10,5,202,0.405940594,0.054455446,0.628712871,2,0.590599801
16086,108,22682,10,10,0,0,0,20,10,11,0,0,0,21,nowin,loss,beat,dlwin,0,10,20,193,0.435233161,0.056994819,0.559585492,1,0.298824795
16087,140,22682,6,8,0,10,0,24,10,11,0,0,0,21,nowin,loss,bust,plbust,0,10,14,210,0.466666667,0.023809524,0.604761905,3,0.915293335
16088,95,22682,4,10,0,9,0,23,10,11,0,0,0,21,nowin,loss,bust,plbust,0,10,14,218,0.412844037,0.04587156,0.559633028,0,0.024842385
16089,37,22682,10,6,0,6,0,22,10,11,0,0,0,21,nowin,loss,bust,plbust,0,10,16,208,0.394230769,0.038461538,0.581730769,0,0.024682772
16090,135,22682,4,3,4,6,0,17,10,11,0,0,0,21,nowin,loss,beat,dlwin,0,10,7,179,0.391061453,0.067039106,0.586592179,0,0.024924662
16091,130,22682,10,10,0,0,0,20,10,11,0,0,0,21,nowin,loss,beat,dlwin,0,10,20,219,0.410958904,0.03652968,0.566210046,0,0.025888739
16092,114,22683,10,10,0,0,0,20,10,3,4,0,0,17,nowin,win,plwin,beat,20,0,20,198,0.47979798,0.025252525,0.611111111,3,0.937232995
16093,99,22683,9,10,0,0,0,19,10,3,4,0,0,17,nowin,win,plwin,beat,20,0,19,207,0.47826087,0.062801932,0.637681159,3,0.961418446
16094,54,22683,9,5,0,3,0,17,10,3,4,0,0,17,nowin,push,push,push,10,0,14,185,0.437837838,0.032432432,0.556756757,1,0.29899854
16095,5,22683,4,4,9,0,0,17,10,3,4,0,0,17,nowin,push,push,push,10,0,8,203,0.42364532,0.02955665,0.596059113,2,0.582508076
16096,77,22683,11,3,4,0,0,18,10,3,4,0,0,17,nowin,win,plwin,beat,20,0,14,200,0.455,0.04,0.62,3,0.916252116
16097,13,22683,10,6,0,8,0,24,10,3,4,0,0,17,nowin,loss,bust,plbust,0,10,16,206,0.417475728,0.063106796,0.621359223,2,0.59555479
16098,61,22684,9,10,0,0,0,19,3,10,7,0,0,20,nowin,loss,beat,dlwin,0,10,19,194,0.427835052,0.077319588,0.603092784,2,0.591437139
16099,42,22684,5,6,7,0,0,18,3,10,7,0,0,20,nowin,loss,beat,dlwin,0,10,11,212,0.443396226,0.051886792,0.570754717,1,0.309181312
16100,93,22684,4,6,8,0,0,18,3,10,7,0,0,20,nowin,loss,beat,dlwin,0,10,10,175,0.485714286,0.051428571,0.548571429,1,0.323648091
16101,65,22684,4,6,2,10,0,22,3,10,7,0,0,20,nowin,loss,bust,plbust,0,10,10,203,0.492610837,0.054187192,0.571428571,3,0.913702814
16102,128,22684,9,8,0,0,0,17,3,10,7,0,0,20,nowin,loss,beat,dlwin,0,10,17,227,0.356828194,0.052863436,0.577092511,0,0.012352564
16103,143,22684,8,3,6,0,0,17,3,10,7,0,0,20,nowin,loss,beat,dlwin,0,10,11,203,0.463054187,0.044334975,0.57635468,3,0.883143365
16104,118,22685,3,10,0,0,0,13,2,5,10,0,0,17,nowin,loss,beat,dlwin,0,10,13,216,0.393518519,0.037037037,0.555555556,0,0.018059873
16105,81,22685,4,4,10,0,0,18,2,5,10,0,0,17,nowin,win,plwin,beat,20,0,8,182,0.395604396,0.043956044,0.60989011,2,0.567491261
16106,49,22685,5,5,10,0,0,20,2,5,10,0,0,17,nowin,win,plwin,beat,20,0,10,207,0.396135266,0.053140097,0.594202899,0,0.028306925
16107,44,22685,10,5,0,0,0,15,2,5,10,0,0,17,nowin,loss,beat,dlwin,0,10,15,219,0.433789954,0.050228311,0.534246575,1,0.285551035
16108,71,22685,8,3,5,0,0,16,2,5,10,0,0,17,nowin,loss,beat,dlwin,0,10,11,193,0.352331606,0.046632124,0.585492228,0,0.013063661
16109,85,22685,9,9,0,0,0,18,2,5,10,0,0,17,nowin,win,plwin,beat,20,0,18,195,0.41025641,0.066666667,0.594871795,0,0.03269711
16110,7,22686,8,10,0,0,0,18,6,3,8,0,0,17,nowin,win,plwin,beat,20,0,18,183,0.442622951,0.06010929,0.62295082,2,0.619303341
16111,91,22686,10,3,0,0,0,13,6,3,8,0,0,17,nowin,loss,beat,dlwin,0,10,13,194,0.417525773,0.046391753,0.515463918,1,0.266616552
16112,121,22686,6,10,0,0,0,16,6,3,8,0,0,17,nowin,loss,beat,dlwin,0,10,16,195,0.456410256,0.025641026,0.512820513,1,0.288597791
16113,76,22686,11,9,0,0,0,20,6,3,8,0,0,17,nowin,win,plwin,beat,20,0,20,189,0.534391534,0.079365079,0.608465608,3,1
16114,60,22686,11,10,0,0,0,21,6,3,8,0,0,17,win,win,plwin,beat,25,0,21,227,0.418502203,0.022026432,0.559471366,0,0.026496258
16115,16,22686,4,7,8,0,0,19,6,3,8,0,0,17,nowin,win,plwin,beat,20,0,11,220,0.427272727,0.081818182,0.6,2,0.588660176
16116,127,22687,11,9,0,0,0,20,10,9,0,0,0,19,nowin,win,plwin,beat,20,0,20,201,0.402985075,0.029850746,0.60199005,0,0.032263937
16117,132,22687,3,5,10,0,0,18,10,9,0,0,0,19,nowin,loss,beat,dlwin,0,10,8,194,0.412371134,0.036082474,0.649484536,2,0.611633238
16118,149,22687,6,3,9,0,0,18,10,9,0,0,0,19,nowin,loss,beat,dlwin,0,10,9,225,0.457777778,0.057777778,0.648888889,2,0.651965595
16119,3,22687,8,7,0,6,0,21,10,9,0,0,0,19,nowin,win,plwin,beat,20,0,15,190,0.431578947,0.026315789,0.542105263,1,0.288076384
16120,23,22687,7,7,0,6,0,20,10,9,0,0,0,19,nowin,win,plwin,beat,20,0,14,208,0.427884615,0.0625,0.552884615,1,0.29114424
16121,150,22687,8,10,0,0,0,18,10,9,0,0,0,19,nowin,loss,beat,dlwin,0,10,18,192,0.401041667,0.036458333,0.567708333,0,0.023287458
16122,43,22688,6,6,0,2,5,19,1,1,10,2,5,19,nowin,push,push,push,10,0,12,192,0.40625,0.041666667,0.609375,2,0.576671372
16123,54,22688,9,6,0,10,0,25,1,1,10,2,5,19,nowin,loss,bust,plbust,0,10,15,185,0.437837838,0.032432432,0.556756757,1,0.29899854
16124,102,22688,10,10,0,0,0,20,1,1,10,2,5,19,nowin,win,plwin,beat,20,0,20,192,0.338541667,0.046875,0.5625,0,0.003306118
16125,80,22688,2,10,0,10,0,22,1,1,10,2,5,19,nowin,loss,bust,plbust,0,10,12,186,0.419354839,0.059139785,0.623655914,2,0.59892924
16126,13,22688,7,3,9,0,0,19,1,1,10,2,5,19,nowin,push,push,push,10,0,10,206,0.417475728,0.063106796,0.621359223,2,0.59555479
16127,150,22688,8,4,0,7,0,19,1,1,10,2,5,19,nowin,push,push,push,10,0,12,192,0.401041667,0.036458333,0.567708333,0,0.023287458
16128,129,22689,4,4,2,4,7,21,10,10,0,0,0,20,nowin,win,plwin,beat,20,0,8,201,0.422885572,0.064676617,0.55721393,0,0.027255383
16129,31,22689,4,10,0,10,0,24,10,10,0,0,0,20,nowin,loss,bust,plbust,0,10,14,188,0.473404255,0.058510638,0.515957447,1,0.300306557
16130,26,22689,8,10,0,0,0,18,10,10,0,0,0,20,nowin,loss,beat,dlwin,0,10,18,203,0.463054187,0.0591133,0.541871921,1,0.306802864
16131,53,22689,8,10,0,0,0,18,10,10,0,0,0,20,nowin,loss,beat,dlwin,0,10,18,250,0.372,0.064,0.564,0,0.013687345
16132,47,22689,10,8,0,0,0,18,10,10,0,0,0,20,nowin,loss,beat,dlwin,0,10,18,210,0.438095238,0.057142857,0.623809524,2,0.615868808
16133,125,22689,7,10,0,0,0,17,10,10,0,0,0,20,nowin,loss,beat,dlwin,0,10,17,219,0.438356164,0.050228311,0.575342466,1,0.308411257
16134,88,22690,8,10,0,0,0,18,9,11,0,0,0,20,nowin,loss,beat,dlwin,0,10,18,206,0.466019417,0.033980583,0.54368932,1,0.309467903
16135,134,22690,3,9,0,2,3,17,9,11,0,0,0,20,nowin,loss,beat,dlwin,0,10,12,185,0.443243243,0.021621622,0.545945946,1,0.296939509
16136,105,22690,5,7,0,8,0,20,9,11,0,0,0,20,nowin,push,push,push,10,0,12,198,0.414141414,0.070707071,0.590909091,0,0.032889494
16137,62,22690,6,3,10,0,0,19,9,11,0,0,0,20,nowin,loss,beat,dlwin,0,10,9,178,0.370786517,0.028089888,0.54494382,0,0.008657722
16138,69,22690,10,11,0,0,0,21,9,11,0,0,0,20,win,win,plwin,beat,25,0,21,194,0.365979381,0.030927835,0.515463918,0,0
16139,42,22690,11,10,0,0,0,21,9,11,0,0,0,20,win,win,plwin,beat,25,0,21,212,0.443396226,0.051886792,0.570754717,1,0.309181312
16140,11,22691,9,10,0,0,0,19,2,11,3,8,0,24,nowin,win,dlbust,bust,20,0,19,236,0.457627119,0.016949153,0.588983051,3,0.889015813
16141,36,22691,10,2,0,8,0,20,2,11,3,8,0,24,nowin,win,dlbust,bust,20,0,12,229,0.445414847,0.056768559,0.655021834,2,0.645370571
16142,117,22691,10,6,0,0,0,16,2,11,3,8,0,24,nowin,win,dlbust,bust,20,0,16,173,0.410404624,0.069364162,0.606936416,2,0.578610282
16143,66,22691,2,10,0,6,0,18,2,11,3,8,0,24,nowin,win,dlbust,bust,20,0,12,217,0.456221198,0.064516129,0.626728111,3,0.924304367
16144,13,22691,10,5,0,0,0,15,2,11,3,8,0,24,nowin,win,dlbust,bust,20,0,15,206,0.417475728,0.063106796,0.621359223,2,0.59555479
16145,64,22691,10,6,0,0,0,16,2,11,3,8,0,24,nowin,win,dlbust,bust,20,0,16,187,0.363636364,0.048128342,0.631016043,0,0.027594885
16146,118,22692,2,10,0,5,0,17,10,11,0,0,0,21,nowin,loss,beat,dlwin,0,10,12,216,0.393518519,0.037037037,0.555555556,0,0.018059873
16147,108,22692,3,10,0,5,0,18,10,11,0,0,0,21,nowin,loss,beat,dlwin,0,10,13,193,0.435233161,0.056994819,0.559585492,1,0.298824795
16148,141,22692,3,10,0,10,0,23,10,11,0,0,0,21,nowin,loss,bust,plbust,0,10,13,202,0.420792079,0.074257426,0.564356436,0,0.028377851
16149,60,22692,9,7,0,10,0,26,10,11,0,0,0,21,nowin,loss,bust,plbust,0,10,16,227,0.418502203,0.022026432,0.559471366,0,0.026496258
16150,84,22692,7,2,3,6,0,18,10,11,0,0,0,21,nowin,loss,beat,dlwin,0,10,9,195,0.379487179,0.056410256,0.569230769,0,0.017209119
16151,53,22692,6,8,0,1,2,17,10,11,0,0,0,21,nowin,loss,beat,dlwin,0,10,14,250,0.372,0.064,0.564,0,0.013687345
16152,85,22693,10,5,0,0,0,15,5,5,4,6,0,20,nowin,loss,beat,dlwin,0,10,15,195,0.41025641,0.066666667,0.594871795,0,0.03269711
16153,144,22693,7,10,0,0,0,17,5,5,4,6,0,20,nowin,loss,beat,dlwin,0,10,17,202,0.386138614,0.054455446,0.564356436,0,0.018006244
16154,120,22693,3,10,0,0,0,13,5,5,4,6,0,20,nowin,loss,beat,dlwin,0,10,13,202,0.440594059,0.034653465,0.618811881,2,0.614441029
16155,128,22693,3,8,9,0,0,20,5,5,4,6,0,20,nowin,push,push,push,10,0,11,227,0.356828194,0.052863436,0.577092511,0,0.012352564
16156,139,22693,3,8,6,0,0,17,5,5,4,6,0,20,nowin,loss,beat,dlwin,0,10,11,192,0.380208333,0.036458333,0.59375,0,0.023429169
16157,37,22693,11,5,2,0,0,18,5,5,4,6,0,20,nowin,loss,beat,dlwin,0,10,16,208,0.394230769,0.038461538,0.581730769,0,0.024682772
16158,148,22694,6,8,0,1,5,20,10,10,0,0,0,20,nowin,push,push,push,10,0,14,204,0.401960784,0.078431373,0.593137255,0,0.029789521
16159,78,22694,11,7,0,0,0,18,10,10,0,0,0,20,nowin,loss,beat,dlwin,0,10,18,201,0.517412935,0.034825871,0.587064677,3,0.95871112
16160,4,22694,2,7,9,0,0,18,10,10,0,0,0,20,nowin,loss,beat,dlwin,0,10,9,217,0.460829493,0.036866359,0.562211982,1,0.315432839
16161,18,22694,4,3,7,2,10,26,10,10,0,0,0,20,nowin,loss,bust,plbust,0,10,7,182,0.461538462,0.043956044,0.587912088,3,0.892649374
16162,105,22694,10,5,0,5,0,20,10,10,0,0,0,20,nowin,push,push,push,10,0,15,198,0.414141414,0.070707071,0.590909091,0,0.032889494
16163,8,22694,10,11,0,0,0,21,10,10,0,0,0,20,win,win,plwin,beat,25,0,21,181,0.44198895,0.071823204,0.596685083,2,0.599438402
16164,53,22695,2,10,0,10,0,22,10,4,8,0,0,22,nowin,loss,bust,plbust,0,10,12,250,0.372,0.064,0.564,0,0.013687345
16165,92,22695,3,5,2,10,0,20,10,4,8,0,0,22,nowin,win,dlbust,bust,20,0,8,186,0.446236559,0.059139785,0.564516129,1,0.307826125
16166,101,22695,2,2,2,1,7,14,10,4,8,0,0,22,nowin,win,dlbust,bust,20,0,4,205,0.424390244,0.068292683,0.63902439,2,0.614740646
16167,136,22695,5,2,3,5,10,25,10,4,8,0,0,22,nowin,loss,bust,plbust,0,10,7,194,0.396907216,0.025773196,0.597938144,0,0.029452644
16168,110,22695,4,10,0,4,0,18,10,4,8,0,0,22,nowin,win,dlbust,bust,20,0,14,192,0.416666667,0.046875,0.557291667,0,0.025413132
16169,34,22695,7,10,0,0,0,17,10,4,8,0,0,22,nowin,win,dlbust,bust,20,0,17,202,0.5,0.079207921,0.618811881,3,0.968961434
16170,5,22696,7,7,0,0,0,14,4,5,10,0,0,19,nowin,loss,beat,dlwin,0,10,14,203,0.42364532,0.02955665,0.596059113,2,0.582508076
16171,42,22696,8,3,3,0,0,14,4,5,10,0,0,19,nowin,loss,beat,dlwin,0,10,11,212,0.443396226,0.051886792,0.570754717,1,0.309181312
16172,113,22696,4,7,10,0,0,21,4,5,10,0,0,19,nowin,win,plwin,beat,20,0,11,199,0.407035176,0.055276382,0.668341709,2,0.620695264
16173,58,22696,10,11,0,0,0,21,4,5,10,0,0,19,win,win,plwin,beat,25,0,21,195,0.430769231,0.041025641,0.584615385,2,0.580497586
16174,57,22696,10,8,0,0,0,18,4,5,10,0,0,19,nowin,loss,beat,dlwin,0,10,18,192,0.46875,0.052083333,0.59375,3,0.907001181
16175,38,22696,2,11,2,0,0,15,4,5,10,0,0,19,nowin,loss,beat,dlwin,0,10,13,202,0.361386139,0.03960396,0.564356436,0,0.010597953
16176,139,22697,5,7,0,5,0,17,9,5,3,0,0,17,nowin,push,push,push,10,0,12,192,0.380208333,0.036458333,0.59375,0,0.023429169
16177,102,22697,6,7,0,10,0,23,9,5,3,0,0,17,nowin,loss,bust,plbust,0,10,13,192,0.338541667,0.046875,0.5625,0,0.003306118
16178,28,22697,4,10,0,5,0,19,9,5,3,0,0,17,nowin,win,plwin,beat,20,0,14,199,0.422110553,0.045226131,0.542713568,1,0.282706618
16179,139,22697,6,10,0,9,0,25,9,5,3,0,0,17,nowin,loss,bust,plbust,0,10,16,192,0.380208333,0.036458333,0.59375,0,0.023429169
16180,55,22697,10,7,0,0,0,17,9,5,3,0,0,17,nowin,push,push,push,10,0,17,191,0.371727749,0.057591623,0.54973822,0,0.01011347
16181,128,22697,10,3,0,2,8,23,9,5,3,0,0,17,nowin,loss,bust,plbust,0,10,13,227,0.356828194,0.052863436,0.577092511,0,0.012352564
16182,41,22698,10,2,0,10,0,22,7,4,5,2,0,18,nowin,loss,bust,plbust,0,10,12,192,0.364583333,0.036458333,0.520833333,0,0.00089702
16183,63,22698,8,7,0,10,0,25,7,4,5,2,0,18,nowin,loss,bust,plbust,0,10,15,216,0.467592593,0.037037037,0.62037037,3,0.931690496
16184,137,22698,6,10,0,5,0,21,7,4,5,2,0,18,nowin,win,plwin,beat,20,0,16,194,0.417525773,0.046391753,0.536082474,1,0.276714602
16185,148,22698,1,1,10,5,0,17,7,4,5,2,0,18,nowin,loss,beat,dlwin,0,10,2,204,0.401960784,0.078431373,0.593137255,0,0.029789521
16186,17,22698,10,11,0,0,0,21,7,4,5,2,0,18,win,win,plwin,beat,25,0,21,171,0.444444444,0.070175439,0.555555556,1,0.302364894
16187,57,22698,10,3,0,6,0,19,7,4,5,2,0,18,nowin,win,plwin,beat,20,0,13,192,0.46875,0.052083333,0.59375,3,0.907001181
16188,118,22699,10,3,0,0,0,13,2,6,7,8,0,23,nowin,win,dlbust,bust,20,0,13,216,0.393518519,0.037037037,0.555555556,0,0.018059873
16189,116,22699,10,8,0,0,0,18,2,6,7,8,0,23,nowin,win,dlbust,bust,20,0,18,195,0.425641026,0.056410256,0.538461538,1,0.28273747
16190,119,22699,4,1,9,0,0,14,2,6,7,8,0,23,nowin,win,dlbust,bust,20,0,5,190,0.405263158,0.068421053,0.515789474,0,0.011837158
16191,148,22699,10,3,0,0,0,13,2,6,7,8,0,23,nowin,win,dlbust,bust,20,0,13,204,0.401960784,0.078431373,0.593137255,0,0.029789521
16192,139,22699,10,10,0,0,0,20,2,6,7,8,0,23,nowin,win,dlbust,bust,20,0,20,192,0.380208333,0.036458333,0.59375,0,0.023429169
16193,76,22699,8,4,0,6,0,18,2,6,7,8,0,23,nowin,win,dlbust,bust,20,0,12,189,0.534391534,0.079365079,0.608465608,3,1
16194,16,22700,8,10,0,0,0,18,2,4,11,0,0,17,nowin,win,plwin,beat,20,0,18,220,0.427272727,0.081818182,0.6,2,0.588660176
16195,142,22700,10,5,0,0,0,15,2,4,11,0,0,17,nowin,loss,beat,dlwin,0,10,15,211,0.417061611,0.047393365,0.526066351,1,0.271531309
16196,123,22700,4,10,0,0,0,14,2,4,11,0,0,17,nowin,loss,beat,dlwin,0,10,14,205,0.43902439,0.034146341,0.614634146,2,0.609962544
16197,104,22700,10,10,0,0,0,20,2,4,11,0,0,17,nowin,win,plwin,beat,20,0,20,209,0.363636364,0.052631579,0.593301435,0,0.018359419
16198,5,22700,11,8,0,0,0,19,2,4,11,0,0,17,nowin,win,plwin,beat,20,0,19,203,0.42364532,0.02955665,0.596059113,2,0.582508076
16199,26,22700,10,9,0,0,0,19,2,4,11,0,0,17,nowin,win,plwin,beat,20,0,19,203,0.463054187,0.0591133,0.541871921,1,0.306802864
16200,11,22701,10,10,0,0,0,20,5,5,9,0,0,19,nowin,win,plwin,beat,20,0,20,236,0.457627119,0.016949153,0.588983051,3,0.889015813
16201,69,22701,10,6,0,0,0,16,5,5,9,0,0,19,nowin,loss,beat,dlwin,0,10,16,194,0.365979381,0.030927835,0.515463918,0,0
16202,135,22701,10,5,0,0,0,15,5,5,9,0,0,19,nowin,loss,beat,dlwin,0,10,15,179,0.391061453,0.067039106,0.586592179,0,0.024924662
16203,92,22701,8,4,0,0,0,12,5,5,9,0,0,19,nowin,loss,beat,dlwin,0,10,12,186,0.446236559,0.059139785,0.564516129,1,0.307826125
16204,146,22701,4,5,10,0,0,19,5,5,9,0,0,19,nowin,push,push,push,10,0,9,221,0.43438914,0.040723982,0.542986425,1,0.290190091
16205,38,22701,5,8,0,0,0,13,5,5,9,0,0,19,nowin,loss,beat,dlwin,0,10,13,202,0.361386139,0.03960396,0.564356436,0,0.010597953
16206,127,22702,3,3,10,6,0,22,10,6,3,0,0,19,nowin,loss,bust,plbust,0,10,6,201,0.402985075,0.029850746,0.60199005,0,0.032263937
16207,124,22702,5,8,0,10,0,23,10,6,3,0,0,19,nowin,loss,bust,plbust,0,10,13,202,0.47029703,0.064356436,0.584158416,3,0.899458193
16208,92,22702,5,10,0,1,8,24,10,6,3,0,0,19,nowin,loss,bust,plbust,0,10,15,186,0.446236559,0.059139785,0.564516129,1,0.307826125
16209,3,22702,11,8,0,0,0,19,10,6,3,0,0,19,nowin,push,push,push,10,0,19,190,0.431578947,0.026315789,0.542105263,1,0.288076384
16210,2,22702,10,10,0,0,0,20,10,6,3,0,0,19,nowin,win,plwin,beat,20,0,20,200,0.445,0.035,0.64,2,0.633962549
16211,8,22702,5,5,10,0,0,20,10,6,3,0,0,19,nowin,win,plwin,beat,20,0,10,181,0.44198895,0.071823204,0.596685083,2,0.599438402
16212,56,22703,4,6,3,0,0,13,2,8,7,0,0,17,nowin,loss,beat,dlwin,0,10,10,175,0.4,0.057142857,0.582857143,0,0.026685297
16213,109,22703,7,4,5,0,0,16,2,8,7,0,0,17,nowin,loss,beat,dlwin,0,10,11,221,0.461538462,0.058823529,0.597285068,3,0.901830309
16214,129,22703,10,3,0,0,0,13,2,8,7,0,0,17,nowin,loss,beat,dlwin,0,10,13,201,0.422885572,0.064676617,0.55721393,0,0.027255383
16215,35,22703,2,3,10,0,0,15,2,8,7,0,0,17,nowin,loss,beat,dlwin,0,10,5,202,0.410891089,0.044554455,0.633663366,2,0.598681573
16216,107,22703,10,3,0,0,0,13,2,8,7,0,0,17,nowin,loss,beat,dlwin,0,10,13,218,0.444954128,0.073394495,0.600917431,2,0.605210014
16217,116,22703,5,10,0,0,0,15,2,8,7,0,0,17,nowin,loss,beat,dlwin,0,10,15,195,0.425641026,0.056410256,0.538461538,1,0.28273747
16218,21,22704,2,9,10,0,0,21,11,2,7,0,0,20,nowin,win,plwin,beat,20,0,11,214,0.359813084,0.042056075,0.626168224,0,0.025263474
16219,132,22704,2,6,9,0,0,17,11,2,7,0,0,20,nowin,loss,beat,dlwin,0,10,8,194,0.412371134,0.036082474,0.649484536,2,0.611633238
16220,54,22704,10,10,0,0,0,20,11,2,7,0,0,20,nowin,push,push,push,10,0,20,185,0.437837838,0.032432432,0.556756757,1,0.29899854
16221,37,22704,7,4,2,5,0,18,11,2,7,0,0,20,nowin,loss,beat,dlwin,0,10,11,208,0.394230769,0.038461538,0.581730769,0,0.024682772
16222,128,22704,11,4,5,0,0,20,11,2,7,0,0,20,nowin,push,push,push,10,0,15,227,0.356828194,0.052863436,0.577092511,0,0.012352564
16223,45,22704,10,10,0,0,0,20,11,2,7,0,0,20,nowin,push,push,push,10,0,20,196,0.428571429,0.051020408,0.612244898,2,0.598821767
16224,127,22705,3,3,7,0,0,13,2,11,6,0,0,19,nowin,loss,beat,dlwin,0,10,6,201,0.402985075,0.029850746,0.60199005,0,0.032263937
16225,56,22705,8,7,0,0,0,15,2,11,6,0,0,19,nowin,loss,beat,dlwin,0,10,15,175,0.4,0.057142857,0.582857143,0,0.026685297
16226,53,22705,2,4,7,0,0,13,2,11,6,0,0,19,nowin,loss,beat,dlwin,0,10,6,250,0.372,0.064,0.564,0,0.013687345
16227,90,22705,10,5,0,0,0,15,2,11,6,0,0,19,nowin,loss,beat,dlwin,0,10,15,201,0.447761194,0.049751244,0.60199005,3,0.889945023
16228,65,22705,2,7,3,1,0,13,2,11,6,0,0,19,nowin,loss,beat,dlwin,0,10,9,203,0.492610837,0.054187192,0.571428571,3,0.913702814
16229,81,22705,6,6,0,1,0,13,2,11,6,0,0,19,nowin,loss,beat,dlwin,0,10,12,182,0.395604396,0.043956044,0.60989011,2,0.567491261
16230,74,22706,1,5,10,10,0,26,8,8,10,0,0,26,nowin,loss,bust,plbust,0,10,6,209,0.411483254,0.04784689,0.531100478,0,0.017448125
16231,126,22706,8,5,0,10,0,23,8,8,10,0,0,26,nowin,loss,bust,plbust,0,10,13,188,0.457446809,0.074468085,0.60106383,3,0.900633203
16232,48,22706,10,9,0,0,0,19,8,8,10,0,0,26,nowin,win,dlbust,bust,20,0,19,203,0.413793103,0.019704433,0.600985222,2,0.577280801
16233,12,22706,10,2,0,10,0,22,8,8,10,0,0,26,nowin,loss,bust,plbust,0,10,12,189,0.470899471,0.015873016,0.613756614,3,0.929171178
16234,97,22706,11,2,3,5,0,21,8,8,10,0,0,26,nowin,win,dlbust,bust,20,0,13,182,0.450549451,0.06043956,0.692307692,2,0.677372279
16235,142,22706,4,10,0,8,0,22,8,8,10,0,0,26,nowin,loss,bust,plbust,0,10,14,211,0.417061611,0.047393365,0.526066351,1,0.271531309
16236,26,22707,3,10,0,6,0,19,7,10,0,0,0,17,nowin,win,plwin,beat,20,0,13,203,0.463054187,0.0591133,0.541871921,1,0.306802864
16237,30,22707,5,5,7,0,0,17,7,10,0,0,0,17,nowin,push,push,push,10,0,10,206,0.393203883,0.033980583,0.601941748,0,0.029324648
16238,44,22707,8,11,0,0,0,19,7,10,0,0,0,17,nowin,win,plwin,beat,20,0,19,219,0.433789954,0.050228311,0.534246575,1,0.285551035
16239,64,22707,8,10,0,0,0,18,7,10,0,0,0,17,nowin,win,plwin,beat,20,0,18,187,0.363636364,0.048128342,0.631016043,0,0.027594885
16240,22,22707,2,10,0,5,0,17,7,10,0,0,0,17,nowin,push,push,push,10,0,12,187,0.481283422,0.042780749,0.577540107,3,0.906128176
16241,128,22707,11,10,0,0,0,21,7,10,0,0,0,17,win,win,plwin,beat,25,0,21,227,0.356828194,0.052863436,0.577092511,0,0.012352564
16242,48,22708,10,8,0,0,0,18,2,5,8,10,0,25,nowin,win,dlbust,bust,20,0,18,203,0.413793103,0.019704433,0.600985222,2,0.577280801
16243,37,22708,10,7,0,0,0,17,2,5,8,10,0,25,nowin,win,dlbust,bust,20,0,17,208,0.394230769,0.038461538,0.581730769,0,0.024682772
16244,3,22708,2,10,0,4,0,16,2,5,8,10,0,25,nowin,win,dlbust,bust,20,0,12,190,0.431578947,0.026315789,0.542105263,1,0.288076384
16245,57,22708,2,5,10,0,0,17,2,5,8,10,0,25,nowin,win,dlbust,bust,20,0,7,192,0.46875,0.052083333,0.59375,3,0.907001181
16246,133,22708,10,10,0,0,0,20,2,5,8,10,0,25,nowin,win,dlbust,bust,20,0,20,201,0.47761194,0.064676617,0.611940299,3,0.935428111
16247,58,22708,9,8,0,0,0,17,2,5,8,10,0,25,nowin,win,dlbust,bust,20,0,17,195,0.430769231,0.041025641,0.584615385,2,0.580497586
16248,143,22709,3,10,0,0,0,13,2,2,11,5,0,20,nowin,loss,beat,dlwin,0,10,13,203,0.463054187,0.044334975,0.57635468,3,0.883143365
16249,27,22709,11,10,0,0,0,21,2,2,11,5,0,20,win,win,plwin,beat,25,0,21,178,0.370786517,0.016853933,0.573033708,0,0.015536309
16250,76,22709,6,3,10,0,0,19,2,2,11,5,0,20,nowin,loss,beat,dlwin,0,10,9,189,0.534391534,0.079365079,0.608465608,3,1
16251,47,22709,6,10,0,0,0,16,2,2,11,5,0,20,nowin,loss,beat,dlwin,0,10,16,210,0.438095238,0.057142857,0.623809524,2,0.615868808
16252,134,22709,10,9,0,0,0,19,2,2,11,5,0,20,nowin,loss,beat,dlwin,0,10,19,185,0.443243243,0.021621622,0.545945946,1,0.296939509
16253,15,22709,10,5,0,0,0,15,2,2,11,5,0,20,nowin,loss,beat,dlwin,0,10,15,212,0.410377358,0.051886792,0.561320755,0,0.024517408
16254,135,22710,5,10,0,9,0,24,8,10,0,0,0,18,nowin,loss,bust,plbust,0,10,15,179,0.391061453,0.067039106,0.586592179,0,0.024924662
16255,41,22710,10,10,0,0,0,20,8,10,0,0,0,18,nowin,win,plwin,beat,20,0,20,192,0.364583333,0.036458333,0.520833333,0,0.00089702
16256,140,22710,5,8,0,2,5,20,8,10,0,0,0,18,nowin,win,plwin,beat,20,0,13,210,0.466666667,0.023809524,0.604761905,3,0.915293335
16257,145,22710,7,6,0,2,10,25,8,10,0,0,0,18,nowin,loss,bust,plbust,0,10,13,188,0.441489362,0.031914894,0.622340426,2,0.617837093
16258,39,22710,5,3,7,4,0,19,8,10,0,0,0,18,nowin,win,plwin,beat,20,0,8,191,0.429319372,0.062827225,0.57591623,0,0.033760763
16259,140,22710,6,5,4,10,0,25,8,10,0,0,0,18,nowin,loss,bust,plbust,0,10,11,210,0.466666667,0.023809524,0.604761905,3,0.915293335
16260,89,22711,10,10,0,0,0,20,6,5,8,0,0,19,nowin,win,plwin,beat,20,0,20,212,0.537735849,0.047169811,0.594339623,3,0.990167191
16261,81,22711,2,10,0,0,0,12,6,5,8,0,0,19,nowin,loss,beat,dlwin,0,10,12,182,0.395604396,0.043956044,0.60989011,2,0.567491261
16262,144,22711,5,7,0,0,0,12,6,5,8,0,0,19,nowin,loss,beat,dlwin,0,10,12,202,0.386138614,0.054455446,0.564356436,0,0.018006244
16263,53,22711,2,10,0,0,0,12,6,5,8,0,0,19,nowin,loss,beat,dlwin,0,10,12,250,0.372,0.064,0.564,0,0.013687345
16264,39,22711,4,8,0,0,0,12,6,5,8,0,0,19,nowin,loss,beat,dlwin,0,10,12,191,0.429319372,0.062827225,0.57591623,0,0.033760763
16265,115,22711,10,6,0,0,0,16,6,5,8,0,0,19,nowin,loss,beat,dlwin,0,10,16,194,0.427835052,0.041237113,0.592783505,2,0.583863602
16266,10,22712,3,1,10,3,0,17,10,9,0,0,0,19,nowin,loss,beat,dlwin,0,10,4,191,0.413612565,0.057591623,0.596858639,2,0.574087175
16267,42,22712,10,10,0,0,0,20,10,9,0,0,0,19,nowin,win,plwin,beat,20,0,20,212,0.443396226,0.051886792,0.570754717,1,0.309181312
16268,5,22712,2,11,3,5,0,21,10,9,0,0,0,19,nowin,win,plwin,beat,20,0,13,203,0.42364532,0.02955665,0.596059113,2,0.582508076
16269,27,22712,10,7,0,0,0,17,10,9,0,0,0,19,nowin,loss,beat,dlwin,0,10,17,178,0.370786517,0.016853933,0.573033708,0,0.015536309
16270,109,22712,6,1,10,0,0,17,10,9,0,0,0,19,nowin,loss,beat,dlwin,0,10,7,221,0.461538462,0.058823529,0.597285068,3,0.901830309
16271,12,22712,10,9,0,0,0,19,10,9,0,0,0,19,nowin,push,push,push,10,0,19,189,0.470899471,0.015873016,0.613756614,3,0.929171178
16272,118,22713,6,8,0,0,0,14,3,1,8,10,0,22,nowin,win,dlbust,bust,20,0,14,216,0.393518519,0.037037037,0.555555556,0,0.018059873
16273,92,22713,7,10,0,0,0,17,3,1,8,10,0,22,nowin,win,dlbust,bust,20,0,17,186,0.446236559,0.059139785,0.564516129,1,0.307826125
16274,138,22713,7,7,0,0,0,14,3,1,8,10,0,22,nowin,win,dlbust,bust,20,0,14,190,0.442105263,0.047368421,0.610526316,2,0.609711065
16275,143,22713,5,2,10,0,0,17,3,1,8,10,0,22,nowin,win,dlbust,bust,20,0,7,203,0.463054187,0.044334975,0.57635468,3,0.883143365
16276,1,22713,9,10,0,0,0,19,3,1,8,10,0,22,nowin,win,dlbust,bust,20,0,19,197,0.406091371,0.025380711,0.649746193,2,0.606186955
16277,128,22713,3,8,4,0,0,15,3,1,8,10,0,22,nowin,win,dlbust,bust,20,0,11,227,0.356828194,0.052863436,0.577092511,0,0.012352564
16278,17,22714,7,4,10,0,0,21,9,9,0,0,0,18,nowin,win,plwin,beat,20,0,11,171,0.444444444,0.070175439,0.555555556,1,0.302364894
16279,118,22714,10,10,0,0,0,20,9,9,0,0,0,18,nowin,win,plwin,beat,20,0,20,216,0.393518519,0.037037037,0.555555556,0,0.018059873
16280,104,22714,7,11,0,0,0,18,9,9,0,0,0,18,nowin,push,push,push,10,0,18,209,0.363636364,0.052631579,0.593301435,0,0.018359419
16281,74,22714,10,10,0,0,0,20,9,9,0,0,0,18,nowin,win,plwin,beat,20,0,20,209,0.411483254,0.04784689,0.531100478,0,0.017448125
16282,19,22714,3,4,10,0,0,17,9,9,0,0,0,18,nowin,loss,beat,dlwin,0,10,7,237,0.41350211,0.054852321,0.628691983,2,0.597373826
16283,63,22714,5,6,10,0,0,21,9,9,0,0,0,18,nowin,win,plwin,beat,20,0,11,216,0.467592593,0.037037037,0.62037037,3,0.931690496
16284,47,22715,5,4,7,7,0,23,10,3,10,0,0,23,nowin,loss,bust,plbust,0,10,9,210,0.438095238,0.057142857,0.623809524,2,0.615868808
16285,7,22715,10,2,0,5,0,17,10,3,10,0,0,23,nowin,win,dlbust,bust,20,0,12,183,0.442622951,0.06010929,0.62295082,2,0.619303341
16286,82,22715,10,4,0,1,6,21,10,3,10,0,0,23,nowin,win,dlbust,bust,20,0,14,225,0.408888889,0.075555556,0.577777778,0,0.028101874
16287,82,22715,3,6,8,0,0,17,10,3,10,0,0,23,nowin,win,dlbust,bust,20,0,9,225,0.408888889,0.075555556,0.577777778,0,0.028101874
16288,63,22715,10,2,0,9,0,21,10,3,10,0,0,23,nowin,win,dlbust,bust,20,0,12,216,0.467592593,0.037037037,0.62037037,3,0.931690496
16289,6,22715,9,4,0,6,0,19,10,3,10,0,0,23,nowin,win,dlbust,bust,20,0,13,191,0.439790576,0.047120419,0.581151832,1,0.31211505
16290,54,22716,8,6,0,2,10,26,10,7,0,0,0,17,nowin,loss,bust,plbust,0,10,14,185,0.437837838,0.032432432,0.556756757,1,0.29899854
16291,33,22716,4,7,1,6,0,18,10,7,0,0,0,17,nowin,win,plwin,beat,20,0,11,192,0.4375,0.057291667,0.625,2,0.616208916
16292,44,22716,8,7,0,4,0,19,10,7,0,0,0,17,nowin,win,plwin,beat,20,0,15,219,0.433789954,0.050228311,0.534246575,1,0.285551035
16293,118,22716,5,6,3,2,4,20,10,7,0,0,0,17,nowin,win,plwin,beat,20,0,11,216,0.393518519,0.037037037,0.555555556,0,0.018059873
16294,140,22716,3,11,7,0,0,21,10,7,0,0,0,17,nowin,win,plwin,beat,20,0,14,210,0.466666667,0.023809524,0.604761905,3,0.915293335
16295,132,22716,11,8,0,0,0,19,10,7,0,0,0,17,nowin,win,plwin,beat,20,0,19,194,0.412371134,0.036082474,0.649484536,2,0.611633238
16296,1,22717,10,9,0,0,0,19,5,11,4,0,0,20,nowin,loss,beat,dlwin,0,10,19,197,0.406091371,0.025380711,0.649746193,2,0.606186955
16297,149,22717,10,6,0,0,0,16,5,11,4,0,0,20,nowin,loss,beat,dlwin,0,10,16,225,0.457777778,0.057777778,0.648888889,2,0.651965595
16298,129,22717,9,10,0,0,0,19,5,11,4,0,0,20,nowin,loss,beat,dlwin,0,10,19,201,0.422885572,0.064676617,0.55721393,0,0.027255383
16299,124,22717,10,8,0,0,0,18,5,11,4,0,0,20,nowin,loss,beat,dlwin,0,10,18,202,0.47029703,0.064356436,0.584158416,3,0.899458193
16300,40,22717,8,4,0,0,0,12,5,11,4,0,0,20,nowin,loss,beat,dlwin,0,10,12,196,0.367346939,0.030612245,0.617346939,0,0.025358183
16301,120,22717,8,2,9,0,0,19,5,11,4,0,0,20,nowin,loss,beat,dlwin,0,10,10,202,0.440594059,0.034653465,0.618811881,2,0.614441029
16302,111,22718,6,8,0,7,0,21,7,8,2,0,0,17,nowin,win,plwin,beat,20,0,14,180,0.433333333,0.055555556,0.611111111,2,0.602264492
16303,141,22718,7,2,4,3,2,18,7,8,2,0,0,17,nowin,win,plwin,beat,20,0,9,202,0.420792079,0.074257426,0.564356436,0,0.028377851
16304,63,22718,9,8,0,0,0,17,7,8,2,0,0,17,nowin,push,push,push,10,0,17,216,0.467592593,0.037037037,0.62037037,3,0.931690496
16305,40,22718,4,10,0,2,8,24,7,8,2,0,0,17,nowin,loss,bust,plbust,0,10,14,196,0.367346939,0.030612245,0.617346939,0,0.025358183
16306,145,22718,6,2,2,5,10,25,7,8,2,0,0,17,nowin,loss,bust,plbust,0,10,8,188,0.441489362,0.031914894,0.622340426,2,0.617837093
16307,94,22718,3,10,0,10,0,23,7,8,2,0,0,17,nowin,loss,bust,plbust,0,10,13,183,0.43715847,0.043715847,0.540983607,1,0.290866892
16308,42,22719,10,10,0,0,0,20,5,9,10,0,0,24,nowin,win,dlbust,bust,20,0,20,212,0.443396226,0.051886792,0.570754717,1,0.309181312
16309,3,22719,10,6,0,0,0,16,5,9,10,0,0,24,nowin,win,dlbust,bust,20,0,16,190,0.431578947,0.026315789,0.542105263,1,0.288076384
16310,120,22719,10,9,0,0,0,19,5,9,10,0,0,24,nowin,win,dlbust,bust,20,0,19,202,0.440594059,0.034653465,0.618811881,2,0.614441029
16311,111,22719,11,3,4,0,0,18,5,9,10,0,0,24,nowin,win,dlbust,bust,20,0,14,180,0.433333333,0.055555556,0.611111111,2,0.602264492
16312,115,22719,10,8,0,0,0,18,5,9,10,0,0,24,nowin,win,dlbust,bust,20,0,18,194,0.427835052,0.041237113,0.592783505,2,0.583863602
16313,66,22719,7,10,0,0,0,17,5,9,10,0,0,24,nowin,win,dlbust,bust,20,0,17,217,0.456221198,0.064516129,0.626728111,3,0.924304367
16314,24,22720,10,7,0,0,0,17,3,9,10,0,0,22,nowin,win,dlbust,bust,20,0,17,207,0.458937198,0.048309179,0.570048309,1,0.318138014
16315,5,22720,2,6,8,0,0,16,3,9,10,0,0,22,nowin,win,dlbust,bust,20,0,8,203,0.42364532,0.02955665,0.596059113,2,0.582508076
16316,137,22720,2,8,3,0,0,13,3,9,10,0,0,22,nowin,win,dlbust,bust,20,0,10,194,0.417525773,0.046391753,0.536082474,1,0.276714602
16317,51,22720,10,10,0,0,0,20,3,9,10,0,0,22,nowin,win,dlbust,bust,20,0,20,189,0.529100529,0.068783069,0.608465608,3,0.993665715
16318,136,22720,2,3,9,0,0,14,3,9,10,0,0,22,nowin,win,dlbust,bust,20,0,5,194,0.396907216,0.025773196,0.597938144,0,0.029452644
16319,7,22720,8,10,0,0,0,18,3,9,10,0,0,22,nowin,win,dlbust,bust,20,0,18,183,0.442622951,0.06010929,0.62295082,2,0.619303341
16320,136,22721,8,10,0,0,0,18,6,6,7,0,0,19,nowin,loss,beat,dlwin,0,10,18,194,0.396907216,0.025773196,0.597938144,0,0.029452644
16321,36,22721,10,11,0,0,0,21,6,6,7,0,0,19,win,win,plwin,beat,25,0,21,229,0.445414847,0.056768559,0.655021834,2,0.645370571
16322,57,22721,10,10,0,0,0,20,6,6,7,0,0,19,nowin,win,plwin,beat,20,0,20,192,0.46875,0.052083333,0.59375,3,0.907001181
16323,49,22721,10,5,0,0,0,15,6,6,7,0,0,19,nowin,loss,beat,dlwin,0,10,15,207,0.396135266,0.053140097,0.594202899,0,0.028306925
16324,97,22721,10,10,0,0,0,20,6,6,7,0,0,19,nowin,win,plwin,beat,20,0,20,182,0.450549451,0.06043956,0.692307692,2,0.677372279
16325,103,22721,4,2,7,0,0,13,6,6,7,0,0,19,nowin,loss,beat,dlwin,0,10,6,203,0.379310345,0.064039409,0.551724138,0,0.012869209
16326,109,22722,2,10,0,0,0,12,6,7,9,0,0,22,nowin,win,dlbust,bust,20,0,12,221,0.461538462,0.058823529,0.597285068,3,0.901830309
16327,32,22722,10,7,0,0,0,17,6,7,9,0,0,22,nowin,win,dlbust,bust,20,0,17,189,0.391534392,0.037037037,0.53968254,0,0.013579086
16328,31,22722,6,10,0,0,0,16,6,7,9,0,0,22,nowin,win,dlbust,bust,20,0,16,188,0.473404255,0.058510638,0.515957447,1,0.300306557
16329,90,22722,6,2,10,0,0,18,6,7,9,0,0,22,nowin,win,dlbust,bust,20,0,8,201,0.447761194,0.049751244,0.60199005,3,0.889945023
16330,82,22722,10,10,0,0,0,20,6,7,9,0,0,22,nowin,win,dlbust,bust,20,0,20,225,0.408888889,0.075555556,0.577777778,0,0.028101874
16331,68,22722,9,2,10,0,0,21,6,7,9,0,0,22,nowin,win,dlbust,bust,20,0,11,205,0.434146341,0.029268293,0.6,2,0.59483189
16332,89,22723,8,5,0,0,0,13,5,7,1,3,6,22,nowin,win,dlbust,bust,20,0,13,212,0.537735849,0.047169811,0.594339623,3,0.990167191
16333,71,22723,4,8,0,0,0,12,5,7,1,3,6,22,nowin,win,dlbust,bust,20,0,12,193,0.352331606,0.046632124,0.585492228,0,0.013063661
16334,91,22723,3,10,0,0,0,13,5,7,1,3,6,22,nowin,win,dlbust,bust,20,0,13,194,0.417525773,0.046391753,0.515463918,1,0.266616552
16335,47,22723,11,10,0,0,0,21,5,7,1,3,6,22,win,win,dlbust,bust,25,0,21,210,0.438095238,0.057142857,0.623809524,2,0.615868808
16336,19,22723,10,2,0,0,0,12,5,7,1,3,6,22,nowin,win,dlbust,bust,20,0,12,237,0.41350211,0.054852321,0.628691983,2,0.597373826
16337,44,22723,9,4,0,0,0,13,5,7,1,3,6,22,nowin,win,dlbust,bust,20,0,13,219,0.433789954,0.050228311,0.534246575,1,0.285551035
16338,53,22724,2,3,6,5,10,26,8,11,0,0,0,19,nowin,loss,bust,plbust,0,10,5,250,0.372,0.064,0.564,0,0.013687345
16339,127,22724,4,10,0,2,2,18,8,11,0,0,0,19,nowin,loss,beat,dlwin,0,10,14,201,0.402985075,0.029850746,0.60199005,0,0.032263937
16340,46,22724,10,10,0,0,0,20,8,11,0,0,0,19,nowin,win,plwin,beat,20,0,20,186,0.403225806,0.048387097,0.591397849,0,0.029742194
16341,6,22724,10,6,0,10,0,26,8,11,0,0,0,19,nowin,loss,bust,plbust,0,10,16,191,0.439790576,0.047120419,0.581151832,1,0.31211505
16342,35,22724,10,4,0,2,7,23,8,11,0,0,0,19,nowin,loss,bust,plbust,0,10,14,202,0.410891089,0.044554455,0.633663366,2,0.598681573
16343,32,22724,9,8,0,0,0,17,8,11,0,0,0,19,nowin,loss,beat,dlwin,0,10,17,189,0.391534392,0.037037037,0.53968254,0,0.013579086
16344,111,22725,8,10,0,0,0,18,4,5,8,0,0,17,nowin,win,plwin,beat,20,0,18,180,0.433333333,0.055555556,0.611111111,2,0.602264492
16345,59,22725,7,2,6,0,0,15,4,5,8,0,0,17,nowin,loss,beat,dlwin,0,10,9,228,0.429824561,0.048245614,0.543859649,1,0.287885446
16346,37,22725,10,5,0,0,0,15,4,5,8,0,0,17,nowin,loss,beat,dlwin,0,10,15,208,0.394230769,0.038461538,0.581730769,0,0.024682772
16347,80,22725,10,10,0,0,0,20,4,5,8,0,0,17,nowin,win,plwin,beat,20,0,20,186,0.419354839,0.059139785,0.623655914,2,0.59892924
16348,88,22725,7,10,0,0,0,17,4,5,8,0,0,17,nowin,push,push,push,10,0,17,206,0.466019417,0.033980583,0.54368932,1,0.309467903
16349,129,22725,10,10,0,0,0,20,4,5,8,0,0,17,nowin,win,plwin,beat,20,0,20,201,0.422885572,0.064676617,0.55721393,0,0.027255383
16350,131,22726,2,11,3,5,0,21,9,6,5,0,0,20,nowin,win,plwin,beat,20,0,13,217,0.410138249,0.069124424,0.543778802,0,0.02015021
16351,53,22726,4,8,0,1,10,23,9,6,5,0,0,20,nowin,loss,bust,plbust,0,10,12,250,0.372,0.064,0.564,0,0.013687345
16352,107,22726,10,10,0,0,0,20,9,6,5,0,0,20,nowin,push,push,push,10,0,20,218,0.444954128,0.073394495,0.600917431,2,0.605210014
16353,43,22726,7,10,0,0,0,17,9,6,5,0,0,20,nowin,loss,beat,dlwin,0,10,17,192,0.40625,0.041666667,0.609375,2,0.576671372
16354,91,22726,10,2,0,10,0,22,9,6,5,0,0,20,nowin,loss,bust,plbust,0,10,12,194,0.417525773,0.046391753,0.515463918,1,0.266616552
16355,73,22726,7,4,5,10,0,26,9,6,5,0,0,20,nowin,loss,bust,plbust,0,10,11,181,0.375690608,0.011049724,0.596685083,0,0.022795773
16356,113,22727,5,3,11,0,0,19,7,7,10,0,0,24,nowin,win,dlbust,bust,20,0,8,199,0.407035176,0.055276382,0.668341709,2,0.620695264
16357,112,22727,3,10,0,8,0,21,7,7,10,0,0,24,nowin,win,dlbust,bust,20,0,13,203,0.448275862,0.054187192,0.600985222,3,0.889576933
16358,106,22727,8,4,0,8,0,20,7,7,10,0,0,24,nowin,win,dlbust,bust,20,0,12,192,0.411458333,0.026041667,0.557291667,0,0.023854304
16359,73,22727,10,10,0,0,0,20,7,7,10,0,0,24,nowin,win,dlbust,bust,20,0,20,181,0.375690608,0.011049724,0.596685083,0,0.022795773
16360,63,22727,3,6,6,9,0,24,7,7,10,0,0,24,nowin,loss,bust,plbust,0,10,9,216,0.467592593,0.037037037,0.62037037,3,0.931690496
16361,65,22727,9,9,0,0,0,18,7,7,10,0,0,24,nowin,win,dlbust,bust,20,0,18,203,0.492610837,0.054187192,0.571428571,3,0.913702814
16362,66,22728,8,10,0,0,0,18,10,2,10,0,0,22,nowin,win,dlbust,bust,20,0,18,217,0.456221198,0.064516129,0.626728111,3,0.924304367
16363,40,22728,7,4,7,0,0,18,10,2,10,0,0,22,nowin,win,dlbust,bust,20,0,11,196,0.367346939,0.030612245,0.617346939,0,0.025358183
16364,31,22728,3,10,0,6,0,19,10,2,10,0,0,22,nowin,win,dlbust,bust,20,0,13,188,0.473404255,0.058510638,0.515957447,1,0.300306557
16365,54,22728,10,3,0,6,0,19,10,2,10,0,0,22,nowin,win,dlbust,bust,20,0,13,185,0.437837838,0.032432432,0.556756757,1,0.29899854
16366,118,22728,7,2,11,0,0,20,10,2,10,0,0,22,nowin,win,dlbust,bust,20,0,9,216,0.393518519,0.037037037,0.555555556,0,0.018059873
16367,67,22728,10,10,0,0,0,20,10,2,10,0,0,22,nowin,win,dlbust,bust,20,0,20,195,0.369230769,0.041025641,0.569230769,0,0.014139427
16368,142,22729,2,4,7,10,0,23,10,7,0,0,0,17,nowin,loss,bust,plbust,0,10,6,211,0.417061611,0.047393365,0.526066351,1,0.271531309
16369,75,22729,3,1,8,9,0,21,10,7,0,0,0,17,nowin,win,plwin,beat,20,0,4,191,0.418848168,0.052356021,0.570680628,0,0.029344702
16370,49,22729,7,6,0,3,2,18,10,7,0,0,0,17,nowin,win,plwin,beat,20,0,13,207,0.396135266,0.053140097,0.594202899,0,0.028306925
16371,143,22729,8,10,0,0,0,18,10,7,0,0,0,17,nowin,win,plwin,beat,20,0,18,203,0.463054187,0.044334975,0.57635468,3,0.883143365
16372,12,22729,10,10,0,0,0,20,10,7,0,0,0,17,nowin,win,plwin,beat,20,0,20,189,0.470899471,0.015873016,0.613756614,3,0.929171178
16373,77,22729,10,10,0,0,0,20,10,7,0,0,0,17,nowin,win,plwin,beat,20,0,20,200,0.455,0.04,0.62,3,0.916252116
16374,132,22730,10,5,0,1,1,17,10,3,4,0,0,17,nowin,push,push,push,10,0,15,194,0.412371134,0.036082474,0.649484536,2,0.611633238
16375,131,22730,11,10,0,0,0,21,10,3,4,0,0,17,win,win,plwin,beat,25,0,21,217,0.410138249,0.069124424,0.543778802,0,0.02015021
16376,6,22730,10,7,0,0,0,17,10,3,4,0,0,17,nowin,push,push,push,10,0,17,191,0.439790576,0.047120419,0.581151832,1,0.31211505
16377,52,22730,7,3,10,0,0,20,10,3,4,0,0,17,nowin,win,plwin,beat,20,0,10,217,0.414746544,0.02764977,0.599078341,2,0.576736024
16378,27,22730,8,8,0,1,0,17,10,3,4,0,0,17,nowin,push,push,push,10,0,16,178,0.370786517,0.016853933,0.573033708,0,0.015536309
16379,82,22730,10,2,0,1,6,19,10,3,4,0,0,17,nowin,win,plwin,beat,20,0,12,225,0.408888889,0.075555556,0.577777778,0,0.028101874
16380,103,22731,11,3,5,0,0,19,7,9,10,0,0,26,nowin,win,dlbust,bust,20,0,14,203,0.379310345,0.064039409,0.551724138,0,0.012869209
16381,70,22731,8,10,0,0,0,18,7,9,10,0,0,26,nowin,win,dlbust,bust,20,0,18,228,0.385964912,0.039473684,0.557017544,0,0.016157125
16382,53,22731,4,5,10,0,0,19,7,9,10,0,0,26,nowin,win,dlbust,bust,20,0,9,250,0.372,0.064,0.564,0,0.013687345
16383,48,22731,10,10,0,0,0,20,7,9,10,0,0,26,nowin,win,dlbust,bust,20,0,20,203,0.413793103,0.019704433,0.600985222,2,0.577280801
16384,108,22731,10,6,0,2,0,18,7,9,10,0,0,26,nowin,win,dlbust,bust,20,0,16,193,0.435233161,0.056994819,0.559585492,1,0.298824795
16385,4,22731,10,10,0,0,0,20,7,9,10,0,0,26,nowin,win,dlbust,bust,20,0,20,217,0.460829493,0.036866359,0.562211982,1,0.315432839
16386,57,22732,10,4,0,10,0,24,1,2,10,6,0,19,nowin,loss,bust,plbust,0,10,14,192,0.46875,0.052083333,0.59375,3,0.907001181
16387,3,22732,10,7,0,0,0,17,1,2,10,6,0,19,nowin,loss,beat,dlwin,0,10,17,190,0.431578947,0.026315789,0.542105263,1,0.288076384
16388,97,22732,4,11,3,0,0,18,1,2,10,6,0,19,nowin,loss,beat,dlwin,0,10,15,182,0.450549451,0.06043956,0.692307692,2,0.677372279
16389,68,22732,10,10,0,0,0,20,1,2,10,6,0,19,nowin,win,plwin,beat,20,0,20,205,0.434146341,0.029268293,0.6,2,0.59483189
16390,125,22732,3,2,10,7,0,22,1,2,10,6,0,19,nowin,loss,bust,plbust,0,10,5,219,0.438356164,0.050228311,0.575342466,1,0.308411257
16391,121,22732,11,9,0,0,0,20,1,2,10,6,0,19,nowin,win,plwin,beat,20,0,20,195,0.456410256,0.025641026,0.512820513,1,0.288597791
16392,80,22733,4,9,0,10,0,23,10,9,0,0,0,19,nowin,loss,bust,plbust,0,10,13,186,0.419354839,0.059139785,0.623655914,2,0.59892924
16393,97,22733,6,7,0,6,0,19,10,9,0,0,0,19,nowin,push,push,push,10,0,13,182,0.450549451,0.06043956,0.692307692,2,0.677372279
16394,49,22733,7,10,0,0,0,17,10,9,0,0,0,19,nowin,loss,beat,dlwin,0,10,17,207,0.396135266,0.053140097,0.594202899,0,0.028306925
16395,103,22733,10,9,0,0,0,19,10,9,0,0,0,19,nowin,push,push,push,10,0,19,203,0.379310345,0.064039409,0.551724138,0,0.012869209
16396,84,22733,9,11,0,0,0,20,10,9,0,0,0,19,nowin,win,plwin,beat,20,0,20,195,0.379487179,0.056410256,0.569230769,0,0.017209119
16397,85,22733,7,8,0,8,0,23,10,9,0,0,0,19,nowin,loss,bust,plbust,0,10,15,195,0.41025641,0.066666667,0.594871795,0,0.03269711
16398,129,22734,10,8,0,0,0,18,6,10,10,0,0,26,nowin,win,dlbust,bust,20,0,18,201,0.422885572,0.064676617,0.55721393,0,0.027255383
16399,109,22734,10,6,0,0,0,16,6,10,10,0,0,26,nowin,win,dlbust,bust,20,0,16,221,0.461538462,0.058823529,0.597285068,3,0.901830309
16400,15,22734,5,11,3,0,0,19,6,10,10,0,0,26,nowin,win,dlbust,bust,20,0,16,212,0.410377358,0.051886792,0.561320755,0,0.024517408
16401,58,22734,5,5,3,0,0,13,6,10,10,0,0,26,nowin,win,dlbust,bust,20,0,10,195,0.430769231,0.041025641,0.584615385,2,0.580497586
16402,3,22734,10,7,0,0,0,17,6,10,10,0,0,26,nowin,win,dlbust,bust,20,0,17,190,0.431578947,0.026315789,0.542105263,1,0.288076384
16403,85,22734,3,3,6,0,0,12,6,10,10,0,0,26,nowin,win,dlbust,bust,20,0,6,195,0.41025641,0.066666667,0.594871795,0,0.03269711
16404,138,22735,9,7,0,3,0,19,8,4,6,0,0,18,nowin,win,plwin,beat,20,0,16,190,0.442105263,0.047368421,0.610526316,2,0.609711065
16405,94,22735,10,6,0,3,0,19,8,4,6,0,0,18,nowin,win,plwin,beat,20,0,16,183,0.43715847,0.043715847,0.540983607,1,0.290866892
16406,57,22735,10,2,0,10,0,22,8,4,6,0,0,18,nowin,loss,bust,plbust,0,10,12,192,0.46875,0.052083333,0.59375,3,0.907001181
16407,60,22735,9,3,0,8,0,20,8,4,6,0,0,18,nowin,win,plwin,beat,20,0,12,227,0.418502203,0.022026432,0.559471366,0,0.026496258
16408,103,22735,8,10,0,0,0,18,8,4,6,0,0,18,nowin,push,push,push,10,0,18,203,0.379310345,0.064039409,0.551724138,0,0.012869209
16409,123,22735,6,1,6,10,0,23,8,4,6,0,0,18,nowin,loss,bust,plbust,0,10,7,205,0.43902439,0.034146341,0.614634146,2,0.609962544
16410,64,22736,10,4,0,0,0,14,4,10,8,0,0,22,nowin,win,dlbust,bust,20,0,14,187,0.363636364,0.048128342,0.631016043,0,0.027594885
16411,116,22736,10,11,0,0,0,21,4,10,8,0,0,22,win,win,dlbust,bust,25,0,21,195,0.425641026,0.056410256,0.538461538,1,0.28273747
16412,124,22736,10,8,0,0,0,18,4,10,8,0,0,22,nowin,win,dlbust,bust,20,0,18,202,0.47029703,0.064356436,0.584158416,3,0.899458193
16413,136,22736,8,7,0,0,0,15,4,10,8,0,0,22,nowin,win,dlbust,bust,20,0,15,194,0.396907216,0.025773196,0.597938144,0,0.029452644
16414,49,22736,9,10,0,0,0,19,4,10,8,0,0,22,nowin,win,dlbust,bust,20,0,19,207,0.396135266,0.053140097,0.594202899,0,0.028306925
16415,33,22736,6,1,10,0,0,17,4,10,8,0,0,22,nowin,win,dlbust,bust,20,0,7,192,0.4375,0.057291667,0.625,2,0.616208916
16416,99,22737,5,1,10,7,0,23,11,1,3,7,0,22,nowin,loss,bust,plbust,0,10,6,207,0.47826087,0.062801932,0.637681159,3,0.961418446
16417,124,22737,1,2,10,10,0,23,11,1,3,7,0,22,nowin,loss,bust,plbust,0,10,3,202,0.47029703,0.064356436,0.584158416,3,0.899458193
16418,140,22737,10,10,0,0,0,20,11,1,3,7,0,22,nowin,win,dlbust,bust,20,0,20,210,0.466666667,0.023809524,0.604761905,3,0.915293335
16419,120,22737,10,10,0,0,0,20,11,1,3,7,0,22,nowin,win,dlbust,bust,20,0,20,202,0.440594059,0.034653465,0.618811881,2,0.614441029
16420,61,22737,10,6,0,5,0,21,11,1,3,7,0,22,nowin,win,dlbust,bust,20,0,16,194,0.427835052,0.077319588,0.603092784,2,0.591437139
16421,107,22737,9,7,0,4,0,20,11,1,3,7,0,22,nowin,win,dlbust,bust,20,0,16,218,0.444954128,0.073394495,0.600917431,2,0.605210014
16422,72,22738,6,7,0,10,0,23,10,10,0,0,0,20,nowin,loss,bust,plbust,0,10,13,185,0.394594595,0.032432432,0.508108108,0,0.006763115
16423,103,22738,10,10,0,0,0,20,10,10,0,0,0,20,nowin,push,push,push,10,0,20,203,0.379310345,0.064039409,0.551724138,0,0.012869209
16424,10,22738,11,10,0,0,0,21,10,10,0,0,0,20,win,win,plwin,beat,25,0,21,191,0.413612565,0.057591623,0.596858639,2,0.574087175
16425,122,22738,7,10,0,0,0,17,10,10,0,0,0,20,nowin,loss,beat,dlwin,0,10,17,210,0.347619048,0.052380952,0.59047619,0,0.012873677
16426,150,22738,7,4,2,7,0,20,10,10,0,0,0,20,nowin,push,push,push,10,0,11,192,0.401041667,0.036458333,0.567708333,0,0.023287458
16427,26,22738,7,3,9,0,0,19,10,10,0,0,0,20,nowin,loss,beat,dlwin,0,10,10,203,0.463054187,0.0591133,0.541871921,1,0.306802864
16428,89,22739,9,6,0,0,0,15,3,10,10,0,0,23,nowin,win,dlbust,bust,20,0,15,212,0.537735849,0.047169811,0.594339623,3,0.990167191
16429,23,22739,6,3,8,0,0,17,3,10,10,0,0,23,nowin,win,dlbust,bust,20,0,9,208,0.427884615,0.0625,0.552884615,1,0.29114424
16430,18,22739,11,2,8,0,0,21,3,10,10,0,0,23,nowin,win,dlbust,bust,20,0,13,182,0.461538462,0.043956044,0.587912088,3,0.892649374
16431,84,22739,10,3,0,0,0,13,3,10,10,0,0,23,nowin,win,dlbust,bust,20,0,13,195,0.379487179,0.056410256,0.569230769,0,0.017209119
16432,37,22739,3,4,10,0,0,17,3,10,10,0,0,23,nowin,win,dlbust,bust,20,0,7,208,0.394230769,0.038461538,0.581730769,0,0.024682772
16433,33,22739,4,6,6,0,0,16,3,10,10,0,0,23,nowin,win,dlbust,bust,20,0,10,192,0.4375,0.057291667,0.625,2,0.616208916
16434,90,22740,5,3,5,9,0,22,7,10,0,0,0,17,nowin,loss,bust,plbust,0,10,8,201,0.447761194,0.049751244,0.60199005,3,0.889945023
16435,115,22740,4,9,0,9,0,22,7,10,0,0,0,17,nowin,loss,bust,plbust,0,10,13,194,0.427835052,0.041237113,0.592783505,2,0.583863602
16436,51,22740,10,5,0,9,0,24,7,10,0,0,0,17,nowin,loss,bust,plbust,0,10,15,189,0.529100529,0.068783069,0.608465608,3,0.993665715
16437,103,22740,5,11,1,0,0,17,7,10,0,0,0,17,nowin,push,push,push,10,0,16,203,0.379310345,0.064039409,0.551724138,0,0.012869209
16438,45,22740,10,10,0,0,0,20,7,10,0,0,0,17,nowin,win,plwin,beat,20,0,20,196,0.428571429,0.051020408,0.612244898,2,0.598821767
16439,15,22740,10,2,0,10,0,22,7,10,0,0,0,17,nowin,loss,bust,plbust,0,10,12,212,0.410377358,0.051886792,0.561320755,0,0.024517408
16440,59,22741,10,10,0,0,0,20,7,6,8,0,0,21,nowin,loss,beat,dlwin,0,10,20,228,0.429824561,0.048245614,0.543859649,1,0.287885446
16441,78,22741,5,11,4,0,0,20,7,6,8,0,0,21,nowin,loss,beat,dlwin,0,10,16,201,0.517412935,0.034825871,0.587064677,3,0.95871112
16442,125,22741,7,10,0,0,0,17,7,6,8,0,0,21,nowin,loss,beat,dlwin,0,10,17,219,0.438356164,0.050228311,0.575342466,1,0.308411257
16443,98,22741,10,2,0,2,6,20,7,6,8,0,0,21,nowin,loss,beat,dlwin,0,10,12,220,0.422727273,0.054545455,0.55,1,0.28664435
16444,35,22741,6,6,0,7,0,19,7,6,8,0,0,21,nowin,loss,beat,dlwin,0,10,12,202,0.410891089,0.044554455,0.633663366,2,0.598681573
16445,111,22741,10,9,0,0,0,19,7,6,8,0,0,21,nowin,loss,beat,dlwin,0,10,19,180,0.433333333,0.055555556,0.611111111,2,0.602264492
16446,119,22742,10,11,0,0,0,21,2,8,8,0,0,18,win,win,plwin,beat,25,0,21,190,0.405263158,0.068421053,0.515789474,0,0.011837158
16447,18,22742,10,9,0,0,0,19,2,8,8,0,0,18,nowin,win,plwin,beat,20,0,19,182,0.461538462,0.043956044,0.587912088,3,0.892649374
16448,125,22742,9,6,0,0,0,15,2,8,8,0,0,18,nowin,loss,beat,dlwin,0,10,15,219,0.438356164,0.050228311,0.575342466,1,0.308411257
16449,33,22742,5,5,9,0,0,19,2,8,8,0,0,18,nowin,win,plwin,beat,20,0,10,192,0.4375,0.057291667,0.625,2,0.616208916
16450,52,22742,7,7,0,0,0,14,2,8,8,0,0,18,nowin,loss,beat,dlwin,0,10,14,217,0.414746544,0.02764977,0.599078341,2,0.576736024
16451,16,22742,7,4,7,0,0,18,2,8,8,0,0,18,nowin,push,push,push,10,0,11,220,0.427272727,0.081818182,0.6,2,0.588660176
16452,138,22743,5,10,0,5,0,20,10,11,0,0,0,21,nowin,loss,beat,dlwin,0,10,15,190,0.442105263,0.047368421,0.610526316,2,0.609711065
16453,47,22743,6,10,0,10,0,26,10,11,0,0,0,21,nowin,loss,bust,plbust,0,10,16,210,0.438095238,0.057142857,0.623809524,2,0.615868808
16454,98,22743,3,9,0,10,0,22,10,11,0,0,0,21,nowin,loss,bust,plbust,0,10,12,220,0.422727273,0.054545455,0.55,1,0.28664435
16455,2,22743,3,10,0,8,0,21,10,11,0,0,0,21,nowin,push,push,push,10,0,13,200,0.445,0.035,0.64,2,0.633962549
16456,23,22743,10,10,0,0,0,20,10,11,0,0,0,21,nowin,loss,beat,dlwin,0,10,20,208,0.427884615,0.0625,0.552884615,1,0.29114424
16457,49,22743,3,10,0,2,5,20,10,11,0,0,0,21,nowin,loss,beat,dlwin,0,10,13,207,0.396135266,0.053140097,0.594202899,0,0.028306925
16458,133,22744,10,11,0,0,0,21,9,7,8,0,0,24,win,win,dlbust,bust,25,0,21,201,0.47761194,0.064676617,0.611940299,3,0.935428111
16459,23,22744,11,10,0,0,0,21,9,7,8,0,0,24,win,win,dlbust,bust,25,0,21,208,0.427884615,0.0625,0.552884615,1,0.29114424
16460,13,22744,10,2,0,9,0,21,9,7,8,0,0,24,nowin,win,dlbust,bust,20,0,12,206,0.417475728,0.063106796,0.621359223,2,0.59555479
16461,61,22744,11,1,1,6,0,19,9,7,8,0,0,24,nowin,win,dlbust,bust,20,0,12,194,0.427835052,0.077319588,0.603092784,2,0.591437139
16462,150,22744,5,10,0,10,0,25,9,7,8,0,0,24,nowin,loss,bust,plbust,0,10,15,192,0.401041667,0.036458333,0.567708333,0,0.023287458
16463,12,22744,8,7,0,6,0,21,9,7,8,0,0,24,nowin,win,dlbust,bust,20,0,15,189,0.470899471,0.015873016,0.613756614,3,0.929171178
16464,53,22745,9,3,0,0,0,12,4,4,4,1,6,19,nowin,loss,beat,dlwin,0,10,12,250,0.372,0.064,0.564,0,0.013687345
16465,21,22745,8,9,0,0,0,17,4,4,4,1,6,19,nowin,loss,beat,dlwin,0,10,17,214,0.359813084,0.042056075,0.626168224,0,0.025263474
16466,18,22745,10,10,0,0,0,20,4,4,4,1,6,19,nowin,win,plwin,beat,20,0,20,182,0.461538462,0.043956044,0.587912088,3,0.892649374
16467,89,22745,8,10,0,0,0,18,4,4,4,1,6,19,nowin,loss,beat,dlwin,0,10,18,212,0.537735849,0.047169811,0.594339623,3,0.990167191
16468,85,22745,4,10,0,0,0,14,4,4,4,1,6,19,nowin,loss,beat,dlwin,0,10,14,195,0.41025641,0.066666667,0.594871795,0,0.03269711
16469,135,22745,3,3,10,0,0,16,4,4,4,1,6,19,nowin,loss,beat,dlwin,0,10,6,179,0.391061453,0.067039106,0.586592179,0,0.024924662
16470,54,22746,5,10,0,2,0,17,10,4,10,0,0,24,nowin,win,dlbust,bust,20,0,15,185,0.437837838,0.032432432,0.556756757,1,0.29899854
16471,66,22746,10,10,0,0,0,20,10,4,10,0,0,24,nowin,win,dlbust,bust,20,0,20,217,0.456221198,0.064516129,0.626728111,3,0.924304367
16472,122,22746,3,8,7,0,0,18,10,4,10,0,0,24,nowin,win,dlbust,bust,20,0,11,210,0.347619048,0.052380952,0.59047619,0,0.012873677
16473,36,22746,6,10,0,6,0,22,10,4,10,0,0,24,nowin,loss,bust,plbust,0,10,16,229,0.445414847,0.056768559,0.655021834,2,0.645370571
16474,18,22746,10,3,0,10,0,23,10,4,10,0,0,24,nowin,loss,bust,plbust,0,10,13,182,0.461538462,0.043956044,0.587912088,3,0.892649374
16475,145,22746,3,10,0,4,0,17,10,4,10,0,0,24,nowin,win,dlbust,bust,20,0,13,188,0.441489362,0.031914894,0.622340426,2,0.617837093
16476,117,22747,2,5,5,2,3,17,10,6,10,0,0,26,nowin,win,dlbust,bust,20,0,7,173,0.410404624,0.069364162,0.606936416,2,0.578610282
16477,6,22747,7,5,0,10,0,22,10,6,10,0,0,26,nowin,loss,bust,plbust,0,10,12,191,0.439790576,0.047120419,0.581151832,1,0.31211505
16478,93,22747,9,7,0,8,0,24,10,6,10,0,0,26,nowin,loss,bust,plbust,0,10,16,175,0.485714286,0.051428571,0.548571429,1,0.323648091
16479,10,22747,8,10,0,0,0,18,10,6,10,0,0,26,nowin,win,dlbust,bust,20,0,18,191,0.413612565,0.057591623,0.596858639,2,0.574087175
16480,128,22747,6,10,0,10,0,26,10,6,10,0,0,26,nowin,loss,bust,plbust,0,10,16,227,0.356828194,0.052863436,0.577092511,0,0.012352564
16481,114,22747,9,7,0,10,0,26,10,6,10,0,0,26,nowin,loss,bust,plbust,0,10,16,198,0.47979798,0.025252525,0.611111111,3,0.937232995
16482,76,22748,3,4,6,8,0,21,10,10,0,0,0,20,nowin,win,plwin,beat,20,0,7,189,0.534391534,0.079365079,0.608465608,3,1
16483,46,22748,10,11,0,0,0,21,10,10,0,0,0,20,win,win,plwin,beat,25,0,21,186,0.403225806,0.048387097,0.591397849,0,0.029742194
16484,1,22748,10,10,0,0,0,20,10,10,0,0,0,20,nowin,push,push,push,10,0,20,197,0.406091371,0.025380711,0.649746193,2,0.606186955
16485,124,22748,11,10,0,0,0,21,10,10,0,0,0,20,win,win,plwin,beat,25,0,21,202,0.47029703,0.064356436,0.584158416,3,0.899458193
16486,34,22748,10,7,0,0,0,17,10,10,0,0,0,20,nowin,loss,beat,dlwin,0,10,17,202,0.5,0.079207921,0.618811881,3,0.968961434
16487,37,22748,10,10,0,0,0,20,10,10,0,0,0,20,nowin,push,push,push,10,0,20,208,0.394230769,0.038461538,0.581730769,0,0.024682772
16488,148,22749,5,8,0,0,0,13,3,5,10,0,0,18,nowin,loss,beat,dlwin,0,10,13,204,0.401960784,0.078431373,0.593137255,0,0.029789521
16489,118,22749,2,10,0,3,0,15,3,5,10,0,0,18,nowin,loss,beat,dlwin,0,10,12,216,0.393518519,0.037037037,0.555555556,0,0.018059873
16490,13,22749,11,10,0,0,0,21,3,5,10,0,0,18,win,win,plwin,beat,25,0,21,206,0.417475728,0.063106796,0.621359223,2,0.59555479
16491,40,22749,7,11,0,0,0,18,3,5,10,0,0,18,nowin,push,push,push,10,0,18,196,0.367346939,0.030612245,0.617346939,0,0.025358183
16492,97,22749,8,10,0,0,0,18,3,5,10,0,0,18,nowin,push,push,push,10,0,18,182,0.450549451,0.06043956,0.692307692,2,0.677372279
16493,2,22749,10,10,0,0,0,20,3,5,10,0,0,18,nowin,win,plwin,beat,20,0,20,200,0.445,0.035,0.64,2,0.633962549
16494,114,22750,7,3,4,5,0,19,9,4,8,0,0,21,nowin,loss,beat,dlwin,0,10,10,198,0.47979798,0.025252525,0.611111111,3,0.937232995
16495,32,22750,11,10,0,0,0,21,9,4,8,0,0,21,win,push,push,push,10,0,21,189,0.391534392,0.037037037,0.53968254,0,0.013579086
16496,62,22750,10,3,0,1,10,24,9,4,8,0,0,21,nowin,loss,bust,plbust,0,10,13,178,0.370786517,0.028089888,0.54494382,0,0.008657722
16497,149,22750,5,4,2,10,0,21,9,4,8,0,0,21,nowin,push,push,push,10,0,9,225,0.457777778,0.057777778,0.648888889,2,0.651965595
16498,76,22750,7,5,0,10,0,22,9,4,8,0,0,21,nowin,loss,bust,plbust,0,10,12,189,0.534391534,0.079365079,0.608465608,3,1
16499,121,22750,8,6,0,10,0,24,9,4,8,0,0,21,nowin,loss,bust,plbust,0,10,14,195,0.456410256,0.025641026,0.512820513,1,0.288597791
16500,25,22751,10,10,0,0,0,20,2,7,10,0,0,19,nowin,win,plwin,beat,20,0,20,190,0.463157895,0.063157895,0.536842105,1,0.304401563
16501,91,22751,2,3,10,0,0,15,2,7,10,0,0,19,nowin,loss,beat,dlwin,0,10,5,194,0.417525773,0.046391753,0.515463918,1,0.266616552
16502,101,22751,10,9,0,0,0,19,2,7,10,0,0,19,nowin,push,push,push,10,0,19,205,0.424390244,0.068292683,0.63902439,2,0.614740646
16503,7,22751,8,4,0,6,0,18,2,7,10,0,0,19,nowin,loss,beat,dlwin,0,10,12,183,0.442622951,0.06010929,0.62295082,2,0.619303341
16504,97,22751,3,8,10,0,0,21,2,7,10,0,0,19,nowin,win,plwin,beat,20,0,11,182,0.450549451,0.06043956,0.692307692,2,0.677372279
16505,39,22751,10,10,0,0,0,20,2,7,10,0,0,19,nowin,win,plwin,beat,20,0,20,191,0.429319372,0.062827225,0.57591623,0,0.033760763
16506,49,22752,5,4,9,0,0,18,4,5,5,7,0,21,nowin,loss,beat,dlwin,0,10,9,207,0.396135266,0.053140097,0.594202899,0,0.028306925
16507,98,22752,10,11,0,0,0,21,4,5,5,7,0,21,win,push,push,push,10,0,21,220,0.422727273,0.054545455,0.55,1,0.28664435
16508,97,22752,3,11,3,0,0,17,4,5,5,7,0,21,nowin,loss,beat,dlwin,0,10,14,182,0.450549451,0.06043956,0.692307692,2,0.677372279
16509,135,22752,9,11,0,0,0,20,4,5,5,7,0,21,nowin,loss,beat,dlwin,0,10,20,179,0.391061453,0.067039106,0.586592179,0,0.024924662
16510,42,22752,1,4,10,0,0,15,4,5,5,7,0,21,nowin,loss,beat,dlwin,0,10,5,212,0.443396226,0.051886792,0.570754717,1,0.309181312
16511,149,22752,4,10,0,0,0,14,4,5,5,7,0,21,nowin,loss,beat,dlwin,0,10,14,225,0.457777778,0.057777778,0.648888889,2,0.651965595
16512,136,22753,2,9,1,8,0,20,9,2,8,0,0,19,nowin,win,plwin,beat,20,0,11,194,0.396907216,0.025773196,0.597938144,0,0.029452644
16513,84,22753,1,1,10,10,0,22,9,2,8,0,0,19,nowin,loss,bust,plbust,0,10,2,195,0.379487179,0.056410256,0.569230769,0,0.017209119
16514,116,22753,3,5,2,9,0,19,9,2,8,0,0,19,nowin,push,push,push,10,0,8,195,0.425641026,0.056410256,0.538461538,1,0.28273747
16515,30,22753,2,10,0,10,0,22,9,2,8,0,0,19,nowin,loss,bust,plbust,0,10,12,206,0.393203883,0.033980583,0.601941748,0,0.029324648
16516,21,22753,10,7,0,0,0,17,9,2,8,0,0,19,nowin,loss,beat,dlwin,0,10,17,214,0.359813084,0.042056075,0.626168224,0,0.025263474
16517,99,22753,10,5,0,3,0,18,9,2,8,0,0,19,nowin,loss,beat,dlwin,0,10,15,207,0.47826087,0.062801932,0.637681159,3,0.961418446
16518,33,22754,7,10,0,0,0,17,10,9,0,0,0,19,nowin,loss,beat,dlwin,0,10,17,192,0.4375,0.057291667,0.625,2,0.616208916
16519,1,22754,10,7,0,0,0,17,10,9,0,0,0,19,nowin,loss,beat,dlwin,0,10,17,197,0.406091371,0.025380711,0.649746193,2,0.606186955
16520,81,22754,7,7,0,10,0,24,10,9,0,0,0,19,nowin,loss,bust,plbust,0,10,14,182,0.395604396,0.043956044,0.60989011,2,0.567491261
16521,43,22754,10,10,0,0,0,20,10,9,0,0,0,19,nowin,win,plwin,beat,20,0,20,192,0.40625,0.041666667,0.609375,2,0.576671372
16522,125,22754,2,7,10,0,0,19,10,9,0,0,0,19,nowin,push,push,push,10,0,9,219,0.438356164,0.050228311,0.575342466,1,0.308411257
16523,66,22754,7,10,0,0,0,17,10,9,0,0,0,19,nowin,loss,beat,dlwin,0,10,17,217,0.456221198,0.064516129,0.626728111,3,0.924304367
16524,58,22755,9,2,9,0,0,20,10,6,1,0,0,17,nowin,win,plwin,beat,20,0,11,195,0.430769231,0.041025641,0.584615385,2,0.580497586
16525,70,22755,10,4,0,10,0,24,10,6,1,0,0,17,nowin,loss,bust,plbust,0,10,14,228,0.385964912,0.039473684,0.557017544,0,0.016157125
16526,14,22755,8,2,4,5,0,19,10,6,1,0,0,17,nowin,win,plwin,beat,20,0,10,202,0.391089109,0.01980198,0.628712871,2,0.577264877
16527,125,22755,6,6,0,7,0,19,10,6,1,0,0,17,nowin,win,plwin,beat,20,0,12,219,0.438356164,0.050228311,0.575342466,1,0.308411257
16528,144,22755,4,10,0,10,0,24,10,6,1,0,0,17,nowin,loss,bust,plbust,0,10,14,202,0.386138614,0.054455446,0.564356436,0,0.018006244
16529,100,22755,5,10,0,4,0,19,10,6,1,0,0,17,nowin,win,plwin,beat,20,0,15,190,0.452631579,0.036842105,0.594736842,3,0.888671154
16530,76,22756,9,5,0,0,0,14,4,1,10,10,0,25,nowin,win,dlbust,bust,20,0,14,189,0.534391534,0.079365079,0.608465608,3,1
16531,85,22756,5,9,0,0,0,14,4,1,10,10,0,25,nowin,win,dlbust,bust,20,0,14,195,0.41025641,0.066666667,0.594871795,0,0.03269711
16532,52,22756,9,10,0,0,0,19,4,1,10,10,0,25,nowin,win,dlbust,bust,20,0,19,217,0.414746544,0.02764977,0.599078341,2,0.576736024
16533,66,22756,3,2,5,1,4,15,4,1,10,10,0,25,nowin,win,dlbust,bust,20,0,5,217,0.456221198,0.064516129,0.626728111,3,0.924304367
16534,30,22756,2,6,7,0,0,15,4,1,10,10,0,25,nowin,win,dlbust,bust,20,0,8,206,0.393203883,0.033980583,0.601941748,0,0.029324648
16535,145,22756,10,10,0,0,0,20,4,1,10,10,0,25,nowin,win,dlbust,bust,20,0,20,188,0.441489362,0.031914894,0.622340426,2,0.617837093
16536,7,22757,4,5,6,10,0,25,8,5,6,0,0,19,nowin,loss,bust,plbust,0,10,9,183,0.442622951,0.06010929,0.62295082,2,0.619303341
16537,71,22757,6,7,0,1,10,24,8,5,6,0,0,19,nowin,loss,bust,plbust,0,10,13,193,0.352331606,0.046632124,0.585492228,0,0.013063661
16538,104,22757,5,6,3,8,0,22,8,5,6,0,0,19,nowin,loss,bust,plbust,0,10,11,209,0.363636364,0.052631579,0.593301435,0,0.018359419
16539,93,22757,10,3,0,10,0,23,8,5,6,0,0,19,nowin,loss,bust,plbust,0,10,13,175,0.485714286,0.051428571,0.548571429,1,0.323648091
16540,79,22757,9,10,0,0,0,19,8,5,6,0,0,19,nowin,push,push,push,10,0,19,211,0.436018957,0.028436019,0.672985782,2,0.650131054
16541,87,22757,10,2,0,10,0,22,8,5,6,0,0,19,nowin,loss,bust,plbust,0,10,12,202,0.405940594,0.054455446,0.628712871,2,0.590599801
16542,83,22758,11,9,0,0,0,20,11,6,0,0,0,17,nowin,win,plwin,beat,20,0,20,193,0.424870466,0.051813472,0.678756477,2,0.644360335
16543,143,22758,1,6,7,2,8,24,11,6,0,0,0,17,nowin,loss,bust,plbust,0,10,7,203,0.463054187,0.044334975,0.57635468,3,0.883143365
16544,136,22758,10,10,0,0,0,20,11,6,0,0,0,17,nowin,win,plwin,beat,20,0,20,194,0.396907216,0.025773196,0.597938144,0,0.029452644
16545,36,22758,7,10,0,0,0,17,11,6,0,0,0,17,nowin,push,push,push,10,0,17,229,0.445414847,0.056768559,0.655021834,2,0.645370571
16546,96,22758,10,6,0,1,0,17,11,6,0,0,0,17,nowin,push,push,push,10,0,16,190,0.468421053,0.057894737,0.584210526,3,0.897263354
16547,27,22758,6,10,0,10,0,26,11,6,0,0,0,17,nowin,loss,bust,plbust,0,10,16,178,0.370786517,0.016853933,0.573033708,0,0.015536309
16548,141,22759,3,7,6,8,0,24,10,3,7,0,0,20,nowin,loss,bust,plbust,0,10,10,202,0.420792079,0.074257426,0.564356436,0,0.028377851
16549,8,22759,1,5,10,5,0,21,10,3,7,0,0,20,nowin,win,plwin,beat,20,0,6,181,0.44198895,0.071823204,0.596685083,2,0.599438402
16550,128,22759,10,4,0,8,0,22,10,3,7,0,0,20,nowin,loss,bust,plbust,0,10,14,227,0.356828194,0.052863436,0.577092511,0,0.012352564
16551,133,22759,3,9,0,4,5,21,10,3,7,0,0,20,nowin,win,plwin,beat,20,0,12,201,0.47761194,0.064676617,0.611940299,3,0.935428111
16552,84,22759,6,6,0,5,0,17,10,3,7,0,0,20,nowin,loss,beat,dlwin,0,10,12,195,0.379487179,0.056410256,0.569230769,0,0.017209119
16553,55,22759,4,10,0,2,5,21,10,3,7,0,0,20,nowin,win,plwin,beat,20,0,14,191,0.371727749,0.057591623,0.54973822,0,0.01011347
16554,113,22760,10,8,0,0,0,18,9,9,0,0,0,18,nowin,push,push,push,10,0,18,199,0.407035176,0.055276382,0.668341709,2,0.620695264
16555,115,22760,10,3,0,10,0,23,9,9,0,0,0,18,nowin,loss,bust,plbust,0,10,13,194,0.427835052,0.041237113,0.592783505,2,0.583863602
16556,96,22760,11,9,0,0,0,20,9,9,0,0,0,18,nowin,win,plwin,beat,20,0,20,190,0.468421053,0.057894737,0.584210526,3,0.897263354
16557,51,22760,10,4,0,5,0,19,9,9,0,0,0,18,nowin,win,plwin,beat,20,0,14,189,0.529100529,0.068783069,0.608465608,3,0.993665715
16558,112,22760,11,9,0,0,0,20,9,9,0,0,0,18,nowin,win,plwin,beat,20,0,20,203,0.448275862,0.054187192,0.600985222,3,0.889576933
16559,117,22760,6,6,0,4,3,19,9,9,0,0,0,18,nowin,win,plwin,beat,20,0,12,173,0.410404624,0.069364162,0.606936416,2,0.578610282
16560,70,22761,10,6,0,8,0,24,11,10,0,0,0,21,nowin,loss,bust,plbust,0,10,16,228,0.385964912,0.039473684,0.557017544,0,0.016157125
16561,96,22761,2,10,0,2,10,24,11,10,0,0,0,21,nowin,loss,bust,plbust,0,10,12,190,0.468421053,0.057894737,0.584210526,3,0.897263354
16562,42,22761,3,1,9,9,0,22,11,10,0,0,0,21,nowin,loss,bust,plbust,0,10,4,212,0.443396226,0.051886792,0.570754717,1,0.309181312
16563,14,22761,11,10,0,0,0,21,11,10,0,0,0,21,win,push,push,push,10,0,21,202,0.391089109,0.01980198,0.628712871,2,0.577264877
16564,27,22761,10,8,0,0,0,18,11,10,0,0,0,21,nowin,loss,beat,dlwin,0,10,18,178,0.370786517,0.016853933,0.573033708,0,0.015536309
16565,41,22761,10,7,0,0,0,17,11,10,0,0,0,21,nowin,loss,beat,dlwin,0,10,17,192,0.364583333,0.036458333,0.520833333,0,0.00089702
16566,85,22762,10,10,0,0,0,20,3,4,6,3,8,24,nowin,win,dlbust,bust,20,0,20,195,0.41025641,0.066666667,0.594871795,0,0.03269711
16567,82,22762,9,3,0,10,0,22,3,4,6,3,8,24,nowin,loss,bust,plbust,0,10,12,225,0.408888889,0.075555556,0.577777778,0,0.028101874
16568,83,22762,7,11,0,0,0,18,3,4,6,3,8,24,nowin,win,dlbust,bust,20,0,18,193,0.424870466,0.051813472,0.678756477,2,0.644360335
16569,100,22762,6,10,0,0,0,16,3,4,6,3,8,24,nowin,win,dlbust,bust,20,0,16,190,0.452631579,0.036842105,0.594736842,3,0.888671154
16570,137,22762,2,4,10,0,0,16,3,4,6,3,8,24,nowin,win,dlbust,bust,20,0,6,194,0.417525773,0.046391753,0.536082474,1,0.276714602
16571,31,22762,7,3,10,0,0,20,3,4,6,3,8,24,nowin,win,dlbust,bust,20,0,10,188,0.473404255,0.058510638,0.515957447,1,0.300306557
16572,69,22763,10,9,0,0,0,19,10,11,0,0,0,21,nowin,loss,beat,dlwin,0,10,19,194,0.365979381,0.030927835,0.515463918,0,0
16573,20,22763,10,4,0,10,0,24,10,11,0,0,0,21,nowin,loss,bust,plbust,0,10,14,186,0.456989247,0.037634409,0.537634409,1,0.301097108
16574,136,22763,11,7,0,0,0,18,10,11,0,0,0,21,nowin,loss,beat,dlwin,0,10,18,194,0.396907216,0.025773196,0.597938144,0,0.029452644
16575,131,22763,6,3,11,0,0,20,10,11,0,0,0,21,nowin,loss,beat,dlwin,0,10,9,217,0.410138249,0.069124424,0.543778802,0,0.02015021
16576,94,22763,7,9,0,9,0,25,10,11,0,0,0,21,nowin,loss,bust,plbust,0,10,16,183,0.43715847,0.043715847,0.540983607,1,0.290866892
16577,66,22763,10,2,0,4,7,23,10,11,0,0,0,21,nowin,loss,bust,plbust,0,10,12,217,0.456221198,0.064516129,0.626728111,3,0.924304367
16578,102,22764,10,10,0,0,0,20,9,9,0,0,0,18,nowin,win,plwin,beat,20,0,20,192,0.338541667,0.046875,0.5625,0,0.003306118
16579,35,22764,7,10,0,0,0,17,9,9,0,0,0,18,nowin,loss,beat,dlwin,0,10,17,202,0.410891089,0.044554455,0.633663366,2,0.598681573
16580,132,22764,2,5,6,8,0,21,9,9,0,0,0,18,nowin,win,plwin,beat,20,0,7,194,0.412371134,0.036082474,0.649484536,2,0.611633238
16581,15,22764,5,10,0,1,1,17,9,9,0,0,0,18,nowin,loss,beat,dlwin,0,10,15,212,0.410377358,0.051886792,0.561320755,0,0.024517408
16582,144,22764,10,3,0,5,0,18,9,9,0,0,0,18,nowin,push,push,push,10,0,13,202,0.386138614,0.054455446,0.564356436,0,0.018006244
16583,128,22764,2,11,2,10,0,25,9,9,0,0,0,18,nowin,loss,bust,plbust,0,10,13,227,0.356828194,0.052863436,0.577092511,0,0.012352564
16584,53,22765,2,4,3,2,6,17,10,6,5,0,0,21,nowin,loss,beat,dlwin,0,10,6,250,0.372,0.064,0.564,0,0.013687345
16585,38,22765,9,10,0,0,0,19,10,6,5,0,0,21,nowin,loss,beat,dlwin,0,10,19,202,0.361386139,0.03960396,0.564356436,0,0.010597953
16586,73,22765,4,9,0,2,10,25,10,6,5,0,0,21,nowin,loss,bust,plbust,0,10,13,181,0.375690608,0.011049724,0.596685083,0,0.022795773
16587,39,22765,3,4,8,10,0,25,10,6,5,0,0,21,nowin,loss,bust,plbust,0,10,7,191,0.429319372,0.062827225,0.57591623,0,0.033760763
16588,96,22765,2,10,0,2,10,24,10,6,5,0,0,21,nowin,loss,bust,plbust,0,10,12,190,0.468421053,0.057894737,0.584210526,3,0.897263354
16589,58,22765,10,11,0,0,0,21,10,6,5,0,0,21,win,push,push,push,10,0,21,195,0.430769231,0.041025641,0.584615385,2,0.580497586
16590,63,22766,10,7,0,0,0,17,5,1,10,3,0,19,nowin,loss,beat,dlwin,0,10,17,216,0.467592593,0.037037037,0.62037037,3,0.931690496
16591,21,22766,2,8,11,0,0,21,5,1,10,3,0,19,nowin,win,plwin,beat,20,0,10,214,0.359813084,0.042056075,0.626168224,0,0.025263474
16592,67,22766,10,6,0,0,0,16,5,1,10,3,0,19,nowin,loss,beat,dlwin,0,10,16,195,0.369230769,0.041025641,0.569230769,0,0.014139427
16593,53,22766,4,2,9,0,0,15,5,1,10,3,0,19,nowin,loss,beat,dlwin,0,10,6,250,0.372,0.064,0.564,0,0.013687345
16594,17,22766,3,7,3,0,0,13,5,1,10,3,0,19,nowin,loss,beat,dlwin,0,10,10,171,0.444444444,0.070175439,0.555555556,1,0.302364894
16595,127,22766,10,9,0,0,0,19,5,1,10,3,0,19,nowin,push,push,push,10,0,19,201,0.402985075,0.029850746,0.60199005,0,0.032263937
16596,122,22767,5,7,0,9,0,21,10,10,0,0,0,20,nowin,win,plwin,beat,20,0,12,210,0.347619048,0.052380952,0.59047619,0,0.012873677
16597,76,22767,10,2,0,10,0,22,10,10,0,0,0,20,nowin,loss,bust,plbust,0,10,12,189,0.534391534,0.079365079,0.608465608,3,1
16598,89,22767,4,8,0,2,2,16,10,10,0,0,0,20,nowin,loss,beat,dlwin,0,10,12,212,0.537735849,0.047169811,0.594339623,3,0.990167191
16599,133,22767,11,10,0,0,0,21,10,10,0,0,0,20,win,win,plwin,beat,25,0,21,201,0.47761194,0.064676617,0.611940299,3,0.935428111
16600,54,22767,10,6,0,6,0,22,10,10,0,0,0,20,nowin,loss,bust,plbust,0,10,16,185,0.437837838,0.032432432,0.556756757,1,0.29899854
16601,66,22767,10,7,0,0,0,17,10,10,0,0,0,20,nowin,loss,beat,dlwin,0,10,17,217,0.456221198,0.064516129,0.626728111,3,0.924304367
16602,95,22768,2,2,11,4,0,19,10,8,0,0,0,18,nowin,win,plwin,beat,20,0,4,218,0.412844037,0.04587156,0.559633028,0,0.024842385
16603,21,22768,10,10,0,0,0,20,10,8,0,0,0,18,nowin,win,plwin,beat,20,0,20,214,0.359813084,0.042056075,0.626168224,0,0.025263474
16604,33,22768,11,10,0,0,0,21,10,8,0,0,0,18,win,win,plwin,beat,25,0,21,192,0.4375,0.057291667,0.625,2,0.616208916
16605,150,22768,2,3,11,1,0,17,10,8,0,0,0,18,nowin,loss,beat,dlwin,0,10,5,192,0.401041667,0.036458333,0.567708333,0,0.023287458
16606,17,22768,10,3,0,10,0,23,10,8,0,0,0,18,nowin,loss,bust,plbust,0,10,13,171,0.444444444,0.070175439,0.555555556,1,0.302364894
16607,130,22768,9,6,0,10,0,25,10,8,0,0,0,18,nowin,loss,bust,plbust,0,10,15,219,0.410958904,0.03652968,0.566210046,0,0.025888739
16608,25,22769,10,3,0,0,0,13,6,8,8,0,0,22,nowin,win,dlbust,bust,20,0,13,190,0.463157895,0.063157895,0.536842105,1,0.304401563
16609,9,22769,10,7,0,0,0,17,6,8,8,0,0,22,nowin,win,dlbust,bust,20,0,17,194,0.37628866,0.015463918,0.541237113,0,0.009396796
16610,3,22769,4,9,0,0,0,13,6,8,8,0,0,22,nowin,win,dlbust,bust,20,0,13,190,0.431578947,0.026315789,0.542105263,1,0.288076384
16611,138,22769,10,10,0,0,0,20,6,8,8,0,0,22,nowin,win,dlbust,bust,20,0,20,190,0.442105263,0.047368421,0.610526316,2,0.609711065
16612,43,22769,6,3,7,0,0,16,6,8,8,0,0,22,nowin,win,dlbust,bust,20,0,9,192,0.40625,0.041666667,0.609375,2,0.576671372
16613,113,22769,10,10,0,0,0,20,6,8,8,0,0,22,nowin,win,dlbust,bust,20,0,20,199,0.407035176,0.055276382,0.668341709,2,0.620695264
16614,5,22770,10,9,0,0,0,19,10,7,0,0,0,17,nowin,win,plwin,beat,20,0,19,203,0.42364532,0.02955665,0.596059113,2,0.582508076
16615,118,22770,10,3,0,10,0,23,10,7,0,0,0,17,nowin,loss,bust,plbust,0,10,13,216,0.393518519,0.037037037,0.555555556,0,0.018059873
16616,81,22770,11,10,0,0,0,21,10,7,0,0,0,17,win,win,plwin,beat,25,0,21,182,0.395604396,0.043956044,0.60989011,2,0.567491261
16617,43,22770,4,3,5,1,7,20,10,7,0,0,0,17,nowin,win,plwin,beat,20,0,7,192,0.40625,0.041666667,0.609375,2,0.576671372
16618,118,22770,10,2,0,9,0,21,10,7,0,0,0,17,nowin,win,plwin,beat,20,0,12,216,0.393518519,0.037037037,0.555555556,0,0.018059873
16619,93,22770,9,9,0,0,0,18,10,7,0,0,0,17,nowin,win,plwin,beat,20,0,18,175,0.485714286,0.051428571,0.548571429,1,0.323648091
16620,124,22771,4,8,0,0,0,12,6,6,8,0,0,20,nowin,loss,beat,dlwin,0,10,12,202,0.47029703,0.064356436,0.584158416,3,0.899458193
16621,67,22771,9,2,10,0,0,21,6,6,8,0,0,20,nowin,win,plwin,beat,20,0,11,195,0.369230769,0.041025641,0.569230769,0,0.014139427
16622,88,22771,10,5,0,0,0,15,6,6,8,0,0,20,nowin,loss,beat,dlwin,0,10,15,206,0.466019417,0.033980583,0.54368932,1,0.309467903
16623,112,22771,3,11,1,0,0,15,6,6,8,0,0,20,nowin,loss,beat,dlwin,0,10,14,203,0.448275862,0.054187192,0.600985222,3,0.889576933
16624,102,22771,10,6,0,0,0,16,6,6,8,0,0,20,nowin,loss,beat,dlwin,0,10,16,192,0.338541667,0.046875,0.5625,0,0.003306118
16625,96,22771,2,10,0,0,0,12,6,6,8,0,0,20,nowin,loss,beat,dlwin,0,10,12,190,0.468421053,0.057894737,0.584210526,3,0.897263354
16626,99,22772,10,10,0,0,0,20,7,7,9,0,0,23,nowin,win,dlbust,bust,20,0,20,207,0.47826087,0.062801932,0.637681159,3,0.961418446
16627,41,22772,10,9,0,0,0,19,7,7,9,0,0,23,nowin,win,dlbust,bust,20,0,19,192,0.364583333,0.036458333,0.520833333,0,0.00089702
16628,42,22772,6,1,10,0,0,17,7,7,9,0,0,23,nowin,win,dlbust,bust,20,0,7,212,0.443396226,0.051886792,0.570754717,1,0.309181312
16629,118,22772,11,10,0,0,0,21,7,7,9,0,0,23,win,win,dlbust,bust,25,0,21,216,0.393518519,0.037037037,0.555555556,0,0.018059873
16630,5,22772,11,10,0,0,0,21,7,7,9,0,0,23,win,win,dlbust,bust,25,0,21,203,0.42364532,0.02955665,0.596059113,2,0.582508076
16631,12,22772,7,2,7,4,0,20,7,7,9,0,0,23,nowin,win,dlbust,bust,20,0,9,189,0.470899471,0.015873016,0.613756614,3,0.929171178
16632,50,22773,4,6,8,0,0,18,10,10,0,0,0,20,nowin,loss,beat,dlwin,0,10,10,202,0.405940594,0.04950495,0.54950495,0,0.020296079
16633,53,22773,1,2,10,10,0,23,10,10,0,0,0,20,nowin,loss,bust,plbust,0,10,3,250,0.372,0.064,0.564,0,0.013687345
16634,110,22773,5,4,8,0,0,17,10,10,0,0,0,20,nowin,loss,beat,dlwin,0,10,9,192,0.416666667,0.046875,0.557291667,0,0.025413132
16635,67,22773,8,10,0,0,0,18,10,10,0,0,0,20,nowin,loss,beat,dlwin,0,10,18,195,0.369230769,0.041025641,0.569230769,0,0.014139427
16636,84,22773,4,8,0,1,4,17,10,10,0,0,0,20,nowin,loss,beat,dlwin,0,10,12,195,0.379487179,0.056410256,0.569230769,0,0.017209119
16637,138,22773,8,7,0,4,0,19,10,10,0,0,0,20,nowin,loss,beat,dlwin,0,10,15,190,0.442105263,0.047368421,0.610526316,2,0.609711065
16638,134,22774,11,10,0,0,0,21,4,5,5,10,0,24,win,win,dlbust,bust,25,0,21,185,0.443243243,0.021621622,0.545945946,1,0.296939509
16639,90,22774,7,9,0,0,0,16,4,5,5,10,0,24,nowin,win,dlbust,bust,20,0,16,201,0.447761194,0.049751244,0.60199005,3,0.889945023
16640,136,22774,10,10,0,0,0,20,4,5,5,10,0,24,nowin,win,dlbust,bust,20,0,20,194,0.396907216,0.025773196,0.597938144,0,0.029452644
16641,6,22774,8,4,0,0,0,12,4,5,5,10,0,24,nowin,win,dlbust,bust,20,0,12,191,0.439790576,0.047120419,0.581151832,1,0.31211505
16642,84,22774,1,6,10,0,0,17,4,5,5,10,0,24,nowin,win,dlbust,bust,20,0,7,195,0.379487179,0.056410256,0.569230769,0,0.017209119
16643,143,22774,7,3,7,0,0,17,4,5,5,10,0,24,nowin,win,dlbust,bust,20,0,10,203,0.463054187,0.044334975,0.57635468,3,0.883143365
16644,31,22775,9,4,0,0,0,13,5,6,8,0,0,19,nowin,loss,beat,dlwin,0,10,13,188,0.473404255,0.058510638,0.515957447,1,0.300306557
16645,24,22775,10,5,0,0,0,15,5,6,8,0,0,19,nowin,loss,beat,dlwin,0,10,15,207,0.458937198,0.048309179,0.570048309,1,0.318138014
16646,106,22775,7,10,0,0,0,17,5,6,8,0,0,19,nowin,loss,beat,dlwin,0,10,17,192,0.411458333,0.026041667,0.557291667,0,0.023854304
16647,143,22775,11,4,2,0,0,17,5,6,8,0,0,19,nowin,loss,beat,dlwin,0,10,15,203,0.463054187,0.044334975,0.57635468,3,0.883143365
16648,8,22775,10,9,0,0,0,19,5,6,8,0,0,19,nowin,push,push,push,10,0,19,181,0.44198895,0.071823204,0.596685083,2,0.599438402
16649,112,22775,6,6,0,0,0,12,5,6,8,0,0,19,nowin,loss,beat,dlwin,0,10,12,203,0.448275862,0.054187192,0.600985222,3,0.889576933
16650,20,22776,8,3,5,10,0,26,10,9,0,0,0,19,nowin,loss,bust,plbust,0,10,11,186,0.456989247,0.037634409,0.537634409,1,0.301097108
16651,88,22776,10,10,0,0,0,20,10,9,0,0,0,19,nowin,win,plwin,beat,20,0,20,206,0.466019417,0.033980583,0.54368932,1,0.309467903
16652,79,22776,7,10,0,0,0,17,10,9,0,0,0,19,nowin,loss,beat,dlwin,0,10,17,211,0.436018957,0.028436019,0.672985782,2,0.650131054
16653,61,22776,8,8,0,3,0,19,10,9,0,0,0,19,nowin,push,push,push,10,0,16,194,0.427835052,0.077319588,0.603092784,2,0.591437139
16654,114,22776,5,3,3,10,0,21,10,9,0,0,0,19,nowin,win,plwin,beat,20,0,8,198,0.47979798,0.025252525,0.611111111,3,0.937232995
16655,92,22776,4,7,10,0,0,21,10,9,0,0,0,19,nowin,win,plwin,beat,20,0,11,186,0.446236559,0.059139785,0.564516129,1,0.307826125
16656,63,22777,10,10,0,0,0,20,2,4,2,3,6,17,nowin,win,plwin,beat,20,0,20,216,0.467592593,0.037037037,0.62037037,3,0.931690496
16657,41,22777,10,3,0,0,0,13,2,4,2,3,6,17,nowin,loss,beat,dlwin,0,10,13,192,0.364583333,0.036458333,0.520833333,0,0.00089702
16658,105,22777,10,2,0,2,0,14,2,4,2,3,6,17,nowin,loss,beat,dlwin,0,10,12,198,0.414141414,0.070707071,0.590909091,0,0.032889494
16659,118,22777,10,3,0,0,0,13,2,4,2,3,6,17,nowin,loss,beat,dlwin,0,10,13,216,0.393518519,0.037037037,0.555555556,0,0.018059873
16660,53,22777,5,8,0,0,0,13,2,4,2,3,6,17,nowin,loss,beat,dlwin,0,10,13,250,0.372,0.064,0.564,0,0.013687345
16661,87,22777,6,1,10,0,0,17,2,4,2,3,6,17,nowin,push,push,push,10,0,7,202,0.405940594,0.054455446,0.628712871,2,0.590599801
16662,81,22778,10,10,0,0,0,20,10,4,10,0,0,24,nowin,win,dlbust,bust,20,0,20,182,0.395604396,0.043956044,0.60989011,2,0.567491261
16663,94,22778,10,8,0,0,0,18,10,4,10,0,0,24,nowin,win,dlbust,bust,20,0,18,183,0.43715847,0.043715847,0.540983607,1,0.290866892
16664,51,22778,9,3,0,6,0,18,10,4,10,0,0,24,nowin,win,dlbust,bust,20,0,12,189,0.529100529,0.068783069,0.608465608,3,0.993665715
16665,51,22778,7,7,0,3,0,17,10,4,10,0,0,24,nowin,win,dlbust,bust,20,0,14,189,0.529100529,0.068783069,0.608465608,3,0.993665715
16666,88,22778,10,3,0,10,0,23,10,4,10,0,0,24,nowin,loss,bust,plbust,0,10,13,206,0.466019417,0.033980583,0.54368932,1,0.309467903
16667,15,22778,4,10,0,1,8,23,10,4,10,0,0,24,nowin,loss,bust,plbust,0,10,14,212,0.410377358,0.051886792,0.561320755,0,0.024517408
16668,58,22779,10,10,0,0,0,20,10,10,0,0,0,20,nowin,push,push,push,10,0,20,195,0.430769231,0.041025641,0.584615385,2,0.580497586
16669,96,22779,10,9,0,0,0,19,10,10,0,0,0,20,nowin,loss,beat,dlwin,0,10,19,190,0.468421053,0.057894737,0.584210526,3,0.897263354
16670,18,22779,5,10,0,9,0,24,10,10,0,0,0,20,nowin,loss,bust,plbust,0,10,15,182,0.461538462,0.043956044,0.587912088,3,0.892649374
16671,51,22779,8,10,0,0,0,18,10,10,0,0,0,20,nowin,loss,beat,dlwin,0,10,18,189,0.529100529,0.068783069,0.608465608,3,0.993665715
16672,40,22779,6,10,0,1,0,17,10,10,0,0,0,20,nowin,loss,beat,dlwin,0,10,16,196,0.367346939,0.030612245,0.617346939,0,0.025358183
16673,43,22779,8,10,0,0,0,18,10,10,0,0,0,20,nowin,loss,beat,dlwin,0,10,18,192,0.40625,0.041666667,0.609375,2,0.576671372
16674,25,22780,10,3,0,7,0,20,8,11,0,0,0,19,nowin,win,plwin,beat,20,0,13,190,0.463157895,0.063157895,0.536842105,1,0.304401563
16675,53,22780,4,2,7,10,0,23,8,11,0,0,0,19,nowin,loss,bust,plbust,0,10,6,250,0.372,0.064,0.564,0,0.013687345
16676,3,22780,10,2,0,10,0,22,8,11,0,0,0,19,nowin,loss,bust,plbust,0,10,12,190,0.431578947,0.026315789,0.542105263,1,0.288076384
16677,91,22780,8,9,0,0,0,17,8,11,0,0,0,19,nowin,loss,beat,dlwin,0,10,17,194,0.417525773,0.046391753,0.515463918,1,0.266616552
16678,5,22780,10,10,0,0,0,20,8,11,0,0,0,19,nowin,win,plwin,beat,20,0,20,203,0.42364532,0.02955665,0.596059113,2,0.582508076
16679,64,22780,10,10,0,0,0,20,8,11,0,0,0,19,nowin,win,plwin,beat,20,0,20,187,0.363636364,0.048128342,0.631016043,0,0.027594885
16680,70,22781,7,7,0,0,0,14,5,10,5,0,0,20,nowin,loss,beat,dlwin,0,10,14,228,0.385964912,0.039473684,0.557017544,0,0.016157125
16681,82,22781,10,6,0,0,0,16,5,10,5,0,0,20,nowin,loss,beat,dlwin,0,10,16,225,0.408888889,0.075555556,0.577777778,0,0.028101874
16682,79,22781,10,11,0,0,0,21,5,10,5,0,0,20,win,win,plwin,beat,25,0,21,211,0.436018957,0.028436019,0.672985782,2,0.650131054
16683,78,22781,6,10,0,0,0,16,5,10,5,0,0,20,nowin,loss,beat,dlwin,0,10,16,201,0.517412935,0.034825871,0.587064677,3,0.95871112
16684,80,22781,7,7,0,0,0,14,5,10,5,0,0,20,nowin,loss,beat,dlwin,0,10,14,186,0.419354839,0.059139785,0.623655914,2,0.59892924
16685,74,22781,9,4,0,0,0,13,5,10,5,0,0,20,nowin,loss,beat,dlwin,0,10,13,209,0.411483254,0.04784689,0.531100478,0,0.017448125
16686,51,22782,10,10,0,0,0,20,8,9,0,0,0,17,nowin,win,plwin,beat,20,0,20,189,0.529100529,0.068783069,0.608465608,3,0.993665715
16687,14,22782,8,10,0,0,0,18,8,9,0,0,0,17,nowin,win,plwin,beat,20,0,18,202,0.391089109,0.01980198,0.628712871,2,0.577264877
16688,103,22782,3,9,0,10,0,22,8,9,0,0,0,17,nowin,loss,bust,plbust,0,10,12,203,0.379310345,0.064039409,0.551724138,0,0.012869209
16689,70,22782,8,7,0,6,0,21,8,9,0,0,0,17,nowin,win,plwin,beat,20,0,15,228,0.385964912,0.039473684,0.557017544,0,0.016157125
16690,15,22782,4,2,5,6,0,17,8,9,0,0,0,17,nowin,push,push,push,10,0,6,212,0.410377358,0.051886792,0.561320755,0,0.024517408
16691,15,22782,2,5,8,10,0,25,8,9,0,0,0,17,nowin,loss,bust,plbust,0,10,7,212,0.410377358,0.051886792,0.561320755,0,0.024517408
16692,111,22783,7,11,0,0,0,18,10,10,0,0,0,20,nowin,loss,beat,dlwin,0,10,18,180,0.433333333,0.055555556,0.611111111,2,0.602264492
16693,148,22783,10,2,0,2,3,17,10,10,0,0,0,20,nowin,loss,beat,dlwin,0,10,12,204,0.401960784,0.078431373,0.593137255,0,0.029789521
16694,119,22783,11,8,0,0,0,19,10,10,0,0,0,20,nowin,loss,beat,dlwin,0,10,19,190,0.405263158,0.068421053,0.515789474,0,0.011837158
16695,35,22783,7,10,0,0,0,17,10,10,0,0,0,20,nowin,loss,beat,dlwin,0,10,17,202,0.410891089,0.044554455,0.633663366,2,0.598681573
16696,7,22783,10,3,0,8,0,21,10,10,0,0,0,20,nowin,win,plwin,beat,20,0,13,183,0.442622951,0.06010929,0.62295082,2,0.619303341
16697,95,22783,6,1,6,3,3,19,10,10,0,0,0,20,nowin,loss,beat,dlwin,0,10,7,218,0.412844037,0.04587156,0.559633028,0,0.024842385
16698,109,22784,8,3,8,0,0,19,11,10,0,0,0,21,nowin,loss,beat,dlwin,0,10,11,221,0.461538462,0.058823529,0.597285068,3,0.901830309
16699,19,22784,8,7,0,2,0,17,11,10,0,0,0,21,nowin,loss,beat,dlwin,0,10,15,237,0.41350211,0.054852321,0.628691983,2,0.597373826
16700,109,22784,6,3,9,0,0,18,11,10,0,0,0,21,nowin,loss,beat,dlwin,0,10,9,221,0.461538462,0.058823529,0.597285068,3,0.901830309
16701,87,22784,5,8,0,8,0,21,11,10,0,0,0,21,nowin,push,push,push,10,0,13,202,0.405940594,0.054455446,0.628712871,2,0.590599801
16702,139,22784,4,5,10,0,0,19,11,10,0,0,0,21,nowin,loss,beat,dlwin,0,10,9,192,0.380208333,0.036458333,0.59375,0,0.023429169
16703,44,22784,2,5,7,1,1,16,11,10,0,0,0,21,nowin,loss,beat,dlwin,0,10,7,219,0.433789954,0.050228311,0.534246575,1,0.285551035
16704,61,22785,10,10,0,0,0,20,3,9,10,0,0,22,nowin,win,dlbust,bust,20,0,20,194,0.427835052,0.077319588,0.603092784,2,0.591437139
16705,5,22785,10,10,0,0,0,20,3,9,10,0,0,22,nowin,win,dlbust,bust,20,0,20,203,0.42364532,0.02955665,0.596059113,2,0.582508076
16706,119,22785,3,10,0,0,0,13,3,9,10,0,0,22,nowin,win,dlbust,bust,20,0,13,190,0.405263158,0.068421053,0.515789474,0,0.011837158
16707,54,22785,10,5,0,0,0,15,3,9,10,0,0,22,nowin,win,dlbust,bust,20,0,15,185,0.437837838,0.032432432,0.556756757,1,0.29899854
16708,126,22785,2,10,0,3,0,15,3,9,10,0,0,22,nowin,win,dlbust,bust,20,0,12,188,0.457446809,0.074468085,0.60106383,3,0.900633203
16709,119,22785,11,1,8,0,0,20,3,9,10,0,0,22,nowin,win,dlbust,bust,20,0,12,190,0.405263158,0.068421053,0.515789474,0,0.011837158
16710,29,22786,10,10,0,0,0,20,8,10,0,0,0,18,nowin,win,plwin,beat,20,0,20,189,0.44973545,0.058201058,0.544973545,1,0.300349439
16711,116,22786,9,5,0,4,0,18,8,10,0,0,0,18,nowin,push,push,push,10,0,14,195,0.425641026,0.056410256,0.538461538,1,0.28273747
16712,2,22786,8,10,0,0,0,18,8,10,0,0,0,18,nowin,push,push,push,10,0,18,200,0.445,0.035,0.64,2,0.633962549
16713,88,22786,10,10,0,0,0,20,8,10,0,0,0,18,nowin,win,plwin,beat,20,0,20,206,0.466019417,0.033980583,0.54368932,1,0.309467903
16714,136,22786,9,2,6,0,0,17,8,10,0,0,0,18,nowin,loss,beat,dlwin,0,10,11,194,0.396907216,0.025773196,0.597938144,0,0.029452644
16715,113,22786,7,8,0,10,0,25,8,10,0,0,0,18,nowin,loss,bust,plbust,0,10,15,199,0.407035176,0.055276382,0.668341709,2,0.620695264
16716,133,22787,6,1,10,0,0,17,2,3,10,10,0,25,nowin,win,dlbust,bust,20,0,7,201,0.47761194,0.064676617,0.611940299,3,0.935428111
16717,79,22787,4,6,5,0,0,15,2,3,10,10,0,25,nowin,win,dlbust,bust,20,0,10,211,0.436018957,0.028436019,0.672985782,2,0.650131054
16718,76,22787,4,1,10,0,0,15,2,3,10,10,0,25,nowin,win,dlbust,bust,20,0,5,189,0.534391534,0.079365079,0.608465608,3,1
16719,34,22787,10,4,0,0,0,14,2,3,10,10,0,25,nowin,win,dlbust,bust,20,0,14,202,0.5,0.079207921,0.618811881,3,0.968961434
16720,34,22787,8,8,0,0,0,16,2,3,10,10,0,25,nowin,win,dlbust,bust,20,0,16,202,0.5,0.079207921,0.618811881,3,0.968961434
16721,116,22787,4,7,7,0,0,18,2,3,10,10,0,25,nowin,win,dlbust,bust,20,0,11,195,0.425641026,0.056410256,0.538461538,1,0.28273747
16722,45,22788,10,7,0,0,0,17,5,6,2,10,0,23,nowin,win,dlbust,bust,20,0,17,196,0.428571429,0.051020408,0.612244898,2,0.598821767
16723,65,22788,2,6,10,0,0,18,5,6,2,10,0,23,nowin,win,dlbust,bust,20,0,8,203,0.492610837,0.054187192,0.571428571,3,0.913702814
16724,106,22788,7,4,10,0,0,21,5,6,2,10,0,23,nowin,win,dlbust,bust,20,0,11,192,0.411458333,0.026041667,0.557291667,0,0.023854304
16725,125,22788,10,4,0,0,0,14,5,6,2,10,0,23,nowin,win,dlbust,bust,20,0,14,219,0.438356164,0.050228311,0.575342466,1,0.308411257
16726,51,22788,9,10,0,0,0,19,5,6,2,10,0,23,nowin,win,dlbust,bust,20,0,19,189,0.529100529,0.068783069,0.608465608,3,0.993665715
16727,32,22788,7,10,0,0,0,17,5,6,2,10,0,23,nowin,win,dlbust,bust,20,0,17,189,0.391534392,0.037037037,0.53968254,0,0.013579086
16728,136,22789,10,5,0,1,10,26,10,10,0,0,0,20,nowin,loss,bust,plbust,0,10,15,194,0.396907216,0.025773196,0.597938144,0,0.029452644
16729,99,22789,8,10,0,0,0,18,10,10,0,0,0,20,nowin,loss,beat,dlwin,0,10,18,207,0.47826087,0.062801932,0.637681159,3,0.961418446
16730,114,22789,6,10,0,10,0,26,10,10,0,0,0,20,nowin,loss,bust,plbust,0,10,16,198,0.47979798,0.025252525,0.611111111,3,0.937232995
16731,13,22789,10,6,0,3,0,19,10,10,0,0,0,20,nowin,loss,beat,dlwin,0,10,16,206,0.417475728,0.063106796,0.621359223,2,0.59555479
16732,111,22789,5,10,0,5,0,20,10,10,0,0,0,20,nowin,push,push,push,10,0,15,180,0.433333333,0.055555556,0.611111111,2,0.602264492
16733,117,22789,10,8,0,0,0,18,10,10,0,0,0,20,nowin,loss,beat,dlwin,0,10,18,173,0.410404624,0.069364162,0.606936416,2,0.578610282
16734,57,22790,2,8,10,0,0,20,1,2,10,10,0,23,nowin,win,dlbust,bust,20,0,10,192,0.46875,0.052083333,0.59375,3,0.907001181
16735,17,22790,2,10,0,8,0,20,1,2,10,10,0,23,nowin,win,dlbust,bust,20,0,12,171,0.444444444,0.070175439,0.555555556,1,0.302364894
16736,29,22790,7,8,0,10,0,25,1,2,10,10,0,23,nowin,loss,bust,plbust,0,10,15,189,0.44973545,0.058201058,0.544973545,1,0.300349439
16737,142,22790,4,8,0,3,5,20,1,2,10,10,0,23,nowin,win,dlbust,bust,20,0,12,211,0.417061611,0.047393365,0.526066351,1,0.271531309
16738,71,22790,10,10,0,0,0,20,1,2,10,10,0,23,nowin,win,dlbust,bust,20,0,20,193,0.352331606,0.046632124,0.585492228,0,0.013063661
16739,138,22790,9,4,0,10,0,23,1,2,10,10,0,23,nowin,loss,bust,plbust,0,10,13,190,0.442105263,0.047368421,0.610526316,2,0.609711065
16740,65,22791,4,10,0,1,8,23,7,3,9,0,0,19,nowin,loss,bust,plbust,0,10,14,203,0.492610837,0.054187192,0.571428571,3,0.913702814
16741,97,22791,8,7,0,7,0,22,7,3,9,0,0,19,nowin,loss,bust,plbust,0,10,15,182,0.450549451,0.06043956,0.692307692,2,0.677372279
16742,104,22791,10,11,0,0,0,21,7,3,9,0,0,19,win,win,plwin,beat,25,0,21,209,0.363636364,0.052631579,0.593301435,0,0.018359419
16743,99,22791,2,10,0,10,0,22,7,3,9,0,0,19,nowin,loss,bust,plbust,0,10,12,207,0.47826087,0.062801932,0.637681159,3,0.961418446
16744,13,22791,10,10,0,0,0,20,7,3,9,0,0,19,nowin,win,plwin,beat,20,0,20,206,0.417475728,0.063106796,0.621359223,2,0.59555479
16745,106,22791,11,7,0,0,0,18,7,3,9,0,0,19,nowin,loss,beat,dlwin,0,10,18,192,0.411458333,0.026041667,0.557291667,0,0.023854304
16746,120,22792,10,8,0,0,0,18,10,10,0,0,0,20,nowin,loss,beat,dlwin,0,10,18,202,0.440594059,0.034653465,0.618811881,2,0.614441029
16747,19,22792,2,1,10,5,0,18,10,10,0,0,0,20,nowin,loss,beat,dlwin,0,10,3,237,0.41350211,0.054852321,0.628691983,2,0.597373826
16748,56,22792,6,8,0,1,6,21,10,10,0,0,0,20,nowin,win,plwin,beat,20,0,14,175,0.4,0.057142857,0.582857143,0,0.026685297
16749,120,22792,2,9,2,2,4,19,10,10,0,0,0,20,nowin,loss,beat,dlwin,0,10,11,202,0.440594059,0.034653465,0.618811881,2,0.614441029
16750,34,22792,10,2,0,10,0,22,10,10,0,0,0,20,nowin,loss,bust,plbust,0,10,12,202,0.5,0.079207921,0.618811881,3,0.968961434
16751,63,22792,10,10,0,0,0,20,10,10,0,0,0,20,nowin,push,push,push,10,0,20,216,0.467592593,0.037037037,0.62037037,3,0.931690496
16752,79,22793,10,10,0,0,0,20,9,10,0,0,0,19,nowin,win,plwin,beat,20,0,20,211,0.436018957,0.028436019,0.672985782,2,0.650131054
16753,133,22793,9,11,0,0,0,20,9,10,0,0,0,19,nowin,win,plwin,beat,20,0,20,201,0.47761194,0.064676617,0.611940299,3,0.935428111
16754,84,22793,5,6,10,0,0,21,9,10,0,0,0,19,nowin,win,plwin,beat,20,0,11,195,0.379487179,0.056410256,0.569230769,0,0.017209119
16755,35,22793,5,8,0,7,0,20,9,10,0,0,0,19,nowin,win,plwin,beat,20,0,13,202,0.410891089,0.044554455,0.633663366,2,0.598681573
16756,100,22793,4,10,0,9,0,23,9,10,0,0,0,19,nowin,loss,bust,plbust,0,10,14,190,0.452631579,0.036842105,0.594736842,3,0.888671154
16757,89,22793,9,8,0,0,0,17,9,10,0,0,0,19,nowin,loss,beat,dlwin,0,10,17,212,0.537735849,0.047169811,0.594339623,3,0.990167191
16758,135,22794,7,6,0,9,0,22,10,4,1,8,0,23,nowin,loss,bust,plbust,0,10,13,179,0.391061453,0.067039106,0.586592179,0,0.024924662
16759,96,22794,7,10,0,0,0,17,10,4,1,8,0,23,nowin,win,dlbust,bust,20,0,17,190,0.468421053,0.057894737,0.584210526,3,0.897263354
16760,139,22794,5,1,10,5,0,21,10,4,1,8,0,23,nowin,win,dlbust,bust,20,0,6,192,0.380208333,0.036458333,0.59375,0,0.023429169
16761,28,22794,10,4,0,1,1,16,10,4,1,8,0,23,nowin,win,dlbust,bust,20,0,14,199,0.422110553,0.045226131,0.542713568,1,0.282706618
16762,55,22794,6,5,7,0,0,18,10,4,1,8,0,23,nowin,win,dlbust,bust,20,0,11,191,0.371727749,0.057591623,0.54973822,0,0.01011347
16763,129,22794,8,10,0,0,0,18,10,4,1,8,0,23,nowin,win,dlbust,bust,20,0,18,201,0.422885572,0.064676617,0.55721393,0,0.027255383
16764,12,22795,3,2,6,5,6,22,7,2,3,5,0,17,nowin,loss,bust,plbust,0,10,5,189,0.470899471,0.015873016,0.613756614,3,0.929171178
16765,16,22795,10,6,0,6,0,22,7,2,3,5,0,17,nowin,loss,bust,plbust,0,10,16,220,0.427272727,0.081818182,0.6,2,0.588660176
16766,108,22795,11,6,3,0,0,20,7,2,3,5,0,17,nowin,win,plwin,beat,20,0,17,193,0.435233161,0.056994819,0.559585492,1,0.298824795
16767,17,22795,10,11,0,0,0,21,7,2,3,5,0,17,win,win,plwin,beat,25,0,21,171,0.444444444,0.070175439,0.555555556,1,0.302364894
16768,14,22795,7,9,0,10,0,26,7,2,3,5,0,17,nowin,loss,bust,plbust,0,10,16,202,0.391089109,0.01980198,0.628712871,2,0.577264877
16769,31,22795,5,10,0,7,0,22,7,2,3,5,0,17,nowin,loss,bust,plbust,0,10,15,188,0.473404255,0.058510638,0.515957447,1,0.300306557
16770,111,22796,6,8,0,0,0,14,3,5,10,0,0,18,nowin,loss,beat,dlwin,0,10,14,180,0.433333333,0.055555556,0.611111111,2,0.602264492
16771,118,22796,2,2,2,2,2,10,3,5,10,0,0,18,nowin,loss,beat,dlwin,0,10,4,216,0.393518519,0.037037037,0.555555556,0,0.018059873
16772,88,22796,10,10,0,0,0,20,3,5,10,0,0,18,nowin,win,plwin,beat,20,0,20,206,0.466019417,0.033980583,0.54368932,1,0.309467903
16773,28,22796,10,9,0,0,0,19,3,5,10,0,0,18,nowin,win,plwin,beat,20,0,19,199,0.422110553,0.045226131,0.542713568,1,0.282706618
16774,77,22796,9,11,0,0,0,20,3,5,10,0,0,18,nowin,win,plwin,beat,20,0,20,200,0.455,0.04,0.62,3,0.916252116
16775,38,22796,6,9,0,0,0,15,3,5,10,0,0,18,nowin,loss,beat,dlwin,0,10,15,202,0.361386139,0.03960396,0.564356436,0,0.010597953
16776,117,22797,4,10,0,0,0,14,4,10,1,3,0,18,nowin,loss,beat,dlwin,0,10,14,173,0.410404624,0.069364162,0.606936416,2,0.578610282
16777,21,22797,8,11,0,0,0,19,4,10,1,3,0,18,nowin,win,plwin,beat,20,0,19,214,0.359813084,0.042056075,0.626168224,0,0.025263474
16778,8,22797,5,7,0,0,0,12,4,10,1,3,0,18,nowin,loss,beat,dlwin,0,10,12,181,0.44198895,0.071823204,0.596685083,2,0.599438402
16779,107,22797,7,10,0,0,0,17,4,10,1,3,0,18,nowin,loss,beat,dlwin,0,10,17,218,0.444954128,0.073394495,0.600917431,2,0.605210014
16780,100,22797,6,10,0,0,0,16,4,10,1,3,0,18,nowin,loss,beat,dlwin,0,10,16,190,0.452631579,0.036842105,0.594736842,3,0.888671154
16781,50,22797,5,9,0,0,0,14,4,10,1,3,0,18,nowin,loss,beat,dlwin,0,10,14,202,0.405940594,0.04950495,0.54950495,0,0.020296079
16782,142,22798,3,5,8,0,0,16,5,10,10,0,0,25,nowin,win,dlbust,bust,20,0,8,211,0.417061611,0.047393365,0.526066351,1,0.271531309
16783,125,22798,8,9,0,0,0,17,5,10,10,0,0,25,nowin,win,dlbust,bust,20,0,17,219,0.438356164,0.050228311,0.575342466,1,0.308411257
16784,78,22798,3,11,5,0,0,19,5,10,10,0,0,25,nowin,win,dlbust,bust,20,0,14,201,0.517412935,0.034825871,0.587064677,3,0.95871112
16785,71,22798,4,2,6,0,0,12,5,10,10,0,0,25,nowin,win,dlbust,bust,20,0,6,193,0.352331606,0.046632124,0.585492228,0,0.013063661
16786,150,22798,2,9,10,0,0,21,5,10,10,0,0,25,nowin,win,dlbust,bust,20,0,11,192,0.401041667,0.036458333,0.567708333,0,0.023287458
16787,55,22798,6,4,6,0,0,16,5,10,10,0,0,25,nowin,win,dlbust,bust,20,0,10,191,0.371727749,0.057591623,0.54973822,0,0.01011347
16788,58,22799,10,9,0,0,0,19,4,2,11,0,0,17,nowin,win,plwin,beat,20,0,19,195,0.430769231,0.041025641,0.584615385,2,0.580497586
16789,31,22799,5,10,0,0,0,15,4,2,11,0,0,17,nowin,loss,beat,dlwin,0,10,15,188,0.473404255,0.058510638,0.515957447,1,0.300306557
16790,24,22799,4,10,0,0,0,14,4,2,11,0,0,17,nowin,loss,beat,dlwin,0,10,14,207,0.458937198,0.048309179,0.570048309,1,0.318138014
16791,84,22799,9,10,0,0,0,19,4,2,11,0,0,17,nowin,win,plwin,beat,20,0,19,195,0.379487179,0.056410256,0.569230769,0,0.017209119
16792,51,22799,8,8,0,0,0,16,4,2,11,0,0,17,nowin,loss,beat,dlwin,0,10,16,189,0.529100529,0.068783069,0.608465608,3,0.993665715
16793,15,22799,10,5,0,0,0,15,4,2,11,0,0,17,nowin,loss,beat,dlwin,0,10,15,212,0.410377358,0.051886792,0.561320755,0,0.024517408
16794,14,22800,6,3,6,9,0,24,10,10,0,0,0,20,nowin,loss,bust,plbust,0,10,9,202,0.391089109,0.01980198,0.628712871,2,0.577264877
16795,99,22800,1,6,9,10,0,26,10,10,0,0,0,20,nowin,loss,bust,plbust,0,10,7,207,0.47826087,0.062801932,0.637681159,3,0.961418446
16796,56,22800,8,2,2,10,0,22,10,10,0,0,0,20,nowin,loss,bust,plbust,0,10,10,175,0.4,0.057142857,0.582857143,0,0.026685297
16797,14,22800,7,11,0,0,0,18,10,10,0,0,0,20,nowin,loss,beat,dlwin,0,10,18,202,0.391089109,0.01980198,0.628712871,2,0.577264877
16798,116,22800,4,8,0,10,0,22,10,10,0,0,0,20,nowin,loss,bust,plbust,0,10,12,195,0.425641026,0.056410256,0.538461538,1,0.28273747
16799,48,22800,6,3,6,1,1,17,10,10,0,0,0,20,nowin,loss,beat,dlwin,0,10,9,203,0.413793103,0.019704433,0.600985222,2,0.577280801
16800,28,22801,8,8,0,7,0,23,10,3,9,0,0,22,nowin,loss,bust,plbust,0,10,16,199,0.422110553,0.045226131,0.542713568,1,0.282706618
16801,123,22801,5,9,0,7,0,21,10,3,9,0,0,22,nowin,win,dlbust,bust,20,0,14,205,0.43902439,0.034146341,0.614634146,2,0.609962544
16802,148,22801,10,11,0,0,0,21,10,3,9,0,0,22,win,win,dlbust,bust,25,0,21,204,0.401960784,0.078431373,0.593137255,0,0.029789521
16803,116,22801,8,10,0,0,0,18,10,3,9,0,0,22,nowin,win,dlbust,bust,20,0,18,195,0.425641026,0.056410256,0.538461538,1,0.28273747
16804,124,22801,5,6,8,0,0,19,10,3,9,0,0,22,nowin,win,dlbust,bust,20,0,11,202,0.47029703,0.064356436,0.584158416,3,0.899458193
16805,91,22801,9,2,10,0,0,21,10,3,9,0,0,22,nowin,win,dlbust,bust,20,0,11,194,0.417525773,0.046391753,0.515463918,1,0.266616552
16806,136,22802,6,8,0,10,0,24,10,9,0,0,0,19,nowin,loss,bust,plbust,0,10,14,194,0.396907216,0.025773196,0.597938144,0,0.029452644
16807,148,22802,5,3,10,0,0,18,10,9,0,0,0,19,nowin,loss,beat,dlwin,0,10,8,204,0.401960784,0.078431373,0.593137255,0,0.029789521
16808,51,22802,10,2,0,2,2,16,10,9,0,0,0,19,nowin,loss,beat,dlwin,0,10,12,189,0.529100529,0.068783069,0.608465608,3,0.993665715
16809,1,22802,10,10,0,0,0,20,10,9,0,0,0,19,nowin,win,plwin,beat,20,0,20,197,0.406091371,0.025380711,0.649746193,2,0.606186955
16810,121,22802,2,9,6,0,0,17,10,9,0,0,0,19,nowin,loss,beat,dlwin,0,10,11,195,0.456410256,0.025641026,0.512820513,1,0.288597791
16811,29,22802,4,6,10,0,0,20,10,9,0,0,0,19,nowin,win,plwin,beat,20,0,10,189,0.44973545,0.058201058,0.544973545,1,0.300349439
16812,16,22803,4,9,0,6,0,19,9,10,0,0,0,19,nowin,push,push,push,10,0,13,220,0.427272727,0.081818182,0.6,2,0.588660176
16813,82,22803,10,9,0,0,0,19,9,10,0,0,0,19,nowin,push,push,push,10,0,19,225,0.408888889,0.075555556,0.577777778,0,0.028101874
16814,81,22803,7,10,0,0,0,17,9,10,0,0,0,19,nowin,loss,beat,dlwin,0,10,17,182,0.395604396,0.043956044,0.60989011,2,0.567491261
16815,17,22803,6,9,0,4,0,19,9,10,0,0,0,19,nowin,push,push,push,10,0,15,171,0.444444444,0.070175439,0.555555556,1,0.302364894
16816,133,22803,10,10,0,0,0,20,9,10,0,0,0,19,nowin,win,plwin,beat,20,0,20,201,0.47761194,0.064676617,0.611940299,3,0.935428111
16817,122,22803,10,5,0,9,0,24,9,10,0,0,0,19,nowin,loss,bust,plbust,0,10,15,210,0.347619048,0.052380952,0.59047619,0,0.012873677
16818,83,22804,10,6,0,1,0,17,9,3,9,0,0,21,nowin,loss,beat,dlwin,0,10,16,193,0.424870466,0.051813472,0.678756477,2,0.644360335
16819,3,22804,10,11,0,0,0,21,9,3,9,0,0,21,win,push,push,push,10,0,21,190,0.431578947,0.026315789,0.542105263,1,0.288076384
16820,139,22804,3,9,0,9,0,21,9,3,9,0,0,21,nowin,push,push,push,10,0,12,192,0.380208333,0.036458333,0.59375,0,0.023429169
16821,97,22804,10,5,0,5,0,20,9,3,9,0,0,21,nowin,loss,beat,dlwin,0,10,15,182,0.450549451,0.06043956,0.692307692,2,0.677372279
16822,80,22804,11,8,0,0,0,19,9,3,9,0,0,21,nowin,loss,beat,dlwin,0,10,19,186,0.419354839,0.059139785,0.623655914,2,0.59892924
16823,53,22804,7,10,0,0,0,17,9,3,9,0,0,21,nowin,loss,beat,dlwin,0,10,17,250,0.372,0.064,0.564,0,0.013687345
16824,142,22805,11,10,0,0,0,21,9,9,0,0,0,18,win,win,plwin,beat,25,0,21,211,0.417061611,0.047393365,0.526066351,1,0.271531309
16825,111,22805,4,2,8,10,0,24,9,9,0,0,0,18,nowin,loss,bust,plbust,0,10,6,180,0.433333333,0.055555556,0.611111111,2,0.602264492
16826,150,22805,10,5,0,8,0,23,9,9,0,0,0,18,nowin,loss,bust,plbust,0,10,15,192,0.401041667,0.036458333,0.567708333,0,0.023287458
16827,91,22805,4,10,0,10,0,24,9,9,0,0,0,18,nowin,loss,bust,plbust,0,10,14,194,0.417525773,0.046391753,0.515463918,1,0.266616552
16828,129,22805,6,2,9,0,0,17,9,9,0,0,0,18,nowin,loss,beat,dlwin,0,10,8,201,0.422885572,0.064676617,0.55721393,0,0.027255383
16829,132,22805,5,4,5,10,0,24,9,9,0,0,0,18,nowin,loss,bust,plbust,0,10,9,194,0.412371134,0.036082474,0.649484536,2,0.611633238
16830,101,22806,4,3,9,0,0,16,4,3,8,2,0,17,nowin,loss,beat,dlwin,0,10,7,205,0.424390244,0.068292683,0.63902439,2,0.614740646
16831,147,22806,4,10,0,0,0,14,4,3,8,2,0,17,nowin,loss,beat,dlwin,0,10,14,205,0.380487805,0.014634146,0.536585366,0,0.00951447
16832,148,22806,4,2,2,4,0,12,4,3,8,2,0,17,nowin,loss,beat,dlwin,0,10,6,204,0.401960784,0.078431373,0.593137255,0,0.029789521
16833,22,22806,9,10,0,0,0,19,4,3,8,2,0,17,nowin,win,plwin,beat,20,0,19,187,0.481283422,0.042780749,0.577540107,3,0.906128176
16834,10,22806,10,7,0,0,0,17,4,3,8,2,0,17,nowin,push,push,push,10,0,17,191,0.413612565,0.057591623,0.596858639,2,0.574087175
16835,6,22806,10,9,0,0,0,19,4,3,8,2,0,17,nowin,win,plwin,beat,20,0,19,191,0.439790576,0.047120419,0.581151832,1,0.31211505
16836,75,22807,3,10,0,8,0,21,11,10,0,0,0,21,nowin,push,push,push,10,0,13,191,0.418848168,0.052356021,0.570680628,0,0.029344702
16837,49,22807,10,9,0,0,0,19,11,10,0,0,0,21,nowin,loss,beat,dlwin,0,10,19,207,0.396135266,0.053140097,0.594202899,0,0.028306925
16838,53,22807,11,10,0,0,0,21,11,10,0,0,0,21,win,push,push,push,10,0,21,250,0.372,0.064,0.564,0,0.013687345
16839,35,22807,9,11,0,0,0,20,11,10,0,0,0,21,nowin,loss,beat,dlwin,0,10,20,202,0.410891089,0.044554455,0.633663366,2,0.598681573
16840,107,22807,10,3,0,2,7,22,11,10,0,0,0,21,nowin,loss,bust,plbust,0,10,13,218,0.444954128,0.073394495,0.600917431,2,0.605210014
16841,103,22807,10,10,0,0,0,20,11,10,0,0,0,21,nowin,loss,beat,dlwin,0,10,20,203,0.379310345,0.064039409,0.551724138,0,0.012869209
16842,55,22808,4,6,3,0,0,13,5,5,4,3,0,17,nowin,loss,beat,dlwin,0,10,10,191,0.371727749,0.057591623,0.54973822,0,0.01011347
16843,123,22808,5,3,10,0,0,18,5,5,4,3,0,17,nowin,win,plwin,beat,20,0,8,205,0.43902439,0.034146341,0.614634146,2,0.609962544
16844,13,22808,4,7,10,0,0,21,5,5,4,3,0,17,nowin,win,plwin,beat,20,0,11,206,0.417475728,0.063106796,0.621359223,2,0.59555479
16845,99,22808,6,4,2,0,0,12,5,5,4,3,0,17,nowin,loss,beat,dlwin,0,10,10,207,0.47826087,0.062801932,0.637681159,3,0.961418446
16846,117,22808,10,10,0,0,0,20,5,5,4,3,0,17,nowin,win,plwin,beat,20,0,20,173,0.410404624,0.069364162,0.606936416,2,0.578610282
16847,116,22808,3,6,10,0,0,19,5,5,4,3,0,17,nowin,win,plwin,beat,20,0,9,195,0.425641026,0.056410256,0.538461538,1,0.28273747
16848,124,22809,9,2,2,8,0,21,10,10,0,0,0,20,nowin,win,plwin,beat,20,0,11,202,0.47029703,0.064356436,0.584158416,3,0.899458193
16849,35,22809,9,3,0,7,0,19,10,10,0,0,0,20,nowin,loss,beat,dlwin,0,10,12,202,0.410891089,0.044554455,0.633663366,2,0.598681573
16850,145,22809,1,4,10,9,0,24,10,10,0,0,0,20,nowin,loss,bust,plbust,0,10,5,188,0.441489362,0.031914894,0.622340426,2,0.617837093
16851,71,22809,3,3,3,5,5,19,10,10,0,0,0,20,nowin,loss,beat,dlwin,0,10,6,193,0.352331606,0.046632124,0.585492228,0,0.013063661
16852,66,22809,3,10,0,6,0,19,10,10,0,0,0,20,nowin,loss,beat,dlwin,0,10,13,217,0.456221198,0.064516129,0.626728111,3,0.924304367
16853,126,22809,8,10,0,0,0,18,10,10,0,0,0,20,nowin,loss,beat,dlwin,0,10,18,188,0.457446809,0.074468085,0.60106383,3,0.900633203
16854,38,22810,10,10,0,0,0,20,10,10,0,0,0,20,nowin,push,push,push,10,0,20,202,0.361386139,0.03960396,0.564356436,0,0.010597953
16855,131,22810,6,10,0,3,0,19,10,10,0,0,0,20,nowin,loss,beat,dlwin,0,10,16,217,0.410138249,0.069124424,0.543778802,0,0.02015021
16856,108,22810,1,6,5,8,0,20,10,10,0,0,0,20,nowin,push,push,push,10,0,7,193,0.435233161,0.056994819,0.559585492,1,0.298824795
16857,27,22810,10,10,0,0,0,20,10,10,0,0,0,20,nowin,push,push,push,10,0,20,178,0.370786517,0.016853933,0.573033708,0,0.015536309
16858,69,22810,6,10,0,8,0,24,10,10,0,0,0,20,nowin,loss,bust,plbust,0,10,16,194,0.365979381,0.030927835,0.515463918,0,0
16859,145,22810,7,7,0,7,0,21,10,10,0,0,0,20,nowin,win,plwin,beat,20,0,14,188,0.441489362,0.031914894,0.622340426,2,0.617837093
16860,136,22811,7,10,0,0,0,17,8,4,7,0,0,19,nowin,loss,beat,dlwin,0,10,17,194,0.396907216,0.025773196,0.597938144,0,0.029452644
16861,18,22811,10,10,0,0,0,20,8,4,7,0,0,19,nowin,win,plwin,beat,20,0,20,182,0.461538462,0.043956044,0.587912088,3,0.892649374
16862,69,22811,8,4,0,6,0,18,8,4,7,0,0,19,nowin,loss,beat,dlwin,0,10,12,194,0.365979381,0.030927835,0.515463918,0,0
16863,137,22811,10,3,0,2,10,25,8,4,7,0,0,19,nowin,loss,bust,plbust,0,10,13,194,0.417525773,0.046391753,0.536082474,1,0.276714602
16864,81,22811,1,3,10,10,0,24,8,4,7,0,0,19,nowin,loss,bust,plbust,0,10,4,182,0.395604396,0.043956044,0.60989011,2,0.567491261
16865,70,22811,10,8,0,0,0,18,8,4,7,0,0,19,nowin,loss,beat,dlwin,0,10,18,228,0.385964912,0.039473684,0.557017544,0,0.016157125
16866,60,22812,10,7,0,0,0,17,10,10,0,0,0,20,nowin,loss,beat,dlwin,0,10,17,227,0.418502203,0.022026432,0.559471366,0,0.026496258
16867,129,22812,4,7,4,10,0,25,10,10,0,0,0,20,nowin,loss,bust,plbust,0,10,11,201,0.422885572,0.064676617,0.55721393,0,0.027255383
16868,127,22812,10,10,0,0,0,20,10,10,0,0,0,20,nowin,push,push,push,10,0,20,201,0.402985075,0.029850746,0.60199005,0,0.032263937
16869,30,22812,9,10,0,0,0,19,10,10,0,0,0,20,nowin,loss,beat,dlwin,0,10,19,206,0.393203883,0.033980583,0.601941748,0,0.029324648
16870,130,22812,10,4,0,8,0,22,10,10,0,0,0,20,nowin,loss,bust,plbust,0,10,14,219,0.410958904,0.03652968,0.566210046,0,0.025888739
16871,98,22812,5,9,0,10,0,24,10,10,0,0,0,20,nowin,loss,bust,plbust,0,10,14,220,0.422727273,0.054545455,0.55,1,0.28664435
16872,22,22813,10,10,0,0,0,20,9,10,0,0,0,19,nowin,win,plwin,beat,20,0,20,187,0.481283422,0.042780749,0.577540107,3,0.906128176
16873,44,22813,10,3,0,10,0,23,9,10,0,0,0,19,nowin,loss,bust,plbust,0,10,13,219,0.433789954,0.050228311,0.534246575,1,0.285551035
16874,102,22813,4,1,10,9,0,24,9,10,0,0,0,19,nowin,loss,bust,plbust,0,10,5,192,0.338541667,0.046875,0.5625,0,0.003306118
16875,8,22813,7,8,0,10,0,25,9,10,0,0,0,19,nowin,loss,bust,plbust,0,10,15,181,0.44198895,0.071823204,0.596685083,2,0.599438402
16876,82,22813,4,10,0,1,10,25,9,10,0,0,0,19,nowin,loss,bust,plbust,0,10,14,225,0.408888889,0.075555556,0.577777778,0,0.028101874
16877,122,22813,4,8,0,4,6,22,9,10,0,0,0,19,nowin,loss,bust,plbust,0,10,12,210,0.347619048,0.052380952,0.59047619,0,0.012873677
16878,49,22814,10,10,0,0,0,20,10,10,0,0,0,20,nowin,push,push,push,10,0,20,207,0.396135266,0.053140097,0.594202899,0,0.028306925
16879,94,22814,10,4,0,10,0,24,10,10,0,0,0,20,nowin,loss,bust,plbust,0,10,14,183,0.43715847,0.043715847,0.540983607,1,0.290866892
16880,13,22814,4,3,10,0,0,17,10,10,0,0,0,20,nowin,loss,beat,dlwin,0,10,7,206,0.417475728,0.063106796,0.621359223,2,0.59555479
16881,74,22814,7,7,0,5,0,19,10,10,0,0,0,20,nowin,loss,beat,dlwin,0,10,14,209,0.411483254,0.04784689,0.531100478,0,0.017448125
16882,148,22814,9,8,0,0,0,17,10,10,0,0,0,20,nowin,loss,beat,dlwin,0,10,17,204,0.401960784,0.078431373,0.593137255,0,0.029789521
16883,75,22814,10,11,0,0,0,21,10,10,0,0,0,20,win,win,plwin,beat,25,0,21,191,0.418848168,0.052356021,0.570680628,0,0.029344702
16884,26,22815,9,8,0,0,0,17,9,10,0,0,0,19,nowin,loss,beat,dlwin,0,10,17,203,0.463054187,0.0591133,0.541871921,1,0.306802864
16885,120,22815,10,10,0,0,0,20,9,10,0,0,0,19,nowin,win,plwin,beat,20,0,20,202,0.440594059,0.034653465,0.618811881,2,0.614441029
16886,67,22815,4,5,10,0,0,19,9,10,0,0,0,19,nowin,push,push,push,10,0,9,195,0.369230769,0.041025641,0.569230769,0,0.014139427
16887,9,22815,7,10,0,0,0,17,9,10,0,0,0,19,nowin,loss,beat,dlwin,0,10,17,194,0.37628866,0.015463918,0.541237113,0,0.009396796
16888,21,22815,11,3,4,0,0,18,9,10,0,0,0,19,nowin,loss,beat,dlwin,0,10,14,214,0.359813084,0.042056075,0.626168224,0,0.025263474
16889,122,22815,5,3,10,0,0,18,9,10,0,0,0,19,nowin,loss,beat,dlwin,0,10,8,210,0.347619048,0.052380952,0.59047619,0,0.012873677
16890,95,22816,2,6,9,0,0,17,4,5,9,0,0,18,nowin,loss,beat,dlwin,0,10,8,218,0.412844037,0.04587156,0.559633028,0,0.024842385
16891,40,22816,10,10,0,0,0,20,4,5,9,0,0,18,nowin,win,plwin,beat,20,0,20,196,0.367346939,0.030612245,0.617346939,0,0.025358183
16892,82,22816,11,7,0,0,0,18,4,5,9,0,0,18,nowin,push,push,push,10,0,18,225,0.408888889,0.075555556,0.577777778,0,0.028101874
16893,143,22816,6,10,0,0,0,16,4,5,9,0,0,18,nowin,loss,beat,dlwin,0,10,16,203,0.463054187,0.044334975,0.57635468,3,0.883143365
16894,53,22816,9,10,0,0,0,19,4,5,9,0,0,18,nowin,win,plwin,beat,20,0,19,250,0.372,0.064,0.564,0,0.013687345
16895,122,22816,4,2,10,0,0,16,4,5,9,0,0,18,nowin,loss,beat,dlwin,0,10,6,210,0.347619048,0.052380952,0.59047619,0,0.012873677
16896,10,22817,3,6,10,0,0,19,7,2,10,0,0,19,nowin,push,push,push,10,0,9,191,0.413612565,0.057591623,0.596858639,2,0.574087175
16897,36,22817,9,10,0,0,0,19,7,2,10,0,0,19,nowin,push,push,push,10,0,19,229,0.445414847,0.056768559,0.655021834,2,0.645370571
16898,36,22817,7,6,0,10,0,23,7,2,10,0,0,19,nowin,loss,bust,plbust,0,10,13,229,0.445414847,0.056768559,0.655021834,2,0.645370571
16899,149,22817,11,9,0,0,0,20,7,2,10,0,0,19,nowin,win,plwin,beat,20,0,20,225,0.457777778,0.057777778,0.648888889,2,0.651965595
16900,145,22817,8,8,0,4,0,20,7,2,10,0,0,19,nowin,win,plwin,beat,20,0,16,188,0.441489362,0.031914894,0.622340426,2,0.617837093
16901,64,22817,10,10,0,0,0,20,7,2,10,0,0,19,nowin,win,plwin,beat,20,0,20,187,0.363636364,0.048128342,0.631016043,0,0.027594885
16902,148,22818,3,11,5,0,0,19,10,4,3,0,0,17,nowin,win,plwin,beat,20,0,14,204,0.401960784,0.078431373,0.593137255,0,0.029789521
16903,87,22818,2,10,0,9,0,21,10,4,3,0,0,17,nowin,win,plwin,beat,20,0,12,202,0.405940594,0.054455446,0.628712871,2,0.590599801
16904,131,22818,6,10,0,4,0,20,10,4,3,0,0,17,nowin,win,plwin,beat,20,0,16,217,0.410138249,0.069124424,0.543778802,0,0.02015021
16905,149,22818,4,11,6,0,0,21,10,4,3,0,0,17,nowin,win,plwin,beat,20,0,15,225,0.457777778,0.057777778,0.648888889,2,0.651965595
16906,125,22818,2,1,10,5,0,18,10,4,3,0,0,17,nowin,win,plwin,beat,20,0,3,219,0.438356164,0.050228311,0.575342466,1,0.308411257
16907,5,22818,10,10,0,0,0,20,10,4,3,0,0,17,nowin,win,plwin,beat,20,0,20,203,0.42364532,0.02955665,0.596059113,2,0.582508076
16908,146,22819,10,3,0,2,7,22,7,7,10,0,0,24,nowin,loss,bust,plbust,0,10,13,221,0.43438914,0.040723982,0.542986425,1,0.290190091
16909,70,22819,3,10,0,9,0,22,7,7,10,0,0,24,nowin,loss,bust,plbust,0,10,13,228,0.385964912,0.039473684,0.557017544,0,0.016157125
16910,115,22819,5,7,0,5,0,17,7,7,10,0,0,24,nowin,win,dlbust,bust,20,0,12,194,0.427835052,0.041237113,0.592783505,2,0.583863602
16911,141,22819,3,10,0,4,0,17,7,7,10,0,0,24,nowin,win,dlbust,bust,20,0,13,202,0.420792079,0.074257426,0.564356436,0,0.028377851
16912,86,22819,5,4,8,0,0,17,7,7,10,0,0,24,nowin,win,dlbust,bust,20,0,9,196,0.454081633,0.040816327,0.591836735,3,0.887566443
16913,5,22819,8,6,0,1,10,25,7,7,10,0,0,24,nowin,loss,bust,plbust,0,10,14,203,0.42364532,0.02955665,0.596059113,2,0.582508076
16914,84,22820,10,11,0,0,0,21,10,4,3,0,0,17,win,win,plwin,beat,25,0,21,195,0.379487179,0.056410256,0.569230769,0,0.017209119
16915,87,22820,7,5,0,10,0,22,10,4,3,0,0,17,nowin,loss,bust,plbust,0,10,12,202,0.405940594,0.054455446,0.628712871,2,0.590599801
16916,99,22820,9,11,0,0,0,20,10,4,3,0,0,17,nowin,win,plwin,beat,20,0,20,207,0.47826087,0.062801932,0.637681159,3,0.961418446
16917,104,22820,3,2,11,9,0,25,10,4,3,0,0,17,nowin,loss,bust,plbust,0,10,5,209,0.363636364,0.052631579,0.593301435,0,0.018359419
16918,103,22820,10,6,0,10,0,26,10,4,3,0,0,17,nowin,loss,bust,plbust,0,10,16,203,0.379310345,0.064039409,0.551724138,0,0.012869209
16919,60,22820,7,10,0,0,0,17,10,4,3,0,0,17,nowin,push,push,push,10,0,17,227,0.418502203,0.022026432,0.559471366,0,0.026496258
16920,68,22821,8,11,0,0,0,19,2,7,2,5,9,25,nowin,win,dlbust,bust,20,0,19,205,0.434146341,0.029268293,0.6,2,0.59483189
16921,45,22821,5,10,0,0,0,15,2,7,2,5,9,25,nowin,win,dlbust,bust,20,0,15,196,0.428571429,0.051020408,0.612244898,2,0.598821767
16922,20,22821,3,7,11,0,0,21,2,7,2,5,9,25,nowin,win,dlbust,bust,20,0,10,186,0.456989247,0.037634409,0.537634409,1,0.301097108
16923,115,22821,10,2,0,2,0,14,2,7,2,5,9,25,nowin,win,dlbust,bust,20,0,12,194,0.427835052,0.041237113,0.592783505,2,0.583863602
16924,96,22821,6,10,0,0,0,16,2,7,2,5,9,25,nowin,win,dlbust,bust,20,0,16,190,0.468421053,0.057894737,0.584210526,3,0.897263354
16925,116,22821,6,8,0,0,0,14,2,7,2,5,9,25,nowin,win,dlbust,bust,20,0,14,195,0.425641026,0.056410256,0.538461538,1,0.28273747
16926,89,22822,7,8,0,9,0,24,10,8,0,0,0,18,nowin,loss,bust,plbust,0,10,15,212,0.537735849,0.047169811,0.594339623,3,0.990167191
16927,118,22822,10,9,0,0,0,19,10,8,0,0,0,18,nowin,win,plwin,beat,20,0,19,216,0.393518519,0.037037037,0.555555556,0,0.018059873
16928,96,22822,7,11,0,0,0,18,10,8,0,0,0,18,nowin,push,push,push,10,0,18,190,0.468421053,0.057894737,0.584210526,3,0.897263354
16929,21,22822,10,8,0,0,0,18,10,8,0,0,0,18,nowin,push,push,push,10,0,18,214,0.359813084,0.042056075,0.626168224,0,0.025263474
16930,117,22822,6,10,0,10,0,26,10,8,0,0,0,18,nowin,loss,bust,plbust,0,10,16,173,0.410404624,0.069364162,0.606936416,2,0.578610282
16931,69,22822,6,10,0,3,0,19,10,8,0,0,0,18,nowin,win,plwin,beat,20,0,16,194,0.365979381,0.030927835,0.515463918,0,0
16932,52,22823,10,3,0,0,0,13,4,1,7,8,0,20,nowin,loss,beat,dlwin,0,10,13,217,0.414746544,0.02764977,0.599078341,2,0.576736024
16933,113,22823,10,8,0,0,0,18,4,1,7,8,0,20,nowin,loss,beat,dlwin,0,10,18,199,0.407035176,0.055276382,0.668341709,2,0.620695264
16934,143,22823,10,10,0,0,0,20,4,1,7,8,0,20,nowin,push,push,push,10,0,20,203,0.463054187,0.044334975,0.57635468,3,0.883143365
16935,61,22823,10,10,0,0,0,20,4,1,7,8,0,20,nowin,push,push,push,10,0,20,194,0.427835052,0.077319588,0.603092784,2,0.591437139
16936,28,22823,3,10,0,0,0,13,4,1,7,8,0,20,nowin,loss,beat,dlwin,0,10,13,199,0.422110553,0.045226131,0.542713568,1,0.282706618
16937,150,22823,10,10,0,0,0,20,4,1,7,8,0,20,nowin,push,push,push,10,0,20,192,0.401041667,0.036458333,0.567708333,0,0.023287458
16938,27,22824,6,6,0,4,10,26,10,8,0,0,0,18,nowin,loss,bust,plbust,0,10,12,178,0.370786517,0.016853933,0.573033708,0,0.015536309
16939,98,22824,8,4,0,10,0,22,10,8,0,0,0,18,nowin,loss,bust,plbust,0,10,12,220,0.422727273,0.054545455,0.55,1,0.28664435
16940,73,22824,10,9,0,0,0,19,10,8,0,0,0,18,nowin,win,plwin,beat,20,0,19,181,0.375690608,0.011049724,0.596685083,0,0.022795773
16941,32,22824,2,10,0,6,0,18,10,8,0,0,0,18,nowin,push,push,push,10,0,12,189,0.391534392,0.037037037,0.53968254,0,0.013579086
16942,72,22824,4,10,0,8,0,22,10,8,0,0,0,18,nowin,loss,bust,plbust,0,10,14,185,0.394594595,0.032432432,0.508108108,0,0.006763115
16943,39,22824,2,10,0,1,10,23,10,8,0,0,0,18,nowin,loss,bust,plbust,0,10,12,191,0.429319372,0.062827225,0.57591623,0,0.033760763
16944,75,22825,10,10,0,0,0,20,6,5,5,6,0,22,nowin,win,dlbust,bust,20,0,20,191,0.418848168,0.052356021,0.570680628,0,0.029344702
16945,64,22825,1,6,5,0,0,12,6,5,5,6,0,22,nowin,win,dlbust,bust,20,0,7,187,0.363636364,0.048128342,0.631016043,0,0.027594885
16946,8,22825,9,7,0,0,0,16,6,5,5,6,0,22,nowin,win,dlbust,bust,20,0,16,181,0.44198895,0.071823204,0.596685083,2,0.599438402
16947,68,22825,10,10,0,0,0,20,6,5,5,6,0,22,nowin,win,dlbust,bust,20,0,20,205,0.434146341,0.029268293,0.6,2,0.59483189
16948,38,22825,5,4,6,0,0,15,6,5,5,6,0,22,nowin,win,dlbust,bust,20,0,9,202,0.361386139,0.03960396,0.564356436,0,0.010597953
16949,124,22825,11,10,0,0,0,21,6,5,5,6,0,22,win,win,dlbust,bust,25,0,21,202,0.47029703,0.064356436,0.584158416,3,0.899458193
16950,144,22826,3,2,3,6,0,14,3,9,1,4,0,17,nowin,loss,beat,dlwin,0,10,5,202,0.386138614,0.054455446,0.564356436,0,0.018006244
16951,127,22826,3,7,11,0,0,21,3,9,1,4,0,17,nowin,win,plwin,beat,20,0,10,201,0.402985075,0.029850746,0.60199005,0,0.032263937
16952,102,22826,7,10,0,0,0,17,3,9,1,4,0,17,nowin,push,push,push,10,0,17,192,0.338541667,0.046875,0.5625,0,0.003306118
16953,147,22826,2,10,0,10,0,22,3,9,1,4,0,17,nowin,loss,bust,plbust,0,10,12,205,0.380487805,0.014634146,0.536585366,0,0.00951447
16954,125,22826,2,8,7,0,0,17,3,9,1,4,0,17,nowin,push,push,push,10,0,10,219,0.438356164,0.050228311,0.575342466,1,0.308411257
16955,57,22826,4,2,5,7,0,18,3,9,1,4,0,17,nowin,win,plwin,beat,20,0,6,192,0.46875,0.052083333,0.59375,3,0.907001181
16956,74,22827,8,7,0,2,0,17,10,6,10,0,0,26,nowin,win,dlbust,bust,20,0,15,209,0.411483254,0.04784689,0.531100478,0,0.017448125
16957,132,22827,2,10,0,4,8,24,10,6,10,0,0,26,nowin,loss,bust,plbust,0,10,12,194,0.412371134,0.036082474,0.649484536,2,0.611633238
16958,129,22827,10,11,0,0,0,21,10,6,10,0,0,26,win,win,dlbust,bust,25,0,21,201,0.422885572,0.064676617,0.55721393,0,0.027255383
16959,100,22827,2,2,2,10,6,22,10,6,10,0,0,26,nowin,loss,bust,plbust,0,10,4,190,0.452631579,0.036842105,0.594736842,3,0.888671154
16960,30,22827,3,7,7,0,0,17,10,6,10,0,0,26,nowin,win,dlbust,bust,20,0,10,206,0.393203883,0.033980583,0.601941748,0,0.029324648
16961,56,22827,8,3,7,0,0,18,10,6,10,0,0,26,nowin,win,dlbust,bust,20,0,11,175,0.4,0.057142857,0.582857143,0,0.026685297
16962,49,22828,10,6,0,0,0,16,6,8,7,0,0,21,nowin,loss,beat,dlwin,0,10,16,207,0.396135266,0.053140097,0.594202899,0,0.028306925
16963,120,22828,3,6,8,0,0,17,6,8,7,0,0,21,nowin,loss,beat,dlwin,0,10,9,202,0.440594059,0.034653465,0.618811881,2,0.614441029
16964,63,22828,3,5,4,0,0,12,6,8,7,0,0,21,nowin,loss,beat,dlwin,0,10,8,216,0.467592593,0.037037037,0.62037037,3,0.931690496
16965,2,22828,5,9,0,0,0,14,6,8,7,0,0,21,nowin,loss,beat,dlwin,0,10,14,200,0.445,0.035,0.64,2,0.633962549
16966,128,22828,10,10,0,0,0,20,6,8,7,0,0,21,nowin,loss,beat,dlwin,0,10,20,227,0.356828194,0.052863436,0.577092511,0,0.012352564
16967,134,22828,2,2,10,0,0,14,6,8,7,0,0,21,nowin,loss,beat,dlwin,0,10,4,185,0.443243243,0.021621622,0.545945946,1,0.296939509
16968,77,22829,10,3,0,0,0,13,5,7,9,0,0,21,nowin,loss,beat,dlwin,0,10,13,200,0.455,0.04,0.62,3,0.916252116
16969,11,22829,6,4,3,0,0,13,5,7,9,0,0,21,nowin,loss,beat,dlwin,0,10,10,236,0.457627119,0.016949153,0.588983051,3,0.889015813
16970,75,22829,10,10,0,0,0,20,5,7,9,0,0,21,nowin,loss,beat,dlwin,0,10,20,191,0.418848168,0.052356021,0.570680628,0,0.029344702
16971,87,22829,3,10,0,0,0,13,5,7,9,0,0,21,nowin,loss,beat,dlwin,0,10,13,202,0.405940594,0.054455446,0.628712871,2,0.590599801
16972,122,22829,5,1,10,0,0,16,5,7,9,0,0,21,nowin,loss,beat,dlwin,0,10,6,210,0.347619048,0.052380952,0.59047619,0,0.012873677
16973,31,22829,5,10,0,0,0,15,5,7,9,0,0,21,nowin,loss,beat,dlwin,0,10,15,188,0.473404255,0.058510638,0.515957447,1,0.300306557
16974,116,22830,7,5,0,0,0,12,4,4,5,4,0,17,nowin,loss,beat,dlwin,0,10,12,195,0.425641026,0.056410256,0.538461538,1,0.28273747
16975,76,22830,2,10,0,0,0,12,4,4,5,4,0,17,nowin,loss,beat,dlwin,0,10,12,189,0.534391534,0.079365079,0.608465608,3,1
16976,88,22830,6,9,0,0,0,15,4,4,5,4,0,17,nowin,loss,beat,dlwin,0,10,15,206,0.466019417,0.033980583,0.54368932,1,0.309467903
16977,72,22830,9,10,0,0,0,19,4,4,5,4,0,17,nowin,win,plwin,beat,20,0,19,185,0.394594595,0.032432432,0.508108108,0,0.006763115
16978,4,22830,10,6,0,0,0,16,4,4,5,4,0,17,nowin,loss,beat,dlwin,0,10,16,217,0.460829493,0.036866359,0.562211982,1,0.315432839
16979,76,22830,9,11,0,0,0,20,4,4,5,4,0,17,nowin,win,plwin,beat,20,0,20,189,0.534391534,0.079365079,0.608465608,3,1
16980,49,22831,10,10,0,0,0,20,3,10,1,10,0,24,nowin,win,dlbust,bust,20,0,20,207,0.396135266,0.053140097,0.594202899,0,0.028306925
16981,50,22831,10,10,0,0,0,20,3,10,1,10,0,24,nowin,win,dlbust,bust,20,0,20,202,0.405940594,0.04950495,0.54950495,0,0.020296079
16982,136,22831,9,4,0,0,0,13,3,10,1,10,0,24,nowin,win,dlbust,bust,20,0,13,194,0.396907216,0.025773196,0.597938144,0,0.029452644
16983,84,22831,2,10,0,7,0,19,3,10,1,10,0,24,nowin,win,dlbust,bust,20,0,12,195,0.379487179,0.056410256,0.569230769,0,0.017209119
16984,6,22831,3,10,0,0,0,13,3,10,1,10,0,24,nowin,win,dlbust,bust,20,0,13,191,0.439790576,0.047120419,0.581151832,1,0.31211505
16985,99,22831,9,6,0,0,0,15,3,10,1,10,0,24,nowin,win,dlbust,bust,20,0,15,207,0.47826087,0.062801932,0.637681159,3,0.961418446
16986,4,22832,9,7,0,0,0,16,5,10,6,0,0,21,nowin,loss,beat,dlwin,0,10,16,217,0.460829493,0.036866359,0.562211982,1,0.315432839
16987,37,22832,2,7,5,0,0,14,5,10,6,0,0,21,nowin,loss,beat,dlwin,0,10,9,208,0.394230769,0.038461538,0.581730769,0,0.024682772
16988,116,22832,5,4,10,0,0,19,5,10,6,0,0,21,nowin,loss,beat,dlwin,0,10,9,195,0.425641026,0.056410256,0.538461538,1,0.28273747
16989,39,22832,10,8,0,0,0,18,5,10,6,0,0,21,nowin,loss,beat,dlwin,0,10,18,191,0.429319372,0.062827225,0.57591623,0,0.033760763
16990,38,22832,11,1,3,0,0,15,5,10,6,0,0,21,nowin,loss,beat,dlwin,0,10,12,202,0.361386139,0.03960396,0.564356436,0,0.010597953
16991,15,22832,6,10,0,0,0,16,5,10,6,0,0,21,nowin,loss,beat,dlwin,0,10,16,212,0.410377358,0.051886792,0.561320755,0,0.024517408
16992,119,22833,4,10,0,0,0,14,4,8,7,0,0,19,nowin,loss,beat,dlwin,0,10,14,190,0.405263158,0.068421053,0.515789474,0,0.011837158
16993,37,22833,4,9,0,0,0,13,4,8,7,0,0,19,nowin,loss,beat,dlwin,0,10,13,208,0.394230769,0.038461538,0.581730769,0,0.024682772
16994,150,22833,10,10,0,0,0,20,4,8,7,0,0,19,nowin,win,plwin,beat,20,0,20,192,0.401041667,0.036458333,0.567708333,0,0.023287458
16995,20,22833,7,5,0,0,0,12,4,8,7,0,0,19,nowin,loss,beat,dlwin,0,10,12,186,0.456989247,0.037634409,0.537634409,1,0.301097108
16996,147,22833,10,10,0,0,0,20,4,8,7,0,0,19,nowin,win,plwin,beat,20,0,20,205,0.380487805,0.014634146,0.536585366,0,0.00951447
16997,13,22833,11,10,0,0,0,21,4,8,7,0,0,19,win,win,plwin,beat,25,0,21,206,0.417475728,0.063106796,0.621359223,2,0.59555479
16998,89,22834,10,9,0,0,0,19,5,10,10,0,0,25,nowin,win,dlbust,bust,20,0,19,212,0.537735849,0.047169811,0.594339623,3,0.990167191
16999,94,22834,11,10,0,0,0,21,5,10,10,0,0,25,win,win,dlbust,bust,25,0,21,183,0.43715847,0.043715847,0.540983607,1,0.290866892
17000,130,22834,4,7,8,0,0,19,5,10,10,0,0,25,nowin,win,dlbust,bust,20,0,11,219,0.410958904,0.03652968,0.566210046,0,0.025888739
17001,138,22834,11,5,3,0,0,19,5,10,10,0,0,25,nowin,win,dlbust,bust,20,0,16,190,0.442105263,0.047368421,0.610526316,2,0.609711065
17002,3,22834,10,7,0,0,0,17,5,10,10,0,0,25,nowin,win,dlbust,bust,20,0,17,190,0.431578947,0.026315789,0.542105263,1,0.288076384
17003,91,22834,8,7,0,0,0,15,5,10,10,0,0,25,nowin,win,dlbust,bust,20,0,15,194,0.417525773,0.046391753,0.515463918,1,0.266616552
17004,24,22835,10,4,0,5,0,19,10,10,0,0,0,20,nowin,loss,beat,dlwin,0,10,14,207,0.458937198,0.048309179,0.570048309,1,0.318138014
17005,143,22835,7,8,0,6,0,21,10,10,0,0,0,20,nowin,win,plwin,beat,20,0,15,203,0.463054187,0.044334975,0.57635468,3,0.883143365
17006,60,22835,10,4,0,3,0,17,10,10,0,0,0,20,nowin,loss,beat,dlwin,0,10,14,227,0.418502203,0.022026432,0.559471366,0,0.026496258
17007,123,22835,2,8,9,0,0,19,10,10,0,0,0,20,nowin,loss,beat,dlwin,0,10,10,205,0.43902439,0.034146341,0.614634146,2,0.609962544
17008,83,22835,7,3,6,8,0,24,10,10,0,0,0,20,nowin,loss,bust,plbust,0,10,10,193,0.424870466,0.051813472,0.678756477,2,0.644360335
17009,94,22835,8,10,0,0,0,18,10,10,0,0,0,20,nowin,loss,beat,dlwin,0,10,18,183,0.43715847,0.043715847,0.540983607,1,0.290866892
17010,1,22836,8,6,0,0,0,14,4,4,10,0,0,18,nowin,loss,beat,dlwin,0,10,14,197,0.406091371,0.025380711,0.649746193,2,0.606186955
17011,126,22836,10,8,0,0,0,18,4,4,10,0,0,18,nowin,push,push,push,10,0,18,188,0.457446809,0.074468085,0.60106383,3,0.900633203
17012,104,22836,10,7,0,0,0,17,4,4,10,0,0,18,nowin,loss,beat,dlwin,0,10,17,209,0.363636364,0.052631579,0.593301435,0,0.018359419
17013,121,22836,4,2,10,0,0,16,4,4,10,0,0,18,nowin,loss,beat,dlwin,0,10,6,195,0.456410256,0.025641026,0.512820513,1,0.288597791
17014,37,22836,8,4,0,0,0,12,4,4,10,0,0,18,nowin,loss,beat,dlwin,0,10,12,208,0.394230769,0.038461538,0.581730769,0,0.024682772
17015,74,22836,10,10,0,0,0,20,4,4,10,0,0,18,nowin,win,plwin,beat,20,0,20,209,0.411483254,0.04784689,0.531100478,0,0.017448125
17016,39,22837,4,11,5,0,0,20,7,8,10,0,0,25,nowin,win,dlbust,bust,20,0,15,191,0.429319372,0.062827225,0.57591623,0,0.033760763
17017,130,22837,10,10,0,0,0,20,7,8,10,0,0,25,nowin,win,dlbust,bust,20,0,20,219,0.410958904,0.03652968,0.566210046,0,0.025888739
17018,112,22837,6,2,4,6,0,18,7,8,10,0,0,25,nowin,win,dlbust,bust,20,0,8,203,0.448275862,0.054187192,0.600985222,3,0.889576933
17019,67,22837,8,6,0,5,0,19,7,8,10,0,0,25,nowin,win,dlbust,bust,20,0,14,195,0.369230769,0.041025641,0.569230769,0,0.014139427
17020,36,22837,10,8,0,0,0,18,7,8,10,0,0,25,nowin,win,dlbust,bust,20,0,18,229,0.445414847,0.056768559,0.655021834,2,0.645370571
17021,26,22837,6,10,0,6,0,22,7,8,10,0,0,25,nowin,loss,bust,plbust,0,10,16,203,0.463054187,0.0591133,0.541871921,1,0.306802864
17022,30,22838,9,8,0,0,0,17,10,10,0,0,0,20,nowin,loss,beat,dlwin,0,10,17,206,0.393203883,0.033980583,0.601941748,0,0.029324648
17023,41,22838,5,10,0,10,0,25,10,10,0,0,0,20,nowin,loss,bust,plbust,0,10,15,192,0.364583333,0.036458333,0.520833333,0,0.00089702
17024,24,22838,9,4,0,1,2,16,10,10,0,0,0,20,nowin,loss,beat,dlwin,0,10,13,207,0.458937198,0.048309179,0.570048309,1,0.318138014
17025,84,22838,6,5,10,0,0,21,10,10,0,0,0,20,nowin,win,plwin,beat,20,0,11,195,0.379487179,0.056410256,0.569230769,0,0.017209119
17026,46,22838,6,10,0,4,0,20,10,10,0,0,0,20,nowin,push,push,push,10,0,16,186,0.403225806,0.048387097,0.591397849,0,0.029742194
17027,41,22838,9,11,0,0,0,20,10,10,0,0,0,20,nowin,push,push,push,10,0,20,192,0.364583333,0.036458333,0.520833333,0,0.00089702
17028,21,22839,10,7,0,0,0,17,5,10,4,0,0,19,nowin,loss,beat,dlwin,0,10,17,214,0.359813084,0.042056075,0.626168224,0,0.025263474
17029,125,22839,5,10,0,0,0,15,5,10,4,0,0,19,nowin,loss,beat,dlwin,0,10,15,219,0.438356164,0.050228311,0.575342466,1,0.308411257
17030,126,22839,10,4,0,0,0,14,5,10,4,0,0,19,nowin,loss,beat,dlwin,0,10,14,188,0.457446809,0.074468085,0.60106383,3,0.900633203
17031,107,22839,4,9,0,0,0,13,5,10,4,0,0,19,nowin,loss,beat,dlwin,0,10,13,218,0.444954128,0.073394495,0.600917431,2,0.605210014
17032,65,22839,7,3,4,0,0,14,5,10,4,0,0,19,nowin,loss,beat,dlwin,0,10,10,203,0.492610837,0.054187192,0.571428571,3,0.913702814
17033,106,22839,10,2,0,0,0,12,5,10,4,0,0,19,nowin,loss,beat,dlwin,0,10,12,192,0.411458333,0.026041667,0.557291667,0,0.023854304
17034,11,22840,7,10,0,0,0,17,3,10,4,0,0,17,nowin,push,push,push,10,0,17,236,0.457627119,0.016949153,0.588983051,3,0.889015813
17035,137,22840,5,3,10,0,0,18,3,10,4,0,0,17,nowin,win,plwin,beat,20,0,8,194,0.417525773,0.046391753,0.536082474,1,0.276714602
17036,6,22840,9,5,0,0,0,14,3,10,4,0,0,17,nowin,loss,beat,dlwin,0,10,14,191,0.439790576,0.047120419,0.581151832,1,0.31211505
17037,102,22840,9,11,0,0,0,20,3,10,4,0,0,17,nowin,win,plwin,beat,20,0,20,192,0.338541667,0.046875,0.5625,0,0.003306118
17038,40,22840,10,10,0,0,0,20,3,10,4,0,0,17,nowin,win,plwin,beat,20,0,20,196,0.367346939,0.030612245,0.617346939,0,0.025358183
17039,137,22840,6,10,0,0,0,16,3,10,4,0,0,17,nowin,loss,beat,dlwin,0,10,16,194,0.417525773,0.046391753,0.536082474,1,0.276714602
17040,23,22841,2,3,4,10,0,19,11,8,0,0,0,19,nowin,push,push,push,10,0,5,208,0.427884615,0.0625,0.552884615,1,0.29114424
17041,34,22841,10,9,0,0,0,19,11,8,0,0,0,19,nowin,push,push,push,10,0,19,202,0.5,0.079207921,0.618811881,3,0.968961434
17042,120,22841,10,10,0,0,0,20,11,8,0,0,0,19,nowin,win,plwin,beat,20,0,20,202,0.440594059,0.034653465,0.618811881,2,0.614441029
17043,115,22841,4,9,0,7,0,20,11,8,0,0,0,19,nowin,win,plwin,beat,20,0,13,194,0.427835052,0.041237113,0.592783505,2,0.583863602
17044,40,22841,6,4,8,0,0,18,11,8,0,0,0,19,nowin,loss,beat,dlwin,0,10,10,196,0.367346939,0.030612245,0.617346939,0,0.025358183
17045,90,22841,2,6,5,4,0,17,11,8,0,0,0,19,nowin,loss,beat,dlwin,0,10,8,201,0.447761194,0.049751244,0.60199005,3,0.889945023
17046,21,22842,10,10,0,0,0,20,7,5,1,3,10,26,nowin,win,dlbust,bust,20,0,20,214,0.359813084,0.042056075,0.626168224,0,0.025263474
17047,150,22842,7,10,0,0,0,17,7,5,1,3,10,26,nowin,win,dlbust,bust,20,0,17,192,0.401041667,0.036458333,0.567708333,0,0.023287458
17048,113,22842,5,4,7,4,0,20,7,5,1,3,10,26,nowin,win,dlbust,bust,20,0,9,199,0.407035176,0.055276382,0.668341709,2,0.620695264
17049,35,22842,11,9,0,0,0,20,7,5,1,3,10,26,nowin,win,dlbust,bust,20,0,20,202,0.410891089,0.044554455,0.633663366,2,0.598681573
17050,27,22842,6,10,0,2,0,18,7,5,1,3,10,26,nowin,win,dlbust,bust,20,0,16,178,0.370786517,0.016853933,0.573033708,0,0.015536309
17051,38,22842,6,10,0,6,0,22,7,5,1,3,10,26,nowin,loss,bust,plbust,0,10,16,202,0.361386139,0.03960396,0.564356436,0,0.010597953
17052,61,22843,11,4,3,0,0,18,11,3,1,10,0,25,nowin,win,dlbust,bust,20,0,15,194,0.427835052,0.077319588,0.603092784,2,0.591437139
17053,21,22843,3,3,2,3,1,12,11,3,1,10,0,25,nowin,win,dlbust,bust,20,0,6,214,0.359813084,0.042056075,0.626168224,0,0.025263474
17054,129,22843,4,9,0,10,0,23,11,3,1,10,0,25,nowin,loss,bust,plbust,0,10,13,201,0.422885572,0.064676617,0.55721393,0,0.027255383
17055,112,22843,7,10,0,0,0,17,11,3,1,10,0,25,nowin,win,dlbust,bust,20,0,17,203,0.448275862,0.054187192,0.600985222,3,0.889576933
17056,104,22843,2,4,7,10,0,23,11,3,1,10,0,25,nowin,loss,bust,plbust,0,10,6,209,0.363636364,0.052631579,0.593301435,0,0.018359419
17057,131,22843,10,4,0,5,0,19,11,3,1,10,0,25,nowin,win,dlbust,bust,20,0,14,217,0.410138249,0.069124424,0.543778802,0,0.02015021
17058,136,22844,4,8,0,10,0,22,2,8,8,0,0,18,nowin,loss,bust,plbust,0,10,12,194,0.396907216,0.025773196,0.597938144,0,0.029452644
17059,139,22844,5,10,0,0,0,15,2,8,8,0,0,18,nowin,loss,beat,dlwin,0,10,15,192,0.380208333,0.036458333,0.59375,0,0.023429169
17060,27,22844,5,3,9,0,0,17,2,8,8,0,0,18,nowin,loss,beat,dlwin,0,10,8,178,0.370786517,0.016853933,0.573033708,0,0.015536309
17061,49,22844,8,2,10,0,0,20,2,8,8,0,0,18,nowin,win,plwin,beat,20,0,10,207,0.396135266,0.053140097,0.594202899,0,0.028306925
17062,66,22844,8,9,0,0,0,17,2,8,8,0,0,18,nowin,loss,beat,dlwin,0,10,17,217,0.456221198,0.064516129,0.626728111,3,0.924304367
17063,81,22844,10,10,0,0,0,20,2,8,8,0,0,18,nowin,win,plwin,beat,20,0,20,182,0.395604396,0.043956044,0.60989011,2,0.567491261
17064,13,22845,2,10,0,7,0,19,11,10,0,0,0,21,nowin,loss,beat,dlwin,0,10,12,206,0.417475728,0.063106796,0.621359223,2,0.59555479
17065,41,22845,10,5,0,10,0,25,11,10,0,0,0,21,nowin,loss,bust,plbust,0,10,15,192,0.364583333,0.036458333,0.520833333,0,0.00089702
17066,102,22845,7,7,0,7,0,21,11,10,0,0,0,21,nowin,push,push,push,10,0,14,192,0.338541667,0.046875,0.5625,0,0.003306118
17067,119,22845,10,6,0,7,0,23,11,10,0,0,0,21,nowin,loss,bust,plbust,0,10,16,190,0.405263158,0.068421053,0.515789474,0,0.011837158
17068,110,22845,2,10,0,10,0,22,11,10,0,0,0,21,nowin,loss,bust,plbust,0,10,12,192,0.416666667,0.046875,0.557291667,0,0.025413132
17069,24,22845,3,6,9,0,0,18,11,10,0,0,0,21,nowin,loss,beat,dlwin,0,10,9,207,0.458937198,0.048309179,0.570048309,1,0.318138014
17070,115,22846,4,10,0,10,0,24,10,8,0,0,0,18,nowin,loss,bust,plbust,0,10,14,194,0.427835052,0.041237113,0.592783505,2,0.583863602
17071,69,22846,8,6,0,5,0,19,10,8,0,0,0,18,nowin,win,plwin,beat,20,0,14,194,0.365979381,0.030927835,0.515463918,0,0
17072,59,22846,1,4,8,6,0,19,10,8,0,0,0,18,nowin,win,plwin,beat,20,0,5,228,0.429824561,0.048245614,0.543859649,1,0.287885446
17073,33,22846,5,4,7,10,0,26,10,8,0,0,0,18,nowin,loss,bust,plbust,0,10,9,192,0.4375,0.057291667,0.625,2,0.616208916
17074,44,22846,10,10,0,0,0,20,10,8,0,0,0,18,nowin,win,plwin,beat,20,0,20,219,0.433789954,0.050228311,0.534246575,1,0.285551035
17075,36,22846,10,7,0,0,0,17,10,8,0,0,0,18,nowin,loss,beat,dlwin,0,10,17,229,0.445414847,0.056768559,0.655021834,2,0.645370571
17076,59,22847,10,4,0,6,0,20,10,11,0,0,0,21,nowin,loss,beat,dlwin,0,10,14,228,0.429824561,0.048245614,0.543859649,1,0.287885446
17077,124,22847,9,10,0,0,0,19,10,11,0,0,0,21,nowin,loss,beat,dlwin,0,10,19,202,0.47029703,0.064356436,0.584158416,3,0.899458193
17078,115,22847,8,6,0,7,0,21,10,11,0,0,0,21,nowin,push,push,push,10,0,14,194,0.427835052,0.041237113,0.592783505,2,0.583863602
17079,9,22847,10,10,0,0,0,20,10,11,0,0,0,21,nowin,loss,beat,dlwin,0,10,20,194,0.37628866,0.015463918,0.541237113,0,0.009396796
17080,101,22847,4,4,7,1,2,18,10,11,0,0,0,21,nowin,loss,beat,dlwin,0,10,8,205,0.424390244,0.068292683,0.63902439,2,0.614740646
17081,52,22847,10,8,0,0,0,18,10,11,0,0,0,21,nowin,loss,beat,dlwin,0,10,18,217,0.414746544,0.02764977,0.599078341,2,0.576736024
17082,99,22848,10,7,0,0,0,17,11,7,0,0,0,18,nowin,loss,beat,dlwin,0,10,17,207,0.47826087,0.062801932,0.637681159,3,0.961418446
17083,127,22848,8,7,0,10,0,25,11,7,0,0,0,18,nowin,loss,bust,plbust,0,10,15,201,0.402985075,0.029850746,0.60199005,0,0.032263937
17084,116,22848,6,7,0,3,10,26,11,7,0,0,0,18,nowin,loss,bust,plbust,0,10,13,195,0.425641026,0.056410256,0.538461538,1,0.28273747
17085,101,22848,10,7,0,0,0,17,11,7,0,0,0,18,nowin,loss,beat,dlwin,0,10,17,205,0.424390244,0.068292683,0.63902439,2,0.614740646
17086,6,22848,10,10,0,0,0,20,11,7,0,0,0,18,nowin,win,plwin,beat,20,0,20,191,0.439790576,0.047120419,0.581151832,1,0.31211505
17087,22,22848,9,10,0,0,0,19,11,7,0,0,0,18,nowin,win,plwin,beat,20,0,19,187,0.481283422,0.042780749,0.577540107,3,0.906128176
17088,37,22849,6,7,0,10,0,23,8,4,10,0,0,22,nowin,loss,bust,plbust,0,10,13,208,0.394230769,0.038461538,0.581730769,0,0.024682772
17089,141,22849,8,6,0,9,0,23,8,4,10,0,0,22,nowin,loss,bust,plbust,0,10,14,202,0.420792079,0.074257426,0.564356436,0,0.028377851
17090,138,22849,6,9,0,10,0,25,8,4,10,0,0,22,nowin,loss,bust,plbust,0,10,15,190,0.442105263,0.047368421,0.610526316,2,0.609711065
17091,49,22849,10,3,0,10,0,23,8,4,10,0,0,22,nowin,loss,bust,plbust,0,10,13,207,0.396135266,0.053140097,0.594202899,0,0.028306925
17092,126,22849,2,1,10,10,0,23,8,4,10,0,0,22,nowin,loss,bust,plbust,0,10,3,188,0.457446809,0.074468085,0.60106383,3,0.900633203
17093,39,22849,6,10,0,2,0,18,8,4,10,0,0,22,nowin,win,dlbust,bust,20,0,16,191,0.429319372,0.062827225,0.57591623,0,0.033760763
17094,105,22850,7,2,10,0,0,19,10,10,0,0,0,20,nowin,loss,beat,dlwin,0,10,9,198,0.414141414,0.070707071,0.590909091,0,0.032889494
17095,109,22850,9,11,0,0,0,20,10,10,0,0,0,20,nowin,push,push,push,10,0,20,221,0.461538462,0.058823529,0.597285068,3,0.901830309
17096,58,22850,10,10,0,0,0,20,10,10,0,0,0,20,nowin,push,push,push,10,0,20,195,0.430769231,0.041025641,0.584615385,2,0.580497586
17097,53,22850,8,10,0,0,0,18,10,10,0,0,0,20,nowin,loss,beat,dlwin,0,10,18,250,0.372,0.064,0.564,0,0.013687345
17098,11,22850,3,10,0,3,6,22,10,10,0,0,0,20,nowin,loss,bust,plbust,0,10,13,236,0.457627119,0.016949153,0.588983051,3,0.889015813
17099,33,22850,1,4,10,10,0,25,10,10,0,0,0,20,nowin,loss,bust,plbust,0,10,5,192,0.4375,0.057291667,0.625,2,0.616208916
17100,53,22851,5,8,0,0,0,13,4,6,2,6,0,18,nowin,loss,beat,dlwin,0,10,13,250,0.372,0.064,0.564,0,0.013687345
17101,106,22851,10,9,0,0,0,19,4,6,2,6,0,18,nowin,win,plwin,beat,20,0,19,192,0.411458333,0.026041667,0.557291667,0,0.023854304
17102,124,22851,5,8,0,0,0,13,4,6,2,6,0,18,nowin,loss,beat,dlwin,0,10,13,202,0.47029703,0.064356436,0.584158416,3,0.899458193
17103,95,22851,4,5,10,0,0,19,4,6,2,6,0,18,nowin,win,plwin,beat,20,0,9,218,0.412844037,0.04587156,0.559633028,0,0.024842385
17104,82,22851,2,4,10,0,0,16,4,6,2,6,0,18,nowin,loss,beat,dlwin,0,10,6,225,0.408888889,0.075555556,0.577777778,0,0.028101874
17105,122,22851,4,10,0,0,0,14,4,6,2,6,0,18,nowin,loss,beat,dlwin,0,10,14,210,0.347619048,0.052380952,0.59047619,0,0.012873677
17106,140,22852,7,5,0,4,0,16,3,10,5,0,0,18,nowin,loss,beat,dlwin,0,10,12,210,0.466666667,0.023809524,0.604761905,3,0.915293335
17107,8,22852,8,6,0,0,0,14,3,10,5,0,0,18,nowin,loss,beat,dlwin,0,10,14,181,0.44198895,0.071823204,0.596685083,2,0.599438402
17108,99,22852,8,11,0,0,0,19,3,10,5,0,0,18,nowin,win,plwin,beat,20,0,19,207,0.47826087,0.062801932,0.637681159,3,0.961418446
17109,130,22852,7,10,0,0,0,17,3,10,5,0,0,18,nowin,loss,beat,dlwin,0,10,17,219,0.410958904,0.03652968,0.566210046,0,0.025888739
17110,59,22852,3,4,10,0,0,17,3,10,5,0,0,18,nowin,loss,beat,dlwin,0,10,7,228,0.429824561,0.048245614,0.543859649,1,0.287885446
17111,94,22852,10,8,0,0,0,18,3,10,5,0,0,18,nowin,push,push,push,10,0,18,183,0.43715847,0.043715847,0.540983607,1,0.290866892
17112,45,22853,8,9,0,0,0,17,3,6,6,1,3,19,nowin,loss,beat,dlwin,0,10,17,196,0.428571429,0.051020408,0.612244898,2,0.598821767
17113,100,22853,11,10,0,0,0,21,3,6,6,1,3,19,win,win,plwin,beat,25,0,21,190,0.452631579,0.036842105,0.594736842,3,0.888671154
17114,101,22853,8,6,0,0,0,14,3,6,6,1,3,19,nowin,loss,beat,dlwin,0,10,14,205,0.424390244,0.068292683,0.63902439,2,0.614740646
17115,108,22853,2,8,10,0,0,20,3,6,6,1,3,19,nowin,win,plwin,beat,20,0,10,193,0.435233161,0.056994819,0.559585492,1,0.298824795
17116,137,22853,10,10,0,0,0,20,3,6,6,1,3,19,nowin,win,plwin,beat,20,0,20,194,0.417525773,0.046391753,0.536082474,1,0.276714602
17117,74,22853,6,4,10,0,0,20,3,6,6,1,3,19,nowin,win,plwin,beat,20,0,10,209,0.411483254,0.04784689,0.531100478,0,0.017448125
17118,14,22854,9,9,0,0,0,18,2,10,10,0,0,22,nowin,win,dlbust,bust,20,0,18,202,0.391089109,0.01980198,0.628712871,2,0.577264877
17119,77,22854,10,10,0,0,0,20,2,10,10,0,0,22,nowin,win,dlbust,bust,20,0,20,200,0.455,0.04,0.62,3,0.916252116
17120,83,22854,3,1,10,0,0,14,2,10,10,0,0,22,nowin,win,dlbust,bust,20,0,4,193,0.424870466,0.051813472,0.678756477,2,0.644360335
17121,32,22854,5,5,10,0,0,20,2,10,10,0,0,22,nowin,win,dlbust,bust,20,0,10,189,0.391534392,0.037037037,0.53968254,0,0.013579086
17122,119,22854,7,9,0,0,0,16,2,10,10,0,0,22,nowin,win,dlbust,bust,20,0,16,190,0.405263158,0.068421053,0.515789474,0,0.011837158
17123,60,22854,8,5,0,0,0,13,2,10,10,0,0,22,nowin,win,dlbust,bust,20,0,13,227,0.418502203,0.022026432,0.559471366,0,0.026496258
17124,10,22855,4,10,0,0,0,14,3,6,7,8,0,24,nowin,win,dlbust,bust,20,0,14,191,0.413612565,0.057591623,0.596858639,2,0.574087175
17125,150,22855,5,10,0,0,0,15,3,6,7,8,0,24,nowin,win,dlbust,bust,20,0,15,192,0.401041667,0.036458333,0.567708333,0,0.023287458
17126,49,22855,7,4,10,0,0,21,3,6,7,8,0,24,nowin,win,dlbust,bust,20,0,11,207,0.396135266,0.053140097,0.594202899,0,0.028306925
17127,96,22855,8,7,0,0,0,15,3,6,7,8,0,24,nowin,win,dlbust,bust,20,0,15,190,0.468421053,0.057894737,0.584210526,3,0.897263354
17128,94,22855,2,6,10,0,0,18,3,6,7,8,0,24,nowin,win,dlbust,bust,20,0,8,183,0.43715847,0.043715847,0.540983607,1,0.290866892
17129,60,22855,10,4,0,0,0,14,3,6,7,8,0,24,nowin,win,dlbust,bust,20,0,14,227,0.418502203,0.022026432,0.559471366,0,0.026496258
17130,96,22856,3,2,9,3,0,17,10,10,0,0,0,20,nowin,loss,beat,dlwin,0,10,5,190,0.468421053,0.057894737,0.584210526,3,0.897263354
17131,73,22856,10,10,0,0,0,20,10,10,0,0,0,20,nowin,push,push,push,10,0,20,181,0.375690608,0.011049724,0.596685083,0,0.022795773
17132,86,22856,10,10,0,0,0,20,10,10,0,0,0,20,nowin,push,push,push,10,0,20,196,0.454081633,0.040816327,0.591836735,3,0.887566443
17133,40,22856,10,11,0,0,0,21,10,10,0,0,0,20,win,win,plwin,beat,25,0,21,196,0.367346939,0.030612245,0.617346939,0,0.025358183
17134,100,22856,8,7,0,8,0,23,10,10,0,0,0,20,nowin,loss,bust,plbust,0,10,15,190,0.452631579,0.036842105,0.594736842,3,0.888671154
17135,148,22856,9,2,4,6,0,21,10,10,0,0,0,20,nowin,win,plwin,beat,20,0,11,204,0.401960784,0.078431373,0.593137255,0,0.029789521
17136,90,22857,5,2,10,0,0,17,10,11,0,0,0,21,nowin,loss,beat,dlwin,0,10,7,201,0.447761194,0.049751244,0.60199005,3,0.889945023
17137,98,22857,2,10,0,8,0,20,10,11,0,0,0,21,nowin,loss,beat,dlwin,0,10,12,220,0.422727273,0.054545455,0.55,1,0.28664435
17138,55,22857,7,10,0,0,0,17,10,11,0,0,0,21,nowin,loss,beat,dlwin,0,10,17,191,0.371727749,0.057591623,0.54973822,0,0.01011347
17139,148,22857,8,3,3,8,0,22,10,11,0,0,0,21,nowin,loss,bust,plbust,0,10,11,204,0.401960784,0.078431373,0.593137255,0,0.029789521
17140,84,22857,8,5,0,6,0,19,10,11,0,0,0,21,nowin,loss,beat,dlwin,0,10,13,195,0.379487179,0.056410256,0.569230769,0,0.017209119
17141,44,22857,10,10,0,0,0,20,10,11,0,0,0,21,nowin,loss,beat,dlwin,0,10,20,219,0.433789954,0.050228311,0.534246575,1,0.285551035
17142,24,22858,6,4,6,3,0,19,7,4,3,8,0,22,nowin,win,dlbust,bust,20,0,10,207,0.458937198,0.048309179,0.570048309,1,0.318138014
17143,43,22858,11,1,3,3,0,18,7,4,3,8,0,22,nowin,win,dlbust,bust,20,0,12,192,0.40625,0.041666667,0.609375,2,0.576671372
17144,130,22858,10,10,0,0,0,20,7,4,3,8,0,22,nowin,win,dlbust,bust,20,0,20,219,0.410958904,0.03652968,0.566210046,0,0.025888739
17145,119,22858,10,4,0,10,0,24,7,4,3,8,0,22,nowin,loss,bust,plbust,0,10,14,190,0.405263158,0.068421053,0.515789474,0,0.011837158
17146,63,22858,7,8,0,8,0,23,7,4,3,8,0,22,nowin,loss,bust,plbust,0,10,15,216,0.467592593,0.037037037,0.62037037,3,0.931690496
17147,111,22858,4,5,10,0,0,19,7,4,3,8,0,22,nowin,win,dlbust,bust,20,0,9,180,0.433333333,0.055555556,0.611111111,2,0.602264492
17148,128,22859,3,5,2,10,0,20,5,7,4,4,0,20,nowin,push,push,push,10,0,8,227,0.356828194,0.052863436,0.577092511,0,0.012352564
17149,117,22859,9,10,0,0,0,19,5,7,4,4,0,20,nowin,loss,beat,dlwin,0,10,19,173,0.410404624,0.069364162,0.606936416,2,0.578610282
17150,124,22859,10,5,0,0,0,15,5,7,4,4,0,20,nowin,loss,beat,dlwin,0,10,15,202,0.47029703,0.064356436,0.584158416,3,0.899458193
17151,121,22859,9,4,0,0,0,13,5,7,4,4,0,20,nowin,loss,beat,dlwin,0,10,13,195,0.456410256,0.025641026,0.512820513,1,0.288597791
17152,101,22859,10,4,0,0,0,14,5,7,4,4,0,20,nowin,loss,beat,dlwin,0,10,14,205,0.424390244,0.068292683,0.63902439,2,0.614740646
17153,54,22859,10,4,0,0,0,14,5,7,4,4,0,20,nowin,loss,beat,dlwin,0,10,14,185,0.437837838,0.032432432,0.556756757,1,0.29899854
17154,68,22860,10,2,0,10,0,22,2,10,10,0,0,22,nowin,loss,bust,plbust,0,10,12,205,0.434146341,0.029268293,0.6,2,0.59483189
17155,143,22860,4,6,10,0,0,20,2,10,10,0,0,22,nowin,win,dlbust,bust,20,0,10,203,0.463054187,0.044334975,0.57635468,3,0.883143365
17156,7,22860,5,3,4,4,0,16,2,10,10,0,0,22,nowin,win,dlbust,bust,20,0,8,183,0.442622951,0.06010929,0.62295082,2,0.619303341
17157,33,22860,5,9,0,0,0,14,2,10,10,0,0,22,nowin,win,dlbust,bust,20,0,14,192,0.4375,0.057291667,0.625,2,0.616208916
17158,78,22860,6,5,10,0,0,21,2,10,10,0,0,22,nowin,win,dlbust,bust,20,0,11,201,0.517412935,0.034825871,0.587064677,3,0.95871112
17159,114,22860,4,10,0,0,0,14,2,10,10,0,0,22,nowin,win,dlbust,bust,20,0,14,198,0.47979798,0.025252525,0.611111111,3,0.937232995
17160,108,22861,7,9,0,6,0,22,10,2,5,0,0,17,nowin,loss,bust,plbust,0,10,16,193,0.435233161,0.056994819,0.559585492,1,0.298824795
17161,137,22861,3,7,2,5,0,17,10,2,5,0,0,17,nowin,push,push,push,10,0,10,194,0.417525773,0.046391753,0.536082474,1,0.276714602
17162,104,22861,9,10,0,0,0,19,10,2,5,0,0,17,nowin,win,plwin,beat,20,0,19,209,0.363636364,0.052631579,0.593301435,0,0.018359419
17163,25,22861,10,6,0,4,0,20,10,2,5,0,0,17,nowin,win,plwin,beat,20,0,16,190,0.463157895,0.063157895,0.536842105,1,0.304401563
17164,64,22861,1,6,6,9,0,22,10,2,5,0,0,17,nowin,loss,bust,plbust,0,10,7,187,0.363636364,0.048128342,0.631016043,0,0.027594885
17165,59,22861,10,9,0,0,0,19,10,2,5,0,0,17,nowin,win,plwin,beat,20,0,19,228,0.429824561,0.048245614,0.543859649,1,0.287885446
17166,68,22862,3,4,9,9,0,25,11,10,0,0,0,21,nowin,loss,bust,plbust,0,10,7,205,0.434146341,0.029268293,0.6,2,0.59483189
17167,2,22862,10,10,0,0,0,20,11,10,0,0,0,21,nowin,loss,beat,dlwin,0,10,20,200,0.445,0.035,0.64,2,0.633962549
17168,122,22862,9,2,6,0,0,17,11,10,0,0,0,21,nowin,loss,beat,dlwin,0,10,11,210,0.347619048,0.052380952,0.59047619,0,0.012873677
17169,148,22862,6,10,0,10,0,26,11,10,0,0,0,21,nowin,loss,bust,plbust,0,10,16,204,0.401960784,0.078431373,0.593137255,0,0.029789521
17170,122,22862,10,2,0,7,0,19,11,10,0,0,0,21,nowin,loss,beat,dlwin,0,10,12,210,0.347619048,0.052380952,0.59047619,0,0.012873677
17171,142,22862,11,10,0,0,0,21,11,10,0,0,0,21,win,push,push,push,10,0,21,211,0.417061611,0.047393365,0.526066351,1,0.271531309
17172,139,22863,10,6,0,0,0,16,4,4,8,10,0,26,nowin,win,dlbust,bust,20,0,16,192,0.380208333,0.036458333,0.59375,0,0.023429169
17173,25,22863,4,7,9,0,0,20,4,4,8,10,0,26,nowin,win,dlbust,bust,20,0,11,190,0.463157895,0.063157895,0.536842105,1,0.304401563
17174,133,22863,2,5,10,0,0,17,4,4,8,10,0,26,nowin,win,dlbust,bust,20,0,7,201,0.47761194,0.064676617,0.611940299,3,0.935428111
17175,127,22863,5,8,0,0,0,13,4,4,8,10,0,26,nowin,win,dlbust,bust,20,0,13,201,0.402985075,0.029850746,0.60199005,0,0.032263937
17176,102,22863,10,10,0,0,0,20,4,4,8,10,0,26,nowin,win,dlbust,bust,20,0,20,192,0.338541667,0.046875,0.5625,0,0.003306118
17177,138,22863,10,10,0,0,0,20,4,4,8,10,0,26,nowin,win,dlbust,bust,20,0,20,190,0.442105263,0.047368421,0.610526316,2,0.609711065
17178,83,22864,9,10,0,0,0,19,8,5,7,0,0,20,nowin,loss,beat,dlwin,0,10,19,193,0.424870466,0.051813472,0.678756477,2,0.644360335
17179,124,22864,10,11,0,0,0,21,8,5,7,0,0,20,win,win,plwin,beat,25,0,21,202,0.47029703,0.064356436,0.584158416,3,0.899458193
17180,73,22864,10,10,0,0,0,20,8,5,7,0,0,20,nowin,push,push,push,10,0,20,181,0.375690608,0.011049724,0.596685083,0,0.022795773
17181,79,22864,3,10,0,10,0,23,8,5,7,0,0,20,nowin,loss,bust,plbust,0,10,13,211,0.436018957,0.028436019,0.672985782,2,0.650131054
17182,30,22864,9,8,0,0,0,17,8,5,7,0,0,20,nowin,loss,beat,dlwin,0,10,17,206,0.393203883,0.033980583,0.601941748,0,0.029324648
17183,146,22864,6,10,0,6,0,22,8,5,7,0,0,20,nowin,loss,bust,plbust,0,10,16,221,0.43438914,0.040723982,0.542986425,1,0.290190091
17184,76,22865,9,6,0,6,0,21,9,10,0,0,0,19,nowin,win,plwin,beat,20,0,15,189,0.534391534,0.079365079,0.608465608,3,1
17185,148,22865,3,10,0,9,0,22,9,10,0,0,0,19,nowin,loss,bust,plbust,0,10,13,204,0.401960784,0.078431373,0.593137255,0,0.029789521
17186,36,22865,10,10,0,0,0,20,9,10,0,0,0,19,nowin,win,plwin,beat,20,0,20,229,0.445414847,0.056768559,0.655021834,2,0.645370571
17187,38,22865,2,4,6,1,8,21,9,10,0,0,0,19,nowin,win,plwin,beat,20,0,6,202,0.361386139,0.03960396,0.564356436,0,0.010597953
17188,95,22865,10,4,0,1,9,24,9,10,0,0,0,19,nowin,loss,bust,plbust,0,10,14,218,0.412844037,0.04587156,0.559633028,0,0.024842385
17189,134,22865,7,6,0,7,0,20,9,10,0,0,0,19,nowin,win,plwin,beat,20,0,13,185,0.443243243,0.021621622,0.545945946,1,0.296939509
17190,19,22866,10,3,0,6,0,19,10,6,10,0,0,26,nowin,win,dlbust,bust,20,0,13,237,0.41350211,0.054852321,0.628691983,2,0.597373826
17191,40,22866,10,10,0,0,0,20,10,6,10,0,0,26,nowin,win,dlbust,bust,20,0,20,196,0.367346939,0.030612245,0.617346939,0,0.025358183
17192,15,22866,5,5,10,0,0,20,10,6,10,0,0,26,nowin,win,dlbust,bust,20,0,10,212,0.410377358,0.051886792,0.561320755,0,0.024517408
17193,39,22866,10,8,0,0,0,18,10,6,10,0,0,26,nowin,win,dlbust,bust,20,0,18,191,0.429319372,0.062827225,0.57591623,0,0.033760763
17194,7,22866,10,4,0,10,0,24,10,6,10,0,0,26,nowin,loss,bust,plbust,0,10,14,183,0.442622951,0.06010929,0.62295082,2,0.619303341
17195,19,22866,10,4,0,10,0,24,10,6,10,0,0,26,nowin,loss,bust,plbust,0,10,14,237,0.41350211,0.054852321,0.628691983,2,0.597373826
17196,15,22867,7,10,0,0,0,17,7,4,10,0,0,21,nowin,loss,beat,dlwin,0,10,17,212,0.410377358,0.051886792,0.561320755,0,0.024517408
17197,46,22867,7,9,0,3,0,19,7,4,10,0,0,21,nowin,loss,beat,dlwin,0,10,16,186,0.403225806,0.048387097,0.591397849,0,0.029742194
17198,61,22867,6,10,0,10,0,26,7,4,10,0,0,21,nowin,loss,bust,plbust,0,10,16,194,0.427835052,0.077319588,0.603092784,2,0.591437139
17199,82,22867,10,10,0,0,0,20,7,4,10,0,0,21,nowin,loss,beat,dlwin,0,10,20,225,0.408888889,0.075555556,0.577777778,0,0.028101874
17200,15,22867,10,6,0,3,0,19,7,4,10,0,0,21,nowin,loss,beat,dlwin,0,10,16,212,0.410377358,0.051886792,0.561320755,0,0.024517408
17201,82,22867,10,10,0,0,0,20,7,4,10,0,0,21,nowin,loss,beat,dlwin,0,10,20,225,0.408888889,0.075555556,0.577777778,0,0.028101874
17202,109,22868,6,5,7,0,0,18,4,6,10,0,0,20,nowin,loss,beat,dlwin,0,10,11,221,0.461538462,0.058823529,0.597285068,3,0.901830309
17203,148,22868,2,11,6,0,0,19,4,6,10,0,0,20,nowin,loss,beat,dlwin,0,10,13,204,0.401960784,0.078431373,0.593137255,0,0.029789521
17204,81,22868,1,1,10,0,0,12,4,6,10,0,0,20,nowin,loss,beat,dlwin,0,10,2,182,0.395604396,0.043956044,0.60989011,2,0.567491261
17205,144,22868,4,3,10,0,0,17,4,6,10,0,0,20,nowin,loss,beat,dlwin,0,10,7,202,0.386138614,0.054455446,0.564356436,0,0.018006244
17206,35,22868,2,3,8,0,0,13,4,6,10,0,0,20,nowin,loss,beat,dlwin,0,10,5,202,0.410891089,0.044554455,0.633663366,2,0.598681573
17207,21,22868,8,8,0,0,0,16,4,6,10,0,0,20,nowin,loss,beat,dlwin,0,10,16,214,0.359813084,0.042056075,0.626168224,0,0.025263474
17208,77,22869,3,1,9,1,3,17,8,5,5,0,0,18,nowin,loss,beat,dlwin,0,10,4,200,0.455,0.04,0.62,3,0.916252116
17209,64,22869,10,10,0,0,0,20,8,5,5,0,0,18,nowin,win,plwin,beat,20,0,20,187,0.363636364,0.048128342,0.631016043,0,0.027594885
17210,42,22869,3,6,7,9,0,25,8,5,5,0,0,18,nowin,loss,bust,plbust,0,10,9,212,0.443396226,0.051886792,0.570754717,1,0.309181312
17211,59,22869,8,2,10,0,0,20,8,5,5,0,0,18,nowin,win,plwin,beat,20,0,10,228,0.429824561,0.048245614,0.543859649,1,0.287885446
17212,146,22869,10,7,0,0,0,17,8,5,5,0,0,18,nowin,loss,beat,dlwin,0,10,17,221,0.43438914,0.040723982,0.542986425,1,0.290190091
17213,36,22869,10,8,0,0,0,18,8,5,5,0,0,18,nowin,push,push,push,10,0,18,229,0.445414847,0.056768559,0.655021834,2,0.645370571
17214,137,22870,9,11,0,0,0,20,5,2,9,10,0,26,nowin,win,dlbust,bust,20,0,20,194,0.417525773,0.046391753,0.536082474,1,0.276714602
17215,63,22870,9,7,0,0,0,16,5,2,9,10,0,26,nowin,win,dlbust,bust,20,0,16,216,0.467592593,0.037037037,0.62037037,3,0.931690496
17216,122,22870,10,6,0,0,0,16,5,2,9,10,0,26,nowin,win,dlbust,bust,20,0,16,210,0.347619048,0.052380952,0.59047619,0,0.012873677
17217,133,22870,9,9,0,0,0,18,5,2,9,10,0,26,nowin,win,dlbust,bust,20,0,18,201,0.47761194,0.064676617,0.611940299,3,0.935428111
17218,120,22870,1,3,8,0,0,12,5,2,9,10,0,26,nowin,win,dlbust,bust,20,0,4,202,0.440594059,0.034653465,0.618811881,2,0.614441029
17219,41,22870,10,10,0,0,0,20,5,2,9,10,0,26,nowin,win,dlbust,bust,20,0,20,192,0.364583333,0.036458333,0.520833333,0,0.00089702
17220,133,22871,9,6,0,0,0,15,5,10,10,0,0,25,nowin,win,dlbust,bust,20,0,15,201,0.47761194,0.064676617,0.611940299,3,0.935428111
17221,141,22871,7,2,9,0,0,18,5,10,10,0,0,25,nowin,win,dlbust,bust,20,0,9,202,0.420792079,0.074257426,0.564356436,0,0.028377851
17222,14,22871,1,2,10,0,0,13,5,10,10,0,0,25,nowin,win,dlbust,bust,20,0,3,202,0.391089109,0.01980198,0.628712871,2,0.577264877
17223,9,22871,10,10,0,0,0,20,5,10,10,0,0,25,nowin,win,dlbust,bust,20,0,20,194,0.37628866,0.015463918,0.541237113,0,0.009396796
17224,78,22871,7,10,0,0,0,17,5,10,10,0,0,25,nowin,win,dlbust,bust,20,0,17,201,0.517412935,0.034825871,0.587064677,3,0.95871112
17225,130,22871,10,3,0,0,0,13,5,10,10,0,0,25,nowin,win,dlbust,bust,20,0,13,219,0.410958904,0.03652968,0.566210046,0,0.025888739
17226,45,22872,2,10,0,4,0,16,3,10,3,7,0,23,nowin,win,dlbust,bust,20,0,12,196,0.428571429,0.051020408,0.612244898,2,0.598821767
17227,53,22872,5,6,7,0,0,18,3,10,3,7,0,23,nowin,win,dlbust,bust,20,0,11,250,0.372,0.064,0.564,0,0.013687345
17228,81,22872,10,6,0,0,0,16,3,10,3,7,0,23,nowin,win,dlbust,bust,20,0,16,182,0.395604396,0.043956044,0.60989011,2,0.567491261
17229,105,22872,7,10,0,0,0,17,3,10,3,7,0,23,nowin,win,dlbust,bust,20,0,17,198,0.414141414,0.070707071,0.590909091,0,0.032889494
17230,76,22872,10,6,0,0,0,16,3,10,3,7,0,23,nowin,win,dlbust,bust,20,0,16,189,0.534391534,0.079365079,0.608465608,3,1
17231,75,22872,10,2,0,10,0,22,3,10,3,7,0,23,nowin,loss,bust,plbust,0,10,12,191,0.418848168,0.052356021,0.570680628,0,0.029344702
17232,137,22873,4,10,0,6,0,20,10,8,0,0,0,18,nowin,win,plwin,beat,20,0,14,194,0.417525773,0.046391753,0.536082474,1,0.276714602
17233,63,22873,10,2,0,8,0,20,10,8,0,0,0,18,nowin,win,plwin,beat,20,0,12,216,0.467592593,0.037037037,0.62037037,3,0.931690496
17234,129,22873,10,3,0,2,3,18,10,8,0,0,0,18,nowin,push,push,push,10,0,13,201,0.422885572,0.064676617,0.55721393,0,0.027255383
17235,137,22873,9,5,0,4,0,18,10,8,0,0,0,18,nowin,push,push,push,10,0,14,194,0.417525773,0.046391753,0.536082474,1,0.276714602
17236,95,22873,5,10,0,2,0,17,10,8,0,0,0,18,nowin,loss,beat,dlwin,0,10,15,218,0.412844037,0.04587156,0.559633028,0,0.024842385
17237,48,22873,3,3,11,0,0,17,10,8,0,0,0,18,nowin,loss,beat,dlwin,0,10,6,203,0.413793103,0.019704433,0.600985222,2,0.577280801
17238,60,22874,2,4,3,2,3,14,1,2,10,4,0,17,nowin,loss,beat,dlwin,0,10,6,227,0.418502203,0.022026432,0.559471366,0,0.026496258
17239,23,22874,4,4,9,0,0,17,1,2,10,4,0,17,nowin,push,push,push,10,0,8,208,0.427884615,0.0625,0.552884615,1,0.29114424
17240,115,22874,5,10,0,5,0,20,1,2,10,4,0,17,nowin,win,plwin,beat,20,0,15,194,0.427835052,0.041237113,0.592783505,2,0.583863602
17241,85,22874,1,3,10,2,2,18,1,2,10,4,0,17,nowin,win,plwin,beat,20,0,4,195,0.41025641,0.066666667,0.594871795,0,0.03269711
17242,64,22874,4,10,0,2,8,24,1,2,10,4,0,17,nowin,loss,bust,plbust,0,10,14,187,0.363636364,0.048128342,0.631016043,0,0.027594885
17243,2,22874,8,8,0,8,0,24,1,2,10,4,0,17,nowin,loss,bust,plbust,0,10,16,200,0.445,0.035,0.64,2,0.633962549
17244,70,22875,5,10,0,0,0,15,2,10,10,0,0,22,nowin,win,dlbust,bust,20,0,15,228,0.385964912,0.039473684,0.557017544,0,0.016157125
17245,81,22875,10,8,0,0,0,18,2,10,10,0,0,22,nowin,win,dlbust,bust,20,0,18,182,0.395604396,0.043956044,0.60989011,2,0.567491261
17246,5,22875,2,10,0,3,0,15,2,10,10,0,0,22,nowin,win,dlbust,bust,20,0,12,203,0.42364532,0.02955665,0.596059113,2,0.582508076
17247,26,22875,4,9,0,0,0,13,2,10,10,0,0,22,nowin,win,dlbust,bust,20,0,13,203,0.463054187,0.0591133,0.541871921,1,0.306802864
17248,50,22875,2,10,0,9,0,21,2,10,10,0,0,22,nowin,win,dlbust,bust,20,0,12,202,0.405940594,0.04950495,0.54950495,0,0.020296079
17249,34,22875,10,10,0,0,0,20,2,10,10,0,0,22,nowin,win,dlbust,bust,20,0,20,202,0.5,0.079207921,0.618811881,3,0.968961434
17250,43,22876,5,10,0,0,0,15,6,9,10,0,0,25,nowin,win,dlbust,bust,20,0,15,192,0.40625,0.041666667,0.609375,2,0.576671372
17251,92,22876,9,7,0,0,0,16,6,9,10,0,0,25,nowin,win,dlbust,bust,20,0,16,186,0.446236559,0.059139785,0.564516129,1,0.307826125
17252,137,22876,8,6,0,0,0,14,6,9,10,0,0,25,nowin,win,dlbust,bust,20,0,14,194,0.417525773,0.046391753,0.536082474,1,0.276714602
17253,59,22876,3,6,6,0,0,15,6,9,10,0,0,25,nowin,win,dlbust,bust,20,0,9,228,0.429824561,0.048245614,0.543859649,1,0.287885446
17254,95,22876,11,7,0,0,0,18,6,9,10,0,0,25,nowin,win,dlbust,bust,20,0,18,218,0.412844037,0.04587156,0.559633028,0,0.024842385
17255,82,22876,11,7,0,0,0,18,6,9,10,0,0,25,nowin,win,dlbust,bust,20,0,18,225,0.408888889,0.075555556,0.577777778,0,0.028101874
17256,33,22877,10,10,0,0,0,20,10,10,0,0,0,20,nowin,push,push,push,10,0,20,192,0.4375,0.057291667,0.625,2,0.616208916
17257,115,22877,5,11,1,0,0,17,10,10,0,0,0,20,nowin,loss,beat,dlwin,0,10,16,194,0.427835052,0.041237113,0.592783505,2,0.583863602
17258,143,22877,9,4,0,5,0,18,10,10,0,0,0,20,nowin,loss,beat,dlwin,0,10,13,203,0.463054187,0.044334975,0.57635468,3,0.883143365
17259,19,22877,10,10,0,0,0,20,10,10,0,0,0,20,nowin,push,push,push,10,0,20,237,0.41350211,0.054852321,0.628691983,2,0.597373826
17260,32,22877,10,6,0,6,0,22,10,10,0,0,0,20,nowin,loss,bust,plbust,0,10,16,189,0.391534392,0.037037037,0.53968254,0,0.013579086
17261,92,22877,2,10,0,2,3,17,10,10,0,0,0,20,nowin,loss,beat,dlwin,0,10,12,186,0.446236559,0.059139785,0.564516129,1,0.307826125
17262,8,22878,10,5,0,10,0,25,10,9,0,0,0,19,nowin,loss,bust,plbust,0,10,15,181,0.44198895,0.071823204,0.596685083,2,0.599438402
17263,86,22878,4,10,0,10,0,24,10,9,0,0,0,19,nowin,loss,bust,plbust,0,10,14,196,0.454081633,0.040816327,0.591836735,3,0.887566443
17264,82,22878,10,5,0,1,6,22,10,9,0,0,0,19,nowin,loss,bust,plbust,0,10,15,225,0.408888889,0.075555556,0.577777778,0,0.028101874
17265,77,22878,3,3,8,7,0,21,10,9,0,0,0,19,nowin,win,plwin,beat,20,0,6,200,0.455,0.04,0.62,3,0.916252116
17266,25,22878,3,10,0,8,0,21,10,9,0,0,0,19,nowin,win,plwin,beat,20,0,13,190,0.463157895,0.063157895,0.536842105,1,0.304401563
17267,2,22878,11,8,0,0,0,19,10,9,0,0,0,19,nowin,push,push,push,10,0,19,200,0.445,0.035,0.64,2,0.633962549
17268,46,22879,10,8,0,0,0,18,10,10,0,0,0,20,nowin,loss,beat,dlwin,0,10,18,186,0.403225806,0.048387097,0.591397849,0,0.029742194
17269,116,22879,10,5,0,2,0,17,10,10,0,0,0,20,nowin,loss,beat,dlwin,0,10,15,195,0.425641026,0.056410256,0.538461538,1,0.28273747
17270,31,22879,6,3,9,0,0,18,10,10,0,0,0,20,nowin,loss,beat,dlwin,0,10,9,188,0.473404255,0.058510638,0.515957447,1,0.300306557
17271,57,22879,11,9,0,0,0,20,10,10,0,0,0,20,nowin,push,push,push,10,0,20,192,0.46875,0.052083333,0.59375,3,0.907001181
17272,92,22879,10,3,0,7,0,20,10,10,0,0,0,20,nowin,push,push,push,10,0,13,186,0.446236559,0.059139785,0.564516129,1,0.307826125
17273,17,22879,9,6,0,8,0,23,10,10,0,0,0,20,nowin,loss,bust,plbust,0,10,15,171,0.444444444,0.070175439,0.555555556,1,0.302364894
17274,30,22880,10,10,0,0,0,20,3,8,6,0,0,17,nowin,win,plwin,beat,20,0,20,206,0.393203883,0.033980583,0.601941748,0,0.029324648
17275,143,22880,9,10,0,0,0,19,3,8,6,0,0,17,nowin,win,plwin,beat,20,0,19,203,0.463054187,0.044334975,0.57635468,3,0.883143365
17276,119,22880,10,3,0,0,0,13,3,8,6,0,0,17,nowin,loss,beat,dlwin,0,10,13,190,0.405263158,0.068421053,0.515789474,0,0.011837158
17277,109,22880,4,7,9,0,0,20,3,8,6,0,0,17,nowin,win,plwin,beat,20,0,11,221,0.461538462,0.058823529,0.597285068,3,0.901830309
17278,34,22880,5,10,0,0,0,15,3,8,6,0,0,17,nowin,loss,beat,dlwin,0,10,15,202,0.5,0.079207921,0.618811881,3,0.968961434
17279,85,22880,10,11,0,0,0,21,3,8,6,0,0,17,win,win,plwin,beat,25,0,21,195,0.41025641,0.066666667,0.594871795,0,0.03269711
17280,67,22881,4,10,0,0,0,14,4,6,10,0,0,20,nowin,loss,beat,dlwin,0,10,14,195,0.369230769,0.041025641,0.569230769,0,0.014139427
17281,5,22881,10,2,0,0,0,12,4,6,10,0,0,20,nowin,loss,beat,dlwin,0,10,12,203,0.42364532,0.02955665,0.596059113,2,0.582508076
17282,107,22881,8,2,2,0,0,12,4,6,10,0,0,20,nowin,loss,beat,dlwin,0,10,10,218,0.444954128,0.073394495,0.600917431,2,0.605210014
17283,83,22881,10,10,0,0,0,20,4,6,10,0,0,20,nowin,push,push,push,10,0,20,193,0.424870466,0.051813472,0.678756477,2,0.644360335
17284,128,22881,10,2,0,0,0,12,4,6,10,0,0,20,nowin,loss,beat,dlwin,0,10,12,227,0.356828194,0.052863436,0.577092511,0,0.012352564
17285,144,22881,5,7,0,0,0,12,4,6,10,0,0,20,nowin,loss,beat,dlwin,0,10,12,202,0.386138614,0.054455446,0.564356436,0,0.018006244
17286,111,22882,10,4,0,0,0,14,5,10,1,1,0,17,nowin,loss,beat,dlwin,0,10,14,180,0.433333333,0.055555556,0.611111111,2,0.602264492
17287,61,22882,3,11,1,0,0,15,5,10,1,1,0,17,nowin,loss,beat,dlwin,0,10,14,194,0.427835052,0.077319588,0.603092784,2,0.591437139
17288,101,22882,3,11,7,0,0,21,5,10,1,1,0,17,nowin,win,plwin,beat,20,0,14,205,0.424390244,0.068292683,0.63902439,2,0.614740646
17289,44,22882,10,8,0,0,0,18,5,10,1,1,0,17,nowin,win,plwin,beat,20,0,18,219,0.433789954,0.050228311,0.534246575,1,0.285551035
17290,95,22882,4,4,8,0,0,16,5,10,1,1,0,17,nowin,loss,beat,dlwin,0,10,8,218,0.412844037,0.04587156,0.559633028,0,0.024842385
17291,43,22882,6,3,10,0,0,19,5,10,1,1,0,17,nowin,win,plwin,beat,20,0,9,192,0.40625,0.041666667,0.609375,2,0.576671372
17292,11,22883,10,9,0,0,0,19,8,11,0,0,0,19,nowin,push,push,push,10,0,19,236,0.457627119,0.016949153,0.588983051,3,0.889015813
17293,131,22883,5,6,1,1,1,14,8,11,0,0,0,19,nowin,loss,beat,dlwin,0,10,11,217,0.410138249,0.069124424,0.543778802,0,0.02015021
17294,92,22883,3,4,7,1,5,20,8,11,0,0,0,19,nowin,win,plwin,beat,20,0,7,186,0.446236559,0.059139785,0.564516129,1,0.307826125
17295,41,22883,9,2,4,2,0,17,8,11,0,0,0,19,nowin,loss,beat,dlwin,0,10,11,192,0.364583333,0.036458333,0.520833333,0,0.00089702
17296,35,22883,6,10,0,5,0,21,8,11,0,0,0,19,nowin,win,plwin,beat,20,0,16,202,0.410891089,0.044554455,0.633663366,2,0.598681573
17297,71,22883,10,3,0,10,0,23,8,11,0,0,0,19,nowin,loss,bust,plbust,0,10,13,193,0.352331606,0.046632124,0.585492228,0,0.013063661
17298,105,22884,4,10,0,10,0,24,10,4,8,0,0,22,nowin,loss,bust,plbust,0,10,14,198,0.414141414,0.070707071,0.590909091,0,0.032889494
17299,32,22884,10,10,0,0,0,20,10,4,8,0,0,22,nowin,win,dlbust,bust,20,0,20,189,0.391534392,0.037037037,0.53968254,0,0.013579086
17300,59,22884,7,5,0,8,0,20,10,4,8,0,0,22,nowin,win,dlbust,bust,20,0,12,228,0.429824561,0.048245614,0.543859649,1,0.287885446
17301,65,22884,10,9,0,0,0,19,10,4,8,0,0,22,nowin,win,dlbust,bust,20,0,19,203,0.492610837,0.054187192,0.571428571,3,0.913702814
17302,125,22884,11,10,0,0,0,21,10,4,8,0,0,22,win,win,dlbust,bust,25,0,21,219,0.438356164,0.050228311,0.575342466,1,0.308411257
17303,25,22884,6,5,10,0,0,21,10,4,8,0,0,22,nowin,win,dlbust,bust,20,0,11,190,0.463157895,0.063157895,0.536842105,1,0.304401563
17304,69,22885,8,11,0,0,0,19,7,6,1,6,0,20,nowin,loss,beat,dlwin,0,10,19,194,0.365979381,0.030927835,0.515463918,0,0
17305,44,22885,9,9,0,0,0,18,7,6,1,6,0,20,nowin,loss,beat,dlwin,0,10,18,219,0.433789954,0.050228311,0.534246575,1,0.285551035
17306,120,22885,10,10,0,0,0,20,7,6,1,6,0,20,nowin,push,push,push,10,0,20,202,0.440594059,0.034653465,0.618811881,2,0.614441029
17307,110,22885,9,10,0,0,0,19,7,6,1,6,0,20,nowin,loss,beat,dlwin,0,10,19,192,0.416666667,0.046875,0.557291667,0,0.025413132
17308,37,22885,6,8,0,7,0,21,7,6,1,6,0,20,nowin,win,plwin,beat,20,0,14,208,0.394230769,0.038461538,0.581730769,0,0.024682772
17309,146,22885,3,10,0,5,0,18,7,6,1,6,0,20,nowin,loss,beat,dlwin,0,10,13,221,0.43438914,0.040723982,0.542986425,1,0.290190091
17310,69,22886,7,7,0,4,0,18,9,4,10,0,0,23,nowin,win,dlbust,bust,20,0,14,194,0.365979381,0.030927835,0.515463918,0,0
17311,122,22886,3,7,5,5,0,20,9,4,10,0,0,23,nowin,win,dlbust,bust,20,0,10,210,0.347619048,0.052380952,0.59047619,0,0.012873677
17312,101,22886,6,10,0,1,0,17,9,4,10,0,0,23,nowin,win,dlbust,bust,20,0,16,205,0.424390244,0.068292683,0.63902439,2,0.614740646
17313,123,22886,6,1,9,8,0,24,9,4,10,0,0,23,nowin,loss,bust,plbust,0,10,7,205,0.43902439,0.034146341,0.614634146,2,0.609962544
17314,21,22886,4,6,6,10,0,26,9,4,10,0,0,23,nowin,loss,bust,plbust,0,10,10,214,0.359813084,0.042056075,0.626168224,0,0.025263474
17315,26,22886,7,2,9,0,0,18,9,4,10,0,0,23,nowin,win,dlbust,bust,20,0,9,203,0.463054187,0.0591133,0.541871921,1,0.306802864
17316,140,22887,10,3,0,0,0,13,2,4,7,3,4,20,nowin,loss,beat,dlwin,0,10,13,210,0.466666667,0.023809524,0.604761905,3,0.915293335
17317,104,22887,5,9,0,0,0,14,2,4,7,3,4,20,nowin,loss,beat,dlwin,0,10,14,209,0.363636364,0.052631579,0.593301435,0,0.018359419
17318,37,22887,10,8,0,0,0,18,2,4,7,3,4,20,nowin,loss,beat,dlwin,0,10,18,208,0.394230769,0.038461538,0.581730769,0,0.024682772
17319,114,22887,6,7,0,0,0,13,2,4,7,3,4,20,nowin,loss,beat,dlwin,0,10,13,198,0.47979798,0.025252525,0.611111111,3,0.937232995
17320,35,22887,11,5,3,0,0,19,2,4,7,3,4,20,nowin,loss,beat,dlwin,0,10,16,202,0.410891089,0.044554455,0.633663366,2,0.598681573
17321,67,22887,10,4,0,0,0,14,2,4,7,3,4,20,nowin,loss,beat,dlwin,0,10,14,195,0.369230769,0.041025641,0.569230769,0,0.014139427
17322,53,22888,10,10,0,0,0,20,10,4,2,9,0,25,nowin,win,dlbust,bust,20,0,20,250,0.372,0.064,0.564,0,0.013687345
17323,81,22888,10,6,0,2,0,18,10,4,2,9,0,25,nowin,win,dlbust,bust,20,0,16,182,0.395604396,0.043956044,0.60989011,2,0.567491261
17324,10,22888,8,10,0,0,0,18,10,4,2,9,0,25,nowin,win,dlbust,bust,20,0,18,191,0.413612565,0.057591623,0.596858639,2,0.574087175
17325,138,22888,8,10,0,0,0,18,10,4,2,9,0,25,nowin,win,dlbust,bust,20,0,18,190,0.442105263,0.047368421,0.610526316,2,0.609711065
17326,15,22888,6,6,0,1,10,23,10,4,2,9,0,25,nowin,loss,bust,plbust,0,10,12,212,0.410377358,0.051886792,0.561320755,0,0.024517408
17327,102,22888,5,4,6,1,3,19,10,4,2,9,0,25,nowin,win,dlbust,bust,20,0,9,192,0.338541667,0.046875,0.5625,0,0.003306118
17328,90,22889,10,10,0,0,0,20,1,4,7,8,0,20,nowin,push,push,push,10,0,20,201,0.447761194,0.049751244,0.60199005,3,0.889945023
17329,66,22889,4,2,3,10,0,19,1,4,7,8,0,20,nowin,loss,beat,dlwin,0,10,6,217,0.456221198,0.064516129,0.626728111,3,0.924304367
17330,61,22889,2,10,0,5,0,17,1,4,7,8,0,20,nowin,loss,beat,dlwin,0,10,12,194,0.427835052,0.077319588,0.603092784,2,0.591437139
17331,144,22889,10,8,0,0,0,18,1,4,7,8,0,20,nowin,loss,beat,dlwin,0,10,18,202,0.386138614,0.054455446,0.564356436,0,0.018006244
17332,91,22889,10,10,0,0,0,20,1,4,7,8,0,20,nowin,push,push,push,10,0,20,194,0.417525773,0.046391753,0.515463918,1,0.266616552
17333,25,22889,3,7,11,0,0,21,1,4,7,8,0,20,nowin,win,plwin,beat,20,0,10,190,0.463157895,0.063157895,0.536842105,1,0.304401563
17334,40,22890,5,9,0,10,0,24,11,10,0,0,0,21,nowin,loss,bust,plbust,0,10,14,196,0.367346939,0.030612245,0.617346939,0,0.025358183
17335,50,22890,10,10,0,0,0,20,11,10,0,0,0,21,nowin,loss,beat,dlwin,0,10,20,202,0.405940594,0.04950495,0.54950495,0,0.020296079
17336,131,22890,11,10,0,0,0,21,11,10,0,0,0,21,win,push,push,push,10,0,21,217,0.410138249,0.069124424,0.543778802,0,0.02015021
17337,93,22890,10,3,0,3,10,26,11,10,0,0,0,21,nowin,loss,bust,plbust,0,10,13,175,0.485714286,0.051428571,0.548571429,1,0.323648091
17338,150,22890,5,10,0,3,0,18,11,10,0,0,0,21,nowin,loss,beat,dlwin,0,10,15,192,0.401041667,0.036458333,0.567708333,0,0.023287458
17339,119,22890,4,3,10,0,0,17,11,10,0,0,0,21,nowin,loss,beat,dlwin,0,10,7,190,0.405263158,0.068421053,0.515789474,0,0.011837158
17340,112,22891,10,10,0,0,0,20,5,10,5,0,0,20,nowin,push,push,push,10,0,20,203,0.448275862,0.054187192,0.600985222,3,0.889576933
17341,62,22891,10,2,0,0,0,12,5,10,5,0,0,20,nowin,loss,beat,dlwin,0,10,12,178,0.370786517,0.028089888,0.54494382,0,0.008657722
17342,142,22891,4,10,0,0,0,14,5,10,5,0,0,20,nowin,loss,beat,dlwin,0,10,14,211,0.417061611,0.047393365,0.526066351,1,0.271531309
17343,22,22891,11,10,0,0,0,21,5,10,5,0,0,20,win,win,plwin,beat,25,0,21,187,0.481283422,0.042780749,0.577540107,3,0.906128176
17344,114,22891,10,4,0,0,0,14,5,10,5,0,0,20,nowin,loss,beat,dlwin,0,10,14,198,0.47979798,0.025252525,0.611111111,3,0.937232995
17345,60,22891,10,5,0,0,0,15,5,10,5,0,0,20,nowin,loss,beat,dlwin,0,10,15,227,0.418502203,0.022026432,0.559471366,0,0.026496258
17346,51,22892,4,10,0,1,2,17,10,10,0,0,0,20,nowin,loss,beat,dlwin,0,10,14,189,0.529100529,0.068783069,0.608465608,3,0.993665715
17347,149,22892,3,4,3,10,0,20,10,10,0,0,0,20,nowin,push,push,push,10,0,7,225,0.457777778,0.057777778,0.648888889,2,0.651965595
17348,71,22892,7,10,0,0,0,17,10,10,0,0,0,20,nowin,loss,beat,dlwin,0,10,17,193,0.352331606,0.046632124,0.585492228,0,0.013063661
17349,56,22892,2,5,10,0,0,17,10,10,0,0,0,20,nowin,loss,beat,dlwin,0,10,7,175,0.4,0.057142857,0.582857143,0,0.026685297
17350,80,22892,10,8,0,0,0,18,10,10,0,0,0,20,nowin,loss,beat,dlwin,0,10,18,186,0.419354839,0.059139785,0.623655914,2,0.59892924
17351,8,22892,4,10,0,10,0,24,10,10,0,0,0,20,nowin,loss,bust,plbust,0,10,14,181,0.44198895,0.071823204,0.596685083,2,0.599438402
17352,87,22893,2,1,10,0,0,13,2,4,7,8,0,21,nowin,loss,beat,dlwin,0,10,3,202,0.405940594,0.054455446,0.628712871,2,0.590599801
17353,56,22893,6,4,10,0,0,20,2,4,7,8,0,21,nowin,loss,beat,dlwin,0,10,10,175,0.4,0.057142857,0.582857143,0,0.026685297
17354,125,22893,7,6,0,0,0,13,2,4,7,8,0,21,nowin,loss,beat,dlwin,0,10,13,219,0.438356164,0.050228311,0.575342466,1,0.308411257
17355,99,22893,8,10,0,0,0,18,2,4,7,8,0,21,nowin,loss,beat,dlwin,0,10,18,207,0.47826087,0.062801932,0.637681159,3,0.961418446
17356,92,22893,10,10,0,0,0,20,2,4,7,8,0,21,nowin,loss,beat,dlwin,0,10,20,186,0.446236559,0.059139785,0.564516129,1,0.307826125
17357,117,22893,10,11,0,0,0,21,2,4,7,8,0,21,win,push,push,push,10,0,21,173,0.410404624,0.069364162,0.606936416,2,0.578610282
17358,94,22894,4,5,10,0,0,19,3,2,6,9,0,20,nowin,loss,beat,dlwin,0,10,9,183,0.43715847,0.043715847,0.540983607,1,0.290866892
17359,46,22894,4,10,0,0,0,14,3,2,6,9,0,20,nowin,loss,beat,dlwin,0,10,14,186,0.403225806,0.048387097,0.591397849,0,0.029742194
17360,60,22894,5,10,0,0,0,15,3,2,6,9,0,20,nowin,loss,beat,dlwin,0,10,15,227,0.418502203,0.022026432,0.559471366,0,0.026496258
17361,3,22894,4,8,0,5,0,17,3,2,6,9,0,20,nowin,loss,beat,dlwin,0,10,12,190,0.431578947,0.026315789,0.542105263,1,0.288076384
17362,101,22894,10,8,0,0,0,18,3,2,6,9,0,20,nowin,loss,beat,dlwin,0,10,18,205,0.424390244,0.068292683,0.63902439,2,0.614740646
17363,62,22894,2,10,0,7,0,19,3,2,6,9,0,20,nowin,loss,beat,dlwin,0,10,12,178,0.370786517,0.028089888,0.54494382,0,0.008657722
17364,81,22895,5,2,10,0,0,17,9,4,1,10,0,24,nowin,win,dlbust,bust,20,0,7,182,0.395604396,0.043956044,0.60989011,2,0.567491261
17365,109,22895,4,4,8,4,0,20,9,4,1,10,0,24,nowin,win,dlbust,bust,20,0,8,221,0.461538462,0.058823529,0.597285068,3,0.901830309
17366,143,22895,5,10,0,5,0,20,9,4,1,10,0,24,nowin,win,dlbust,bust,20,0,15,203,0.463054187,0.044334975,0.57635468,3,0.883143365
17367,77,22895,8,5,0,10,0,23,9,4,1,10,0,24,nowin,loss,bust,plbust,0,10,13,200,0.455,0.04,0.62,3,0.916252116
17368,118,22895,9,4,0,3,10,26,9,4,1,10,0,24,nowin,loss,bust,plbust,0,10,13,216,0.393518519,0.037037037,0.555555556,0,0.018059873
17369,80,22895,10,10,0,0,0,20,9,4,1,10,0,24,nowin,win,dlbust,bust,20,0,20,186,0.419354839,0.059139785,0.623655914,2,0.59892924
17370,104,22896,10,10,0,0,0,20,10,5,10,0,0,25,nowin,win,dlbust,bust,20,0,20,209,0.363636364,0.052631579,0.593301435,0,0.018359419
17371,133,22896,7,6,0,5,0,18,10,5,10,0,0,25,nowin,win,dlbust,bust,20,0,13,201,0.47761194,0.064676617,0.611940299,3,0.935428111
17372,115,22896,10,3,0,10,0,23,10,5,10,0,0,25,nowin,loss,bust,plbust,0,10,13,194,0.427835052,0.041237113,0.592783505,2,0.583863602
17373,21,22896,7,10,0,0,0,17,10,5,10,0,0,25,nowin,win,dlbust,bust,20,0,17,214,0.359813084,0.042056075,0.626168224,0,0.025263474
17374,140,22896,10,10,0,0,0,20,10,5,10,0,0,25,nowin,win,dlbust,bust,20,0,20,210,0.466666667,0.023809524,0.604761905,3,0.915293335
17375,107,22896,4,4,9,0,0,17,10,5,10,0,0,25,nowin,win,dlbust,bust,20,0,8,218,0.444954128,0.073394495,0.600917431,2,0.605210014
17376,17,22897,10,4,0,10,0,24,10,6,10,0,0,26,nowin,loss,bust,plbust,0,10,14,171,0.444444444,0.070175439,0.555555556,1,0.302364894
17377,144,22897,3,3,6,10,0,22,10,6,10,0,0,26,nowin,loss,bust,plbust,0,10,6,202,0.386138614,0.054455446,0.564356436,0,0.018006244
17378,56,22897,6,10,0,6,0,22,10,6,10,0,0,26,nowin,loss,bust,plbust,0,10,16,175,0.4,0.057142857,0.582857143,0,0.026685297
17379,135,22897,3,9,0,10,0,22,10,6,10,0,0,26,nowin,loss,bust,plbust,0,10,12,179,0.391061453,0.067039106,0.586592179,0,0.024924662
17380,118,22897,1,4,8,9,0,22,10,6,10,0,0,26,nowin,loss,bust,plbust,0,10,5,216,0.393518519,0.037037037,0.555555556,0,0.018059873
17381,92,22897,4,10,0,5,0,19,10,6,10,0,0,26,nowin,win,dlbust,bust,20,0,14,186,0.446236559,0.059139785,0.564516129,1,0.307826125
17382,124,22898,7,11,0,0,0,18,6,6,5,0,0,17,nowin,win,plwin,beat,20,0,18,202,0.47029703,0.064356436,0.584158416,3,0.899458193
17383,76,22898,7,10,0,0,0,17,6,6,5,0,0,17,nowin,push,push,push,10,0,17,189,0.534391534,0.079365079,0.608465608,3,1
17384,116,22898,11,8,0,0,0,19,6,6,5,0,0,17,nowin,win,plwin,beat,20,0,19,195,0.425641026,0.056410256,0.538461538,1,0.28273747
17385,26,22898,10,4,0,0,0,14,6,6,5,0,0,17,nowin,loss,beat,dlwin,0,10,14,203,0.463054187,0.0591133,0.541871921,1,0.306802864
17386,77,22898,10,2,0,0,0,12,6,6,5,0,0,17,nowin,loss,beat,dlwin,0,10,12,200,0.455,0.04,0.62,3,0.916252116
17387,132,22898,6,10,0,0,0,16,6,6,5,0,0,17,nowin,loss,beat,dlwin,0,10,16,194,0.412371134,0.036082474,0.649484536,2,0.611633238
17388,46,22899,8,8,0,5,0,21,11,7,0,0,0,18,nowin,win,plwin,beat,20,0,16,186,0.403225806,0.048387097,0.591397849,0,0.029742194
17389,130,22899,1,4,10,3,0,18,11,7,0,0,0,18,nowin,push,push,push,10,0,5,219,0.410958904,0.03652968,0.566210046,0,0.025888739
17390,104,22899,10,9,0,0,0,19,11,7,0,0,0,18,nowin,win,plwin,beat,20,0,19,209,0.363636364,0.052631579,0.593301435,0,0.018359419
17391,31,22899,5,9,0,6,0,20,11,7,0,0,0,18,nowin,win,plwin,beat,20,0,14,188,0.473404255,0.058510638,0.515957447,1,0.300306557
17392,66,22899,10,2,0,7,0,19,11,7,0,0,0,18,nowin,win,plwin,beat,20,0,12,217,0.456221198,0.064516129,0.626728111,3,0.924304367
17393,66,22899,10,10,0,0,0,20,11,7,0,0,0,18,nowin,win,plwin,beat,20,0,20,217,0.456221198,0.064516129,0.626728111,3,0.924304367
17394,123,22900,8,4,0,4,10,26,9,4,1,4,0,18,nowin,loss,bust,plbust,0,10,12,205,0.43902439,0.034146341,0.614634146,2,0.609962544
17395,82,22900,4,9,0,8,0,21,9,4,1,4,0,18,nowin,win,plwin,beat,20,0,13,225,0.408888889,0.075555556,0.577777778,0,0.028101874
17396,123,22900,7,10,0,0,0,17,9,4,1,4,0,18,nowin,loss,beat,dlwin,0,10,17,205,0.43902439,0.034146341,0.614634146,2,0.609962544
17397,68,22900,4,4,10,0,0,18,9,4,1,4,0,18,nowin,push,push,push,10,0,8,205,0.434146341,0.029268293,0.6,2,0.59483189
17398,59,22900,10,11,0,0,0,21,9,4,1,4,0,18,win,win,plwin,beat,25,0,21,228,0.429824561,0.048245614,0.543859649,1,0.287885446
17399,42,22900,11,8,0,0,0,19,9,4,1,4,0,18,nowin,win,plwin,beat,20,0,19,212,0.443396226,0.051886792,0.570754717,1,0.309181312
17400,57,22901,5,3,10,0,0,18,10,10,0,0,0,20,nowin,loss,beat,dlwin,0,10,8,192,0.46875,0.052083333,0.59375,3,0.907001181
17401,136,22901,5,10,0,6,0,21,10,10,0,0,0,20,nowin,win,plwin,beat,20,0,15,194,0.396907216,0.025773196,0.597938144,0,0.029452644
17402,105,22901,10,10,0,0,0,20,10,10,0,0,0,20,nowin,push,push,push,10,0,20,198,0.414141414,0.070707071,0.590909091,0,0.032889494
17403,93,22901,5,5,4,10,0,24,10,10,0,0,0,20,nowin,loss,bust,plbust,0,10,10,175,0.485714286,0.051428571,0.548571429,1,0.323648091
17404,45,22901,10,5,0,2,0,17,10,10,0,0,0,20,nowin,loss,beat,dlwin,0,10,15,196,0.428571429,0.051020408,0.612244898,2,0.598821767
17405,70,22901,5,10,0,6,0,21,10,10,0,0,0,20,nowin,win,plwin,beat,20,0,15,228,0.385964912,0.039473684,0.557017544,0,0.016157125
17406,4,22902,10,10,0,0,0,20,10,8,0,0,0,18,nowin,win,plwin,beat,20,0,20,217,0.460829493,0.036866359,0.562211982,1,0.315432839
17407,56,22902,1,1,10,5,0,17,10,8,0,0,0,18,nowin,loss,beat,dlwin,0,10,2,175,0.4,0.057142857,0.582857143,0,0.026685297
17408,95,22902,5,3,7,3,0,18,10,8,0,0,0,18,nowin,push,push,push,10,0,8,218,0.412844037,0.04587156,0.559633028,0,0.024842385
17409,34,22902,10,3,0,10,0,23,10,8,0,0,0,18,nowin,loss,bust,plbust,0,10,13,202,0.5,0.079207921,0.618811881,3,0.968961434
17410,128,22902,3,4,5,4,2,18,10,8,0,0,0,18,nowin,push,push,push,10,0,7,227,0.356828194,0.052863436,0.577092511,0,0.012352564
17411,75,22902,10,11,0,0,0,21,10,8,0,0,0,18,win,win,plwin,beat,25,0,21,191,0.418848168,0.052356021,0.570680628,0,0.029344702
17412,70,22903,6,2,10,0,0,18,10,8,0,0,0,18,nowin,push,push,push,10,0,8,228,0.385964912,0.039473684,0.557017544,0,0.016157125
17413,49,22903,5,3,10,0,0,18,10,8,0,0,0,18,nowin,push,push,push,10,0,8,207,0.396135266,0.053140097,0.594202899,0,0.028306925
17414,150,22903,6,8,0,10,0,24,10,8,0,0,0,18,nowin,loss,bust,plbust,0,10,14,192,0.401041667,0.036458333,0.567708333,0,0.023287458
17415,11,22903,10,10,0,0,0,20,10,8,0,0,0,18,nowin,win,plwin,beat,20,0,20,236,0.457627119,0.016949153,0.588983051,3,0.889015813
17416,36,22903,4,3,2,7,2,18,10,8,0,0,0,18,nowin,push,push,push,10,0,7,229,0.445414847,0.056768559,0.655021834,2,0.645370571
17417,19,22903,10,10,0,0,0,20,10,8,0,0,0,18,nowin,win,plwin,beat,20,0,20,237,0.41350211,0.054852321,0.628691983,2,0.597373826
17418,105,22904,9,10,0,0,0,19,10,6,10,0,0,26,nowin,win,dlbust,bust,20,0,19,198,0.414141414,0.070707071,0.590909091,0,0.032889494
17419,125,22904,10,10,0,0,0,20,10,6,10,0,0,26,nowin,win,dlbust,bust,20,0,20,219,0.438356164,0.050228311,0.575342466,1,0.308411257
17420,55,22904,2,8,9,0,0,19,10,6,10,0,0,26,nowin,win,dlbust,bust,20,0,10,191,0.371727749,0.057591623,0.54973822,0,0.01011347
17421,58,22904,8,10,0,0,0,18,10,6,10,0,0,26,nowin,win,dlbust,bust,20,0,18,195,0.430769231,0.041025641,0.584615385,2,0.580497586
17422,124,22904,10,5,0,10,0,25,10,6,10,0,0,26,nowin,loss,bust,plbust,0,10,15,202,0.47029703,0.064356436,0.584158416,3,0.899458193
17423,45,22904,9,9,0,0,0,18,10,6,10,0,0,26,nowin,win,dlbust,bust,20,0,18,196,0.428571429,0.051020408,0.612244898,2,0.598821767
17424,30,22905,10,3,0,10,0,23,7,7,2,1,0,17,nowin,loss,bust,plbust,0,10,13,206,0.393203883,0.033980583,0.601941748,0,0.029324648
17425,109,22905,10,6,0,6,0,22,7,7,2,1,0,17,nowin,loss,bust,plbust,0,10,16,221,0.461538462,0.058823529,0.597285068,3,0.901830309
17426,68,22905,10,10,0,0,0,20,7,7,2,1,0,17,nowin,win,plwin,beat,20,0,20,205,0.434146341,0.029268293,0.6,2,0.59483189
17427,86,22905,6,2,7,1,9,25,7,7,2,1,0,17,nowin,loss,bust,plbust,0,10,8,196,0.454081633,0.040816327,0.591836735,3,0.887566443
17428,11,22905,6,10,0,10,0,26,7,7,2,1,0,17,nowin,loss,bust,plbust,0,10,16,236,0.457627119,0.016949153,0.588983051,3,0.889015813
17429,2,22905,7,10,0,0,0,17,7,7,2,1,0,17,nowin,push,push,push,10,0,17,200,0.445,0.035,0.64,2,0.633962549
17430,40,22906,8,10,0,0,0,18,10,10,0,0,0,20,nowin,loss,beat,dlwin,0,10,18,196,0.367346939,0.030612245,0.617346939,0,0.025358183
17431,115,22906,7,10,0,0,0,17,10,10,0,0,0,20,nowin,loss,beat,dlwin,0,10,17,194,0.427835052,0.041237113,0.592783505,2,0.583863602
17432,117,22906,11,7,0,0,0,18,10,10,0,0,0,20,nowin,loss,beat,dlwin,0,10,18,173,0.410404624,0.069364162,0.606936416,2,0.578610282
17433,101,22906,11,1,2,2,7,23,10,10,0,0,0,20,nowin,loss,bust,plbust,0,10,12,205,0.424390244,0.068292683,0.63902439,2,0.614740646
17434,148,22906,3,9,0,3,10,25,10,10,0,0,0,20,nowin,loss,bust,plbust,0,10,12,204,0.401960784,0.078431373,0.593137255,0,0.029789521
17435,23,22906,8,2,4,1,8,23,10,10,0,0,0,20,nowin,loss,bust,plbust,0,10,10,208,0.427884615,0.0625,0.552884615,1,0.29114424
17436,50,22907,10,10,0,0,0,20,9,3,7,0,0,19,nowin,win,plwin,beat,20,0,20,202,0.405940594,0.04950495,0.54950495,0,0.020296079
17437,129,22907,2,5,3,4,2,16,9,3,7,0,0,19,nowin,loss,beat,dlwin,0,10,7,201,0.422885572,0.064676617,0.55721393,0,0.027255383
17438,35,22907,5,3,10,0,0,18,9,3,7,0,0,19,nowin,loss,beat,dlwin,0,10,8,202,0.410891089,0.044554455,0.633663366,2,0.598681573
17439,80,22907,10,2,0,7,0,19,9,3,7,0,0,19,nowin,push,push,push,10,0,12,186,0.419354839,0.059139785,0.623655914,2,0.59892924
17440,135,22907,4,11,6,0,0,21,9,3,7,0,0,19,nowin,win,plwin,beat,20,0,15,179,0.391061453,0.067039106,0.586592179,0,0.024924662
17441,142,22907,10,4,0,9,0,23,9,3,7,0,0,19,nowin,loss,bust,plbust,0,10,14,211,0.417061611,0.047393365,0.526066351,1,0.271531309
17442,30,22908,3,7,7,0,0,17,3,10,9,0,0,22,nowin,win,dlbust,bust,20,0,10,206,0.393203883,0.033980583,0.601941748,0,0.029324648
17443,25,22908,9,5,0,0,0,14,3,10,9,0,0,22,nowin,win,dlbust,bust,20,0,14,190,0.463157895,0.063157895,0.536842105,1,0.304401563
17444,9,22908,5,5,11,0,0,21,3,10,9,0,0,22,nowin,win,dlbust,bust,20,0,10,194,0.37628866,0.015463918,0.541237113,0,0.009396796
17445,49,22908,10,2,0,9,0,21,3,10,9,0,0,22,nowin,win,dlbust,bust,20,0,12,207,0.396135266,0.053140097,0.594202899,0,0.028306925
17446,88,22908,9,6,0,0,0,15,3,10,9,0,0,22,nowin,win,dlbust,bust,20,0,15,206,0.466019417,0.033980583,0.54368932,1,0.309467903
17447,51,22908,11,10,0,0,0,21,3,10,9,0,0,22,win,win,dlbust,bust,25,0,21,189,0.529100529,0.068783069,0.608465608,3,0.993665715
17448,63,22909,6,10,0,10,0,26,10,6,8,0,0,24,nowin,loss,bust,plbust,0,10,16,216,0.467592593,0.037037037,0.62037037,3,0.931690496
17449,130,22909,7,10,0,0,0,17,10,6,8,0,0,24,nowin,win,dlbust,bust,20,0,17,219,0.410958904,0.03652968,0.566210046,0,0.025888739
17450,8,22909,7,10,0,0,0,17,10,6,8,0,0,24,nowin,win,dlbust,bust,20,0,17,181,0.44198895,0.071823204,0.596685083,2,0.599438402
17451,51,22909,5,3,7,6,0,21,10,6,8,0,0,24,nowin,win,dlbust,bust,20,0,8,189,0.529100529,0.068783069,0.608465608,3,0.993665715
17452,90,22909,6,9,0,8,0,23,10,6,8,0,0,24,nowin,loss,bust,plbust,0,10,15,201,0.447761194,0.049751244,0.60199005,3,0.889945023
17453,100,22909,5,4,9,0,0,18,10,6,8,0,0,24,nowin,win,dlbust,bust,20,0,9,190,0.452631579,0.036842105,0.594736842,3,0.888671154
17454,147,22910,9,7,0,0,0,16,5,10,10,0,0,25,nowin,win,dlbust,bust,20,0,16,205,0.380487805,0.014634146,0.536585366,0,0.00951447
17455,94,22910,10,10,0,0,0,20,5,10,10,0,0,25,nowin,win,dlbust,bust,20,0,20,183,0.43715847,0.043715847,0.540983607,1,0.290866892
17456,142,22910,10,5,0,0,0,15,5,10,10,0,0,25,nowin,win,dlbust,bust,20,0,15,211,0.417061611,0.047393365,0.526066351,1,0.271531309
17457,138,22910,3,10,0,0,0,13,5,10,10,0,0,25,nowin,win,dlbust,bust,20,0,13,190,0.442105263,0.047368421,0.610526316,2,0.609711065
17458,142,22910,7,11,0,0,0,18,5,10,10,0,0,25,nowin,win,dlbust,bust,20,0,18,211,0.417061611,0.047393365,0.526066351,1,0.271531309
17459,106,22910,2,10,0,0,0,12,5,10,10,0,0,25,nowin,win,dlbust,bust,20,0,12,192,0.411458333,0.026041667,0.557291667,0,0.023854304
17460,144,22911,4,7,5,10,0,26,10,9,0,0,0,19,nowin,loss,bust,plbust,0,10,11,202,0.386138614,0.054455446,0.564356436,0,0.018006244
17461,23,22911,7,5,0,10,0,22,10,9,0,0,0,19,nowin,loss,bust,plbust,0,10,12,208,0.427884615,0.0625,0.552884615,1,0.29114424
17462,7,22911,2,10,0,10,0,22,10,9,0,0,0,19,nowin,loss,bust,plbust,0,10,12,183,0.442622951,0.06010929,0.62295082,2,0.619303341
17463,32,22911,4,8,0,3,5,20,10,9,0,0,0,19,nowin,win,plwin,beat,20,0,12,189,0.391534392,0.037037037,0.53968254,0,0.013579086
17464,70,22911,9,3,0,9,0,21,10,9,0,0,0,19,nowin,win,plwin,beat,20,0,12,228,0.385964912,0.039473684,0.557017544,0,0.016157125
17465,48,22911,2,9,5,10,0,26,10,9,0,0,0,19,nowin,loss,bust,plbust,0,10,11,203,0.413793103,0.019704433,0.600985222,2,0.577280801
17466,38,22912,9,2,10,0,0,21,4,10,9,0,0,23,nowin,win,dlbust,bust,20,0,11,202,0.361386139,0.03960396,0.564356436,0,0.010597953
17467,42,22912,7,3,9,0,0,19,4,10,9,0,0,23,nowin,win,dlbust,bust,20,0,10,212,0.443396226,0.051886792,0.570754717,1,0.309181312
17468,127,22912,4,10,0,0,0,14,4,10,9,0,0,23,nowin,win,dlbust,bust,20,0,14,201,0.402985075,0.029850746,0.60199005,0,0.032263937
17469,150,22912,2,7,10,0,0,19,4,10,9,0,0,23,nowin,win,dlbust,bust,20,0,9,192,0.401041667,0.036458333,0.567708333,0,0.023287458
17470,92,22912,10,4,0,0,0,14,4,10,9,0,0,23,nowin,win,dlbust,bust,20,0,14,186,0.446236559,0.059139785,0.564516129,1,0.307826125
17471,121,22912,10,6,0,0,0,16,4,10,9,0,0,23,nowin,win,dlbust,bust,20,0,16,195,0.456410256,0.025641026,0.512820513,1,0.288597791
17472,129,22913,4,10,0,0,0,14,4,3,5,5,0,17,nowin,loss,beat,dlwin,0,10,14,201,0.422885572,0.064676617,0.55721393,0,0.027255383
17473,85,22913,10,5,0,0,0,15,4,3,5,5,0,17,nowin,loss,beat,dlwin,0,10,15,195,0.41025641,0.066666667,0.594871795,0,0.03269711
17474,46,22913,11,10,0,0,0,21,4,3,5,5,0,17,win,win,plwin,beat,25,0,21,186,0.403225806,0.048387097,0.591397849,0,0.029742194
17475,72,22913,5,8,0,0,0,13,4,3,5,5,0,17,nowin,loss,beat,dlwin,0,10,13,185,0.394594595,0.032432432,0.508108108,0,0.006763115
17476,41,22913,10,10,0,0,0,20,4,3,5,5,0,17,nowin,win,plwin,beat,20,0,20,192,0.364583333,0.036458333,0.520833333,0,0.00089702
17477,72,22913,4,10,0,0,0,14,4,3,5,5,0,17,nowin,loss,beat,dlwin,0,10,14,185,0.394594595,0.032432432,0.508108108,0,0.006763115
17478,42,22914,7,10,0,0,0,17,5,7,10,0,0,22,nowin,win,dlbust,bust,20,0,17,212,0.443396226,0.051886792,0.570754717,1,0.309181312
17479,38,22914,4,5,5,0,0,14,5,7,10,0,0,22,nowin,win,dlbust,bust,20,0,9,202,0.361386139,0.03960396,0.564356436,0,0.010597953
17480,59,22914,10,10,0,0,0,20,5,7,10,0,0,22,nowin,win,dlbust,bust,20,0,20,228,0.429824561,0.048245614,0.543859649,1,0.287885446
17481,36,22914,9,2,10,0,0,21,5,7,10,0,0,22,nowin,win,dlbust,bust,20,0,11,229,0.445414847,0.056768559,0.655021834,2,0.645370571
17482,120,22914,10,10,0,0,0,20,5,7,10,0,0,22,nowin,win,dlbust,bust,20,0,20,202,0.440594059,0.034653465,0.618811881,2,0.614441029
17483,120,22914,11,7,0,0,0,18,5,7,10,0,0,22,nowin,win,dlbust,bust,20,0,18,202,0.440594059,0.034653465,0.618811881,2,0.614441029
17484,148,22915,11,10,0,0,0,21,10,6,10,0,0,26,win,win,dlbust,bust,25,0,21,204,0.401960784,0.078431373,0.593137255,0,0.029789521
17485,2,22915,2,6,8,2,0,18,10,6,10,0,0,26,nowin,win,dlbust,bust,20,0,8,200,0.445,0.035,0.64,2,0.633962549
17486,104,22915,8,10,0,0,0,18,10,6,10,0,0,26,nowin,win,dlbust,bust,20,0,18,209,0.363636364,0.052631579,0.593301435,0,0.018359419
17487,103,22915,10,4,0,2,3,19,10,6,10,0,0,26,nowin,win,dlbust,bust,20,0,14,203,0.379310345,0.064039409,0.551724138,0,0.012869209
17488,92,22915,10,10,0,0,0,20,10,6,10,0,0,26,nowin,win,dlbust,bust,20,0,20,186,0.446236559,0.059139785,0.564516129,1,0.307826125
17489,109,22915,8,9,0,0,0,17,10,6,10,0,0,26,nowin,win,dlbust,bust,20,0,17,221,0.461538462,0.058823529,0.597285068,3,0.901830309
17490,128,22916,2,11,3,5,0,21,7,10,0,0,0,17,nowin,win,plwin,beat,20,0,13,227,0.356828194,0.052863436,0.577092511,0,0.012352564
17491,137,22916,10,9,0,0,0,19,7,10,0,0,0,17,nowin,win,plwin,beat,20,0,19,194,0.417525773,0.046391753,0.536082474,1,0.276714602
17492,75,22916,5,4,4,10,0,23,7,10,0,0,0,17,nowin,loss,bust,plbust,0,10,9,191,0.418848168,0.052356021,0.570680628,0,0.029344702
17493,88,22916,10,2,0,1,3,16,7,10,0,0,0,17,nowin,loss,beat,dlwin,0,10,12,206,0.466019417,0.033980583,0.54368932,1,0.309467903
17494,100,22916,10,11,0,0,0,21,7,10,0,0,0,17,win,win,plwin,beat,25,0,21,190,0.452631579,0.036842105,0.594736842,3,0.888671154
17495,49,22916,5,9,0,10,0,24,7,10,0,0,0,17,nowin,loss,bust,plbust,0,10,14,207,0.396135266,0.053140097,0.594202899,0,0.028306925
17496,92,22917,8,4,0,4,8,24,10,11,0,0,0,21,nowin,loss,bust,plbust,0,10,12,186,0.446236559,0.059139785,0.564516129,1,0.307826125
17497,99,22917,6,3,10,0,0,19,10,11,0,0,0,21,nowin,loss,beat,dlwin,0,10,9,207,0.47826087,0.062801932,0.637681159,3,0.961418446
17498,59,22917,3,4,11,0,0,18,10,11,0,0,0,21,nowin,loss,beat,dlwin,0,10,7,228,0.429824561,0.048245614,0.543859649,1,0.287885446
17499,123,22917,3,10,0,8,0,21,10,11,0,0,0,21,nowin,push,push,push,10,0,13,205,0.43902439,0.034146341,0.614634146,2,0.609962544
17500,40,22917,10,4,0,5,0,19,10,11,0,0,0,21,nowin,loss,beat,dlwin,0,10,14,196,0.367346939,0.030612245,0.617346939,0,0.025358183
17501,70,22917,10,8,0,0,0,18,10,11,0,0,0,21,nowin,loss,beat,dlwin,0,10,18,228,0.385964912,0.039473684,0.557017544,0,0.016157125
17502,47,22918,2,8,6,4,0,20,11,10,0,0,0,21,nowin,loss,beat,dlwin,0,10,10,210,0.438095238,0.057142857,0.623809524,2,0.615868808
17503,38,22918,3,5,11,0,0,19,11,10,0,0,0,21,nowin,loss,beat,dlwin,0,10,8,202,0.361386139,0.03960396,0.564356436,0,0.010597953
17504,55,22918,4,8,0,10,0,22,11,10,0,0,0,21,nowin,loss,bust,plbust,0,10,12,191,0.371727749,0.057591623,0.54973822,0,0.01011347
17505,129,22918,6,7,0,10,0,23,11,10,0,0,0,21,nowin,loss,bust,plbust,0,10,13,201,0.422885572,0.064676617,0.55721393,0,0.027255383
17506,131,22918,8,11,0,0,0,19,11,10,0,0,0,21,nowin,loss,beat,dlwin,0,10,19,217,0.410138249,0.069124424,0.543778802,0,0.02015021
17507,90,22918,11,7,0,0,0,18,11,10,0,0,0,21,nowin,loss,beat,dlwin,0,10,18,201,0.447761194,0.049751244,0.60199005,3,0.889945023
17508,10,22919,10,10,0,0,0,20,8,5,10,0,0,23,nowin,win,dlbust,bust,20,0,20,191,0.413612565,0.057591623,0.596858639,2,0.574087175
17509,20,22919,1,4,10,10,0,25,8,5,10,0,0,23,nowin,loss,bust,plbust,0,10,5,186,0.456989247,0.037634409,0.537634409,1,0.301097108
17510,68,22919,11,9,0,0,0,20,8,5,10,0,0,23,nowin,win,dlbust,bust,20,0,20,205,0.434146341,0.029268293,0.6,2,0.59483189
17511,78,22919,4,10,0,6,0,20,8,5,10,0,0,23,nowin,win,dlbust,bust,20,0,14,201,0.517412935,0.034825871,0.587064677,3,0.95871112
17512,121,22919,2,7,10,0,0,19,8,5,10,0,0,23,nowin,win,dlbust,bust,20,0,9,195,0.456410256,0.025641026,0.512820513,1,0.288597791
17513,95,22919,10,3,0,10,0,23,8,5,10,0,0,23,nowin,loss,bust,plbust,0,10,13,218,0.412844037,0.04587156,0.559633028,0,0.024842385
17514,16,22920,11,8,0,0,0,19,10,2,10,0,0,22,nowin,win,dlbust,bust,20,0,19,220,0.427272727,0.081818182,0.6,2,0.588660176
17515,51,22920,8,5,0,3,7,23,10,2,10,0,0,22,nowin,loss,bust,plbust,0,10,13,189,0.529100529,0.068783069,0.608465608,3,0.993665715
17516,4,22920,3,1,10,8,0,22,10,2,10,0,0,22,nowin,loss,bust,plbust,0,10,4,217,0.460829493,0.036866359,0.562211982,1,0.315432839
17517,123,22920,7,9,0,2,0,18,10,2,10,0,0,22,nowin,win,dlbust,bust,20,0,16,205,0.43902439,0.034146341,0.614634146,2,0.609962544
17518,39,22920,2,8,9,0,0,19,10,2,10,0,0,22,nowin,win,dlbust,bust,20,0,10,191,0.429319372,0.062827225,0.57591623,0,0.033760763
17519,77,22920,10,10,0,0,0,20,10,2,10,0,0,22,nowin,win,dlbust,bust,20,0,20,200,0.455,0.04,0.62,3,0.916252116
17520,137,22921,8,8,0,5,0,21,8,10,0,0,0,18,nowin,win,plwin,beat,20,0,16,194,0.417525773,0.046391753,0.536082474,1,0.276714602
17521,125,22921,4,3,3,8,0,18,8,10,0,0,0,18,nowin,push,push,push,10,0,7,219,0.438356164,0.050228311,0.575342466,1,0.308411257
17522,101,22921,10,6,0,9,0,25,8,10,0,0,0,18,nowin,loss,bust,plbust,0,10,16,205,0.424390244,0.068292683,0.63902439,2,0.614740646
17523,82,22921,9,5,0,2,6,22,8,10,0,0,0,18,nowin,loss,bust,plbust,0,10,14,225,0.408888889,0.075555556,0.577777778,0,0.028101874
17524,83,22921,10,10,0,0,0,20,8,10,0,0,0,18,nowin,win,plwin,beat,20,0,20,193,0.424870466,0.051813472,0.678756477,2,0.644360335
17525,36,22921,7,10,0,0,0,17,8,10,0,0,0,18,nowin,loss,beat,dlwin,0,10,17,229,0.445414847,0.056768559,0.655021834,2,0.645370571
17526,31,22922,8,2,10,0,0,20,9,7,10,0,0,26,nowin,win,dlbust,bust,20,0,10,188,0.473404255,0.058510638,0.515957447,1,0.300306557
17527,123,22922,4,7,1,10,0,22,9,7,10,0,0,26,nowin,loss,bust,plbust,0,10,11,205,0.43902439,0.034146341,0.614634146,2,0.609962544
17528,79,22922,4,7,10,0,0,21,9,7,10,0,0,26,nowin,win,dlbust,bust,20,0,11,211,0.436018957,0.028436019,0.672985782,2,0.650131054
17529,72,22922,5,2,6,10,0,23,9,7,10,0,0,26,nowin,loss,bust,plbust,0,10,7,185,0.394594595,0.032432432,0.508108108,0,0.006763115
17530,132,22922,5,10,0,10,0,25,9,7,10,0,0,26,nowin,loss,bust,plbust,0,10,15,194,0.412371134,0.036082474,0.649484536,2,0.611633238
17531,86,22922,5,6,10,0,0,21,9,7,10,0,0,26,nowin,win,dlbust,bust,20,0,11,196,0.454081633,0.040816327,0.591836735,3,0.887566443
17532,138,22923,10,3,0,3,10,26,8,8,2,0,0,18,nowin,loss,bust,plbust,0,10,13,190,0.442105263,0.047368421,0.610526316,2,0.609711065
17533,69,22923,9,11,0,0,0,20,8,8,2,0,0,18,nowin,win,plwin,beat,20,0,20,194,0.365979381,0.030927835,0.515463918,0,0
17534,42,22923,7,9,0,3,0,19,8,8,2,0,0,18,nowin,win,plwin,beat,20,0,16,212,0.443396226,0.051886792,0.570754717,1,0.309181312
17535,39,22923,5,5,10,0,0,20,8,8,2,0,0,18,nowin,win,plwin,beat,20,0,10,191,0.429319372,0.062827225,0.57591623,0,0.033760763
17536,137,22923,3,10,0,8,0,21,8,8,2,0,0,18,nowin,win,plwin,beat,20,0,13,194,0.417525773,0.046391753,0.536082474,1,0.276714602
17537,70,22923,8,4,0,9,0,21,8,8,2,0,0,18,nowin,win,plwin,beat,20,0,12,228,0.385964912,0.039473684,0.557017544,0,0.016157125
17538,109,22924,9,10,0,0,0,19,2,10,10,0,0,22,nowin,win,dlbust,bust,20,0,19,221,0.461538462,0.058823529,0.597285068,3,0.901830309
17539,16,22924,9,8,0,0,0,17,2,10,10,0,0,22,nowin,win,dlbust,bust,20,0,17,220,0.427272727,0.081818182,0.6,2,0.588660176
17540,144,22924,4,7,3,0,0,14,2,10,10,0,0,22,nowin,win,dlbust,bust,20,0,11,202,0.386138614,0.054455446,0.564356436,0,0.018006244
17541,74,22924,11,1,5,0,0,17,2,10,10,0,0,22,nowin,win,dlbust,bust,20,0,12,209,0.411483254,0.04784689,0.531100478,0,0.017448125
17542,74,22924,2,5,10,0,0,17,2,10,10,0,0,22,nowin,win,dlbust,bust,20,0,7,209,0.411483254,0.04784689,0.531100478,0,0.017448125
17543,142,22924,9,2,8,0,0,19,2,10,10,0,0,22,nowin,win,dlbust,bust,20,0,11,211,0.417061611,0.047393365,0.526066351,1,0.271531309
17544,18,22925,11,10,0,0,0,21,10,8,0,0,0,18,win,win,plwin,beat,25,0,21,182,0.461538462,0.043956044,0.587912088,3,0.892649374
17545,121,22925,2,5,8,3,0,18,10,8,0,0,0,18,nowin,push,push,push,10,0,7,195,0.456410256,0.025641026,0.512820513,1,0.288597791
17546,3,22925,4,5,7,10,0,26,10,8,0,0,0,18,nowin,loss,bust,plbust,0,10,9,190,0.431578947,0.026315789,0.542105263,1,0.288076384
17547,98,22925,10,10,0,0,0,20,10,8,0,0,0,18,nowin,win,plwin,beat,20,0,20,220,0.422727273,0.054545455,0.55,1,0.28664435
17548,40,22925,7,10,0,0,0,17,10,8,0,0,0,18,nowin,loss,beat,dlwin,0,10,17,196,0.367346939,0.030612245,0.617346939,0,0.025358183
17549,147,22925,5,6,4,4,0,19,10,8,0,0,0,18,nowin,win,plwin,beat,20,0,11,205,0.380487805,0.014634146,0.536585366,0,0.00951447
17550,39,22926,1,1,10,0,0,12,5,5,10,0,0,20,nowin,loss,beat,dlwin,0,10,2,191,0.429319372,0.062827225,0.57591623,0,0.033760763
17551,46,22926,10,10,0,0,0,20,5,5,10,0,0,20,nowin,push,push,push,10,0,20,186,0.403225806,0.048387097,0.591397849,0,0.029742194
17552,56,22926,10,11,0,0,0,21,5,5,10,0,0,20,win,win,plwin,beat,25,0,21,175,0.4,0.057142857,0.582857143,0,0.026685297
17553,129,22926,7,11,0,0,0,18,5,5,10,0,0,20,nowin,loss,beat,dlwin,0,10,18,201,0.422885572,0.064676617,0.55721393,0,0.027255383
17554,97,22926,10,3,0,0,0,13,5,5,10,0,0,20,nowin,loss,beat,dlwin,0,10,13,182,0.450549451,0.06043956,0.692307692,2,0.677372279
17555,77,22926,9,4,0,0,0,13,5,5,10,0,0,20,nowin,loss,beat,dlwin,0,10,13,200,0.455,0.04,0.62,3,0.916252116
17556,119,22927,5,10,0,10,0,25,11,7,0,0,0,18,nowin,loss,bust,plbust,0,10,15,190,0.405263158,0.068421053,0.515789474,0,0.011837158
17557,27,22927,10,2,0,6,0,18,11,7,0,0,0,18,nowin,push,push,push,10,0,12,178,0.370786517,0.016853933,0.573033708,0,0.015536309
17558,8,22927,5,7,0,9,0,21,11,7,0,0,0,18,nowin,win,plwin,beat,20,0,12,181,0.44198895,0.071823204,0.596685083,2,0.599438402
17559,134,22927,10,6,0,1,0,17,11,7,0,0,0,18,nowin,loss,beat,dlwin,0,10,16,185,0.443243243,0.021621622,0.545945946,1,0.296939509
17560,130,22927,2,2,10,10,0,24,11,7,0,0,0,18,nowin,loss,bust,plbust,0,10,4,219,0.410958904,0.03652968,0.566210046,0,0.025888739
17561,127,22927,5,3,10,0,0,18,11,7,0,0,0,18,nowin,push,push,push,10,0,8,201,0.402985075,0.029850746,0.60199005,0,0.032263937
17562,118,22928,8,4,0,6,0,18,2,10,10,0,0,22,nowin,win,dlbust,bust,20,0,12,216,0.393518519,0.037037037,0.555555556,0,0.018059873
17563,50,22928,3,7,4,0,0,14,2,10,10,0,0,22,nowin,win,dlbust,bust,20,0,10,202,0.405940594,0.04950495,0.54950495,0,0.020296079
17564,64,22928,10,10,0,0,0,20,2,10,10,0,0,22,nowin,win,dlbust,bust,20,0,20,187,0.363636364,0.048128342,0.631016043,0,0.027594885
17565,113,22928,10,10,0,0,0,20,2,10,10,0,0,22,nowin,win,dlbust,bust,20,0,20,199,0.407035176,0.055276382,0.668341709,2,0.620695264
17566,32,22928,10,8,0,0,0,18,2,10,10,0,0,22,nowin,win,dlbust,bust,20,0,18,189,0.391534392,0.037037037,0.53968254,0,0.013579086
17567,44,22928,10,9,0,0,0,19,2,10,10,0,0,22,nowin,win,dlbust,bust,20,0,19,219,0.433789954,0.050228311,0.534246575,1,0.285551035
17568,108,22929,6,7,0,3,2,18,10,5,4,0,0,19,nowin,loss,beat,dlwin,0,10,13,193,0.435233161,0.056994819,0.559585492,1,0.298824795
17569,112,22929,3,10,0,1,5,19,10,5,4,0,0,19,nowin,push,push,push,10,0,13,203,0.448275862,0.054187192,0.600985222,3,0.889576933
17570,16,22929,10,5,0,6,0,21,10,5,4,0,0,19,nowin,win,plwin,beat,20,0,15,220,0.427272727,0.081818182,0.6,2,0.588660176
17571,29,22929,9,3,0,7,0,19,10,5,4,0,0,19,nowin,push,push,push,10,0,12,189,0.44973545,0.058201058,0.544973545,1,0.300349439
17572,19,22929,10,9,0,0,0,19,10,5,4,0,0,19,nowin,push,push,push,10,0,19,237,0.41350211,0.054852321,0.628691983,2,0.597373826
17573,58,22929,4,9,0,5,0,18,10,5,4,0,0,19,nowin,loss,beat,dlwin,0,10,13,195,0.430769231,0.041025641,0.584615385,2,0.580497586
17574,58,22930,6,2,10,0,0,18,6,5,1,10,0,22,nowin,win,dlbust,bust,20,0,8,195,0.430769231,0.041025641,0.584615385,2,0.580497586
17575,136,22930,9,2,7,0,0,18,6,5,1,10,0,22,nowin,win,dlbust,bust,20,0,11,194,0.396907216,0.025773196,0.597938144,0,0.029452644
17576,53,22930,9,10,0,0,0,19,6,5,1,10,0,22,nowin,win,dlbust,bust,20,0,19,250,0.372,0.064,0.564,0,0.013687345
17577,147,22930,4,3,6,0,0,13,6,5,1,10,0,22,nowin,win,dlbust,bust,20,0,7,205,0.380487805,0.014634146,0.536585366,0,0.00951447
17578,8,22930,5,10,0,0,0,15,6,5,1,10,0,22,nowin,win,dlbust,bust,20,0,15,181,0.44198895,0.071823204,0.596685083,2,0.599438402
17579,61,22930,7,5,0,0,0,12,6,5,1,10,0,22,nowin,win,dlbust,bust,20,0,12,194,0.427835052,0.077319588,0.603092784,2,0.591437139
17580,87,22931,10,10,0,0,0,20,10,9,0,0,0,19,nowin,win,plwin,beat,20,0,20,202,0.405940594,0.054455446,0.628712871,2,0.590599801
17581,16,22931,2,2,10,10,0,24,10,9,0,0,0,19,nowin,loss,bust,plbust,0,10,4,220,0.427272727,0.081818182,0.6,2,0.588660176
17582,82,22931,10,10,0,0,0,20,10,9,0,0,0,19,nowin,win,plwin,beat,20,0,20,225,0.408888889,0.075555556,0.577777778,0,0.028101874
17583,52,22931,2,7,4,9,0,22,10,9,0,0,0,19,nowin,loss,bust,plbust,0,10,9,217,0.414746544,0.02764977,0.599078341,2,0.576736024
17584,2,22931,10,3,0,6,0,19,10,9,0,0,0,19,nowin,push,push,push,10,0,13,200,0.445,0.035,0.64,2,0.633962549
17585,17,22931,3,4,2,3,10,22,10,9,0,0,0,19,nowin,loss,bust,plbust,0,10,7,171,0.444444444,0.070175439,0.555555556,1,0.302364894
17586,71,22932,4,10,0,0,0,14,6,10,8,0,0,24,nowin,win,dlbust,bust,20,0,14,193,0.352331606,0.046632124,0.585492228,0,0.013063661
17587,92,22932,5,10,0,0,0,15,6,10,8,0,0,24,nowin,win,dlbust,bust,20,0,15,186,0.446236559,0.059139785,0.564516129,1,0.307826125
17588,32,22932,3,11,2,0,0,16,6,10,8,0,0,24,nowin,win,dlbust,bust,20,0,14,189,0.391534392,0.037037037,0.53968254,0,0.013579086
17589,6,22932,10,10,0,0,0,20,6,10,8,0,0,24,nowin,win,dlbust,bust,20,0,20,191,0.439790576,0.047120419,0.581151832,1,0.31211505
17590,125,22932,10,9,0,0,0,19,6,10,8,0,0,24,nowin,win,dlbust,bust,20,0,19,219,0.438356164,0.050228311,0.575342466,1,0.308411257
17591,84,22932,8,10,0,0,0,18,6,10,8,0,0,24,nowin,win,dlbust,bust,20,0,18,195,0.379487179,0.056410256,0.569230769,0,0.017209119
17592,34,22933,7,8,0,0,0,15,2,2,10,8,0,22,nowin,win,dlbust,bust,20,0,15,202,0.5,0.079207921,0.618811881,3,0.968961434
17593,3,22933,10,4,0,0,0,14,2,2,10,8,0,22,nowin,win,dlbust,bust,20,0,14,190,0.431578947,0.026315789,0.542105263,1,0.288076384
17594,90,22933,10,11,0,0,0,21,2,2,10,8,0,22,win,win,dlbust,bust,25,0,21,201,0.447761194,0.049751244,0.60199005,3,0.889945023
17595,105,22933,10,11,0,0,0,21,2,2,10,8,0,22,win,win,dlbust,bust,25,0,21,198,0.414141414,0.070707071,0.590909091,0,0.032889494
17596,45,22933,8,7,0,0,0,15,2,2,10,8,0,22,nowin,win,dlbust,bust,20,0,15,196,0.428571429,0.051020408,0.612244898,2,0.598821767
17597,3,22933,10,2,0,3,0,15,2,2,10,8,0,22,nowin,win,dlbust,bust,20,0,12,190,0.431578947,0.026315789,0.542105263,1,0.288076384
17598,90,22934,10,9,0,0,0,19,10,5,10,0,0,25,nowin,win,dlbust,bust,20,0,19,201,0.447761194,0.049751244,0.60199005,3,0.889945023
17599,11,22934,10,8,0,0,0,18,10,5,10,0,0,25,nowin,win,dlbust,bust,20,0,18,236,0.457627119,0.016949153,0.588983051,3,0.889015813
17600,62,22934,11,10,0,0,0,21,10,5,10,0,0,25,win,win,dlbust,bust,25,0,21,178,0.370786517,0.028089888,0.54494382,0,0.008657722
17601,9,22934,10,3,0,1,9,23,10,5,10,0,0,25,nowin,loss,bust,plbust,0,10,13,194,0.37628866,0.015463918,0.541237113,0,0.009396796
17602,32,22934,7,10,0,0,0,17,10,5,10,0,0,25,nowin,win,dlbust,bust,20,0,17,189,0.391534392,0.037037037,0.53968254,0,0.013579086
17603,39,22934,9,2,7,0,0,18,10,5,10,0,0,25,nowin,win,dlbust,bust,20,0,11,191,0.429319372,0.062827225,0.57591623,0,0.033760763
17604,21,22935,10,6,0,10,0,26,10,9,0,0,0,19,nowin,loss,bust,plbust,0,10,16,214,0.359813084,0.042056075,0.626168224,0,0.025263474
17605,92,22935,9,10,0,0,0,19,10,9,0,0,0,19,nowin,push,push,push,10,0,19,186,0.446236559,0.059139785,0.564516129,1,0.307826125
17606,32,22935,5,10,0,4,0,19,10,9,0,0,0,19,nowin,push,push,push,10,0,15,189,0.391534392,0.037037037,0.53968254,0,0.013579086
17607,58,22935,10,3,0,9,0,22,10,9,0,0,0,19,nowin,loss,bust,plbust,0,10,13,195,0.430769231,0.041025641,0.584615385,2,0.580497586
17608,77,22935,7,10,0,0,0,17,10,9,0,0,0,19,nowin,loss,beat,dlwin,0,10,17,200,0.455,0.04,0.62,3,0.916252116
17609,54,22935,2,9,10,0,0,21,10,9,0,0,0,19,nowin,win,plwin,beat,20,0,11,185,0.437837838,0.032432432,0.556756757,1,0.29899854
17610,47,22936,6,5,3,10,0,24,11,8,0,0,0,19,nowin,loss,bust,plbust,0,10,11,210,0.438095238,0.057142857,0.623809524,2,0.615868808
17611,43,22936,10,10,0,0,0,20,11,8,0,0,0,19,nowin,win,plwin,beat,20,0,20,192,0.40625,0.041666667,0.609375,2,0.576671372
17612,8,22936,2,3,3,9,0,17,11,8,0,0,0,19,nowin,loss,beat,dlwin,0,10,5,181,0.44198895,0.071823204,0.596685083,2,0.599438402
17613,84,22936,4,3,9,7,0,23,11,8,0,0,0,19,nowin,loss,bust,plbust,0,10,7,195,0.379487179,0.056410256,0.569230769,0,0.017209119
17614,85,22936,8,5,0,8,0,21,11,8,0,0,0,19,nowin,win,plwin,beat,20,0,13,195,0.41025641,0.066666667,0.594871795,0,0.03269711
17615,129,22936,3,2,9,8,0,22,11,8,0,0,0,19,nowin,loss,bust,plbust,0,10,5,201,0.422885572,0.064676617,0.55721393,0,0.027255383
17616,53,22937,10,5,0,4,0,19,10,10,0,0,0,20,nowin,loss,beat,dlwin,0,10,15,250,0.372,0.064,0.564,0,0.013687345
17617,55,22937,4,3,10,0,0,17,10,10,0,0,0,20,nowin,loss,beat,dlwin,0,10,7,191,0.371727749,0.057591623,0.54973822,0,0.01011347
17618,114,22937,10,8,0,0,0,18,10,10,0,0,0,20,nowin,loss,beat,dlwin,0,10,18,198,0.47979798,0.025252525,0.611111111,3,0.937232995
17619,131,22937,10,10,0,0,0,20,10,10,0,0,0,20,nowin,push,push,push,10,0,20,217,0.410138249,0.069124424,0.543778802,0,0.02015021
17620,79,22937,10,10,0,0,0,20,10,10,0,0,0,20,nowin,push,push,push,10,0,20,211,0.436018957,0.028436019,0.672985782,2,0.650131054
17621,141,22937,10,9,0,0,0,19,10,10,0,0,0,20,nowin,loss,beat,dlwin,0,10,19,202,0.420792079,0.074257426,0.564356436,0,0.028377851
17622,116,22938,3,10,0,9,0,22,10,3,9,0,0,22,nowin,loss,bust,plbust,0,10,13,195,0.425641026,0.056410256,0.538461538,1,0.28273747
17623,150,22938,4,10,0,10,0,24,10,3,9,0,0,22,nowin,loss,bust,plbust,0,10,14,192,0.401041667,0.036458333,0.567708333,0,0.023287458
17624,93,22938,10,2,0,7,0,19,10,3,9,0,0,22,nowin,win,dlbust,bust,20,0,12,175,0.485714286,0.051428571,0.548571429,1,0.323648091
17625,142,22938,1,4,10,1,5,21,10,3,9,0,0,22,nowin,win,dlbust,bust,20,0,5,211,0.417061611,0.047393365,0.526066351,1,0.271531309
17626,32,22938,4,10,0,2,6,22,10,3,9,0,0,22,nowin,loss,bust,plbust,0,10,14,189,0.391534392,0.037037037,0.53968254,0,0.013579086
17627,51,22938,10,2,0,10,0,22,10,3,9,0,0,22,nowin,loss,bust,plbust,0,10,12,189,0.529100529,0.068783069,0.608465608,3,0.993665715
17628,88,22939,1,2,10,0,0,13,3,7,10,0,0,20,nowin,loss,beat,dlwin,0,10,3,206,0.466019417,0.033980583,0.54368932,1,0.309467903
17629,103,22939,10,3,0,0,0,13,3,7,10,0,0,20,nowin,loss,beat,dlwin,0,10,13,203,0.379310345,0.064039409,0.551724138,0,0.012869209
17630,141,22939,10,3,0,0,0,13,3,7,10,0,0,20,nowin,loss,beat,dlwin,0,10,13,202,0.420792079,0.074257426,0.564356436,0,0.028377851
17631,49,22939,10,10,0,0,0,20,3,7,10,0,0,20,nowin,push,push,push,10,0,20,207,0.396135266,0.053140097,0.594202899,0,0.028306925
17632,7,22939,10,11,0,0,0,21,3,7,10,0,0,20,win,win,plwin,beat,25,0,21,183,0.442622951,0.06010929,0.62295082,2,0.619303341
17633,59,22939,10,2,0,9,0,21,3,7,10,0,0,20,nowin,win,plwin,beat,20,0,12,228,0.429824561,0.048245614,0.543859649,1,0.287885446
17634,99,22940,7,2,8,0,0,17,11,9,0,0,0,20,nowin,loss,beat,dlwin,0,10,9,207,0.47826087,0.062801932,0.637681159,3,0.961418446
17635,54,22940,7,9,0,10,0,26,11,9,0,0,0,20,nowin,loss,bust,plbust,0,10,16,185,0.437837838,0.032432432,0.556756757,1,0.29899854
17636,62,22940,6,9,0,2,0,17,11,9,0,0,0,20,nowin,loss,beat,dlwin,0,10,15,178,0.370786517,0.028089888,0.54494382,0,0.008657722
17637,61,22940,11,10,0,0,0,21,11,9,0,0,0,20,win,win,plwin,beat,25,0,21,194,0.427835052,0.077319588,0.603092784,2,0.591437139
17638,52,22940,4,8,0,8,0,20,11,9,0,0,0,20,nowin,push,push,push,10,0,12,217,0.414746544,0.02764977,0.599078341,2,0.576736024
17639,84,22940,10,9,0,0,0,19,11,9,0,0,0,20,nowin,loss,beat,dlwin,0,10,19,195,0.379487179,0.056410256,0.569230769,0,0.017209119
17640,20,22941,5,10,0,10,0,25,10,10,0,0,0,20,nowin,loss,bust,plbust,0,10,15,186,0.456989247,0.037634409,0.537634409,1,0.301097108
17641,106,22941,10,9,0,0,0,19,10,10,0,0,0,20,nowin,loss,beat,dlwin,0,10,19,192,0.411458333,0.026041667,0.557291667,0,0.023854304
17642,86,22941,2,9,4,5,0,20,10,10,0,0,0,20,nowin,push,push,push,10,0,11,196,0.454081633,0.040816327,0.591836735,3,0.887566443
17643,62,22941,3,10,0,10,0,23,10,10,0,0,0,20,nowin,loss,bust,plbust,0,10,13,178,0.370786517,0.028089888,0.54494382,0,0.008657722
17644,70,22941,6,6,0,1,10,23,10,10,0,0,0,20,nowin,loss,bust,plbust,0,10,12,228,0.385964912,0.039473684,0.557017544,0,0.016157125
17645,92,22941,10,9,0,0,0,19,10,10,0,0,0,20,nowin,loss,beat,dlwin,0,10,19,186,0.446236559,0.059139785,0.564516129,1,0.307826125
17646,71,22942,10,6,0,2,0,18,10,6,4,0,0,20,nowin,loss,beat,dlwin,0,10,16,193,0.352331606,0.046632124,0.585492228,0,0.013063661
17647,83,22942,10,7,0,0,0,17,10,6,4,0,0,20,nowin,loss,beat,dlwin,0,10,17,193,0.424870466,0.051813472,0.678756477,2,0.644360335
17648,98,22942,10,9,0,0,0,19,10,6,4,0,0,20,nowin,loss,beat,dlwin,0,10,19,220,0.422727273,0.054545455,0.55,1,0.28664435
17649,130,22942,10,8,0,0,0,18,10,6,4,0,0,20,nowin,loss,beat,dlwin,0,10,18,219,0.410958904,0.03652968,0.566210046,0,0.025888739
17650,142,22942,10,10,0,0,0,20,10,6,4,0,0,20,nowin,push,push,push,10,0,20,211,0.417061611,0.047393365,0.526066351,1,0.271531309
17651,107,22942,10,5,0,9,0,24,10,6,4,0,0,20,nowin,loss,bust,plbust,0,10,15,218,0.444954128,0.073394495,0.600917431,2,0.605210014
17652,142,22943,9,6,0,0,0,15,5,10,5,0,0,20,nowin,loss,beat,dlwin,0,10,15,211,0.417061611,0.047393365,0.526066351,1,0.271531309
17653,21,22943,10,10,0,0,0,20,5,10,5,0,0,20,nowin,push,push,push,10,0,20,214,0.359813084,0.042056075,0.626168224,0,0.025263474
17654,129,22943,3,11,3,0,0,17,5,10,5,0,0,20,nowin,loss,beat,dlwin,0,10,14,201,0.422885572,0.064676617,0.55721393,0,0.027255383
17655,118,22943,9,4,0,0,0,13,5,10,5,0,0,20,nowin,loss,beat,dlwin,0,10,13,216,0.393518519,0.037037037,0.555555556,0,0.018059873
17656,22,22943,6,10,0,0,0,16,5,10,5,0,0,20,nowin,loss,beat,dlwin,0,10,16,187,0.481283422,0.042780749,0.577540107,3,0.906128176
17657,71,22943,11,10,0,0,0,21,5,10,5,0,0,20,win,win,plwin,beat,25,0,21,193,0.352331606,0.046632124,0.585492228,0,0.013063661
17658,88,22944,2,10,0,0,0,12,4,7,7,0,0,18,nowin,loss,beat,dlwin,0,10,12,206,0.466019417,0.033980583,0.54368932,1,0.309467903
17659,66,22944,10,8,0,0,0,18,4,7,7,0,0,18,nowin,push,push,push,10,0,18,217,0.456221198,0.064516129,0.626728111,3,0.924304367
17660,143,22944,3,6,2,4,0,15,4,7,7,0,0,18,nowin,loss,beat,dlwin,0,10,9,203,0.463054187,0.044334975,0.57635468,3,0.883143365
17661,133,22944,5,8,0,0,0,13,4,7,7,0,0,18,nowin,loss,beat,dlwin,0,10,13,201,0.47761194,0.064676617,0.611940299,3,0.935428111
17662,10,22944,10,2,0,0,0,12,4,7,7,0,0,18,nowin,loss,beat,dlwin,0,10,12,191,0.413612565,0.057591623,0.596858639,2,0.574087175
17663,16,22944,8,3,9,0,0,20,4,7,7,0,0,18,nowin,win,plwin,beat,20,0,11,220,0.427272727,0.081818182,0.6,2,0.588660176
17664,78,22945,10,8,0,0,0,18,10,10,0,0,0,20,nowin,loss,beat,dlwin,0,10,18,201,0.517412935,0.034825871,0.587064677,3,0.95871112
17665,19,22945,10,2,0,3,10,25,10,10,0,0,0,20,nowin,loss,bust,plbust,0,10,12,237,0.41350211,0.054852321,0.628691983,2,0.597373826
17666,113,22945,10,8,0,0,0,18,10,10,0,0,0,20,nowin,loss,beat,dlwin,0,10,18,199,0.407035176,0.055276382,0.668341709,2,0.620695264
17667,114,22945,8,3,9,0,0,20,10,10,0,0,0,20,nowin,push,push,push,10,0,11,198,0.47979798,0.025252525,0.611111111,3,0.937232995
17668,46,22945,5,10,0,10,0,25,10,10,0,0,0,20,nowin,loss,bust,plbust,0,10,15,186,0.403225806,0.048387097,0.591397849,0,0.029742194
17669,5,22945,10,8,0,0,0,18,10,10,0,0,0,20,nowin,loss,beat,dlwin,0,10,18,203,0.42364532,0.02955665,0.596059113,2,0.582508076
17670,137,22946,11,10,0,0,0,21,2,10,2,5,0,19,win,win,plwin,beat,25,0,21,194,0.417525773,0.046391753,0.536082474,1,0.276714602
17671,24,22946,7,6,0,0,0,13,2,10,2,5,0,19,nowin,loss,beat,dlwin,0,10,13,207,0.458937198,0.048309179,0.570048309,1,0.318138014
17672,57,22946,4,9,0,0,0,13,2,10,2,5,0,19,nowin,loss,beat,dlwin,0,10,13,192,0.46875,0.052083333,0.59375,3,0.907001181
17673,76,22946,10,6,0,0,0,16,2,10,2,5,0,19,nowin,loss,beat,dlwin,0,10,16,189,0.534391534,0.079365079,0.608465608,3,1
17674,51,22946,2,10,0,8,0,20,2,10,2,5,0,19,nowin,win,plwin,beat,20,0,12,189,0.529100529,0.068783069,0.608465608,3,0.993665715
17675,17,22946,11,10,0,0,0,21,2,10,2,5,0,19,win,win,plwin,beat,25,0,21,171,0.444444444,0.070175439,0.555555556,1,0.302364894
17676,29,22947,8,10,0,0,0,18,10,7,0,0,0,17,nowin,win,plwin,beat,20,0,18,189,0.44973545,0.058201058,0.544973545,1,0.300349439
17677,139,22947,4,7,6,0,0,17,10,7,0,0,0,17,nowin,push,push,push,10,0,11,192,0.380208333,0.036458333,0.59375,0,0.023429169
17678,67,22947,3,3,9,9,0,24,10,7,0,0,0,17,nowin,loss,bust,plbust,0,10,6,195,0.369230769,0.041025641,0.569230769,0,0.014139427
17679,16,22947,10,11,0,0,0,21,10,7,0,0,0,17,win,win,plwin,beat,25,0,21,220,0.427272727,0.081818182,0.6,2,0.588660176
17680,16,22947,5,5,7,0,0,17,10,7,0,0,0,17,nowin,push,push,push,10,0,10,220,0.427272727,0.081818182,0.6,2,0.588660176
17681,43,22947,8,8,0,1,0,17,10,7,0,0,0,17,nowin,push,push,push,10,0,16,192,0.40625,0.041666667,0.609375,2,0.576671372
17682,7,22948,6,6,0,5,0,17,2,10,8,0,0,20,nowin,loss,beat,dlwin,0,10,12,183,0.442622951,0.06010929,0.62295082,2,0.619303341
17683,99,22948,2,1,10,0,0,13,2,10,8,0,0,20,nowin,loss,beat,dlwin,0,10,3,207,0.47826087,0.062801932,0.637681159,3,0.961418446
17684,82,22948,10,8,0,0,0,18,2,10,8,0,0,20,nowin,loss,beat,dlwin,0,10,18,225,0.408888889,0.075555556,0.577777778,0,0.028101874
17685,119,22948,1,1,10,10,0,22,2,10,8,0,0,20,nowin,loss,bust,plbust,0,10,2,190,0.405263158,0.068421053,0.515789474,0,0.011837158
17686,150,22948,6,10,0,0,0,16,2,10,8,0,0,20,nowin,loss,beat,dlwin,0,10,16,192,0.401041667,0.036458333,0.567708333,0,0.023287458
17687,134,22948,4,9,0,0,0,13,2,10,8,0,0,20,nowin,loss,beat,dlwin,0,10,13,185,0.443243243,0.021621622,0.545945946,1,0.296939509
17688,120,22949,6,10,0,10,0,26,10,10,0,0,0,20,nowin,loss,bust,plbust,0,10,16,202,0.440594059,0.034653465,0.618811881,2,0.614441029
17689,15,22949,9,10,0,0,0,19,10,10,0,0,0,20,nowin,loss,beat,dlwin,0,10,19,212,0.410377358,0.051886792,0.561320755,0,0.024517408
17690,29,22949,5,3,4,10,0,22,10,10,0,0,0,20,nowin,loss,bust,plbust,0,10,8,189,0.44973545,0.058201058,0.544973545,1,0.300349439
17691,15,22949,4,3,2,8,0,17,10,10,0,0,0,20,nowin,loss,beat,dlwin,0,10,7,212,0.410377358,0.051886792,0.561320755,0,0.024517408
17692,23,22949,9,7,0,3,0,19,10,10,0,0,0,20,nowin,loss,beat,dlwin,0,10,16,208,0.427884615,0.0625,0.552884615,1,0.29114424
17693,74,22949,5,10,0,6,0,21,10,10,0,0,0,20,nowin,win,plwin,beat,20,0,15,209,0.411483254,0.04784689,0.531100478,0,0.017448125
17694,88,22950,11,10,0,0,0,21,9,11,0,0,0,20,win,win,plwin,beat,25,0,21,206,0.466019417,0.033980583,0.54368932,1,0.309467903
17695,1,22950,5,1,10,4,0,20,9,11,0,0,0,20,nowin,push,push,push,10,0,6,197,0.406091371,0.025380711,0.649746193,2,0.606186955
17696,61,22950,10,10,0,0,0,20,9,11,0,0,0,20,nowin,push,push,push,10,0,20,194,0.427835052,0.077319588,0.603092784,2,0.591437139
17697,46,22950,5,10,0,4,0,19,9,11,0,0,0,20,nowin,loss,beat,dlwin,0,10,15,186,0.403225806,0.048387097,0.591397849,0,0.029742194
17698,53,22950,6,10,0,10,0,26,9,11,0,0,0,20,nowin,loss,bust,plbust,0,10,16,250,0.372,0.064,0.564,0,0.013687345
17699,70,22950,9,4,0,10,0,23,9,11,0,0,0,20,nowin,loss,bust,plbust,0,10,13,228,0.385964912,0.039473684,0.557017544,0,0.016157125
17700,25,22951,6,6,0,8,0,20,9,8,0,0,0,17,nowin,win,plwin,beat,20,0,12,190,0.463157895,0.063157895,0.536842105,1,0.304401563
17701,99,22951,8,7,0,10,0,25,9,8,0,0,0,17,nowin,loss,bust,plbust,0,10,15,207,0.47826087,0.062801932,0.637681159,3,0.961418446
17702,138,22951,10,2,0,9,0,21,9,8,0,0,0,17,nowin,win,plwin,beat,20,0,12,190,0.442105263,0.047368421,0.610526316,2,0.609711065
17703,35,22951,9,10,0,0,0,19,9,8,0,0,0,17,nowin,win,plwin,beat,20,0,19,202,0.410891089,0.044554455,0.633663366,2,0.598681573
17704,131,22951,10,10,0,0,0,20,9,8,0,0,0,17,nowin,win,plwin,beat,20,0,20,217,0.410138249,0.069124424,0.543778802,0,0.02015021
17705,129,22951,10,8,0,0,0,18,9,8,0,0,0,17,nowin,win,plwin,beat,20,0,18,201,0.422885572,0.064676617,0.55721393,0,0.027255383
17706,34,22952,1,4,8,0,0,13,6,11,0,0,0,17,nowin,loss,beat,dlwin,0,10,5,202,0.5,0.079207921,0.618811881,3,0.968961434
17707,144,22952,3,10,0,0,0,13,6,11,0,0,0,17,nowin,loss,beat,dlwin,0,10,13,202,0.386138614,0.054455446,0.564356436,0,0.018006244
17708,36,22952,10,10,0,0,0,20,6,11,0,0,0,17,nowin,win,plwin,beat,20,0,20,229,0.445414847,0.056768559,0.655021834,2,0.645370571
17709,63,22952,11,8,0,0,0,19,6,11,0,0,0,17,nowin,win,plwin,beat,20,0,19,216,0.467592593,0.037037037,0.62037037,3,0.931690496
17710,23,22952,10,3,0,0,0,13,6,11,0,0,0,17,nowin,loss,beat,dlwin,0,10,13,208,0.427884615,0.0625,0.552884615,1,0.29114424
17711,61,22952,11,7,0,0,0,18,6,11,0,0,0,17,nowin,win,plwin,beat,20,0,18,194,0.427835052,0.077319588,0.603092784,2,0.591437139
17712,9,22953,7,8,0,0,0,15,2,9,10,0,0,21,nowin,loss,beat,dlwin,0,10,15,194,0.37628866,0.015463918,0.541237113,0,0.009396796
17713,79,22953,7,10,0,0,0,17,2,9,10,0,0,21,nowin,loss,beat,dlwin,0,10,17,211,0.436018957,0.028436019,0.672985782,2,0.650131054
17714,2,22953,7,10,0,0,0,17,2,9,10,0,0,21,nowin,loss,beat,dlwin,0,10,17,200,0.445,0.035,0.64,2,0.633962549
17715,100,22953,4,6,11,0,0,21,2,9,10,0,0,21,nowin,push,push,push,10,0,10,190,0.452631579,0.036842105,0.594736842,3,0.888671154
17716,18,22953,10,7,0,0,0,17,2,9,10,0,0,21,nowin,loss,beat,dlwin,0,10,17,182,0.461538462,0.043956044,0.587912088,3,0.892649374
17717,100,22953,2,10,0,3,0,15,2,9,10,0,0,21,nowin,loss,beat,dlwin,0,10,12,190,0.452631579,0.036842105,0.594736842,3,0.888671154
17718,65,22954,6,10,0,10,0,26,10,7,0,0,0,17,nowin,loss,bust,plbust,0,10,16,203,0.492610837,0.054187192,0.571428571,3,0.913702814
17719,135,22954,3,10,0,2,10,25,10,7,0,0,0,17,nowin,loss,bust,plbust,0,10,13,179,0.391061453,0.067039106,0.586592179,0,0.024924662
17720,37,22954,6,10,0,8,0,24,10,7,0,0,0,17,nowin,loss,bust,plbust,0,10,16,208,0.394230769,0.038461538,0.581730769,0,0.024682772
17721,75,22954,9,10,0,0,0,19,10,7,0,0,0,17,nowin,win,plwin,beat,20,0,19,191,0.418848168,0.052356021,0.570680628,0,0.029344702
17722,32,22954,6,10,0,1,0,17,10,7,0,0,0,17,nowin,push,push,push,10,0,16,189,0.391534392,0.037037037,0.53968254,0,0.013579086
17723,113,22954,10,7,0,0,0,17,10,7,0,0,0,17,nowin,push,push,push,10,0,17,199,0.407035176,0.055276382,0.668341709,2,0.620695264
17724,121,22955,8,10,0,0,0,18,8,8,1,0,0,17,nowin,win,plwin,beat,20,0,18,195,0.456410256,0.025641026,0.512820513,1,0.288597791
17725,58,22955,9,5,0,2,10,26,8,8,1,0,0,17,nowin,loss,bust,plbust,0,10,14,195,0.430769231,0.041025641,0.584615385,2,0.580497586
17726,90,22955,1,6,10,0,0,17,8,8,1,0,0,17,nowin,push,push,push,10,0,7,201,0.447761194,0.049751244,0.60199005,3,0.889945023
17727,17,22955,10,5,0,10,0,25,8,8,1,0,0,17,nowin,loss,bust,plbust,0,10,15,171,0.444444444,0.070175439,0.555555556,1,0.302364894
17728,109,22955,9,4,0,8,0,21,8,8,1,0,0,17,nowin,win,plwin,beat,20,0,13,221,0.461538462,0.058823529,0.597285068,3,0.901830309
17729,149,22955,11,10,0,0,0,21,8,8,1,0,0,17,win,win,plwin,beat,25,0,21,225,0.457777778,0.057777778,0.648888889,2,0.651965595
17730,25,22956,10,4,0,10,0,24,7,9,3,0,0,19,nowin,loss,bust,plbust,0,10,14,190,0.463157895,0.063157895,0.536842105,1,0.304401563
17731,90,22956,3,10,0,2,9,24,7,9,3,0,0,19,nowin,loss,bust,plbust,0,10,13,201,0.447761194,0.049751244,0.60199005,3,0.889945023
17732,24,22956,9,10,0,0,0,19,7,9,3,0,0,19,nowin,push,push,push,10,0,19,207,0.458937198,0.048309179,0.570048309,1,0.318138014
17733,109,22956,7,10,0,0,0,17,7,9,3,0,0,19,nowin,loss,beat,dlwin,0,10,17,221,0.461538462,0.058823529,0.597285068,3,0.901830309
17734,120,22956,4,10,0,9,0,23,7,9,3,0,0,19,nowin,loss,bust,plbust,0,10,14,202,0.440594059,0.034653465,0.618811881,2,0.614441029
17735,114,22956,10,3,0,7,0,20,7,9,3,0,0,19,nowin,win,plwin,beat,20,0,13,198,0.47979798,0.025252525,0.611111111,3,0.937232995
17736,94,22957,5,2,6,6,0,19,7,6,1,10,0,24,nowin,win,dlbust,bust,20,0,7,183,0.43715847,0.043715847,0.540983607,1,0.290866892
17737,64,22957,10,3,0,5,0,18,7,6,1,10,0,24,nowin,win,dlbust,bust,20,0,13,187,0.363636364,0.048128342,0.631016043,0,0.027594885
17738,122,22957,10,5,0,10,0,25,7,6,1,10,0,24,nowin,loss,bust,plbust,0,10,15,210,0.347619048,0.052380952,0.59047619,0,0.012873677
17739,121,22957,3,10,0,6,0,19,7,6,1,10,0,24,nowin,win,dlbust,bust,20,0,13,195,0.456410256,0.025641026,0.512820513,1,0.288597791
17740,14,22957,7,10,0,0,0,17,7,6,1,10,0,24,nowin,win,dlbust,bust,20,0,17,202,0.391089109,0.01980198,0.628712871,2,0.577264877
17741,12,22957,4,10,0,5,0,19,7,6,1,10,0,24,nowin,win,dlbust,bust,20,0,14,189,0.470899471,0.015873016,0.613756614,3,0.929171178
17742,4,22958,2,10,0,4,10,26,7,10,0,0,0,17,nowin,loss,bust,plbust,0,10,12,217,0.460829493,0.036866359,0.562211982,1,0.315432839
17743,96,22958,9,10,0,0,0,19,7,10,0,0,0,17,nowin,win,plwin,beat,20,0,19,190,0.468421053,0.057894737,0.584210526,3,0.897263354
17744,101,22958,8,7,0,10,0,25,7,10,0,0,0,17,nowin,loss,bust,plbust,0,10,15,205,0.424390244,0.068292683,0.63902439,2,0.614740646
17745,51,22958,9,5,0,9,0,23,7,10,0,0,0,17,nowin,loss,bust,plbust,0,10,14,189,0.529100529,0.068783069,0.608465608,3,0.993665715
17746,107,22958,2,9,10,0,0,21,7,10,0,0,0,17,nowin,win,plwin,beat,20,0,11,218,0.444954128,0.073394495,0.600917431,2,0.605210014
17747,104,22958,11,10,0,0,0,21,7,10,0,0,0,17,win,win,plwin,beat,25,0,21,209,0.363636364,0.052631579,0.593301435,0,0.018359419
17748,95,22959,5,9,0,10,0,24,11,10,0,0,0,21,nowin,loss,bust,plbust,0,10,14,218,0.412844037,0.04587156,0.559633028,0,0.024842385
17749,23,22959,6,10,0,8,0,24,11,10,0,0,0,21,nowin,loss,bust,plbust,0,10,16,208,0.427884615,0.0625,0.552884615,1,0.29114424
17750,85,22959,8,3,10,0,0,21,11,10,0,0,0,21,nowin,push,push,push,10,0,11,195,0.41025641,0.066666667,0.594871795,0,0.03269711
17751,73,22959,6,6,0,1,10,23,11,10,0,0,0,21,nowin,loss,bust,plbust,0,10,12,181,0.375690608,0.011049724,0.596685083,0,0.022795773
17752,88,22959,10,10,0,0,0,20,11,10,0,0,0,21,nowin,loss,beat,dlwin,0,10,20,206,0.466019417,0.033980583,0.54368932,1,0.309467903
17753,93,22959,7,10,0,0,0,17,11,10,0,0,0,21,nowin,loss,beat,dlwin,0,10,17,175,0.485714286,0.051428571,0.548571429,1,0.323648091
17754,9,22960,10,2,0,3,1,16,10,11,0,0,0,21,nowin,loss,beat,dlwin,0,10,12,194,0.37628866,0.015463918,0.541237113,0,0.009396796
17755,47,22960,2,10,0,10,0,22,10,11,0,0,0,21,nowin,loss,bust,plbust,0,10,12,210,0.438095238,0.057142857,0.623809524,2,0.615868808
17756,136,22960,10,5,0,5,0,20,10,11,0,0,0,21,nowin,loss,beat,dlwin,0,10,15,194,0.396907216,0.025773196,0.597938144,0,0.029452644
17757,53,22960,10,10,0,0,0,20,10,11,0,0,0,21,nowin,loss,beat,dlwin,0,10,20,250,0.372,0.064,0.564,0,0.013687345
17758,5,22960,7,10,0,0,0,17,10,11,0,0,0,21,nowin,loss,beat,dlwin,0,10,17,203,0.42364532,0.02955665,0.596059113,2,0.582508076
17759,54,22960,9,10,0,0,0,19,10,11,0,0,0,21,nowin,loss,beat,dlwin,0,10,19,185,0.437837838,0.032432432,0.556756757,1,0.29899854
17760,105,22961,3,4,9,3,0,19,10,11,0,0,0,21,nowin,loss,beat,dlwin,0,10,7,198,0.414141414,0.070707071,0.590909091,0,0.032889494
17761,78,22961,8,4,0,2,7,21,10,11,0,0,0,21,nowin,push,push,push,10,0,12,201,0.517412935,0.034825871,0.587064677,3,0.95871112
17762,119,22961,5,11,4,0,0,20,10,11,0,0,0,21,nowin,loss,beat,dlwin,0,10,16,190,0.405263158,0.068421053,0.515789474,0,0.011837158
17763,144,22961,10,4,0,10,0,24,10,11,0,0,0,21,nowin,loss,bust,plbust,0,10,14,202,0.386138614,0.054455446,0.564356436,0,0.018006244
17764,32,22961,2,9,1,10,0,22,10,11,0,0,0,21,nowin,loss,bust,plbust,0,10,11,189,0.391534392,0.037037037,0.53968254,0,0.013579086
17765,45,22961,3,3,10,10,0,26,10,11,0,0,0,21,nowin,loss,bust,plbust,0,10,6,196,0.428571429,0.051020408,0.612244898,2,0.598821767
17766,127,22962,10,9,0,0,0,19,2,10,6,0,0,18,nowin,win,plwin,beat,20,0,19,201,0.402985075,0.029850746,0.60199005,0,0.032263937
17767,101,22962,3,2,4,3,8,20,2,10,6,0,0,18,nowin,win,plwin,beat,20,0,5,205,0.424390244,0.068292683,0.63902439,2,0.614740646
17768,24,22962,10,10,0,0,0,20,2,10,6,0,0,18,nowin,win,plwin,beat,20,0,20,207,0.458937198,0.048309179,0.570048309,1,0.318138014
17769,71,22962,10,4,0,0,0,14,2,10,6,0,0,18,nowin,loss,beat,dlwin,0,10,14,193,0.352331606,0.046632124,0.585492228,0,0.013063661
17770,7,22962,10,8,0,0,0,18,2,10,6,0,0,18,nowin,push,push,push,10,0,18,183,0.442622951,0.06010929,0.62295082,2,0.619303341
17771,62,22962,7,5,0,10,0,22,2,10,6,0,0,18,nowin,loss,bust,plbust,0,10,12,178,0.370786517,0.028089888,0.54494382,0,0.008657722
17772,141,22963,5,9,0,10,0,24,10,10,0,0,0,20,nowin,loss,bust,plbust,0,10,14,202,0.420792079,0.074257426,0.564356436,0,0.028377851
17773,14,22963,6,6,0,1,7,20,10,10,0,0,0,20,nowin,push,push,push,10,0,12,202,0.391089109,0.01980198,0.628712871,2,0.577264877
17774,132,22963,2,3,11,1,0,17,10,10,0,0,0,20,nowin,loss,beat,dlwin,0,10,5,194,0.412371134,0.036082474,0.649484536,2,0.611633238
17775,143,22963,8,10,0,0,0,18,10,10,0,0,0,20,nowin,loss,beat,dlwin,0,10,18,203,0.463054187,0.044334975,0.57635468,3,0.883143365
17776,64,22963,10,3,0,8,0,21,10,10,0,0,0,20,nowin,win,plwin,beat,20,0,13,187,0.363636364,0.048128342,0.631016043,0,0.027594885
17777,10,22963,2,10,0,4,1,17,10,10,0,0,0,20,nowin,loss,beat,dlwin,0,10,12,191,0.413612565,0.057591623,0.596858639,2,0.574087175
17778,66,22964,8,10,0,0,0,18,7,11,0,0,0,18,nowin,push,push,push,10,0,18,217,0.456221198,0.064516129,0.626728111,3,0.924304367
17779,6,22964,8,3,1,8,0,20,7,11,0,0,0,18,nowin,win,plwin,beat,20,0,11,191,0.439790576,0.047120419,0.581151832,1,0.31211505
17780,117,22964,6,4,10,0,0,20,7,11,0,0,0,18,nowin,win,plwin,beat,20,0,10,173,0.410404624,0.069364162,0.606936416,2,0.578610282
17781,48,22964,10,10,0,0,0,20,7,11,0,0,0,18,nowin,win,plwin,beat,20,0,20,203,0.413793103,0.019704433,0.600985222,2,0.577280801
17782,144,22964,7,5,0,10,0,22,7,11,0,0,0,18,nowin,loss,bust,plbust,0,10,12,202,0.386138614,0.054455446,0.564356436,0,0.018006244
17783,147,22964,10,8,0,0,0,18,7,11,0,0,0,18,nowin,push,push,push,10,0,18,205,0.380487805,0.014634146,0.536585366,0,0.00951447
17784,146,22965,6,3,7,4,0,20,10,8,0,0,0,18,nowin,win,plwin,beat,20,0,9,221,0.43438914,0.040723982,0.542986425,1,0.290190091
17785,63,22965,3,7,10,0,0,20,10,8,0,0,0,18,nowin,win,plwin,beat,20,0,10,216,0.467592593,0.037037037,0.62037037,3,0.931690496
17786,82,22965,10,11,0,0,0,21,10,8,0,0,0,18,win,win,plwin,beat,25,0,21,225,0.408888889,0.075555556,0.577777778,0,0.028101874
17787,60,22965,10,7,0,0,0,17,10,8,0,0,0,18,nowin,loss,beat,dlwin,0,10,17,227,0.418502203,0.022026432,0.559471366,0,0.026496258
17788,98,22965,2,5,6,6,0,19,10,8,0,0,0,18,nowin,win,plwin,beat,20,0,7,220,0.422727273,0.054545455,0.55,1,0.28664435
17789,85,22965,9,7,0,2,0,18,10,8,0,0,0,18,nowin,push,push,push,10,0,16,195,0.41025641,0.066666667,0.594871795,0,0.03269711
17790,149,22966,11,6,2,0,0,19,4,4,5,1,1,15,nowin,win,plwin,beat,20,0,17,225,0.457777778,0.057777778,0.648888889,2,0.651965595
17791,130,22966,2,3,4,10,0,19,4,4,5,1,1,15,nowin,win,plwin,beat,20,0,5,219,0.410958904,0.03652968,0.566210046,0,0.025888739
17792,95,22966,3,8,10,0,0,21,4,4,5,1,1,15,nowin,win,plwin,beat,20,0,11,218,0.412844037,0.04587156,0.559633028,0,0.024842385
17793,47,22966,6,6,0,0,0,12,4,4,5,1,1,15,nowin,loss,beat,dlwin,0,10,12,210,0.438095238,0.057142857,0.623809524,2,0.615868808
17794,96,22966,4,3,6,0,0,13,4,4,5,1,1,15,nowin,loss,beat,dlwin,0,10,7,190,0.468421053,0.057894737,0.584210526,3,0.897263354
17795,146,22966,10,6,0,0,0,16,4,4,5,1,1,15,nowin,win,plwin,beat,20,0,16,221,0.43438914,0.040723982,0.542986425,1,0.290190091
17796,33,22967,2,5,11,0,0,18,8,11,0,0,0,19,nowin,loss,beat,dlwin,0,10,7,192,0.4375,0.057291667,0.625,2,0.616208916
17797,133,22967,10,10,0,0,0,20,8,11,0,0,0,19,nowin,win,plwin,beat,20,0,20,201,0.47761194,0.064676617,0.611940299,3,0.935428111
17798,97,22967,7,11,0,0,0,18,8,11,0,0,0,19,nowin,loss,beat,dlwin,0,10,18,182,0.450549451,0.06043956,0.692307692,2,0.677372279
17799,23,22967,10,3,0,10,0,23,8,11,0,0,0,19,nowin,loss,bust,plbust,0,10,13,208,0.427884615,0.0625,0.552884615,1,0.29114424
17800,109,22967,7,2,10,0,0,19,8,11,0,0,0,19,nowin,push,push,push,10,0,9,221,0.461538462,0.058823529,0.597285068,3,0.901830309
17801,141,22967,2,3,4,6,2,17,8,11,0,0,0,19,nowin,loss,beat,dlwin,0,10,5,202,0.420792079,0.074257426,0.564356436,0,0.028377851
17802,5,22968,10,2,0,3,9,24,10,11,0,0,0,21,nowin,loss,bust,plbust,0,10,12,203,0.42364532,0.02955665,0.596059113,2,0.582508076
17803,85,22968,5,1,6,8,0,20,10,11,0,0,0,21,nowin,loss,beat,dlwin,0,10,6,195,0.41025641,0.066666667,0.594871795,0,0.03269711
17804,18,22968,2,11,6,0,0,19,10,11,0,0,0,21,nowin,loss,beat,dlwin,0,10,13,182,0.461538462,0.043956044,0.587912088,3,0.892649374
17805,14,22968,6,5,2,10,0,23,10,11,0,0,0,21,nowin,loss,bust,plbust,0,10,11,202,0.391089109,0.01980198,0.628712871,2,0.577264877
17806,9,22968,7,3,5,10,0,25,10,11,0,0,0,21,nowin,loss,bust,plbust,0,10,10,194,0.37628866,0.015463918,0.541237113,0,0.009396796
17807,53,22968,4,1,8,10,0,23,10,11,0,0,0,21,nowin,loss,bust,plbust,0,10,5,250,0.372,0.064,0.564,0,0.013687345
17808,52,22969,6,5,5,10,0,26,10,3,6,0,0,19,nowin,loss,bust,plbust,0,10,11,217,0.414746544,0.02764977,0.599078341,2,0.576736024
17809,9,22969,6,3,10,0,0,19,10,3,6,0,0,19,nowin,push,push,push,10,0,9,194,0.37628866,0.015463918,0.541237113,0,0.009396796
17810,41,22969,10,4,0,10,0,24,10,3,6,0,0,19,nowin,loss,bust,plbust,0,10,14,192,0.364583333,0.036458333,0.520833333,0,0.00089702
17811,53,22969,7,2,2,2,4,17,10,3,6,0,0,19,nowin,loss,beat,dlwin,0,10,9,250,0.372,0.064,0.564,0,0.013687345
17812,127,22969,7,10,0,0,0,17,10,3,6,0,0,19,nowin,loss,beat,dlwin,0,10,17,201,0.402985075,0.029850746,0.60199005,0,0.032263937
17813,31,22969,11,9,0,0,0,20,10,3,6,0,0,19,nowin,win,plwin,beat,20,0,20,188,0.473404255,0.058510638,0.515957447,1,0.300306557
17814,121,22970,2,7,10,0,0,19,9,7,7,0,0,23,nowin,win,dlbust,bust,20,0,9,195,0.456410256,0.025641026,0.512820513,1,0.288597791
17815,15,22970,2,5,10,0,0,17,9,7,7,0,0,23,nowin,win,dlbust,bust,20,0,7,212,0.410377358,0.051886792,0.561320755,0,0.024517408
17816,62,22970,10,10,0,0,0,20,9,7,7,0,0,23,nowin,win,dlbust,bust,20,0,20,178,0.370786517,0.028089888,0.54494382,0,0.008657722
17817,49,22970,10,11,0,0,0,21,9,7,7,0,0,23,win,win,dlbust,bust,25,0,21,207,0.396135266,0.053140097,0.594202899,0,0.028306925
17818,40,22970,8,8,0,9,0,25,9,7,7,0,0,23,nowin,loss,bust,plbust,0,10,16,196,0.367346939,0.030612245,0.617346939,0,0.025358183
17819,101,22970,5,2,6,2,10,25,9,7,7,0,0,23,nowin,loss,bust,plbust,0,10,7,205,0.424390244,0.068292683,0.63902439,2,0.614740646
17820,82,22971,11,10,0,0,0,21,10,4,10,0,0,24,win,win,dlbust,bust,25,0,21,225,0.408888889,0.075555556,0.577777778,0,0.028101874
17821,111,22971,7,10,0,0,0,17,10,4,10,0,0,24,nowin,win,dlbust,bust,20,0,17,180,0.433333333,0.055555556,0.611111111,2,0.602264492
17822,25,22971,7,10,0,0,0,17,10,4,10,0,0,24,nowin,win,dlbust,bust,20,0,17,190,0.463157895,0.063157895,0.536842105,1,0.304401563
17823,19,22971,6,6,0,10,0,22,10,4,10,0,0,24,nowin,loss,bust,plbust,0,10,12,237,0.41350211,0.054852321,0.628691983,2,0.597373826
17824,79,22971,10,9,0,0,0,19,10,4,10,0,0,24,nowin,win,dlbust,bust,20,0,19,211,0.436018957,0.028436019,0.672985782,2,0.650131054
17825,114,22971,4,9,0,1,6,20,10,4,10,0,0,24,nowin,win,dlbust,bust,20,0,13,198,0.47979798,0.025252525,0.611111111,3,0.937232995
17826,17,22972,5,10,0,2,0,17,7,10,0,0,0,17,nowin,push,push,push,10,0,15,171,0.444444444,0.070175439,0.555555556,1,0.302364894
17827,78,22972,10,5,0,1,6,22,7,10,0,0,0,17,nowin,loss,bust,plbust,0,10,15,201,0.517412935,0.034825871,0.587064677,3,0.95871112
17828,106,22972,10,7,0,0,0,17,7,10,0,0,0,17,nowin,push,push,push,10,0,17,192,0.411458333,0.026041667,0.557291667,0,0.023854304
17829,144,22972,4,6,7,0,0,17,7,10,0,0,0,17,nowin,push,push,push,10,0,10,202,0.386138614,0.054455446,0.564356436,0,0.018006244
17830,58,22972,10,2,0,5,0,17,7,10,0,0,0,17,nowin,push,push,push,10,0,12,195,0.430769231,0.041025641,0.584615385,2,0.580497586
17831,143,22972,9,10,0,0,0,19,7,10,0,0,0,17,nowin,win,plwin,beat,20,0,19,203,0.463054187,0.044334975,0.57635468,3,0.883143365
17832,145,22973,3,5,3,10,0,21,10,4,10,0,0,24,nowin,win,dlbust,bust,20,0,8,188,0.441489362,0.031914894,0.622340426,2,0.617837093
17833,90,22973,11,10,0,0,0,21,10,4,10,0,0,24,win,win,dlbust,bust,25,0,21,201,0.447761194,0.049751244,0.60199005,3,0.889945023
17834,118,22973,10,10,0,0,0,20,10,4,10,0,0,24,nowin,win,dlbust,bust,20,0,20,216,0.393518519,0.037037037,0.555555556,0,0.018059873
17835,91,22973,10,5,0,5,0,20,10,4,10,0,0,24,nowin,win,dlbust,bust,20,0,15,194,0.417525773,0.046391753,0.515463918,1,0.266616552
17836,136,22973,5,10,0,1,10,26,10,4,10,0,0,24,nowin,loss,bust,plbust,0,10,15,194,0.396907216,0.025773196,0.597938144,0,0.029452644
17837,122,22973,10,5,0,10,0,25,10,4,10,0,0,24,nowin,loss,bust,plbust,0,10,15,210,0.347619048,0.052380952,0.59047619,0,0.012873677
17838,14,22974,11,6,3,0,0,20,9,11,0,0,0,20,nowin,push,push,push,10,0,17,202,0.391089109,0.01980198,0.628712871,2,0.577264877
17839,60,22974,7,10,0,0,0,17,9,11,0,0,0,20,nowin,loss,beat,dlwin,0,10,17,227,0.418502203,0.022026432,0.559471366,0,0.026496258
17840,138,22974,8,2,5,5,0,20,9,11,0,0,0,20,nowin,push,push,push,10,0,10,190,0.442105263,0.047368421,0.610526316,2,0.609711065
17841,9,22974,3,10,0,3,8,24,9,11,0,0,0,20,nowin,loss,bust,plbust,0,10,13,194,0.37628866,0.015463918,0.541237113,0,0.009396796
17842,115,22974,7,4,3,10,0,24,9,11,0,0,0,20,nowin,loss,bust,plbust,0,10,11,194,0.427835052,0.041237113,0.592783505,2,0.583863602
17843,13,22974,11,6,2,0,0,19,9,11,0,0,0,20,nowin,loss,beat,dlwin,0,10,17,206,0.417475728,0.063106796,0.621359223,2,0.59555479
17844,125,22975,9,7,0,8,0,24,9,4,10,0,0,23,nowin,loss,bust,plbust,0,10,16,219,0.438356164,0.050228311,0.575342466,1,0.308411257
17845,145,22975,5,6,1,10,0,22,9,4,10,0,0,23,nowin,loss,bust,plbust,0,10,11,188,0.441489362,0.031914894,0.622340426,2,0.617837093
17846,134,22975,10,10,0,0,0,20,9,4,10,0,0,23,nowin,win,dlbust,bust,20,0,20,185,0.443243243,0.021621622,0.545945946,1,0.296939509
17847,79,22975,10,11,0,0,0,21,9,4,10,0,0,23,win,win,dlbust,bust,25,0,21,211,0.436018957,0.028436019,0.672985782,2,0.650131054
17848,19,22975,8,9,0,0,0,17,9,4,10,0,0,23,nowin,win,dlbust,bust,20,0,17,237,0.41350211,0.054852321,0.628691983,2,0.597373826
17849,50,22975,8,8,0,6,0,22,9,4,10,0,0,23,nowin,loss,bust,plbust,0,10,16,202,0.405940594,0.04950495,0.54950495,0,0.020296079
17850,11,22976,9,6,0,0,0,15,5,5,10,0,0,20,nowin,loss,beat,dlwin,0,10,15,236,0.457627119,0.016949153,0.588983051,3,0.889015813
17851,84,22976,4,6,10,0,0,20,5,5,10,0,0,20,nowin,push,push,push,10,0,10,195,0.379487179,0.056410256,0.569230769,0,0.017209119
17852,38,22976,10,2,0,0,0,12,5,5,10,0,0,20,nowin,loss,beat,dlwin,0,10,12,202,0.361386139,0.03960396,0.564356436,0,0.010597953
17853,54,22976,7,10,0,0,0,17,5,5,10,0,0,20,nowin,loss,beat,dlwin,0,10,17,185,0.437837838,0.032432432,0.556756757,1,0.29899854
17854,48,22976,1,3,10,0,0,14,5,5,10,0,0,20,nowin,loss,beat,dlwin,0,10,4,203,0.413793103,0.019704433,0.600985222,2,0.577280801
17855,140,22976,2,6,11,0,0,19,5,5,10,0,0,20,nowin,loss,beat,dlwin,0,10,8,210,0.466666667,0.023809524,0.604761905,3,0.915293335
17856,121,22977,10,10,0,0,0,20,5,10,9,0,0,24,nowin,win,dlbust,bust,20,0,20,195,0.456410256,0.025641026,0.512820513,1,0.288597791
17857,146,22977,4,10,0,0,0,14,5,10,9,0,0,24,nowin,win,dlbust,bust,20,0,14,221,0.43438914,0.040723982,0.542986425,1,0.290190091
17858,138,22977,2,3,6,4,0,15,5,10,9,0,0,24,nowin,win,dlbust,bust,20,0,5,190,0.442105263,0.047368421,0.610526316,2,0.609711065
17859,82,22977,5,10,0,0,0,15,5,10,9,0,0,24,nowin,win,dlbust,bust,20,0,15,225,0.408888889,0.075555556,0.577777778,0,0.028101874
17860,111,22977,5,6,2,0,0,13,5,10,9,0,0,24,nowin,win,dlbust,bust,20,0,11,180,0.433333333,0.055555556,0.611111111,2,0.602264492
17861,148,22977,10,10,0,0,0,20,5,10,9,0,0,24,nowin,win,dlbust,bust,20,0,20,204,0.401960784,0.078431373,0.593137255,0,0.029789521
17862,141,22978,10,4,0,5,0,19,10,10,0,0,0,20,nowin,loss,beat,dlwin,0,10,14,202,0.420792079,0.074257426,0.564356436,0,0.028377851
17863,29,22978,9,11,0,0,0,20,10,10,0,0,0,20,nowin,push,push,push,10,0,20,189,0.44973545,0.058201058,0.544973545,1,0.300349439
17864,44,22978,4,8,0,8,0,20,10,10,0,0,0,20,nowin,push,push,push,10,0,12,219,0.433789954,0.050228311,0.534246575,1,0.285551035
17865,140,22978,11,7,0,0,0,18,10,10,0,0,0,20,nowin,loss,beat,dlwin,0,10,18,210,0.466666667,0.023809524,0.604761905,3,0.915293335
17866,110,22978,11,10,0,0,0,21,10,10,0,0,0,20,win,win,plwin,beat,25,0,21,192,0.416666667,0.046875,0.557291667,0,0.025413132
17867,119,22978,3,3,7,5,0,18,10,10,0,0,0,20,nowin,loss,beat,dlwin,0,10,6,190,0.405263158,0.068421053,0.515789474,0,0.011837158
17868,51,22979,10,10,0,0,0,20,10,9,0,0,0,19,nowin,win,plwin,beat,20,0,20,189,0.529100529,0.068783069,0.608465608,3,0.993665715
17869,123,22979,9,11,0,0,0,20,10,9,0,0,0,19,nowin,win,plwin,beat,20,0,20,205,0.43902439,0.034146341,0.614634146,2,0.609962544
17870,91,22979,7,7,0,10,0,24,10,9,0,0,0,19,nowin,loss,bust,plbust,0,10,14,194,0.417525773,0.046391753,0.515463918,1,0.266616552
17871,126,22979,10,5,0,5,0,20,10,9,0,0,0,19,nowin,win,plwin,beat,20,0,15,188,0.457446809,0.074468085,0.60106383,3,0.900633203
17872,6,22979,4,9,0,9,0,22,10,9,0,0,0,19,nowin,loss,bust,plbust,0,10,13,191,0.439790576,0.047120419,0.581151832,1,0.31211505
17873,109,22979,11,6,2,0,0,19,10,9,0,0,0,19,nowin,push,push,push,10,0,17,221,0.461538462,0.058823529,0.597285068,3,0.901830309
17874,79,22980,7,7,0,3,0,17,1,3,10,8,0,22,nowin,win,dlbust,bust,20,0,14,211,0.436018957,0.028436019,0.672985782,2,0.650131054
17875,16,22980,9,6,0,2,0,17,1,3,10,8,0,22,nowin,win,dlbust,bust,20,0,15,220,0.427272727,0.081818182,0.6,2,0.588660176
17876,11,22980,11,9,0,0,0,20,1,3,10,8,0,22,nowin,win,dlbust,bust,20,0,20,236,0.457627119,0.016949153,0.588983051,3,0.889015813
17877,31,22980,10,6,0,3,0,19,1,3,10,8,0,22,nowin,win,dlbust,bust,20,0,16,188,0.473404255,0.058510638,0.515957447,1,0.300306557
17878,88,22980,2,3,9,9,0,23,1,3,10,8,0,22,nowin,loss,bust,plbust,0,10,5,206,0.466019417,0.033980583,0.54368932,1,0.309467903
17879,74,22980,11,8,0,0,0,19,1,3,10,8,0,22,nowin,win,dlbust,bust,20,0,19,209,0.411483254,0.04784689,0.531100478,0,0.017448125
17880,3,22981,10,10,0,0,0,20,8,4,6,0,0,18,nowin,win,plwin,beat,20,0,20,190,0.431578947,0.026315789,0.542105263,1,0.288076384
17881,4,22981,4,8,0,9,0,21,8,4,6,0,0,18,nowin,win,plwin,beat,20,0,12,217,0.460829493,0.036866359,0.562211982,1,0.315432839
17882,118,22981,3,10,0,2,2,17,8,4,6,0,0,18,nowin,loss,beat,dlwin,0,10,13,216,0.393518519,0.037037037,0.555555556,0,0.018059873
17883,44,22981,1,6,10,0,0,17,8,4,6,0,0,18,nowin,loss,beat,dlwin,0,10,7,219,0.433789954,0.050228311,0.534246575,1,0.285551035
17884,40,22981,9,8,0,0,0,17,8,4,6,0,0,18,nowin,loss,beat,dlwin,0,10,17,196,0.367346939,0.030612245,0.617346939,0,0.025358183
17885,21,22981,11,7,0,0,0,18,8,4,6,0,0,18,nowin,push,push,push,10,0,18,214,0.359813084,0.042056075,0.626168224,0,0.025263474
17886,124,22982,10,9,0,0,0,19,3,3,2,10,0,18,nowin,win,plwin,beat,20,0,19,202,0.47029703,0.064356436,0.584158416,3,0.899458193
17887,147,22982,10,9,0,0,0,19,3,3,2,10,0,18,nowin,win,plwin,beat,20,0,19,205,0.380487805,0.014634146,0.536585366,0,0.00951447
17888,125,22982,10,11,0,0,0,21,3,3,2,10,0,18,win,win,plwin,beat,25,0,21,219,0.438356164,0.050228311,0.575342466,1,0.308411257
17889,74,22982,10,5,0,0,0,15,3,3,2,10,0,18,nowin,loss,beat,dlwin,0,10,15,209,0.411483254,0.04784689,0.531100478,0,0.017448125
17890,38,22982,7,2,10,0,0,19,3,3,2,10,0,18,nowin,win,plwin,beat,20,0,9,202,0.361386139,0.03960396,0.564356436,0,0.010597953
17891,61,22982,5,9,0,0,0,14,3,3,2,10,0,18,nowin,loss,beat,dlwin,0,10,14,194,0.427835052,0.077319588,0.603092784,2,0.591437139
17892,92,22983,5,2,8,10,0,25,10,4,7,0,0,21,nowin,loss,bust,plbust,0,10,7,186,0.446236559,0.059139785,0.564516129,1,0.307826125
17893,84,22983,10,11,0,0,0,21,10,4,7,0,0,21,win,push,push,push,10,0,21,195,0.379487179,0.056410256,0.569230769,0,0.017209119
17894,29,22983,3,2,7,10,0,22,10,4,7,0,0,21,nowin,loss,bust,plbust,0,10,5,189,0.44973545,0.058201058,0.544973545,1,0.300349439
17895,131,22983,5,7,0,7,0,19,10,4,7,0,0,21,nowin,loss,beat,dlwin,0,10,12,217,0.410138249,0.069124424,0.543778802,0,0.02015021
17896,89,22983,9,10,0,0,0,19,10,4,7,0,0,21,nowin,loss,beat,dlwin,0,10,19,212,0.537735849,0.047169811,0.594339623,3,0.990167191
17897,95,22983,1,2,10,10,0,23,10,4,7,0,0,21,nowin,loss,bust,plbust,0,10,3,218,0.412844037,0.04587156,0.559633028,0,0.024842385
17898,8,22984,11,1,7,0,0,19,3,2,10,5,0,20,nowin,loss,beat,dlwin,0,10,12,181,0.44198895,0.071823204,0.596685083,2,0.599438402
17899,138,22984,9,3,0,3,0,15,3,2,10,5,0,20,nowin,loss,beat,dlwin,0,10,12,190,0.442105263,0.047368421,0.610526316,2,0.609711065
17900,32,22984,10,7,0,0,0,17,3,2,10,5,0,20,nowin,loss,beat,dlwin,0,10,17,189,0.391534392,0.037037037,0.53968254,0,0.013579086
17901,51,22984,7,6,0,0,0,13,3,2,10,5,0,20,nowin,loss,beat,dlwin,0,10,13,189,0.529100529,0.068783069,0.608465608,3,0.993665715
17902,135,22984,10,10,0,0,0,20,3,2,10,5,0,20,nowin,push,push,push,10,0,20,179,0.391061453,0.067039106,0.586592179,0,0.024924662
17903,80,22984,10,7,0,0,0,17,3,2,10,5,0,20,nowin,loss,beat,dlwin,0,10,17,186,0.419354839,0.059139785,0.623655914,2,0.59892924
17904,45,22985,10,8,0,0,0,18,9,11,0,0,0,20,nowin,loss,beat,dlwin,0,10,18,196,0.428571429,0.051020408,0.612244898,2,0.598821767
17905,81,22985,10,10,0,0,0,20,9,11,0,0,0,20,nowin,push,push,push,10,0,20,182,0.395604396,0.043956044,0.60989011,2,0.567491261
17906,37,22985,8,10,0,0,0,18,9,11,0,0,0,20,nowin,loss,beat,dlwin,0,10,18,208,0.394230769,0.038461538,0.581730769,0,0.024682772
17907,96,22985,8,2,2,6,0,18,9,11,0,0,0,20,nowin,loss,beat,dlwin,0,10,10,190,0.468421053,0.057894737,0.584210526,3,0.897263354
17908,9,22985,2,6,6,4,0,18,9,11,0,0,0,20,nowin,loss,beat,dlwin,0,10,8,194,0.37628866,0.015463918,0.541237113,0,0.009396796
17909,14,22985,6,4,2,3,4,19,9,11,0,0,0,20,nowin,loss,beat,dlwin,0,10,10,202,0.391089109,0.01980198,0.628712871,2,0.577264877
17910,122,22986,10,7,0,0,0,17,4,6,9,0,0,19,nowin,loss,beat,dlwin,0,10,17,210,0.347619048,0.052380952,0.59047619,0,0.012873677
17911,23,22986,2,4,10,0,0,16,4,6,9,0,0,19,nowin,loss,beat,dlwin,0,10,6,208,0.427884615,0.0625,0.552884615,1,0.29114424
17912,120,22986,10,10,0,0,0,20,4,6,9,0,0,19,nowin,win,plwin,beat,20,0,20,202,0.440594059,0.034653465,0.618811881,2,0.614441029
17913,70,22986,10,3,0,0,0,13,4,6,9,0,0,19,nowin,loss,beat,dlwin,0,10,13,228,0.385964912,0.039473684,0.557017544,0,0.016157125
17914,117,22986,5,10,0,0,0,15,4,6,9,0,0,19,nowin,loss,beat,dlwin,0,10,15,173,0.410404624,0.069364162,0.606936416,2,0.578610282
17915,8,22986,10,7,0,0,0,17,4,6,9,0,0,19,nowin,loss,beat,dlwin,0,10,17,181,0.44198895,0.071823204,0.596685083,2,0.599438402
17916,3,22987,3,7,4,3,0,17,10,3,8,0,0,21,nowin,loss,beat,dlwin,0,10,10,190,0.431578947,0.026315789,0.542105263,1,0.288076384
17917,42,22987,6,8,0,2,10,26,10,3,8,0,0,21,nowin,loss,bust,plbust,0,10,14,212,0.443396226,0.051886792,0.570754717,1,0.309181312
17918,124,22987,9,7,0,9,0,25,10,3,8,0,0,21,nowin,loss,bust,plbust,0,10,16,202,0.47029703,0.064356436,0.584158416,3,0.899458193
17919,24,22987,3,4,11,0,0,18,10,3,8,0,0,21,nowin,loss,beat,dlwin,0,10,7,207,0.458937198,0.048309179,0.570048309,1,0.318138014
17920,6,22987,8,7,0,10,0,25,10,3,8,0,0,21,nowin,loss,bust,plbust,0,10,15,191,0.439790576,0.047120419,0.581151832,1,0.31211505
17921,29,22987,6,10,0,4,0,20,10,3,8,0,0,21,nowin,loss,beat,dlwin,0,10,16,189,0.44973545,0.058201058,0.544973545,1,0.300349439
17922,53,22988,6,10,0,2,0,18,10,5,8,0,0,23,nowin,win,dlbust,bust,20,0,16,250,0.372,0.064,0.564,0,0.013687345
17923,14,22988,8,7,0,10,0,25,10,5,8,0,0,23,nowin,loss,bust,plbust,0,10,15,202,0.391089109,0.01980198,0.628712871,2,0.577264877
17924,58,22988,4,10,0,7,0,21,10,5,8,0,0,23,nowin,win,dlbust,bust,20,0,14,195,0.430769231,0.041025641,0.584615385,2,0.580497586
17925,1,22988,6,10,0,10,0,26,10,5,8,0,0,23,nowin,loss,bust,plbust,0,10,16,197,0.406091371,0.025380711,0.649746193,2,0.606186955
17926,65,22988,4,10,0,10,0,24,10,5,8,0,0,23,nowin,loss,bust,plbust,0,10,14,203,0.492610837,0.054187192,0.571428571,3,0.913702814
17927,39,22988,10,8,0,0,0,18,10,5,8,0,0,23,nowin,win,dlbust,bust,20,0,18,191,0.429319372,0.062827225,0.57591623,0,0.033760763
17928,90,22989,11,3,2,0,0,16,3,4,10,0,0,17,nowin,loss,beat,dlwin,0,10,14,201,0.447761194,0.049751244,0.60199005,3,0.889945023
17929,123,22989,8,5,0,0,0,13,3,4,10,0,0,17,nowin,loss,beat,dlwin,0,10,13,205,0.43902439,0.034146341,0.614634146,2,0.609962544
17930,134,22989,10,10,0,0,0,20,3,4,10,0,0,17,nowin,win,plwin,beat,20,0,20,185,0.443243243,0.021621622,0.545945946,1,0.296939509
17931,49,22989,11,10,0,0,0,21,3,4,10,0,0,17,win,win,plwin,beat,25,0,21,207,0.396135266,0.053140097,0.594202899,0,0.028306925
17932,14,22989,9,10,0,0,0,19,3,4,10,0,0,17,nowin,win,plwin,beat,20,0,19,202,0.391089109,0.01980198,0.628712871,2,0.577264877
17933,106,22989,4,10,0,0,0,14,3,4,10,0,0,17,nowin,loss,beat,dlwin,0,10,14,192,0.411458333,0.026041667,0.557291667,0,0.023854304
17934,34,22990,10,8,0,0,0,18,5,6,2,9,0,22,nowin,win,dlbust,bust,20,0,18,202,0.5,0.079207921,0.618811881,3,0.968961434
17935,35,22990,8,8,0,0,0,16,5,6,2,9,0,22,nowin,win,dlbust,bust,20,0,16,202,0.410891089,0.044554455,0.633663366,2,0.598681573
17936,78,22990,6,4,10,0,0,20,5,6,2,9,0,22,nowin,win,dlbust,bust,20,0,10,201,0.517412935,0.034825871,0.587064677,3,0.95871112
17937,96,22990,10,3,0,0,0,13,5,6,2,9,0,22,nowin,win,dlbust,bust,20,0,13,190,0.468421053,0.057894737,0.584210526,3,0.897263354
17938,64,22990,3,2,6,10,0,21,5,6,2,9,0,22,nowin,win,dlbust,bust,20,0,5,187,0.363636364,0.048128342,0.631016043,0,0.027594885
17939,13,22990,7,10,0,0,0,17,5,6,2,9,0,22,nowin,win,dlbust,bust,20,0,17,206,0.417475728,0.063106796,0.621359223,2,0.59555479
17940,142,22991,4,10,0,0,0,14,4,10,6,0,0,20,nowin,loss,beat,dlwin,0,10,14,211,0.417061611,0.047393365,0.526066351,1,0.271531309
17941,141,22991,5,9,0,0,0,14,4,10,6,0,0,20,nowin,loss,beat,dlwin,0,10,14,202,0.420792079,0.074257426,0.564356436,0,0.028377851
17942,63,22991,8,7,0,0,0,15,4,10,6,0,0,20,nowin,loss,beat,dlwin,0,10,15,216,0.467592593,0.037037037,0.62037037,3,0.931690496
17943,28,22991,9,3,0,0,0,12,4,10,6,0,0,20,nowin,loss,beat,dlwin,0,10,12,199,0.422110553,0.045226131,0.542713568,1,0.282706618
17944,128,22991,7,10,0,0,0,17,4,10,6,0,0,20,nowin,loss,beat,dlwin,0,10,17,227,0.356828194,0.052863436,0.577092511,0,0.012352564
17945,42,22991,10,5,0,0,0,15,4,10,6,0,0,20,nowin,loss,beat,dlwin,0,10,15,212,0.443396226,0.051886792,0.570754717,1,0.309181312
17946,28,22992,10,10,0,0,0,20,2,1,10,1,1,15,nowin,win,plwin,beat,20,0,20,199,0.422110553,0.045226131,0.542713568,1,0.282706618
17947,53,22992,4,2,10,0,0,16,2,1,10,1,1,15,nowin,win,plwin,beat,20,0,6,250,0.372,0.064,0.564,0,0.013687345
17948,20,22992,10,4,0,0,0,14,2,1,10,1,1,15,nowin,loss,beat,dlwin,0,10,14,186,0.456989247,0.037634409,0.537634409,1,0.301097108
17949,2,22992,10,10,0,0,0,20,2,1,10,1,1,15,nowin,win,plwin,beat,20,0,20,200,0.445,0.035,0.64,2,0.633962549
17950,54,22992,4,8,0,6,0,18,2,1,10,1,1,15,nowin,win,plwin,beat,20,0,12,185,0.437837838,0.032432432,0.556756757,1,0.29899854
17951,40,22992,10,10,0,0,0,20,2,1,10,1,1,15,nowin,win,plwin,beat,20,0,20,196,0.367346939,0.030612245,0.617346939,0,0.025358183
17952,28,22993,8,7,0,0,0,15,2,5,10,0,0,17,nowin,loss,beat,dlwin,0,10,15,199,0.422110553,0.045226131,0.542713568,1,0.282706618
17953,45,22993,2,10,0,7,0,19,2,5,10,0,0,17,nowin,win,plwin,beat,20,0,12,196,0.428571429,0.051020408,0.612244898,2,0.598821767
17954,83,22993,8,2,7,0,0,17,2,5,10,0,0,17,nowin,push,push,push,10,0,10,193,0.424870466,0.051813472,0.678756477,2,0.644360335
17955,94,22993,3,10,0,0,0,13,2,5,10,0,0,17,nowin,loss,beat,dlwin,0,10,13,183,0.43715847,0.043715847,0.540983607,1,0.290866892
17956,134,22993,10,4,0,0,0,14,2,5,10,0,0,17,nowin,loss,beat,dlwin,0,10,14,185,0.443243243,0.021621622,0.545945946,1,0.296939509
17957,11,22993,10,10,0,0,0,20,2,5,10,0,0,17,nowin,win,plwin,beat,20,0,20,236,0.457627119,0.016949153,0.588983051,3,0.889015813
17958,122,22994,10,3,0,6,0,19,10,6,8,0,0,24,nowin,win,dlbust,bust,20,0,13,210,0.347619048,0.052380952,0.59047619,0,0.012873677
17959,47,22994,8,10,0,0,0,18,10,6,8,0,0,24,nowin,win,dlbust,bust,20,0,18,210,0.438095238,0.057142857,0.623809524,2,0.615868808
17960,29,22994,5,4,10,0,0,19,10,6,8,0,0,24,nowin,win,dlbust,bust,20,0,9,189,0.44973545,0.058201058,0.544973545,1,0.300349439
17961,99,22994,2,10,0,6,0,18,10,6,8,0,0,24,nowin,win,dlbust,bust,20,0,12,207,0.47826087,0.062801932,0.637681159,3,0.961418446
17962,38,22994,4,4,10,0,0,18,10,6,8,0,0,24,nowin,win,dlbust,bust,20,0,8,202,0.361386139,0.03960396,0.564356436,0,0.010597953
17963,106,22994,9,7,0,10,0,26,10,6,8,0,0,24,nowin,loss,bust,plbust,0,10,16,192,0.411458333,0.026041667,0.557291667,0,0.023854304
17964,19,22995,8,10,0,0,0,18,10,2,9,0,0,21,nowin,loss,beat,dlwin,0,10,18,237,0.41350211,0.054852321,0.628691983,2,0.597373826
17965,132,22995,6,10,0,6,0,22,10,2,9,0,0,21,nowin,loss,bust,plbust,0,10,16,194,0.412371134,0.036082474,0.649484536,2,0.611633238
17966,17,22995,10,10,0,0,0,20,10,2,9,0,0,21,nowin,loss,beat,dlwin,0,10,20,171,0.444444444,0.070175439,0.555555556,1,0.302364894
17967,91,22995,4,1,8,6,0,19,10,2,9,0,0,21,nowin,loss,beat,dlwin,0,10,5,194,0.417525773,0.046391753,0.515463918,1,0.266616552
17968,86,22995,6,11,3,0,0,20,10,2,9,0,0,21,nowin,loss,beat,dlwin,0,10,17,196,0.454081633,0.040816327,0.591836735,3,0.887566443
17969,18,22995,5,11,2,0,0,18,10,2,9,0,0,21,nowin,loss,beat,dlwin,0,10,16,182,0.461538462,0.043956044,0.587912088,3,0.892649374
17970,26,22996,2,4,6,3,0,15,2,10,10,0,0,22,nowin,win,dlbust,bust,20,0,6,203,0.463054187,0.0591133,0.541871921,1,0.306802864
17971,50,22996,10,7,0,0,0,17,2,10,10,0,0,22,nowin,win,dlbust,bust,20,0,17,202,0.405940594,0.04950495,0.54950495,0,0.020296079
17972,86,22996,10,9,0,0,0,19,2,10,10,0,0,22,nowin,win,dlbust,bust,20,0,19,196,0.454081633,0.040816327,0.591836735,3,0.887566443
17973,33,22996,9,6,0,0,0,15,2,10,10,0,0,22,nowin,win,dlbust,bust,20,0,15,192,0.4375,0.057291667,0.625,2,0.616208916
17974,9,22996,1,5,10,0,0,16,2,10,10,0,0,22,nowin,win,dlbust,bust,20,0,6,194,0.37628866,0.015463918,0.541237113,0,0.009396796
17975,20,22996,7,3,6,0,0,16,2,10,10,0,0,22,nowin,win,dlbust,bust,20,0,10,186,0.456989247,0.037634409,0.537634409,1,0.301097108
17976,78,22997,10,10,0,0,0,20,7,9,10,0,0,26,nowin,win,dlbust,bust,20,0,20,201,0.517412935,0.034825871,0.587064677,3,0.95871112
17977,7,22997,7,10,0,0,0,17,7,9,10,0,0,26,nowin,win,dlbust,bust,20,0,17,183,0.442622951,0.06010929,0.62295082,2,0.619303341
17978,47,22997,2,4,11,0,0,17,7,9,10,0,0,26,nowin,win,dlbust,bust,20,0,6,210,0.438095238,0.057142857,0.623809524,2,0.615868808
17979,81,22997,4,7,2,10,0,23,7,9,10,0,0,26,nowin,loss,bust,plbust,0,10,11,182,0.395604396,0.043956044,0.60989011,2,0.567491261
17980,119,22997,10,5,0,10,0,25,7,9,10,0,0,26,nowin,loss,bust,plbust,0,10,15,190,0.405263158,0.068421053,0.515789474,0,0.011837158
17981,120,22997,7,7,0,10,0,24,7,9,10,0,0,26,nowin,loss,bust,plbust,0,10,14,202,0.440594059,0.034653465,0.618811881,2,0.614441029
17982,145,22998,4,10,0,0,0,14,6,3,5,6,0,20,nowin,loss,beat,dlwin,0,10,14,188,0.441489362,0.031914894,0.622340426,2,0.617837093
17983,51,22998,3,3,10,0,0,16,6,3,5,6,0,20,nowin,loss,beat,dlwin,0,10,6,189,0.529100529,0.068783069,0.608465608,3,0.993665715
17984,30,22998,11,10,0,0,0,21,6,3,5,6,0,20,win,win,plwin,beat,25,0,21,206,0.393203883,0.033980583,0.601941748,0,0.029324648
17985,52,22998,10,7,0,0,0,17,6,3,5,6,0,20,nowin,loss,beat,dlwin,0,10,17,217,0.414746544,0.02764977,0.599078341,2,0.576736024
17986,55,22998,10,6,0,0,0,16,6,3,5,6,0,20,nowin,loss,beat,dlwin,0,10,16,191,0.371727749,0.057591623,0.54973822,0,0.01011347
17987,60,22998,8,5,0,0,0,13,6,3,5,6,0,20,nowin,loss,beat,dlwin,0,10,13,227,0.418502203,0.022026432,0.559471366,0,0.026496258
17988,129,22999,2,2,10,9,0,23,8,10,0,0,0,18,nowin,loss,bust,plbust,0,10,4,201,0.422885572,0.064676617,0.55721393,0,0.027255383
17989,8,22999,7,7,0,1,10,25,8,10,0,0,0,18,nowin,loss,bust,plbust,0,10,14,181,0.44198895,0.071823204,0.596685083,2,0.599438402
17990,110,22999,2,10,0,10,0,22,8,10,0,0,0,18,nowin,loss,bust,plbust,0,10,12,192,0.416666667,0.046875,0.557291667,0,0.025413132
17991,32,22999,2,2,4,3,10,21,8,10,0,0,0,18,nowin,win,plwin,beat,20,0,4,189,0.391534392,0.037037037,0.53968254,0,0.013579086
17992,98,22999,5,10,0,4,0,19,8,10,0,0,0,18,nowin,win,plwin,beat,20,0,15,220,0.422727273,0.054545455,0.55,1,0.28664435
17993,19,22999,9,10,0,0,0,19,8,10,0,0,0,18,nowin,win,plwin,beat,20,0,19,237,0.41350211,0.054852321,0.628691983,2,0.597373826
17994,92,23000,10,10,0,0,0,20,7,11,0,0,0,18,nowin,win,plwin,beat,20,0,20,186,0.446236559,0.059139785,0.564516129,1,0.307826125
17995,60,23000,2,8,5,5,0,20,7,11,0,0,0,18,nowin,win,plwin,beat,20,0,10,227,0.418502203,0.022026432,0.559471366,0,0.026496258
17996,77,23000,9,3,0,4,10,26,7,11,0,0,0,18,nowin,loss,bust,plbust,0,10,12,200,0.455,0.04,0.62,3,0.916252116
17997,104,23000,6,2,3,6,0,17,7,11,0,0,0,18,nowin,loss,beat,dlwin,0,10,8,209,0.363636364,0.052631579,0.593301435,0,0.018359419
17998,43,23000,3,8,10,0,0,21,7,11,0,0,0,18,nowin,win,plwin,beat,20,0,11,192,0.40625,0.041666667,0.609375,2,0.576671372
17999,124,23000,10,10,0,0,0,20,7,11,0,0,0,18,nowin,win,plwin,beat,20,0,20,202,0.47029703,0.064356436,0.584158416,3,0.899458193
18000,53,23001,7,4,8,0,0,19,5,9,2,10,0,26,nowin,win,dlbust,bust,20,0,11,250,0.372,0.064,0.564,0,0.013687345
18001,4,23001,10,10,0,0,0,20,5,9,2,10,0,26,nowin,win,dlbust,bust,20,0,20,217,0.460829493,0.036866359,0.562211982,1,0.315432839
18002,89,23001,4,3,11,0,0,18,5,9,2,10,0,26,nowin,win,dlbust,bust,20,0,7,212,0.537735849,0.047169811,0.594339623,3,0.990167191
18003,59,23001,6,8,0,0,0,14,5,9,2,10,0,26,nowin,win,dlbust,bust,20,0,14,228,0.429824561,0.048245614,0.543859649,1,0.287885446
18004,138,23001,10,8,0,0,0,18,5,9,2,10,0,26,nowin,win,dlbust,bust,20,0,18,190,0.442105263,0.047368421,0.610526316,2,0.609711065
18005,32,23001,10,7,0,0,0,17,5,9,2,10,0,26,nowin,win,dlbust,bust,20,0,17,189,0.391534392,0.037037037,0.53968254,0,0.013579086
18006,35,23002,5,8,0,8,0,21,7,8,7,0,0,22,nowin,win,dlbust,bust,20,0,13,202,0.410891089,0.044554455,0.633663366,2,0.598681573
18007,120,23002,1,5,8,2,1,17,7,8,7,0,0,22,nowin,win,dlbust,bust,20,0,6,202,0.440594059,0.034653465,0.618811881,2,0.614441029
18008,107,23002,10,8,0,0,0,18,7,8,7,0,0,22,nowin,win,dlbust,bust,20,0,18,218,0.444954128,0.073394495,0.600917431,2,0.605210014
18009,108,23002,10,9,0,0,0,19,7,8,7,0,0,22,nowin,win,dlbust,bust,20,0,19,193,0.435233161,0.056994819,0.559585492,1,0.298824795
18010,106,23002,8,2,10,0,0,20,7,8,7,0,0,22,nowin,win,dlbust,bust,20,0,10,192,0.411458333,0.026041667,0.557291667,0,0.023854304
18011,83,23002,9,9,0,0,0,18,7,8,7,0,0,22,nowin,win,dlbust,bust,20,0,18,193,0.424870466,0.051813472,0.678756477,2,0.644360335
18012,74,23003,7,10,0,0,0,17,10,8,0,0,0,18,nowin,loss,beat,dlwin,0,10,17,209,0.411483254,0.04784689,0.531100478,0,0.017448125
18013,133,23003,9,11,0,0,0,20,10,8,0,0,0,18,nowin,win,plwin,beat,20,0,20,201,0.47761194,0.064676617,0.611940299,3,0.935428111
18014,102,23003,3,10,0,6,0,19,10,8,0,0,0,18,nowin,win,plwin,beat,20,0,13,192,0.338541667,0.046875,0.5625,0,0.003306118
18015,127,23003,10,8,0,0,0,18,10,8,0,0,0,18,nowin,push,push,push,10,0,18,201,0.402985075,0.029850746,0.60199005,0,0.032263937
18016,54,23003,7,5,0,10,0,22,10,8,0,0,0,18,nowin,loss,bust,plbust,0,10,12,185,0.437837838,0.032432432,0.556756757,1,0.29899854
18017,30,23003,7,6,0,8,0,21,10,8,0,0,0,18,nowin,win,plwin,beat,20,0,13,206,0.393203883,0.033980583,0.601941748,0,0.029324648
18018,81,23004,6,10,0,8,0,24,10,10,0,0,0,20,nowin,loss,bust,plbust,0,10,16,182,0.395604396,0.043956044,0.60989011,2,0.567491261
18019,91,23004,10,10,0,0,0,20,10,10,0,0,0,20,nowin,push,push,push,10,0,20,194,0.417525773,0.046391753,0.515463918,1,0.266616552
18020,74,23004,7,10,0,0,0,17,10,10,0,0,0,20,nowin,loss,beat,dlwin,0,10,17,209,0.411483254,0.04784689,0.531100478,0,0.017448125
18021,29,23004,10,10,0,0,0,20,10,10,0,0,0,20,nowin,push,push,push,10,0,20,189,0.44973545,0.058201058,0.544973545,1,0.300349439
18022,55,23004,3,6,6,10,0,25,10,10,0,0,0,20,nowin,loss,bust,plbust,0,10,9,191,0.371727749,0.057591623,0.54973822,0,0.01011347
18023,19,23004,11,10,0,0,0,21,10,10,0,0,0,20,win,win,plwin,beat,25,0,21,237,0.41350211,0.054852321,0.628691983,2,0.597373826
18024,69,23005,4,8,0,10,0,22,9,10,0,0,0,19,nowin,loss,bust,plbust,0,10,12,194,0.365979381,0.030927835,0.515463918,0,0
18025,110,23005,7,10,0,0,0,17,9,10,0,0,0,19,nowin,loss,beat,dlwin,0,10,17,192,0.416666667,0.046875,0.557291667,0,0.025413132
18026,129,23005,4,10,0,7,0,21,9,10,0,0,0,19,nowin,win,plwin,beat,20,0,14,201,0.422885572,0.064676617,0.55721393,0,0.027255383
18027,13,23005,10,2,0,9,0,21,9,10,0,0,0,19,nowin,win,plwin,beat,20,0,12,206,0.417475728,0.063106796,0.621359223,2,0.59555479
18028,95,23005,6,10,0,1,0,17,9,10,0,0,0,19,nowin,loss,beat,dlwin,0,10,16,218,0.412844037,0.04587156,0.559633028,0,0.024842385
18029,112,23005,7,7,0,10,0,24,9,10,0,0,0,19,nowin,loss,bust,plbust,0,10,14,203,0.448275862,0.054187192,0.600985222,3,0.889576933
18030,33,23006,11,8,0,0,0,19,5,6,4,9,0,24,nowin,win,dlbust,bust,20,0,19,192,0.4375,0.057291667,0.625,2,0.616208916
18031,107,23006,10,3,0,0,0,13,5,6,4,9,0,24,nowin,win,dlbust,bust,20,0,13,218,0.444954128,0.073394495,0.600917431,2,0.605210014
18032,73,23006,4,5,2,7,0,18,5,6,4,9,0,24,nowin,win,dlbust,bust,20,0,9,181,0.375690608,0.011049724,0.596685083,0,0.022795773
18033,88,23006,5,6,3,0,0,14,5,6,4,9,0,24,nowin,win,dlbust,bust,20,0,11,206,0.466019417,0.033980583,0.54368932,1,0.309467903
18034,83,23006,10,11,0,0,0,21,5,6,4,9,0,24,win,win,dlbust,bust,25,0,21,193,0.424870466,0.051813472,0.678756477,2,0.644360335
18035,47,23006,8,11,0,0,0,19,5,6,4,9,0,24,nowin,win,dlbust,bust,20,0,19,210,0.438095238,0.057142857,0.623809524,2,0.615868808
18036,101,23007,10,5,0,0,0,15,3,2,7,10,0,22,nowin,win,dlbust,bust,20,0,15,205,0.424390244,0.068292683,0.63902439,2,0.614740646
18037,75,23007,6,3,3,10,0,22,3,2,7,10,0,22,nowin,loss,bust,plbust,0,10,9,191,0.418848168,0.052356021,0.570680628,0,0.029344702
18038,102,23007,10,4,0,0,0,14,3,2,7,10,0,22,nowin,win,dlbust,bust,20,0,14,192,0.338541667,0.046875,0.5625,0,0.003306118
18039,114,23007,4,4,11,0,0,19,3,2,7,10,0,22,nowin,win,dlbust,bust,20,0,8,198,0.47979798,0.025252525,0.611111111,3,0.937232995
18040,62,23007,5,10,0,0,0,15,3,2,7,10,0,22,nowin,win,dlbust,bust,20,0,15,178,0.370786517,0.028089888,0.54494382,0,0.008657722
18041,144,23007,3,4,10,0,0,17,3,2,7,10,0,22,nowin,win,dlbust,bust,20,0,7,202,0.386138614,0.054455446,0.564356436,0,0.018006244
18042,83,23008,10,5,0,0,0,15,6,4,10,0,0,20,nowin,loss,beat,dlwin,0,10,15,193,0.424870466,0.051813472,0.678756477,2,0.644360335
18043,5,23008,5,6,1,0,0,12,6,4,10,0,0,20,nowin,loss,beat,dlwin,0,10,11,203,0.42364532,0.02955665,0.596059113,2,0.582508076
18044,120,23008,10,10,0,0,0,20,6,4,10,0,0,20,nowin,push,push,push,10,0,20,202,0.440594059,0.034653465,0.618811881,2,0.614441029
18045,2,23008,7,10,0,0,0,17,6,4,10,0,0,20,nowin,loss,beat,dlwin,0,10,17,200,0.445,0.035,0.64,2,0.633962549
18046,108,23008,1,1,10,0,0,12,6,4,10,0,0,20,nowin,loss,beat,dlwin,0,10,2,193,0.435233161,0.056994819,0.559585492,1,0.298824795
18047,111,23008,2,10,0,0,0,12,6,4,10,0,0,20,nowin,loss,beat,dlwin,0,10,12,180,0.433333333,0.055555556,0.611111111,2,0.602264492
18048,37,23009,6,4,5,0,0,15,4,7,1,10,0,22,nowin,win,dlbust,bust,20,0,10,208,0.394230769,0.038461538,0.581730769,0,0.024682772
18049,39,23009,10,8,0,0,0,18,4,7,1,10,0,22,nowin,win,dlbust,bust,20,0,18,191,0.429319372,0.062827225,0.57591623,0,0.033760763
18050,142,23009,4,6,3,0,0,13,4,7,1,10,0,22,nowin,win,dlbust,bust,20,0,10,211,0.417061611,0.047393365,0.526066351,1,0.271531309
18051,127,23009,3,10,0,0,0,13,4,7,1,10,0,22,nowin,win,dlbust,bust,20,0,13,201,0.402985075,0.029850746,0.60199005,0,0.032263937
18052,11,23009,10,10,0,0,0,20,4,7,1,10,0,22,nowin,win,dlbust,bust,20,0,20,236,0.457627119,0.016949153,0.588983051,3,0.889015813
18053,11,23009,5,6,7,0,0,18,4,7,1,10,0,22,nowin,win,dlbust,bust,20,0,11,236,0.457627119,0.016949153,0.588983051,3,0.889015813
18054,37,23010,10,6,0,2,0,18,11,9,0,0,0,20,nowin,loss,beat,dlwin,0,10,16,208,0.394230769,0.038461538,0.581730769,0,0.024682772
18055,57,23010,10,9,0,0,0,19,11,9,0,0,0,20,nowin,loss,beat,dlwin,0,10,19,192,0.46875,0.052083333,0.59375,3,0.907001181
18056,131,23010,5,6,7,0,0,18,11,9,0,0,0,20,nowin,loss,beat,dlwin,0,10,11,217,0.410138249,0.069124424,0.543778802,0,0.02015021
18057,12,23010,10,2,0,6,0,18,11,9,0,0,0,20,nowin,loss,beat,dlwin,0,10,12,189,0.470899471,0.015873016,0.613756614,3,0.929171178
18058,51,23010,10,10,0,0,0,20,11,9,0,0,0,20,nowin,push,push,push,10,0,20,189,0.529100529,0.068783069,0.608465608,3,0.993665715
18059,44,23010,3,11,7,0,0,21,11,9,0,0,0,20,nowin,win,plwin,beat,20,0,14,219,0.433789954,0.050228311,0.534246575,1,0.285551035
18060,150,23011,4,10,0,10,0,24,10,6,10,0,0,26,nowin,loss,bust,plbust,0,10,14,192,0.401041667,0.036458333,0.567708333,0,0.023287458
18061,147,23011,5,10,0,2,0,17,10,6,10,0,0,26,nowin,win,dlbust,bust,20,0,15,205,0.380487805,0.014634146,0.536585366,0,0.00951447
18062,13,23011,6,9,0,10,0,25,10,6,10,0,0,26,nowin,loss,bust,plbust,0,10,15,206,0.417475728,0.063106796,0.621359223,2,0.59555479
18063,83,23011,4,8,0,1,3,16,10,6,10,0,0,26,nowin,win,dlbust,bust,20,0,12,193,0.424870466,0.051813472,0.678756477,2,0.644360335
18064,107,23011,6,5,9,0,0,20,10,6,10,0,0,26,nowin,win,dlbust,bust,20,0,11,218,0.444954128,0.073394495,0.600917431,2,0.605210014
18065,49,23011,7,10,0,0,0,17,10,6,10,0,0,26,nowin,win,dlbust,bust,20,0,17,207,0.396135266,0.053140097,0.594202899,0,0.028306925
18066,93,23012,10,4,0,7,0,21,10,9,0,0,0,19,nowin,win,plwin,beat,20,0,14,175,0.485714286,0.051428571,0.548571429,1,0.323648091
18067,47,23012,7,10,0,0,0,17,10,9,0,0,0,19,nowin,loss,beat,dlwin,0,10,17,210,0.438095238,0.057142857,0.623809524,2,0.615868808
18068,100,23012,10,10,0,0,0,20,10,9,0,0,0,19,nowin,win,plwin,beat,20,0,20,190,0.452631579,0.036842105,0.594736842,3,0.888671154
18069,61,23012,10,7,0,0,0,17,10,9,0,0,0,19,nowin,loss,beat,dlwin,0,10,17,194,0.427835052,0.077319588,0.603092784,2,0.591437139
18070,107,23012,9,5,0,10,0,24,10,9,0,0,0,19,nowin,loss,bust,plbust,0,10,14,218,0.444954128,0.073394495,0.600917431,2,0.605210014
18071,26,23012,4,2,10,5,0,21,10,9,0,0,0,19,nowin,win,plwin,beat,20,0,6,203,0.463054187,0.0591133,0.541871921,1,0.306802864
18072,93,23013,5,10,0,10,0,25,7,10,0,0,0,17,nowin,loss,bust,plbust,0,10,15,175,0.485714286,0.051428571,0.548571429,1,0.323648091
18073,23,23013,9,4,0,6,0,19,7,10,0,0,0,17,nowin,win,plwin,beat,20,0,13,208,0.427884615,0.0625,0.552884615,1,0.29114424
18074,133,23013,9,6,0,9,0,24,7,10,0,0,0,17,nowin,loss,bust,plbust,0,10,15,201,0.47761194,0.064676617,0.611940299,3,0.935428111
18075,50,23013,3,10,0,8,0,21,7,10,0,0,0,17,nowin,win,plwin,beat,20,0,13,202,0.405940594,0.04950495,0.54950495,0,0.020296079
18076,26,23013,4,2,5,3,2,16,7,10,0,0,0,17,nowin,loss,beat,dlwin,0,10,6,203,0.463054187,0.0591133,0.541871921,1,0.306802864
18077,133,23013,10,10,0,0,0,20,7,10,0,0,0,17,nowin,win,plwin,beat,20,0,20,201,0.47761194,0.064676617,0.611940299,3,0.935428111
18078,24,23014,5,10,0,10,0,25,10,4,2,2,0,18,nowin,loss,bust,plbust,0,10,15,207,0.458937198,0.048309179,0.570048309,1,0.318138014
18079,65,23014,2,8,6,9,0,25,10,4,2,2,0,18,nowin,loss,bust,plbust,0,10,10,203,0.492610837,0.054187192,0.571428571,3,0.913702814
18080,78,23014,4,8,0,1,4,17,10,4,2,2,0,18,nowin,loss,beat,dlwin,0,10,12,201,0.517412935,0.034825871,0.587064677,3,0.95871112
18081,102,23014,6,10,0,8,0,24,10,4,2,2,0,18,nowin,loss,bust,plbust,0,10,16,192,0.338541667,0.046875,0.5625,0,0.003306118
18082,75,23014,5,7,0,10,0,22,10,4,2,2,0,18,nowin,loss,bust,plbust,0,10,12,191,0.418848168,0.052356021,0.570680628,0,0.029344702
18083,15,23014,5,10,0,10,0,25,10,4,2,2,0,18,nowin,loss,bust,plbust,0,10,15,212,0.410377358,0.051886792,0.561320755,0,0.024517408
18084,142,23015,11,3,6,0,0,20,10,10,0,0,0,20,nowin,push,push,push,10,0,14,211,0.417061611,0.047393365,0.526066351,1,0.271531309
18085,90,23015,10,2,0,7,0,19,10,10,0,0,0,20,nowin,loss,beat,dlwin,0,10,12,201,0.447761194,0.049751244,0.60199005,3,0.889945023
18086,133,23015,6,6,0,4,10,26,10,10,0,0,0,20,nowin,loss,bust,plbust,0,10,12,201,0.47761194,0.064676617,0.611940299,3,0.935428111
18087,103,23015,11,4,1,4,0,20,10,10,0,0,0,20,nowin,push,push,push,10,0,15,203,0.379310345,0.064039409,0.551724138,0,0.012869209
18088,126,23015,10,2,0,10,0,22,10,10,0,0,0,20,nowin,loss,bust,plbust,0,10,12,188,0.457446809,0.074468085,0.60106383,3,0.900633203
18089,3,23015,5,6,9,0,0,20,10,10,0,0,0,20,nowin,push,push,push,10,0,11,190,0.431578947,0.026315789,0.542105263,1,0.288076384
18090,65,23016,5,7,0,3,0,15,2,2,3,3,8,18,nowin,loss,beat,dlwin,0,10,12,203,0.492610837,0.054187192,0.571428571,3,0.913702814
18091,146,23016,10,3,0,0,0,13,2,2,3,3,8,18,nowin,loss,beat,dlwin,0,10,13,221,0.43438914,0.040723982,0.542986425,1,0.290190091
18092,73,23016,11,4,6,0,0,21,2,2,3,3,8,18,nowin,win,plwin,beat,20,0,15,181,0.375690608,0.011049724,0.596685083,0,0.022795773
18093,46,23016,5,4,6,0,0,15,2,2,3,3,8,18,nowin,loss,beat,dlwin,0,10,9,186,0.403225806,0.048387097,0.591397849,0,0.029742194
18094,33,23016,8,10,0,0,0,18,2,2,3,3,8,18,nowin,push,push,push,10,0,18,192,0.4375,0.057291667,0.625,2,0.616208916
18095,45,23016,8,10,0,0,0,18,2,2,3,3,8,18,nowin,push,push,push,10,0,18,196,0.428571429,0.051020408,0.612244898,2,0.598821767
18096,29,23017,10,5,0,4,0,19,10,6,10,0,0,26,nowin,win,dlbust,bust,20,0,15,189,0.44973545,0.058201058,0.544973545,1,0.300349439
18097,12,23017,6,3,8,0,0,17,10,6,10,0,0,26,nowin,win,dlbust,bust,20,0,9,189,0.470899471,0.015873016,0.613756614,3,0.929171178
18098,64,23017,2,10,0,7,0,19,10,6,10,0,0,26,nowin,win,dlbust,bust,20,0,12,187,0.363636364,0.048128342,0.631016043,0,0.027594885
18099,113,23017,8,8,0,10,0,26,10,6,10,0,0,26,nowin,loss,bust,plbust,0,10,16,199,0.407035176,0.055276382,0.668341709,2,0.620695264
18100,41,23017,10,5,0,6,0,21,10,6,10,0,0,26,nowin,win,dlbust,bust,20,0,15,192,0.364583333,0.036458333,0.520833333,0,0.00089702
18101,30,23017,4,7,4,7,0,22,10,6,10,0,0,26,nowin,loss,bust,plbust,0,10,11,206,0.393203883,0.033980583,0.601941748,0,0.029324648
18102,4,23018,1,3,10,0,0,14,4,9,4,0,0,17,nowin,loss,beat,dlwin,0,10,4,217,0.460829493,0.036866359,0.562211982,1,0.315432839
18103,63,23018,9,5,0,0,0,14,4,9,4,0,0,17,nowin,loss,beat,dlwin,0,10,14,216,0.467592593,0.037037037,0.62037037,3,0.931690496
18104,94,23018,10,10,0,0,0,20,4,9,4,0,0,17,nowin,win,plwin,beat,20,0,20,183,0.43715847,0.043715847,0.540983607,1,0.290866892
18105,106,23018,7,8,0,0,0,15,4,9,4,0,0,17,nowin,loss,beat,dlwin,0,10,15,192,0.411458333,0.026041667,0.557291667,0,0.023854304
18106,64,23018,10,10,0,0,0,20,4,9,4,0,0,17,nowin,win,plwin,beat,20,0,20,187,0.363636364,0.048128342,0.631016043,0,0.027594885
18107,56,23018,5,1,9,0,0,15,4,9,4,0,0,17,nowin,loss,beat,dlwin,0,10,6,175,0.4,0.057142857,0.582857143,0,0.026685297
18108,65,23019,8,3,9,0,0,20,2,10,3,10,0,25,nowin,win,dlbust,bust,20,0,11,203,0.492610837,0.054187192,0.571428571,3,0.913702814
18109,19,23019,2,8,2,9,0,21,2,10,3,10,0,25,nowin,win,dlbust,bust,20,0,10,237,0.41350211,0.054852321,0.628691983,2,0.597373826
18110,37,23019,8,10,0,0,0,18,2,10,3,10,0,25,nowin,win,dlbust,bust,20,0,18,208,0.394230769,0.038461538,0.581730769,0,0.024682772
18111,28,23019,10,10,0,0,0,20,2,10,3,10,0,25,nowin,win,dlbust,bust,20,0,20,199,0.422110553,0.045226131,0.542713568,1,0.282706618
18112,48,23019,2,3,9,0,0,14,2,10,3,10,0,25,nowin,win,dlbust,bust,20,0,5,203,0.413793103,0.019704433,0.600985222,2,0.577280801
18113,62,23019,3,9,0,10,0,22,2,10,3,10,0,25,nowin,loss,bust,plbust,0,10,12,178,0.370786517,0.028089888,0.54494382,0,0.008657722
18114,137,23020,2,2,7,6,0,17,4,8,3,6,0,21,nowin,loss,beat,dlwin,0,10,4,194,0.417525773,0.046391753,0.536082474,1,0.276714602
18115,102,23020,6,10,0,0,0,16,4,8,3,6,0,21,nowin,loss,beat,dlwin,0,10,16,192,0.338541667,0.046875,0.5625,0,0.003306118
18116,101,23020,10,10,0,0,0,20,4,8,3,6,0,21,nowin,loss,beat,dlwin,0,10,20,205,0.424390244,0.068292683,0.63902439,2,0.614740646
18117,121,23020,6,10,0,0,0,16,4,8,3,6,0,21,nowin,loss,beat,dlwin,0,10,16,195,0.456410256,0.025641026,0.512820513,1,0.288597791
18118,138,23020,7,10,0,0,0,17,4,8,3,6,0,21,nowin,loss,beat,dlwin,0,10,17,190,0.442105263,0.047368421,0.610526316,2,0.609711065
18119,75,23020,1,4,10,0,0,15,4,8,3,6,0,21,nowin,loss,beat,dlwin,0,10,5,191,0.418848168,0.052356021,0.570680628,0,0.029344702
18120,93,23021,5,8,0,0,0,13,4,5,4,9,0,22,nowin,win,dlbust,bust,20,0,13,175,0.485714286,0.051428571,0.548571429,1,0.323648091
18121,69,23021,3,10,0,0,0,13,4,5,4,9,0,22,nowin,win,dlbust,bust,20,0,13,194,0.365979381,0.030927835,0.515463918,0,0
18122,126,23021,10,5,0,0,0,15,4,5,4,9,0,22,nowin,win,dlbust,bust,20,0,15,188,0.457446809,0.074468085,0.60106383,3,0.900633203
18123,83,23021,10,9,0,0,0,19,4,5,4,9,0,22,nowin,win,dlbust,bust,20,0,19,193,0.424870466,0.051813472,0.678756477,2,0.644360335
18124,136,23021,10,8,0,0,0,18,4,5,4,9,0,22,nowin,win,dlbust,bust,20,0,18,194,0.396907216,0.025773196,0.597938144,0,0.029452644
18125,135,23021,10,9,0,0,0,19,4,5,4,9,0,22,nowin,win,dlbust,bust,20,0,19,179,0.391061453,0.067039106,0.586592179,0,0.024924662
18126,77,23022,5,5,6,2,0,18,7,10,0,0,0,17,nowin,win,plwin,beat,20,0,10,200,0.455,0.04,0.62,3,0.916252116
18127,132,23022,10,9,0,0,0,19,7,10,0,0,0,17,nowin,win,plwin,beat,20,0,19,194,0.412371134,0.036082474,0.649484536,2,0.611633238
18128,122,23022,8,10,0,0,0,18,7,10,0,0,0,17,nowin,win,plwin,beat,20,0,18,210,0.347619048,0.052380952,0.59047619,0,0.012873677
18129,27,23022,10,7,0,0,0,17,7,10,0,0,0,17,nowin,push,push,push,10,0,17,178,0.370786517,0.016853933,0.573033708,0,0.015536309
18130,57,23022,9,10,0,0,0,19,7,10,0,0,0,17,nowin,win,plwin,beat,20,0,19,192,0.46875,0.052083333,0.59375,3,0.907001181
18131,103,23022,3,7,5,1,10,26,7,10,0,0,0,17,nowin,loss,bust,plbust,0,10,10,203,0.379310345,0.064039409,0.551724138,0,0.012869209
18132,33,23023,11,10,0,0,0,21,7,4,3,9,0,23,win,win,dlbust,bust,25,0,21,192,0.4375,0.057291667,0.625,2,0.616208916
18133,103,23023,10,10,0,0,0,20,7,4,3,9,0,23,nowin,win,dlbust,bust,20,0,20,203,0.379310345,0.064039409,0.551724138,0,0.012869209
18134,132,23023,4,6,11,0,0,21,7,4,3,9,0,23,nowin,win,dlbust,bust,20,0,10,194,0.412371134,0.036082474,0.649484536,2,0.611633238
18135,59,23023,5,10,0,2,0,17,7,4,3,9,0,23,nowin,win,dlbust,bust,20,0,15,228,0.429824561,0.048245614,0.543859649,1,0.287885446
18136,10,23023,6,5,10,0,0,21,7,4,3,9,0,23,nowin,win,dlbust,bust,20,0,11,191,0.413612565,0.057591623,0.596858639,2,0.574087175
18137,25,23023,9,10,0,0,0,19,7,4,3,9,0,23,nowin,win,dlbust,bust,20,0,19,190,0.463157895,0.063157895,0.536842105,1,0.304401563
18138,132,23024,10,10,0,0,0,20,10,11,0,0,0,21,nowin,loss,beat,dlwin,0,10,20,194,0.412371134,0.036082474,0.649484536,2,0.611633238
18139,41,23024,2,10,0,10,0,22,10,11,0,0,0,21,nowin,loss,bust,plbust,0,10,12,192,0.364583333,0.036458333,0.520833333,0,0.00089702
18140,105,23024,3,6,3,10,0,22,10,11,0,0,0,21,nowin,loss,bust,plbust,0,10,9,198,0.414141414,0.070707071,0.590909091,0,0.032889494
18141,130,23024,4,11,1,10,0,26,10,11,0,0,0,21,nowin,loss,bust,plbust,0,10,15,219,0.410958904,0.03652968,0.566210046,0,0.025888739
18142,104,23024,10,11,0,0,0,21,10,11,0,0,0,21,win,push,push,push,10,0,21,209,0.363636364,0.052631579,0.593301435,0,0.018359419
18143,119,23024,6,1,10,0,0,17,10,11,0,0,0,21,nowin,loss,beat,dlwin,0,10,7,190,0.405263158,0.068421053,0.515789474,0,0.011837158
18144,123,23025,3,10,0,10,0,23,11,8,0,0,0,19,nowin,loss,bust,plbust,0,10,13,205,0.43902439,0.034146341,0.614634146,2,0.609962544
18145,104,23025,5,10,0,2,0,17,11,8,0,0,0,19,nowin,loss,beat,dlwin,0,10,15,209,0.363636364,0.052631579,0.593301435,0,0.018359419
18146,14,23025,7,11,0,0,0,18,11,8,0,0,0,19,nowin,loss,beat,dlwin,0,10,18,202,0.391089109,0.01980198,0.628712871,2,0.577264877
18147,22,23025,3,10,0,8,0,21,11,8,0,0,0,19,nowin,win,plwin,beat,20,0,13,187,0.481283422,0.042780749,0.577540107,3,0.906128176
18148,149,23025,3,4,8,1,2,18,11,8,0,0,0,19,nowin,loss,beat,dlwin,0,10,7,225,0.457777778,0.057777778,0.648888889,2,0.651965595
18149,73,23025,4,9,0,4,0,17,11,8,0,0,0,19,nowin,loss,beat,dlwin,0,10,13,181,0.375690608,0.011049724,0.596685083,0,0.022795773
18150,65,23026,10,7,0,0,0,17,5,4,2,10,0,21,nowin,loss,beat,dlwin,0,10,17,203,0.492610837,0.054187192,0.571428571,3,0.913702814
18151,19,23026,5,2,10,0,0,17,5,4,2,10,0,21,nowin,loss,beat,dlwin,0,10,7,237,0.41350211,0.054852321,0.628691983,2,0.597373826
18152,28,23026,7,4,2,0,0,13,5,4,2,10,0,21,nowin,loss,beat,dlwin,0,10,11,199,0.422110553,0.045226131,0.542713568,1,0.282706618
18153,37,23026,10,8,0,0,0,18,5,4,2,10,0,21,nowin,loss,beat,dlwin,0,10,18,208,0.394230769,0.038461538,0.581730769,0,0.024682772
18154,5,23026,7,9,0,0,0,16,5,4,2,10,0,21,nowin,loss,beat,dlwin,0,10,16,203,0.42364532,0.02955665,0.596059113,2,0.582508076
18155,37,23026,2,10,0,0,0,12,5,4,2,10,0,21,nowin,loss,beat,dlwin,0,10,12,208,0.394230769,0.038461538,0.581730769,0,0.024682772
18156,20,23027,3,10,0,0,0,13,2,10,3,5,0,20,nowin,loss,beat,dlwin,0,10,13,186,0.456989247,0.037634409,0.537634409,1,0.301097108
18157,129,23027,4,10,0,0,0,14,2,10,3,5,0,20,nowin,loss,beat,dlwin,0,10,14,201,0.422885572,0.064676617,0.55721393,0,0.027255383
18158,27,23027,5,10,0,0,0,15,2,10,3,5,0,20,nowin,loss,beat,dlwin,0,10,15,178,0.370786517,0.016853933,0.573033708,0,0.015536309
18159,126,23027,6,4,11,0,0,21,2,10,3,5,0,20,nowin,win,plwin,beat,20,0,10,188,0.457446809,0.074468085,0.60106383,3,0.900633203
18160,92,23027,3,8,10,0,0,21,2,10,3,5,0,20,nowin,win,plwin,beat,20,0,11,186,0.446236559,0.059139785,0.564516129,1,0.307826125
18161,136,23027,8,3,10,0,0,21,2,10,3,5,0,20,nowin,win,plwin,beat,20,0,11,194,0.396907216,0.025773196,0.597938144,0,0.029452644
18162,49,23028,1,6,10,0,0,17,2,2,10,10,0,24,nowin,win,dlbust,bust,20,0,7,207,0.396135266,0.053140097,0.594202899,0,0.028306925
18163,36,23028,3,8,5,0,0,16,2,2,10,10,0,24,nowin,win,dlbust,bust,20,0,11,229,0.445414847,0.056768559,0.655021834,2,0.645370571
18164,8,23028,10,10,0,0,0,20,2,2,10,10,0,24,nowin,win,dlbust,bust,20,0,20,181,0.44198895,0.071823204,0.596685083,2,0.599438402
18165,75,23028,11,7,0,0,0,18,2,2,10,10,0,24,nowin,win,dlbust,bust,20,0,18,191,0.418848168,0.052356021,0.570680628,0,0.029344702
18166,121,23028,7,2,4,0,0,13,2,2,10,10,0,24,nowin,win,dlbust,bust,20,0,9,195,0.456410256,0.025641026,0.512820513,1,0.288597791
18167,82,23028,10,10,0,0,0,20,2,2,10,10,0,24,nowin,win,dlbust,bust,20,0,20,225,0.408888889,0.075555556,0.577777778,0,0.028101874
18168,27,23029,1,3,10,8,0,22,8,8,9,0,0,25,nowin,loss,bust,plbust,0,10,4,178,0.370786517,0.016853933,0.573033708,0,0.015536309
18169,136,23029,10,9,0,0,0,19,8,8,9,0,0,25,nowin,win,dlbust,bust,20,0,19,194,0.396907216,0.025773196,0.597938144,0,0.029452644
18170,88,23029,9,8,0,0,0,17,8,8,9,0,0,25,nowin,win,dlbust,bust,20,0,17,206,0.466019417,0.033980583,0.54368932,1,0.309467903
18171,45,23029,6,3,2,10,0,21,8,8,9,0,0,25,nowin,win,dlbust,bust,20,0,9,196,0.428571429,0.051020408,0.612244898,2,0.598821767
18172,92,23029,3,7,4,10,0,24,8,8,9,0,0,25,nowin,loss,bust,plbust,0,10,10,186,0.446236559,0.059139785,0.564516129,1,0.307826125
18173,116,23029,7,8,0,8,0,23,8,8,9,0,0,25,nowin,loss,bust,plbust,0,10,15,195,0.425641026,0.056410256,0.538461538,1,0.28273747
18174,130,23030,10,10,0,0,0,20,2,5,7,4,0,18,nowin,win,plwin,beat,20,0,20,219,0.410958904,0.03652968,0.566210046,0,0.025888739
18175,105,23030,10,3,0,0,0,13,2,5,7,4,0,18,nowin,loss,beat,dlwin,0,10,13,198,0.414141414,0.070707071,0.590909091,0,0.032889494
18176,65,23030,11,1,3,0,0,15,2,5,7,4,0,18,nowin,loss,beat,dlwin,0,10,12,203,0.492610837,0.054187192,0.571428571,3,0.913702814
18177,83,23030,2,2,10,0,0,14,2,5,7,4,0,18,nowin,loss,beat,dlwin,0,10,4,193,0.424870466,0.051813472,0.678756477,2,0.644360335
18178,4,23030,7,11,0,0,0,18,2,5,7,4,0,18,nowin,push,push,push,10,0,18,217,0.460829493,0.036866359,0.562211982,1,0.315432839
18179,147,23030,4,2,10,0,0,16,2,5,7,4,0,18,nowin,loss,beat,dlwin,0,10,6,205,0.380487805,0.014634146,0.536585366,0,0.00951447
18180,6,23031,6,3,11,0,0,20,8,9,0,0,0,17,nowin,win,plwin,beat,20,0,9,191,0.439790576,0.047120419,0.581151832,1,0.31211505
18181,142,23031,5,5,10,0,0,20,8,9,0,0,0,17,nowin,win,plwin,beat,20,0,10,211,0.417061611,0.047393365,0.526066351,1,0.271531309
18182,34,23031,4,9,0,9,0,22,8,9,0,0,0,17,nowin,loss,bust,plbust,0,10,13,202,0.5,0.079207921,0.618811881,3,0.968961434
18183,11,23031,10,8,0,0,0,18,8,9,0,0,0,17,nowin,win,plwin,beat,20,0,18,236,0.457627119,0.016949153,0.588983051,3,0.889015813
18184,2,23031,4,7,2,1,7,21,8,9,0,0,0,17,nowin,win,plwin,beat,20,0,11,200,0.445,0.035,0.64,2,0.633962549
18185,80,23031,9,8,0,0,0,17,8,9,0,0,0,17,nowin,push,push,push,10,0,17,186,0.419354839,0.059139785,0.623655914,2,0.59892924
18186,116,23032,8,7,0,0,0,15,3,6,10,0,0,19,nowin,loss,beat,dlwin,0,10,15,195,0.425641026,0.056410256,0.538461538,1,0.28273747
18187,102,23032,4,10,0,0,0,14,3,6,10,0,0,19,nowin,loss,beat,dlwin,0,10,14,192,0.338541667,0.046875,0.5625,0,0.003306118
18188,130,23032,2,10,0,10,0,22,3,6,10,0,0,19,nowin,loss,bust,plbust,0,10,12,219,0.410958904,0.03652968,0.566210046,0,0.025888739
18189,128,23032,6,10,0,0,0,16,3,6,10,0,0,19,nowin,loss,beat,dlwin,0,10,16,227,0.356828194,0.052863436,0.577092511,0,0.012352564
18190,65,23032,10,10,0,0,0,20,3,6,10,0,0,19,nowin,win,plwin,beat,20,0,20,203,0.492610837,0.054187192,0.571428571,3,0.913702814
18191,84,23032,8,10,0,0,0,18,3,6,10,0,0,19,nowin,loss,beat,dlwin,0,10,18,195,0.379487179,0.056410256,0.569230769,0,0.017209119
18192,9,23033,10,3,0,0,0,13,6,10,5,0,0,21,nowin,loss,beat,dlwin,0,10,13,194,0.37628866,0.015463918,0.541237113,0,0.009396796
18193,131,23033,5,10,0,0,0,15,6,10,5,0,0,21,nowin,loss,beat,dlwin,0,10,15,217,0.410138249,0.069124424,0.543778802,0,0.02015021
18194,64,23033,3,6,3,0,0,12,6,10,5,0,0,21,nowin,loss,beat,dlwin,0,10,9,187,0.363636364,0.048128342,0.631016043,0,0.027594885
18195,44,23033,7,5,0,0,0,12,6,10,5,0,0,21,nowin,loss,beat,dlwin,0,10,12,219,0.433789954,0.050228311,0.534246575,1,0.285551035
18196,67,23033,2,11,5,0,0,18,6,10,5,0,0,21,nowin,loss,beat,dlwin,0,10,13,195,0.369230769,0.041025641,0.569230769,0,0.014139427
18197,87,23033,2,10,0,0,0,12,6,10,5,0,0,21,nowin,loss,beat,dlwin,0,10,12,202,0.405940594,0.054455446,0.628712871,2,0.590599801
18198,125,23034,2,1,9,10,0,22,10,8,0,0,0,18,nowin,loss,bust,plbust,0,10,3,219,0.438356164,0.050228311,0.575342466,1,0.308411257
18199,128,23034,6,3,8,0,0,17,10,8,0,0,0,18,nowin,loss,beat,dlwin,0,10,9,227,0.356828194,0.052863436,0.577092511,0,0.012352564
18200,140,23034,1,5,10,2,0,18,10,8,0,0,0,18,nowin,push,push,push,10,0,6,210,0.466666667,0.023809524,0.604761905,3,0.915293335
18201,24,23034,4,3,7,6,0,20,10,8,0,0,0,18,nowin,win,plwin,beat,20,0,7,207,0.458937198,0.048309179,0.570048309,1,0.318138014
18202,24,23034,10,7,0,0,0,17,10,8,0,0,0,18,nowin,loss,beat,dlwin,0,10,17,207,0.458937198,0.048309179,0.570048309,1,0.318138014
18203,80,23034,10,4,0,3,0,17,10,8,0,0,0,18,nowin,loss,beat,dlwin,0,10,14,186,0.419354839,0.059139785,0.623655914,2,0.59892924
18204,5,23035,8,2,4,2,10,26,10,6,10,0,0,26,nowin,loss,bust,plbust,0,10,10,203,0.42364532,0.02955665,0.596059113,2,0.582508076
18205,125,23035,10,11,0,0,0,21,10,6,10,0,0,26,win,win,dlbust,bust,25,0,21,219,0.438356164,0.050228311,0.575342466,1,0.308411257
18206,25,23035,7,5,0,10,0,22,10,6,10,0,0,26,nowin,loss,bust,plbust,0,10,12,190,0.463157895,0.063157895,0.536842105,1,0.304401563
18207,132,23035,10,8,0,0,0,18,10,6,10,0,0,26,nowin,win,dlbust,bust,20,0,18,194,0.412371134,0.036082474,0.649484536,2,0.611633238
18208,125,23035,7,10,0,0,0,17,10,6,10,0,0,26,nowin,win,dlbust,bust,20,0,17,219,0.438356164,0.050228311,0.575342466,1,0.308411257
18209,119,23035,7,11,0,0,0,18,10,6,10,0,0,26,nowin,win,dlbust,bust,20,0,18,190,0.405263158,0.068421053,0.515789474,0,0.011837158
18210,48,23036,10,3,0,1,10,24,11,7,0,0,0,18,nowin,loss,bust,plbust,0,10,13,203,0.413793103,0.019704433,0.600985222,2,0.577280801
18211,143,23036,5,9,0,10,0,24,11,7,0,0,0,18,nowin,loss,bust,plbust,0,10,14,203,0.463054187,0.044334975,0.57635468,3,0.883143365
18212,53,23036,10,10,0,0,0,20,11,7,0,0,0,18,nowin,win,plwin,beat,20,0,20,250,0.372,0.064,0.564,0,0.013687345
18213,85,23036,4,1,10,6,0,21,11,7,0,0,0,18,nowin,win,plwin,beat,20,0,5,195,0.41025641,0.066666667,0.594871795,0,0.03269711
18214,95,23036,4,9,0,7,0,20,11,7,0,0,0,18,nowin,win,plwin,beat,20,0,13,218,0.412844037,0.04587156,0.559633028,0,0.024842385
18215,88,23036,5,7,0,1,9,22,11,7,0,0,0,18,nowin,loss,bust,plbust,0,10,12,206,0.466019417,0.033980583,0.54368932,1,0.309467903
18216,42,23037,5,8,0,7,0,20,11,3,1,2,0,17,nowin,win,plwin,beat,20,0,13,212,0.443396226,0.051886792,0.570754717,1,0.309181312
18217,3,23037,4,3,10,0,0,17,11,3,1,2,0,17,nowin,push,push,push,10,0,7,190,0.431578947,0.026315789,0.542105263,1,0.288076384
18218,21,23037,10,2,0,10,0,22,11,3,1,2,0,17,nowin,loss,bust,plbust,0,10,12,214,0.359813084,0.042056075,0.626168224,0,0.025263474
18219,89,23037,10,6,0,3,0,19,11,3,1,2,0,17,nowin,win,plwin,beat,20,0,16,212,0.537735849,0.047169811,0.594339623,3,0.990167191
18220,63,23037,2,9,9,0,0,20,11,3,1,2,0,17,nowin,win,plwin,beat,20,0,11,216,0.467592593,0.037037037,0.62037037,3,0.931690496
18221,39,23037,5,5,4,10,0,24,11,3,1,2,0,17,nowin,loss,bust,plbust,0,10,10,191,0.429319372,0.062827225,0.57591623,0,0.033760763
18222,6,23038,10,6,0,0,0,16,5,1,8,2,10,26,nowin,win,dlbust,bust,20,0,16,191,0.439790576,0.047120419,0.581151832,1,0.31211505
18223,49,23038,7,7,0,0,0,14,5,1,8,2,10,26,nowin,win,dlbust,bust,20,0,14,207,0.396135266,0.053140097,0.594202899,0,0.028306925
18224,11,23038,6,8,0,0,0,14,5,1,8,2,10,26,nowin,win,dlbust,bust,20,0,14,236,0.457627119,0.016949153,0.588983051,3,0.889015813
18225,15,23038,9,4,0,0,0,13,5,1,8,2,10,26,nowin,win,dlbust,bust,20,0,13,212,0.410377358,0.051886792,0.561320755,0,0.024517408
18226,32,23038,3,7,10,0,0,20,5,1,8,2,10,26,nowin,win,dlbust,bust,20,0,10,189,0.391534392,0.037037037,0.53968254,0,0.013579086
18227,4,23038,10,5,0,0,0,15,5,1,8,2,10,26,nowin,win,dlbust,bust,20,0,15,217,0.460829493,0.036866359,0.562211982,1,0.315432839
18228,60,23039,4,10,0,0,0,14,6,7,3,10,0,26,nowin,win,dlbust,bust,20,0,14,227,0.418502203,0.022026432,0.559471366,0,0.026496258
18229,16,23039,10,11,0,0,0,21,6,7,3,10,0,26,win,win,dlbust,bust,25,0,21,220,0.427272727,0.081818182,0.6,2,0.588660176
18230,91,23039,6,3,6,0,0,15,6,7,3,10,0,26,nowin,win,dlbust,bust,20,0,9,194,0.417525773,0.046391753,0.515463918,1,0.266616552
18231,22,23039,11,4,6,0,0,21,6,7,3,10,0,26,nowin,win,dlbust,bust,20,0,15,187,0.481283422,0.042780749,0.577540107,3,0.906128176
18232,101,23039,2,8,6,0,0,16,6,7,3,10,0,26,nowin,win,dlbust,bust,20,0,10,205,0.424390244,0.068292683,0.63902439,2,0.614740646
18233,54,23039,5,5,5,0,0,15,6,7,3,10,0,26,nowin,win,dlbust,bust,20,0,10,185,0.437837838,0.032432432,0.556756757,1,0.29899854
18234,93,23040,2,9,3,0,0,14,6,10,5,0,0,21,nowin,loss,beat,dlwin,0,10,11,175,0.485714286,0.051428571,0.548571429,1,0.323648091
18235,2,23040,2,4,3,10,0,19,6,10,5,0,0,21,nowin,loss,beat,dlwin,0,10,6,200,0.445,0.035,0.64,2,0.633962549
18236,117,23040,10,5,0,0,0,15,6,10,5,0,0,21,nowin,loss,beat,dlwin,0,10,15,173,0.410404624,0.069364162,0.606936416,2,0.578610282
18237,100,23040,6,1,9,0,0,16,6,10,5,0,0,21,nowin,loss,beat,dlwin,0,10,7,190,0.452631579,0.036842105,0.594736842,3,0.888671154
18238,29,23040,7,5,0,0,0,12,6,10,5,0,0,21,nowin,loss,beat,dlwin,0,10,12,189,0.44973545,0.058201058,0.544973545,1,0.300349439
18239,98,23040,11,8,0,0,0,19,6,10,5,0,0,21,nowin,loss,beat,dlwin,0,10,19,220,0.422727273,0.054545455,0.55,1,0.28664435
18240,138,23041,2,9,10,0,0,21,6,4,7,0,0,17,nowin,win,plwin,beat,20,0,11,190,0.442105263,0.047368421,0.610526316,2,0.609711065
18241,140,23041,8,10,0,0,0,18,6,4,7,0,0,17,nowin,win,plwin,beat,20,0,18,210,0.466666667,0.023809524,0.604761905,3,0.915293335
18242,25,23041,5,7,0,0,0,12,6,4,7,0,0,17,nowin,loss,beat,dlwin,0,10,12,190,0.463157895,0.063157895,0.536842105,1,0.304401563
18243,85,23041,10,4,0,0,0,14,6,4,7,0,0,17,nowin,loss,beat,dlwin,0,10,14,195,0.41025641,0.066666667,0.594871795,0,0.03269711
18244,119,23041,4,10,0,0,0,14,6,4,7,0,0,17,nowin,loss,beat,dlwin,0,10,14,190,0.405263158,0.068421053,0.515789474,0,0.011837158
18245,52,23041,8,10,0,0,0,18,6,4,7,0,0,17,nowin,win,plwin,beat,20,0,18,217,0.414746544,0.02764977,0.599078341,2,0.576736024
18246,2,23042,3,10,0,8,0,21,10,8,0,0,0,18,nowin,win,plwin,beat,20,0,13,200,0.445,0.035,0.64,2,0.633962549
18247,2,23042,10,6,0,8,0,24,10,8,0,0,0,18,nowin,loss,bust,plbust,0,10,16,200,0.445,0.035,0.64,2,0.633962549
18248,121,23042,10,3,0,9,0,22,10,8,0,0,0,18,nowin,loss,bust,plbust,0,10,13,195,0.456410256,0.025641026,0.512820513,1,0.288597791
18249,54,23042,9,7,0,7,0,23,10,8,0,0,0,18,nowin,loss,bust,plbust,0,10,16,185,0.437837838,0.032432432,0.556756757,1,0.29899854
18250,123,23042,5,7,0,1,6,19,10,8,0,0,0,18,nowin,win,plwin,beat,20,0,12,205,0.43902439,0.034146341,0.614634146,2,0.609962544
18251,67,23042,3,10,0,4,0,17,10,8,0,0,0,18,nowin,loss,beat,dlwin,0,10,13,195,0.369230769,0.041025641,0.569230769,0,0.014139427
18252,10,23043,11,8,0,0,0,19,10,3,8,0,0,21,nowin,loss,beat,dlwin,0,10,19,191,0.413612565,0.057591623,0.596858639,2,0.574087175
18253,122,23043,2,4,11,0,0,17,10,3,8,0,0,21,nowin,loss,beat,dlwin,0,10,6,210,0.347619048,0.052380952,0.59047619,0,0.012873677
18254,91,23043,4,6,10,0,0,20,10,3,8,0,0,21,nowin,loss,beat,dlwin,0,10,10,194,0.417525773,0.046391753,0.515463918,1,0.266616552
18255,139,23043,8,10,0,0,0,18,10,3,8,0,0,21,nowin,loss,beat,dlwin,0,10,18,192,0.380208333,0.036458333,0.59375,0,0.023429169
18256,146,23043,5,3,9,0,0,17,10,3,8,0,0,21,nowin,loss,beat,dlwin,0,10,8,221,0.43438914,0.040723982,0.542986425,1,0.290190091
18257,64,23043,10,11,0,0,0,21,10,3,8,0,0,21,win,push,push,push,10,0,21,187,0.363636364,0.048128342,0.631016043,0,0.027594885
18258,92,23044,7,10,0,0,0,17,10,2,9,0,0,21,nowin,loss,beat,dlwin,0,10,17,186,0.446236559,0.059139785,0.564516129,1,0.307826125
18259,85,23044,4,4,11,0,0,19,10,2,9,0,0,21,nowin,loss,beat,dlwin,0,10,8,195,0.41025641,0.066666667,0.594871795,0,0.03269711
18260,36,23044,2,9,1,10,0,22,10,2,9,0,0,21,nowin,loss,bust,plbust,0,10,11,229,0.445414847,0.056768559,0.655021834,2,0.645370571
18261,124,23044,10,6,0,1,0,17,10,2,9,0,0,21,nowin,loss,beat,dlwin,0,10,16,202,0.47029703,0.064356436,0.584158416,3,0.899458193
18262,38,23044,10,9,0,0,0,19,10,2,9,0,0,21,nowin,loss,beat,dlwin,0,10,19,202,0.361386139,0.03960396,0.564356436,0,0.010597953
18263,94,23044,3,5,4,1,10,23,10,2,9,0,0,21,nowin,loss,bust,plbust,0,10,8,183,0.43715847,0.043715847,0.540983607,1,0.290866892
18264,12,23045,10,10,0,0,0,20,10,3,10,0,0,23,nowin,win,dlbust,bust,20,0,20,189,0.470899471,0.015873016,0.613756614,3,0.929171178
18265,102,23045,5,2,3,10,0,20,10,3,10,0,0,23,nowin,win,dlbust,bust,20,0,7,192,0.338541667,0.046875,0.5625,0,0.003306118
18266,54,23045,9,5,0,6,0,20,10,3,10,0,0,23,nowin,win,dlbust,bust,20,0,14,185,0.437837838,0.032432432,0.556756757,1,0.29899854
18267,63,23045,3,3,9,2,0,17,10,3,10,0,0,23,nowin,win,dlbust,bust,20,0,6,216,0.467592593,0.037037037,0.62037037,3,0.931690496
18268,134,23045,6,7,0,10,0,23,10,3,10,0,0,23,nowin,loss,bust,plbust,0,10,13,185,0.443243243,0.021621622,0.545945946,1,0.296939509
18269,73,23045,7,10,0,0,0,17,10,3,10,0,0,23,nowin,win,dlbust,bust,20,0,17,181,0.375690608,0.011049724,0.596685083,0,0.022795773
18270,132,23046,10,10,0,0,0,20,6,4,3,10,0,23,nowin,win,dlbust,bust,20,0,20,194,0.412371134,0.036082474,0.649484536,2,0.611633238
18271,138,23046,10,10,0,0,0,20,6,4,3,10,0,23,nowin,win,dlbust,bust,20,0,20,190,0.442105263,0.047368421,0.610526316,2,0.609711065
18272,19,23046,10,6,0,0,0,16,6,4,3,10,0,23,nowin,win,dlbust,bust,20,0,16,237,0.41350211,0.054852321,0.628691983,2,0.597373826
18273,29,23046,3,10,0,0,0,13,6,4,3,10,0,23,nowin,win,dlbust,bust,20,0,13,189,0.44973545,0.058201058,0.544973545,1,0.300349439
18274,40,23046,10,11,0,0,0,21,6,4,3,10,0,23,win,win,dlbust,bust,25,0,21,196,0.367346939,0.030612245,0.617346939,0,0.025358183
18275,36,23046,2,6,6,0,0,14,6,4,3,10,0,23,nowin,win,dlbust,bust,20,0,8,229,0.445414847,0.056768559,0.655021834,2,0.645370571
18276,147,23047,10,10,0,0,0,20,9,5,5,0,0,19,nowin,win,plwin,beat,20,0,20,205,0.380487805,0.014634146,0.536585366,0,0.00951447
18277,60,23047,10,11,0,0,0,21,9,5,5,0,0,19,win,win,plwin,beat,25,0,21,227,0.418502203,0.022026432,0.559471366,0,0.026496258
18278,145,23047,8,7,0,10,0,25,9,5,5,0,0,19,nowin,loss,bust,plbust,0,10,15,188,0.441489362,0.031914894,0.622340426,2,0.617837093
18279,59,23047,2,7,5,4,0,18,9,5,5,0,0,19,nowin,loss,beat,dlwin,0,10,9,228,0.429824561,0.048245614,0.543859649,1,0.287885446
18280,123,23047,10,8,0,0,0,18,9,5,5,0,0,19,nowin,loss,beat,dlwin,0,10,18,205,0.43902439,0.034146341,0.614634146,2,0.609962544
18281,66,23047,4,7,7,0,0,18,9,5,5,0,0,19,nowin,loss,beat,dlwin,0,10,11,217,0.456221198,0.064516129,0.626728111,3,0.924304367
18282,80,23048,3,10,0,0,0,13,2,2,10,1,5,20,nowin,loss,beat,dlwin,0,10,13,186,0.419354839,0.059139785,0.623655914,2,0.59892924
18283,16,23048,3,4,2,8,0,17,2,2,10,1,5,20,nowin,loss,beat,dlwin,0,10,7,220,0.427272727,0.081818182,0.6,2,0.588660176
18284,27,23048,4,10,0,0,0,14,2,2,10,1,5,20,nowin,loss,beat,dlwin,0,10,14,178,0.370786517,0.016853933,0.573033708,0,0.015536309
18285,27,23048,9,7,0,0,0,16,2,2,10,1,5,20,nowin,loss,beat,dlwin,0,10,16,178,0.370786517,0.016853933,0.573033708,0,0.015536309
18286,50,23048,10,10,0,0,0,20,2,2,10,1,5,20,nowin,push,push,push,10,0,20,202,0.405940594,0.04950495,0.54950495,0,0.020296079
18287,119,23048,4,3,10,0,0,17,2,2,10,1,5,20,nowin,loss,beat,dlwin,0,10,7,190,0.405263158,0.068421053,0.515789474,0,0.011837158
18288,91,23049,10,8,0,0,0,18,10,10,0,0,0,20,nowin,loss,beat,dlwin,0,10,18,194,0.417525773,0.046391753,0.515463918,1,0.266616552
18289,73,23049,10,7,0,0,0,17,10,10,0,0,0,20,nowin,loss,beat,dlwin,0,10,17,181,0.375690608,0.011049724,0.596685083,0,0.022795773
18290,98,23049,5,2,7,10,0,24,10,10,0,0,0,20,nowin,loss,bust,plbust,0,10,7,220,0.422727273,0.054545455,0.55,1,0.28664435
18291,51,23049,2,10,0,5,0,17,10,10,0,0,0,20,nowin,loss,beat,dlwin,0,10,12,189,0.529100529,0.068783069,0.608465608,3,0.993665715
18292,6,23049,10,11,0,0,0,21,10,10,0,0,0,20,win,win,plwin,beat,25,0,21,191,0.439790576,0.047120419,0.581151832,1,0.31211505
18293,78,23049,10,3,0,9,0,22,10,10,0,0,0,20,nowin,loss,bust,plbust,0,10,13,201,0.517412935,0.034825871,0.587064677,3,0.95871112
18294,23,23050,7,6,0,4,0,17,10,7,0,0,0,17,nowin,push,push,push,10,0,13,208,0.427884615,0.0625,0.552884615,1,0.29114424
18295,106,23050,10,6,0,7,0,23,10,7,0,0,0,17,nowin,loss,bust,plbust,0,10,16,192,0.411458333,0.026041667,0.557291667,0,0.023854304
18296,74,23050,11,10,0,0,0,21,10,7,0,0,0,17,win,win,plwin,beat,25,0,21,209,0.411483254,0.04784689,0.531100478,0,0.017448125
18297,46,23050,7,10,0,0,0,17,10,7,0,0,0,17,nowin,push,push,push,10,0,17,186,0.403225806,0.048387097,0.591397849,0,0.029742194
18298,136,23050,10,10,0,0,0,20,10,7,0,0,0,17,nowin,win,plwin,beat,20,0,20,194,0.396907216,0.025773196,0.597938144,0,0.029452644
18299,150,23050,8,10,0,0,0,18,10,7,0,0,0,17,nowin,win,plwin,beat,20,0,18,192,0.401041667,0.036458333,0.567708333,0,0.023287458
18300,122,23051,4,4,11,0,0,19,10,10,0,0,0,20,nowin,loss,beat,dlwin,0,10,8,210,0.347619048,0.052380952,0.59047619,0,0.012873677
18301,84,23051,5,1,10,3,0,19,10,10,0,0,0,20,nowin,loss,beat,dlwin,0,10,6,195,0.379487179,0.056410256,0.569230769,0,0.017209119
18302,120,23051,7,4,1,10,0,22,10,10,0,0,0,20,nowin,loss,bust,plbust,0,10,11,202,0.440594059,0.034653465,0.618811881,2,0.614441029
18303,61,23051,4,10,0,5,0,19,10,10,0,0,0,20,nowin,loss,beat,dlwin,0,10,14,194,0.427835052,0.077319588,0.603092784,2,0.591437139
18304,4,23051,9,2,10,0,0,21,10,10,0,0,0,20,nowin,win,plwin,beat,20,0,11,217,0.460829493,0.036866359,0.562211982,1,0.315432839
18305,66,23051,11,8,0,0,0,19,10,10,0,0,0,20,nowin,loss,beat,dlwin,0,10,19,217,0.456221198,0.064516129,0.626728111,3,0.924304367
18306,133,23052,10,11,0,0,0,21,4,2,6,10,0,22,win,win,dlbust,bust,25,0,21,201,0.47761194,0.064676617,0.611940299,3,0.935428111
18307,43,23052,10,6,0,0,0,16,4,2,6,10,0,22,nowin,win,dlbust,bust,20,0,16,192,0.40625,0.041666667,0.609375,2,0.576671372
18308,94,23052,11,9,0,0,0,20,4,2,6,10,0,22,nowin,win,dlbust,bust,20,0,20,183,0.43715847,0.043715847,0.540983607,1,0.290866892
18309,137,23052,9,5,0,0,0,14,4,2,6,10,0,22,nowin,win,dlbust,bust,20,0,14,194,0.417525773,0.046391753,0.536082474,1,0.276714602
18310,115,23052,4,11,6,0,0,21,4,2,6,10,0,22,nowin,win,dlbust,bust,20,0,15,194,0.427835052,0.041237113,0.592783505,2,0.583863602
18311,98,23052,7,10,0,0,0,17,4,2,6,10,0,22,nowin,win,dlbust,bust,20,0,17,220,0.422727273,0.054545455,0.55,1,0.28664435
18312,99,23053,9,10,0,0,0,19,8,10,0,0,0,18,nowin,win,plwin,beat,20,0,19,207,0.47826087,0.062801932,0.637681159,3,0.961418446
18313,26,23053,5,10,0,6,0,21,8,10,0,0,0,18,nowin,win,plwin,beat,20,0,15,203,0.463054187,0.0591133,0.541871921,1,0.306802864
18314,37,23053,11,3,5,0,0,19,8,10,0,0,0,18,nowin,win,plwin,beat,20,0,14,208,0.394230769,0.038461538,0.581730769,0,0.024682772
18315,94,23053,3,6,6,6,0,21,8,10,0,0,0,18,nowin,win,plwin,beat,20,0,9,183,0.43715847,0.043715847,0.540983607,1,0.290866892
18316,61,23053,10,10,0,0,0,20,8,10,0,0,0,18,nowin,win,plwin,beat,20,0,20,194,0.427835052,0.077319588,0.603092784,2,0.591437139
18317,16,23053,5,8,0,10,0,23,8,10,0,0,0,18,nowin,loss,bust,plbust,0,10,13,220,0.427272727,0.081818182,0.6,2,0.588660176
18318,81,23054,7,10,0,0,0,17,4,5,8,0,0,17,nowin,push,push,push,10,0,17,182,0.395604396,0.043956044,0.60989011,2,0.567491261
18319,98,23054,10,9,0,0,0,19,4,5,8,0,0,17,nowin,win,plwin,beat,20,0,19,220,0.422727273,0.054545455,0.55,1,0.28664435
18320,136,23054,10,5,0,0,0,15,4,5,8,0,0,17,nowin,loss,beat,dlwin,0,10,15,194,0.396907216,0.025773196,0.597938144,0,0.029452644
18321,60,23054,10,9,0,0,0,19,4,5,8,0,0,17,nowin,win,plwin,beat,20,0,19,227,0.418502203,0.022026432,0.559471366,0,0.026496258
18322,110,23054,9,10,0,0,0,19,4,5,8,0,0,17,nowin,win,plwin,beat,20,0,19,192,0.416666667,0.046875,0.557291667,0,0.025413132
18323,36,23054,4,6,11,0,0,21,4,5,8,0,0,17,nowin,win,plwin,beat,20,0,10,229,0.445414847,0.056768559,0.655021834,2,0.645370571
18324,149,23055,10,6,0,10,0,26,9,10,0,0,0,19,nowin,loss,bust,plbust,0,10,16,225,0.457777778,0.057777778,0.648888889,2,0.651965595
18325,89,23055,10,10,0,0,0,20,9,10,0,0,0,19,nowin,win,plwin,beat,20,0,20,212,0.537735849,0.047169811,0.594339623,3,0.990167191
18326,31,23055,5,10,0,7,0,22,9,10,0,0,0,19,nowin,loss,bust,plbust,0,10,15,188,0.473404255,0.058510638,0.515957447,1,0.300306557
18327,54,23055,5,3,11,0,0,19,9,10,0,0,0,19,nowin,push,push,push,10,0,8,185,0.437837838,0.032432432,0.556756757,1,0.29899854
18328,83,23055,1,6,8,9,0,24,9,10,0,0,0,19,nowin,loss,bust,plbust,0,10,7,193,0.424870466,0.051813472,0.678756477,2,0.644360335
18329,73,23055,11,8,0,0,0,19,9,10,0,0,0,19,nowin,push,push,push,10,0,19,181,0.375690608,0.011049724,0.596685083,0,0.022795773
18330,41,23056,6,7,0,10,0,23,10,2,10,0,0,22,nowin,loss,bust,plbust,0,10,13,192,0.364583333,0.036458333,0.520833333,0,0.00089702
18331,44,23056,10,11,0,0,0,21,10,2,10,0,0,22,win,win,dlbust,bust,25,0,21,219,0.433789954,0.050228311,0.534246575,1,0.285551035
18332,26,23056,2,5,6,3,10,26,10,2,10,0,0,22,nowin,loss,bust,plbust,0,10,7,203,0.463054187,0.0591133,0.541871921,1,0.306802864
18333,50,23056,8,8,0,2,0,18,10,2,10,0,0,22,nowin,win,dlbust,bust,20,0,16,202,0.405940594,0.04950495,0.54950495,0,0.020296079
18334,1,23056,2,9,9,0,0,20,10,2,10,0,0,22,nowin,win,dlbust,bust,20,0,11,197,0.406091371,0.025380711,0.649746193,2,0.606186955
18335,94,23056,2,3,10,10,0,25,10,2,10,0,0,22,nowin,loss,bust,plbust,0,10,5,183,0.43715847,0.043715847,0.540983607,1,0.290866892
18336,146,23057,5,3,10,0,0,18,10,10,0,0,0,20,nowin,loss,beat,dlwin,0,10,8,221,0.43438914,0.040723982,0.542986425,1,0.290190091
18337,100,23057,3,10,0,10,0,23,10,10,0,0,0,20,nowin,loss,bust,plbust,0,10,13,190,0.452631579,0.036842105,0.594736842,3,0.888671154
18338,113,23057,11,4,4,0,0,19,10,10,0,0,0,20,nowin,loss,beat,dlwin,0,10,15,199,0.407035176,0.055276382,0.668341709,2,0.620695264
18339,77,23057,6,4,4,8,0,22,10,10,0,0,0,20,nowin,loss,bust,plbust,0,10,10,200,0.455,0.04,0.62,3,0.916252116
18340,63,23057,4,4,5,7,0,20,10,10,0,0,0,20,nowin,push,push,push,10,0,8,216,0.467592593,0.037037037,0.62037037,3,0.931690496
18341,150,23057,10,3,0,5,0,18,10,10,0,0,0,20,nowin,loss,beat,dlwin,0,10,13,192,0.401041667,0.036458333,0.567708333,0,0.023287458
18342,33,23058,7,3,9,0,0,19,11,3,4,0,0,18,nowin,win,plwin,beat,20,0,10,192,0.4375,0.057291667,0.625,2,0.616208916
18343,9,23058,3,1,10,10,0,24,11,3,4,0,0,18,nowin,loss,bust,plbust,0,10,4,194,0.37628866,0.015463918,0.541237113,0,0.009396796
18344,63,23058,10,11,0,0,0,21,11,3,4,0,0,18,win,win,plwin,beat,25,0,21,216,0.467592593,0.037037037,0.62037037,3,0.931690496
18345,114,23058,3,10,0,5,0,18,11,3,4,0,0,18,nowin,push,push,push,10,0,13,198,0.47979798,0.025252525,0.611111111,3,0.937232995
18346,82,23058,4,10,0,1,10,25,11,3,4,0,0,18,nowin,loss,bust,plbust,0,10,14,225,0.408888889,0.075555556,0.577777778,0,0.028101874
18347,133,23058,10,10,0,0,0,20,11,3,4,0,0,18,nowin,win,plwin,beat,20,0,20,201,0.47761194,0.064676617,0.611940299,3,0.935428111
18348,133,23059,10,10,0,0,0,20,10,3,6,0,0,19,nowin,win,plwin,beat,20,0,20,201,0.47761194,0.064676617,0.611940299,3,0.935428111
18349,129,23059,5,10,0,10,0,25,10,3,6,0,0,19,nowin,loss,bust,plbust,0,10,15,201,0.422885572,0.064676617,0.55721393,0,0.027255383
18350,120,23059,10,10,0,0,0,20,10,3,6,0,0,19,nowin,win,plwin,beat,20,0,20,202,0.440594059,0.034653465,0.618811881,2,0.614441029
18351,75,23059,10,2,0,9,0,21,10,3,6,0,0,19,nowin,win,plwin,beat,20,0,12,191,0.418848168,0.052356021,0.570680628,0,0.029344702
18352,9,23059,10,6,0,4,0,20,10,3,6,0,0,19,nowin,win,plwin,beat,20,0,16,194,0.37628866,0.015463918,0.541237113,0,0.009396796
18353,65,23059,10,6,0,6,0,22,10,3,6,0,0,19,nowin,loss,bust,plbust,0,10,16,203,0.492610837,0.054187192,0.571428571,3,0.913702814
18354,41,23060,5,5,4,0,0,14,2,5,10,0,0,17,nowin,loss,beat,dlwin,0,10,10,192,0.364583333,0.036458333,0.520833333,0,0.00089702
18355,114,23060,1,6,7,0,0,14,2,5,10,0,0,17,nowin,loss,beat,dlwin,0,10,7,198,0.47979798,0.025252525,0.611111111,3,0.937232995
18356,110,23060,10,10,0,0,0,20,2,5,10,0,0,17,nowin,win,plwin,beat,20,0,20,192,0.416666667,0.046875,0.557291667,0,0.025413132
18357,124,23060,4,8,0,5,0,17,2,5,10,0,0,17,nowin,push,push,push,10,0,12,202,0.47029703,0.064356436,0.584158416,3,0.899458193
18358,96,23060,2,11,1,0,0,14,2,5,10,0,0,17,nowin,loss,beat,dlwin,0,10,13,190,0.468421053,0.057894737,0.584210526,3,0.897263354
18359,20,23060,4,1,10,0,0,15,2,5,10,0,0,17,nowin,loss,beat,dlwin,0,10,5,186,0.456989247,0.037634409,0.537634409,1,0.301097108
18360,102,23061,10,11,0,0,0,21,7,10,0,0,0,17,win,win,plwin,beat,25,0,21,192,0.338541667,0.046875,0.5625,0,0.003306118
18361,43,23061,10,10,0,0,0,20,7,10,0,0,0,17,nowin,win,plwin,beat,20,0,20,192,0.40625,0.041666667,0.609375,2,0.576671372
18362,7,23061,8,10,0,0,0,18,7,10,0,0,0,17,nowin,win,plwin,beat,20,0,18,183,0.442622951,0.06010929,0.62295082,2,0.619303341
18363,106,23061,7,9,0,6,0,22,7,10,0,0,0,17,nowin,loss,bust,plbust,0,10,16,192,0.411458333,0.026041667,0.557291667,0,0.023854304
18364,63,23061,2,7,11,0,0,20,7,10,0,0,0,17,nowin,win,plwin,beat,20,0,9,216,0.467592593,0.037037037,0.62037037,3,0.931690496
18365,4,23061,5,10,0,5,0,20,7,10,0,0,0,17,nowin,win,plwin,beat,20,0,15,217,0.460829493,0.036866359,0.562211982,1,0.315432839
18366,104,23062,11,2,8,0,0,21,5,10,5,0,0,20,nowin,win,plwin,beat,20,0,13,209,0.363636364,0.052631579,0.593301435,0,0.018359419
18367,41,23062,6,10,0,0,0,16,5,10,5,0,0,20,nowin,loss,beat,dlwin,0,10,16,192,0.364583333,0.036458333,0.520833333,0,0.00089702
18368,50,23062,10,5,0,0,0,15,5,10,5,0,0,20,nowin,loss,beat,dlwin,0,10,15,202,0.405940594,0.04950495,0.54950495,0,0.020296079
18369,147,23062,10,7,0,0,0,17,5,10,5,0,0,20,nowin,loss,beat,dlwin,0,10,17,205,0.380487805,0.014634146,0.536585366,0,0.00951447
18370,59,23062,2,6,2,10,0,20,5,10,5,0,0,20,nowin,push,push,push,10,0,8,228,0.429824561,0.048245614,0.543859649,1,0.287885446
18371,25,23062,7,10,0,0,0,17,5,10,5,0,0,20,nowin,loss,beat,dlwin,0,10,17,190,0.463157895,0.063157895,0.536842105,1,0.304401563
18372,55,23063,8,10,0,0,0,18,4,6,6,10,0,26,nowin,win,dlbust,bust,20,0,18,191,0.371727749,0.057591623,0.54973822,0,0.01011347
18373,125,23063,9,7,0,0,0,16,4,6,6,10,0,26,nowin,win,dlbust,bust,20,0,16,219,0.438356164,0.050228311,0.575342466,1,0.308411257
18374,19,23063,10,4,0,0,0,14,4,6,6,10,0,26,nowin,win,dlbust,bust,20,0,14,237,0.41350211,0.054852321,0.628691983,2,0.597373826
18375,21,23063,6,5,8,0,0,19,4,6,6,10,0,26,nowin,win,dlbust,bust,20,0,11,214,0.359813084,0.042056075,0.626168224,0,0.025263474
18376,57,23063,11,2,7,0,0,20,4,6,6,10,0,26,nowin,win,dlbust,bust,20,0,13,192,0.46875,0.052083333,0.59375,3,0.907001181
18377,136,23063,7,10,0,0,0,17,4,6,6,10,0,26,nowin,win,dlbust,bust,20,0,17,194,0.396907216,0.025773196,0.597938144,0,0.029452644
18378,7,23064,2,3,6,10,0,21,3,10,10,0,0,23,nowin,win,dlbust,bust,20,0,5,183,0.442622951,0.06010929,0.62295082,2,0.619303341
18379,20,23064,8,3,2,0,0,13,3,10,10,0,0,23,nowin,win,dlbust,bust,20,0,11,186,0.456989247,0.037634409,0.537634409,1,0.301097108
18380,118,23064,6,5,10,0,0,21,3,10,10,0,0,23,nowin,win,dlbust,bust,20,0,11,216,0.393518519,0.037037037,0.555555556,0,0.018059873
18381,134,23064,10,10,0,0,0,20,3,10,10,0,0,23,nowin,win,dlbust,bust,20,0,20,185,0.443243243,0.021621622,0.545945946,1,0.296939509
18382,94,23064,9,10,0,0,0,19,3,10,10,0,0,23,nowin,win,dlbust,bust,20,0,19,183,0.43715847,0.043715847,0.540983607,1,0.290866892
18383,109,23064,11,8,0,0,0,19,3,10,10,0,0,23,nowin,win,dlbust,bust,20,0,19,221,0.461538462,0.058823529,0.597285068,3,0.901830309
18384,142,23065,6,10,0,3,0,19,10,7,0,0,0,17,nowin,win,plwin,beat,20,0,16,211,0.417061611,0.047393365,0.526066351,1,0.271531309
18385,148,23065,2,5,4,8,0,19,10,7,0,0,0,17,nowin,win,plwin,beat,20,0,7,204,0.401960784,0.078431373,0.593137255,0,0.029789521
18386,77,23065,10,2,0,2,4,18,10,7,0,0,0,17,nowin,win,plwin,beat,20,0,12,200,0.455,0.04,0.62,3,0.916252116
18387,106,23065,2,2,4,7,10,25,10,7,0,0,0,17,nowin,loss,bust,plbust,0,10,4,192,0.411458333,0.026041667,0.557291667,0,0.023854304
18388,33,23065,2,4,10,9,0,25,10,7,0,0,0,17,nowin,loss,bust,plbust,0,10,6,192,0.4375,0.057291667,0.625,2,0.616208916
18389,27,23065,6,7,0,7,0,20,10,7,0,0,0,17,nowin,win,plwin,beat,20,0,13,178,0.370786517,0.016853933,0.573033708,0,0.015536309
18390,14,23066,7,5,0,0,0,12,6,10,6,0,0,22,nowin,win,dlbust,bust,20,0,12,202,0.391089109,0.01980198,0.628712871,2,0.577264877
18391,56,23066,5,4,5,0,0,14,6,10,6,0,0,22,nowin,win,dlbust,bust,20,0,9,175,0.4,0.057142857,0.582857143,0,0.026685297
18392,6,23066,7,3,9,0,0,19,6,10,6,0,0,22,nowin,win,dlbust,bust,20,0,10,191,0.439790576,0.047120419,0.581151832,1,0.31211505
18393,87,23066,3,2,9,0,0,14,6,10,6,0,0,22,nowin,win,dlbust,bust,20,0,5,202,0.405940594,0.054455446,0.628712871,2,0.590599801
18394,133,23066,11,7,0,0,0,18,6,10,6,0,0,22,nowin,win,dlbust,bust,20,0,18,201,0.47761194,0.064676617,0.611940299,3,0.935428111
18395,13,23066,3,6,4,0,0,13,6,10,6,0,0,22,nowin,win,dlbust,bust,20,0,9,206,0.417475728,0.063106796,0.621359223,2,0.59555479
18396,78,23067,9,2,7,0,0,18,4,10,10,0,0,24,nowin,win,dlbust,bust,20,0,11,201,0.517412935,0.034825871,0.587064677,3,0.95871112
18397,115,23067,10,10,0,0,0,20,4,10,10,0,0,24,nowin,win,dlbust,bust,20,0,20,194,0.427835052,0.041237113,0.592783505,2,0.583863602
18398,140,23067,10,5,0,0,0,15,4,10,10,0,0,24,nowin,win,dlbust,bust,20,0,15,210,0.466666667,0.023809524,0.604761905,3,0.915293335
18399,12,23067,10,7,0,0,0,17,4,10,10,0,0,24,nowin,win,dlbust,bust,20,0,17,189,0.470899471,0.015873016,0.613756614,3,0.929171178
18400,119,23067,10,5,0,0,0,15,4,10,10,0,0,24,nowin,win,dlbust,bust,20,0,15,190,0.405263158,0.068421053,0.515789474,0,0.011837158
18401,143,23067,4,10,0,0,0,14,4,10,10,0,0,24,nowin,win,dlbust,bust,20,0,14,203,0.463054187,0.044334975,0.57635468,3,0.883143365
18402,54,23068,11,10,0,0,0,21,5,1,9,8,0,23,win,win,dlbust,bust,25,0,21,185,0.437837838,0.032432432,0.556756757,1,0.29899854
18403,63,23068,10,6,0,0,0,16,5,1,9,8,0,23,nowin,win,dlbust,bust,20,0,16,216,0.467592593,0.037037037,0.62037037,3,0.931690496
18404,41,23068,9,9,0,0,0,18,5,1,9,8,0,23,nowin,win,dlbust,bust,20,0,18,192,0.364583333,0.036458333,0.520833333,0,0.00089702
18405,50,23068,2,5,4,6,0,17,5,1,9,8,0,23,nowin,win,dlbust,bust,20,0,7,202,0.405940594,0.04950495,0.54950495,0,0.020296079
18406,107,23068,7,9,0,0,0,16,5,1,9,8,0,23,nowin,win,dlbust,bust,20,0,16,218,0.444954128,0.073394495,0.600917431,2,0.605210014
18407,57,23068,6,7,0,0,0,13,5,1,9,8,0,23,nowin,win,dlbust,bust,20,0,13,192,0.46875,0.052083333,0.59375,3,0.907001181
18408,35,23069,2,10,0,2,8,22,10,11,0,0,0,21,nowin,loss,bust,plbust,0,10,12,202,0.410891089,0.044554455,0.633663366,2,0.598681573
18409,25,23069,10,2,0,10,0,22,10,11,0,0,0,21,nowin,loss,bust,plbust,0,10,12,190,0.463157895,0.063157895,0.536842105,1,0.304401563
18410,46,23069,9,5,0,7,0,21,10,11,0,0,0,21,nowin,push,push,push,10,0,14,186,0.403225806,0.048387097,0.591397849,0,0.029742194
18411,35,23069,2,5,11,0,0,18,10,11,0,0,0,21,nowin,loss,beat,dlwin,0,10,7,202,0.410891089,0.044554455,0.633663366,2,0.598681573
18412,12,23069,10,8,0,0,0,18,10,11,0,0,0,21,nowin,loss,beat,dlwin,0,10,18,189,0.470899471,0.015873016,0.613756614,3,0.929171178
18413,53,23069,6,9,0,8,0,23,10,11,0,0,0,21,nowin,loss,bust,plbust,0,10,15,250,0.372,0.064,0.564,0,0.013687345
18414,70,23070,8,11,0,0,0,19,2,2,5,10,0,19,nowin,push,push,push,10,0,19,228,0.385964912,0.039473684,0.557017544,0,0.016157125
18415,111,23070,2,1,9,5,0,17,2,2,5,10,0,19,nowin,loss,beat,dlwin,0,10,3,180,0.433333333,0.055555556,0.611111111,2,0.602264492
18416,17,23070,2,11,7,0,0,20,2,2,5,10,0,19,nowin,win,plwin,beat,20,0,13,171,0.444444444,0.070175439,0.555555556,1,0.302364894
18417,111,23070,8,5,0,0,0,13,2,2,5,10,0,19,nowin,loss,beat,dlwin,0,10,13,180,0.433333333,0.055555556,0.611111111,2,0.602264492
18418,98,23070,3,6,10,0,0,19,2,2,5,10,0,19,nowin,push,push,push,10,0,9,220,0.422727273,0.054545455,0.55,1,0.28664435
18419,28,23070,8,6,0,0,0,14,2,2,5,10,0,19,nowin,loss,beat,dlwin,0,10,14,199,0.422110553,0.045226131,0.542713568,1,0.282706618
18420,4,23071,9,11,0,0,0,20,5,2,10,0,0,17,nowin,win,plwin,beat,20,0,20,217,0.460829493,0.036866359,0.562211982,1,0.315432839
18421,97,23071,10,11,0,0,0,21,5,2,10,0,0,17,win,win,plwin,beat,25,0,21,182,0.450549451,0.06043956,0.692307692,2,0.677372279
18422,137,23071,2,10,0,0,0,12,5,2,10,0,0,17,nowin,loss,beat,dlwin,0,10,12,194,0.417525773,0.046391753,0.536082474,1,0.276714602
18423,34,23071,11,7,0,0,0,18,5,2,10,0,0,17,nowin,win,plwin,beat,20,0,18,202,0.5,0.079207921,0.618811881,3,0.968961434
18424,133,23071,6,10,0,0,0,16,5,2,10,0,0,17,nowin,loss,beat,dlwin,0,10,16,201,0.47761194,0.064676617,0.611940299,3,0.935428111
18425,129,23071,7,2,4,0,0,13,5,2,10,0,0,17,nowin,loss,beat,dlwin,0,10,9,201,0.422885572,0.064676617,0.55721393,0,0.027255383
18426,80,23072,10,10,0,0,0,20,1,4,10,10,0,25,nowin,win,dlbust,bust,20,0,20,186,0.419354839,0.059139785,0.623655914,2,0.59892924
18427,83,23072,10,2,0,4,10,26,1,4,10,10,0,25,nowin,loss,bust,plbust,0,10,12,193,0.424870466,0.051813472,0.678756477,2,0.644360335
18428,20,23072,6,11,2,0,0,19,1,4,10,10,0,25,nowin,win,dlbust,bust,20,0,17,186,0.456989247,0.037634409,0.537634409,1,0.301097108
18429,103,23072,7,10,0,0,0,17,1,4,10,10,0,25,nowin,win,dlbust,bust,20,0,17,203,0.379310345,0.064039409,0.551724138,0,0.012869209
18430,5,23072,7,8,0,9,0,24,1,4,10,10,0,25,nowin,loss,bust,plbust,0,10,15,203,0.42364532,0.02955665,0.596059113,2,0.582508076
18431,40,23072,2,8,9,0,0,19,1,4,10,10,0,25,nowin,win,dlbust,bust,20,0,10,196,0.367346939,0.030612245,0.617346939,0,0.025358183
18432,25,23073,4,10,0,5,0,19,8,10,0,0,0,18,nowin,win,plwin,beat,20,0,14,190,0.463157895,0.063157895,0.536842105,1,0.304401563
18433,33,23073,10,4,0,3,0,17,8,10,0,0,0,18,nowin,loss,beat,dlwin,0,10,14,192,0.4375,0.057291667,0.625,2,0.616208916
18434,43,23073,9,4,0,10,0,23,8,10,0,0,0,18,nowin,loss,bust,plbust,0,10,13,192,0.40625,0.041666667,0.609375,2,0.576671372
18435,84,23073,7,11,0,0,0,18,8,10,0,0,0,18,nowin,push,push,push,10,0,18,195,0.379487179,0.056410256,0.569230769,0,0.017209119
18436,4,23073,9,10,0,0,0,19,8,10,0,0,0,18,nowin,win,plwin,beat,20,0,19,217,0.460829493,0.036866359,0.562211982,1,0.315432839
18437,53,23073,7,5,0,10,0,22,8,10,0,0,0,18,nowin,loss,bust,plbust,0,10,12,250,0.372,0.064,0.564,0,0.013687345
18438,116,23074,5,7,0,0,0,12,6,2,10,0,0,18,nowin,loss,beat,dlwin,0,10,12,195,0.425641026,0.056410256,0.538461538,1,0.28273747
18439,75,23074,8,4,0,0,0,12,6,2,10,0,0,18,nowin,loss,beat,dlwin,0,10,12,191,0.418848168,0.052356021,0.570680628,0,0.029344702
18440,65,23074,10,11,0,0,0,21,6,2,10,0,0,18,win,win,plwin,beat,25,0,21,203,0.492610837,0.054187192,0.571428571,3,0.913702814
18441,80,23074,5,6,7,0,0,18,6,2,10,0,0,18,nowin,push,push,push,10,0,11,186,0.419354839,0.059139785,0.623655914,2,0.59892924
18442,5,23074,10,10,0,0,0,20,6,2,10,0,0,18,nowin,win,plwin,beat,20,0,20,203,0.42364532,0.02955665,0.596059113,2,0.582508076
18443,133,23074,4,1,10,0,0,15,6,2,10,0,0,18,nowin,loss,beat,dlwin,0,10,5,201,0.47761194,0.064676617,0.611940299,3,0.935428111
18444,141,23075,11,10,0,0,0,21,6,5,10,0,0,21,win,push,push,push,10,0,21,202,0.420792079,0.074257426,0.564356436,0,0.028377851
18445,112,23075,8,4,0,0,0,12,6,5,10,0,0,21,nowin,loss,beat,dlwin,0,10,12,203,0.448275862,0.054187192,0.600985222,3,0.889576933
18446,102,23075,6,10,0,0,0,16,6,5,10,0,0,21,nowin,loss,beat,dlwin,0,10,16,192,0.338541667,0.046875,0.5625,0,0.003306118
18447,31,23075,9,6,0,0,0,15,6,5,10,0,0,21,nowin,loss,beat,dlwin,0,10,15,188,0.473404255,0.058510638,0.515957447,1,0.300306557
18448,43,23075,8,3,5,0,0,16,6,5,10,0,0,21,nowin,loss,beat,dlwin,0,10,11,192,0.40625,0.041666667,0.609375,2,0.576671372
18449,36,23075,7,10,0,0,0,17,6,5,10,0,0,21,nowin,loss,beat,dlwin,0,10,17,229,0.445414847,0.056768559,0.655021834,2,0.645370571
18450,68,23076,6,7,0,4,0,17,8,3,7,0,0,18,nowin,loss,beat,dlwin,0,10,13,205,0.434146341,0.029268293,0.6,2,0.59483189
18451,109,23076,2,10,0,9,0,21,8,3,7,0,0,18,nowin,win,plwin,beat,20,0,12,221,0.461538462,0.058823529,0.597285068,3,0.901830309
18452,95,23076,10,10,0,0,0,20,8,3,7,0,0,18,nowin,win,plwin,beat,20,0,20,218,0.412844037,0.04587156,0.559633028,0,0.024842385
18453,131,23076,10,10,0,0,0,20,8,3,7,0,0,18,nowin,win,plwin,beat,20,0,20,217,0.410138249,0.069124424,0.543778802,0,0.02015021
18454,81,23076,10,5,0,5,0,20,8,3,7,0,0,18,nowin,win,plwin,beat,20,0,15,182,0.395604396,0.043956044,0.60989011,2,0.567491261
18455,64,23076,3,10,0,10,0,23,8,3,7,0,0,18,nowin,loss,bust,plbust,0,10,13,187,0.363636364,0.048128342,0.631016043,0,0.027594885
18456,128,23077,7,10,0,0,0,17,10,4,5,0,0,19,nowin,loss,beat,dlwin,0,10,17,227,0.356828194,0.052863436,0.577092511,0,0.012352564
18457,56,23077,8,11,0,0,0,19,10,4,5,0,0,19,nowin,push,push,push,10,0,19,175,0.4,0.057142857,0.582857143,0,0.026685297
18458,14,23077,5,2,6,10,0,23,10,4,5,0,0,19,nowin,loss,bust,plbust,0,10,7,202,0.391089109,0.01980198,0.628712871,2,0.577264877
18459,35,23077,4,7,5,3,0,19,10,4,5,0,0,19,nowin,push,push,push,10,0,11,202,0.410891089,0.044554455,0.633663366,2,0.598681573
18460,101,23077,11,10,0,0,0,21,10,4,5,0,0,19,win,win,plwin,beat,25,0,21,205,0.424390244,0.068292683,0.63902439,2,0.614740646
18461,79,23077,2,10,0,10,0,22,10,4,5,0,0,19,nowin,loss,bust,plbust,0,10,12,211,0.436018957,0.028436019,0.672985782,2,0.650131054
18462,113,23078,4,10,0,9,0,23,10,4,7,0,0,21,nowin,loss,bust,plbust,0,10,14,199,0.407035176,0.055276382,0.668341709,2,0.620695264
18463,94,23078,2,10,0,4,6,22,10,4,7,0,0,21,nowin,loss,bust,plbust,0,10,12,183,0.43715847,0.043715847,0.540983607,1,0.290866892
18464,95,23078,10,10,0,0,0,20,10,4,7,0,0,21,nowin,loss,beat,dlwin,0,10,20,218,0.412844037,0.04587156,0.559633028,0,0.024842385
18465,64,23078,3,5,10,0,0,18,10,4,7,0,0,21,nowin,loss,beat,dlwin,0,10,8,187,0.363636364,0.048128342,0.631016043,0,0.027594885
18466,45,23078,11,9,0,0,0,20,10,4,7,0,0,21,nowin,loss,beat,dlwin,0,10,20,196,0.428571429,0.051020408,0.612244898,2,0.598821767
18467,53,23078,6,10,0,3,0,19,10,4,7,0,0,21,nowin,loss,beat,dlwin,0,10,16,250,0.372,0.064,0.564,0,0.013687345
18468,129,23079,8,10,0,0,0,18,4,7,6,0,0,17,nowin,win,plwin,beat,20,0,18,201,0.422885572,0.064676617,0.55721393,0,0.027255383
18469,138,23079,10,10,0,0,0,20,4,7,6,0,0,17,nowin,win,plwin,beat,20,0,20,190,0.442105263,0.047368421,0.610526316,2,0.609711065
18470,58,23079,8,11,0,0,0,19,4,7,6,0,0,17,nowin,win,plwin,beat,20,0,19,195,0.430769231,0.041025641,0.584615385,2,0.580497586
18471,53,23079,4,9,0,0,0,13,4,7,6,0,0,17,nowin,loss,beat,dlwin,0,10,13,250,0.372,0.064,0.564,0,0.013687345
18472,51,23079,11,2,7,0,0,20,4,7,6,0,0,17,nowin,win,plwin,beat,20,0,13,189,0.529100529,0.068783069,0.608465608,3,0.993665715
18473,70,23079,3,7,10,0,0,20,4,7,6,0,0,17,nowin,win,plwin,beat,20,0,10,228,0.385964912,0.039473684,0.557017544,0,0.016157125
18474,30,23080,4,9,0,10,0,23,10,4,6,0,0,20,nowin,loss,bust,plbust,0,10,13,206,0.393203883,0.033980583,0.601941748,0,0.029324648
18475,69,23080,10,7,0,0,0,17,10,4,6,0,0,20,nowin,loss,beat,dlwin,0,10,17,194,0.365979381,0.030927835,0.515463918,0,0
18476,48,23080,8,10,0,0,0,18,10,4,6,0,0,20,nowin,loss,beat,dlwin,0,10,18,203,0.413793103,0.019704433,0.600985222,2,0.577280801
18477,89,23080,9,10,0,0,0,19,10,4,6,0,0,20,nowin,loss,beat,dlwin,0,10,19,212,0.537735849,0.047169811,0.594339623,3,0.990167191
18478,88,23080,7,11,0,0,0,18,10,4,6,0,0,20,nowin,loss,beat,dlwin,0,10,18,206,0.466019417,0.033980583,0.54368932,1,0.309467903
18479,49,23080,10,8,0,0,0,18,10,4,6,0,0,20,nowin,loss,beat,dlwin,0,10,18,207,0.396135266,0.053140097,0.594202899,0,0.028306925
18480,110,23081,4,10,0,2,2,18,10,8,0,0,0,18,nowin,push,push,push,10,0,14,192,0.416666667,0.046875,0.557291667,0,0.025413132
18481,36,23081,4,2,10,4,0,20,10,8,0,0,0,18,nowin,win,plwin,beat,20,0,6,229,0.445414847,0.056768559,0.655021834,2,0.645370571
18482,135,23081,3,7,5,7,0,22,10,8,0,0,0,18,nowin,loss,bust,plbust,0,10,10,179,0.391061453,0.067039106,0.586592179,0,0.024924662
18483,130,23081,9,10,0,0,0,19,10,8,0,0,0,18,nowin,win,plwin,beat,20,0,19,219,0.410958904,0.03652968,0.566210046,0,0.025888739
18484,149,23081,10,7,0,0,0,17,10,8,0,0,0,18,nowin,loss,beat,dlwin,0,10,17,225,0.457777778,0.057777778,0.648888889,2,0.651965595
18485,23,23081,10,10,0,0,0,20,10,8,0,0,0,18,nowin,win,plwin,beat,20,0,20,208,0.427884615,0.0625,0.552884615,1,0.29114424
18486,83,23082,2,5,10,0,0,17,10,2,10,0,0,22,nowin,win,dlbust,bust,20,0,7,193,0.424870466,0.051813472,0.678756477,2,0.644360335
18487,33,23082,10,7,0,0,0,17,10,2,10,0,0,22,nowin,win,dlbust,bust,20,0,17,192,0.4375,0.057291667,0.625,2,0.616208916
18488,100,23082,8,3,10,0,0,21,10,2,10,0,0,22,nowin,win,dlbust,bust,20,0,11,190,0.452631579,0.036842105,0.594736842,3,0.888671154
18489,46,23082,4,5,3,10,0,22,10,2,10,0,0,22,nowin,loss,bust,plbust,0,10,9,186,0.403225806,0.048387097,0.591397849,0,0.029742194
18490,41,23082,10,6,0,3,0,19,10,2,10,0,0,22,nowin,win,dlbust,bust,20,0,16,192,0.364583333,0.036458333,0.520833333,0,0.00089702
18491,105,23082,9,9,0,0,0,18,10,2,10,0,0,22,nowin,win,dlbust,bust,20,0,18,198,0.414141414,0.070707071,0.590909091,0,0.032889494
18492,56,23083,5,10,0,5,0,20,10,11,0,0,0,21,nowin,loss,beat,dlwin,0,10,15,175,0.4,0.057142857,0.582857143,0,0.026685297
18493,150,23083,7,10,0,0,0,17,10,11,0,0,0,21,nowin,loss,beat,dlwin,0,10,17,192,0.401041667,0.036458333,0.567708333,0,0.023287458
18494,72,23083,8,9,0,0,0,17,10,11,0,0,0,21,nowin,loss,beat,dlwin,0,10,17,185,0.394594595,0.032432432,0.508108108,0,0.006763115
18495,94,23083,4,9,0,10,0,23,10,11,0,0,0,21,nowin,loss,bust,plbust,0,10,13,183,0.43715847,0.043715847,0.540983607,1,0.290866892
18496,57,23083,11,1,4,1,0,17,10,11,0,0,0,21,nowin,loss,beat,dlwin,0,10,12,192,0.46875,0.052083333,0.59375,3,0.907001181
18497,119,23083,2,5,10,0,0,17,10,11,0,0,0,21,nowin,loss,beat,dlwin,0,10,7,190,0.405263158,0.068421053,0.515789474,0,0.011837158
18498,132,23084,5,10,0,0,0,15,4,10,10,0,0,24,nowin,win,dlbust,bust,20,0,15,194,0.412371134,0.036082474,0.649484536,2,0.611633238
18499,44,23084,5,9,0,0,0,14,4,10,10,0,0,24,nowin,win,dlbust,bust,20,0,14,219,0.433789954,0.050228311,0.534246575,1,0.285551035
18500,22,23084,10,5,0,0,0,15,4,10,10,0,0,24,nowin,win,dlbust,bust,20,0,15,187,0.481283422,0.042780749,0.577540107,3,0.906128176
18501,31,23084,10,11,0,0,0,21,4,10,10,0,0,24,win,win,dlbust,bust,25,0,21,188,0.473404255,0.058510638,0.515957447,1,0.300306557
18502,64,23084,10,3,0,0,0,13,4,10,10,0,0,24,nowin,win,dlbust,bust,20,0,13,187,0.363636364,0.048128342,0.631016043,0,0.027594885
18503,46,23084,11,5,3,0,0,19,4,10,10,0,0,24,nowin,win,dlbust,bust,20,0,16,186,0.403225806,0.048387097,0.591397849,0,0.029742194
18504,6,23085,4,8,0,6,0,18,3,5,8,10,0,26,nowin,win,dlbust,bust,20,0,12,191,0.439790576,0.047120419,0.581151832,1,0.31211505
18505,55,23085,6,6,0,10,0,22,3,5,8,10,0,26,nowin,loss,bust,plbust,0,10,12,191,0.371727749,0.057591623,0.54973822,0,0.01011347
18506,104,23085,10,10,0,0,0,20,3,5,8,10,0,26,nowin,win,dlbust,bust,20,0,20,209,0.363636364,0.052631579,0.593301435,0,0.018359419
18507,4,23085,6,10,0,0,0,16,3,5,8,10,0,26,nowin,win,dlbust,bust,20,0,16,217,0.460829493,0.036866359,0.562211982,1,0.315432839
18508,4,23085,6,7,0,0,0,13,3,5,8,10,0,26,nowin,win,dlbust,bust,20,0,13,217,0.460829493,0.036866359,0.562211982,1,0.315432839
18509,150,23085,4,7,2,0,0,13,3,5,8,10,0,26,nowin,win,dlbust,bust,20,0,11,192,0.401041667,0.036458333,0.567708333,0,0.023287458
18510,137,23086,3,9,0,8,0,20,2,10,1,10,0,23,nowin,win,dlbust,bust,20,0,12,194,0.417525773,0.046391753,0.536082474,1,0.276714602
18511,143,23086,4,7,4,0,0,15,2,10,1,10,0,23,nowin,win,dlbust,bust,20,0,11,203,0.463054187,0.044334975,0.57635468,3,0.883143365
18512,20,23086,4,7,2,0,0,13,2,10,1,10,0,23,nowin,win,dlbust,bust,20,0,11,186,0.456989247,0.037634409,0.537634409,1,0.301097108
18513,16,23086,9,10,0,0,0,19,2,10,1,10,0,23,nowin,win,dlbust,bust,20,0,19,220,0.427272727,0.081818182,0.6,2,0.588660176
18514,66,23086,10,11,0,0,0,21,2,10,1,10,0,23,win,win,dlbust,bust,25,0,21,217,0.456221198,0.064516129,0.626728111,3,0.924304367
18515,95,23086,5,7,0,1,0,13,2,10,1,10,0,23,nowin,win,dlbust,bust,20,0,12,218,0.412844037,0.04587156,0.559633028,0,0.024842385
18516,53,23087,7,9,0,3,0,19,10,9,0,0,0,19,nowin,push,push,push,10,0,16,250,0.372,0.064,0.564,0,0.013687345
18517,10,23087,6,10,0,7,0,23,10,9,0,0,0,19,nowin,loss,bust,plbust,0,10,16,191,0.413612565,0.057591623,0.596858639,2,0.574087175
18518,60,23087,10,6,0,2,0,18,10,9,0,0,0,19,nowin,loss,beat,dlwin,0,10,16,227,0.418502203,0.022026432,0.559471366,0,0.026496258
18519,53,23087,10,2,0,4,2,18,10,9,0,0,0,19,nowin,loss,beat,dlwin,0,10,12,250,0.372,0.064,0.564,0,0.013687345
18520,25,23087,8,3,8,0,0,19,10,9,0,0,0,19,nowin,push,push,push,10,0,11,190,0.463157895,0.063157895,0.536842105,1,0.304401563
18521,30,23087,6,1,8,9,0,24,10,9,0,0,0,19,nowin,loss,bust,plbust,0,10,7,206,0.393203883,0.033980583,0.601941748,0,0.029324648
18522,63,23088,7,4,1,0,0,12,6,11,0,0,0,17,nowin,loss,beat,dlwin,0,10,11,216,0.467592593,0.037037037,0.62037037,3,0.931690496
18523,66,23088,7,2,6,0,0,15,6,11,0,0,0,17,nowin,loss,beat,dlwin,0,10,9,217,0.456221198,0.064516129,0.626728111,3,0.924304367
18524,96,23088,10,4,0,0,0,14,6,11,0,0,0,17,nowin,loss,beat,dlwin,0,10,14,190,0.468421053,0.057894737,0.584210526,3,0.897263354
18525,33,23088,10,2,0,0,0,12,6,11,0,0,0,17,nowin,loss,beat,dlwin,0,10,12,192,0.4375,0.057291667,0.625,2,0.616208916
18526,75,23088,6,4,7,0,0,17,6,11,0,0,0,17,nowin,push,push,push,10,0,10,191,0.418848168,0.052356021,0.570680628,0,0.029344702
18527,23,23088,10,6,0,0,0,16,6,11,0,0,0,17,nowin,loss,beat,dlwin,0,10,16,208,0.427884615,0.0625,0.552884615,1,0.29114424
18528,8,23089,5,2,9,10,0,26,8,10,0,0,0,18,nowin,loss,bust,plbust,0,10,7,181,0.44198895,0.071823204,0.596685083,2,0.599438402
18529,17,23089,3,8,10,0,0,21,8,10,0,0,0,18,nowin,win,plwin,beat,20,0,11,171,0.444444444,0.070175439,0.555555556,1,0.302364894
18530,93,23089,10,10,0,0,0,20,8,10,0,0,0,18,nowin,win,plwin,beat,20,0,20,175,0.485714286,0.051428571,0.548571429,1,0.323648091
18531,90,23089,8,10,0,0,0,18,8,10,0,0,0,18,nowin,push,push,push,10,0,18,201,0.447761194,0.049751244,0.60199005,3,0.889945023
18532,66,23089,7,7,0,8,0,22,8,10,0,0,0,18,nowin,loss,bust,plbust,0,10,14,217,0.456221198,0.064516129,0.626728111,3,0.924304367
18533,32,23089,6,10,0,6,0,22,8,10,0,0,0,18,nowin,loss,bust,plbust,0,10,16,189,0.391534392,0.037037037,0.53968254,0,0.013579086
18534,3,23090,2,9,1,0,0,12,4,9,10,0,0,23,nowin,win,dlbust,bust,20,0,11,190,0.431578947,0.026315789,0.542105263,1,0.288076384
18535,78,23090,10,4,0,0,0,14,4,9,10,0,0,23,nowin,win,dlbust,bust,20,0,14,201,0.517412935,0.034825871,0.587064677,3,0.95871112
18536,15,23090,9,10,0,0,0,19,4,9,10,0,0,23,nowin,win,dlbust,bust,20,0,19,212,0.410377358,0.051886792,0.561320755,0,0.024517408
18537,31,23090,2,6,4,0,0,12,4,9,10,0,0,23,nowin,win,dlbust,bust,20,0,8,188,0.473404255,0.058510638,0.515957447,1,0.300306557
18538,65,23090,10,5,0,0,0,15,4,9,10,0,0,23,nowin,win,dlbust,bust,20,0,15,203,0.492610837,0.054187192,0.571428571,3,0.913702814
18539,68,23090,9,2,10,0,0,21,4,9,10,0,0,23,nowin,win,dlbust,bust,20,0,11,205,0.434146341,0.029268293,0.6,2,0.59483189
18540,35,23091,5,9,0,10,0,24,8,10,0,0,0,18,nowin,loss,bust,plbust,0,10,14,202,0.410891089,0.044554455,0.633663366,2,0.598681573
18541,89,23091,2,3,10,10,0,25,8,10,0,0,0,18,nowin,loss,bust,plbust,0,10,5,212,0.537735849,0.047169811,0.594339623,3,0.990167191
18542,101,23091,10,10,0,0,0,20,8,10,0,0,0,18,nowin,win,plwin,beat,20,0,20,205,0.424390244,0.068292683,0.63902439,2,0.614740646
18543,120,23091,6,9,0,3,0,18,8,10,0,0,0,18,nowin,push,push,push,10,0,15,202,0.440594059,0.034653465,0.618811881,2,0.614441029
18544,117,23091,10,11,0,0,0,21,8,10,0,0,0,18,win,win,plwin,beat,25,0,21,173,0.410404624,0.069364162,0.606936416,2,0.578610282
18545,124,23091,7,7,0,9,0,23,8,10,0,0,0,18,nowin,loss,bust,plbust,0,10,14,202,0.47029703,0.064356436,0.584158416,3,0.899458193
18546,84,23092,8,9,0,0,0,17,4,2,11,0,0,17,nowin,push,push,push,10,0,17,195,0.379487179,0.056410256,0.569230769,0,0.017209119
18547,55,23092,11,10,0,0,0,21,4,2,11,0,0,17,win,win,plwin,beat,25,0,21,191,0.371727749,0.057591623,0.54973822,0,0.01011347
18548,24,23092,10,3,0,0,0,13,4,2,11,0,0,17,nowin,loss,beat,dlwin,0,10,13,207,0.458937198,0.048309179,0.570048309,1,0.318138014
18549,100,23092,7,11,0,0,0,18,4,2,11,0,0,17,nowin,win,plwin,beat,20,0,18,190,0.452631579,0.036842105,0.594736842,3,0.888671154
18550,96,23092,4,10,0,0,0,14,4,2,11,0,0,17,nowin,loss,beat,dlwin,0,10,14,190,0.468421053,0.057894737,0.584210526,3,0.897263354
18551,73,23092,6,1,7,0,0,14,4,2,11,0,0,17,nowin,loss,beat,dlwin,0,10,7,181,0.375690608,0.011049724,0.596685083,0,0.022795773
18552,132,23093,9,9,0,0,0,18,10,3,8,0,0,21,nowin,loss,beat,dlwin,0,10,18,194,0.412371134,0.036082474,0.649484536,2,0.611633238
18553,36,23093,8,10,0,0,0,18,10,3,8,0,0,21,nowin,loss,beat,dlwin,0,10,18,229,0.445414847,0.056768559,0.655021834,2,0.645370571
18554,41,23093,3,5,3,5,10,26,10,3,8,0,0,21,nowin,loss,bust,plbust,0,10,8,192,0.364583333,0.036458333,0.520833333,0,0.00089702
18555,37,23093,10,2,0,5,0,17,10,3,8,0,0,21,nowin,loss,beat,dlwin,0,10,12,208,0.394230769,0.038461538,0.581730769,0,0.024682772
18556,41,23093,10,5,0,8,0,23,10,3,8,0,0,21,nowin,loss,bust,plbust,0,10,15,192,0.364583333,0.036458333,0.520833333,0,0.00089702
18557,97,23093,4,7,3,3,0,17,10,3,8,0,0,21,nowin,loss,beat,dlwin,0,10,11,182,0.450549451,0.06043956,0.692307692,2,0.677372279
18558,115,23094,2,4,9,0,0,15,6,7,7,0,0,20,nowin,loss,beat,dlwin,0,10,6,194,0.427835052,0.041237113,0.592783505,2,0.583863602
18559,136,23094,10,8,0,0,0,18,6,7,7,0,0,20,nowin,loss,beat,dlwin,0,10,18,194,0.396907216,0.025773196,0.597938144,0,0.029452644
18560,124,23094,10,9,0,0,0,19,6,7,7,0,0,20,nowin,loss,beat,dlwin,0,10,19,202,0.47029703,0.064356436,0.584158416,3,0.899458193
18561,30,23094,6,3,5,0,0,14,6,7,7,0,0,20,nowin,loss,beat,dlwin,0,10,9,206,0.393203883,0.033980583,0.601941748,0,0.029324648
18562,74,23094,4,10,0,0,0,14,6,7,7,0,0,20,nowin,loss,beat,dlwin,0,10,14,209,0.411483254,0.04784689,0.531100478,0,0.017448125
18563,81,23094,11,10,0,0,0,21,6,7,7,0,0,20,win,win,plwin,beat,25,0,21,182,0.395604396,0.043956044,0.60989011,2,0.567491261
18564,7,23095,4,6,5,10,0,25,10,2,3,10,0,25,nowin,loss,bust,plbust,0,10,10,183,0.442622951,0.06010929,0.62295082,2,0.619303341
18565,12,23095,1,6,10,0,0,17,10,2,3,10,0,25,nowin,win,dlbust,bust,20,0,7,189,0.470899471,0.015873016,0.613756614,3,0.929171178
18566,47,23095,2,10,0,8,0,20,10,2,3,10,0,25,nowin,win,dlbust,bust,20,0,12,210,0.438095238,0.057142857,0.623809524,2,0.615868808
18567,133,23095,8,6,0,7,0,21,10,2,3,10,0,25,nowin,win,dlbust,bust,20,0,14,201,0.47761194,0.064676617,0.611940299,3,0.935428111
18568,17,23095,5,8,0,6,0,19,10,2,3,10,0,25,nowin,win,dlbust,bust,20,0,13,171,0.444444444,0.070175439,0.555555556,1,0.302364894
18569,96,23095,6,10,0,2,0,18,10,2,3,10,0,25,nowin,win,dlbust,bust,20,0,16,190,0.468421053,0.057894737,0.584210526,3,0.897263354
18570,61,23096,10,10,0,0,0,20,10,6,9,0,0,25,nowin,win,dlbust,bust,20,0,20,194,0.427835052,0.077319588,0.603092784,2,0.591437139
18571,120,23096,4,1,9,1,1,16,10,6,9,0,0,25,nowin,win,dlbust,bust,20,0,5,202,0.440594059,0.034653465,0.618811881,2,0.614441029
18572,126,23096,7,10,0,0,0,17,10,6,9,0,0,25,nowin,win,dlbust,bust,20,0,17,188,0.457446809,0.074468085,0.60106383,3,0.900633203
18573,73,23096,4,10,0,10,0,24,10,6,9,0,0,25,nowin,loss,bust,plbust,0,10,14,181,0.375690608,0.011049724,0.596685083,0,0.022795773
18574,69,23096,10,2,0,10,0,22,10,6,9,0,0,25,nowin,loss,bust,plbust,0,10,12,194,0.365979381,0.030927835,0.515463918,0,0
18575,55,23096,4,10,0,6,0,20,10,6,9,0,0,25,nowin,win,dlbust,bust,20,0,14,191,0.371727749,0.057591623,0.54973822,0,0.01011347
18576,69,23097,9,10,0,0,0,19,9,3,1,5,0,18,nowin,win,plwin,beat,20,0,19,194,0.365979381,0.030927835,0.515463918,0,0
18577,92,23097,11,1,5,0,0,17,9,3,1,5,0,18,nowin,loss,beat,dlwin,0,10,12,186,0.446236559,0.059139785,0.564516129,1,0.307826125
18578,4,23097,10,6,0,10,0,26,9,3,1,5,0,18,nowin,loss,bust,plbust,0,10,16,217,0.460829493,0.036866359,0.562211982,1,0.315432839
18579,114,23097,7,10,0,0,0,17,9,3,1,5,0,18,nowin,loss,beat,dlwin,0,10,17,198,0.47979798,0.025252525,0.611111111,3,0.937232995
18580,51,23097,5,10,0,6,0,21,9,3,1,5,0,18,nowin,win,plwin,beat,20,0,15,189,0.529100529,0.068783069,0.608465608,3,0.993665715
18581,20,23097,4,4,3,2,9,22,9,3,1,5,0,18,nowin,loss,bust,plbust,0,10,8,186,0.456989247,0.037634409,0.537634409,1,0.301097108
18582,33,23098,10,10,0,0,0,20,3,10,5,0,0,18,nowin,win,plwin,beat,20,0,20,192,0.4375,0.057291667,0.625,2,0.616208916
18583,117,23098,4,6,6,0,0,16,3,10,5,0,0,18,nowin,loss,beat,dlwin,0,10,10,173,0.410404624,0.069364162,0.606936416,2,0.578610282
18584,114,23098,10,11,0,0,0,21,3,10,5,0,0,18,win,win,plwin,beat,25,0,21,198,0.47979798,0.025252525,0.611111111,3,0.937232995
18585,41,23098,2,3,4,10,0,19,3,10,5,0,0,18,nowin,win,plwin,beat,20,0,5,192,0.364583333,0.036458333,0.520833333,0,0.00089702
18586,133,23098,11,9,0,0,0,20,3,10,5,0,0,18,nowin,win,plwin,beat,20,0,20,201,0.47761194,0.064676617,0.611940299,3,0.935428111
18587,131,23098,4,10,0,0,0,14,3,10,5,0,0,18,nowin,loss,beat,dlwin,0,10,14,217,0.410138249,0.069124424,0.543778802,0,0.02015021
18588,79,23099,10,10,0,0,0,20,10,4,10,0,0,24,nowin,win,dlbust,bust,20,0,20,211,0.436018957,0.028436019,0.672985782,2,0.650131054
18589,99,23099,2,6,6,6,0,20,10,4,10,0,0,24,nowin,win,dlbust,bust,20,0,8,207,0.47826087,0.062801932,0.637681159,3,0.961418446
18590,13,23099,8,8,0,7,0,23,10,4,10,0,0,24,nowin,loss,bust,plbust,0,10,16,206,0.417475728,0.063106796,0.621359223,2,0.59555479
18591,26,23099,5,10,0,6,0,21,10,4,10,0,0,24,nowin,win,dlbust,bust,20,0,15,203,0.463054187,0.0591133,0.541871921,1,0.306802864
18592,72,23099,9,8,0,0,0,17,10,4,10,0,0,24,nowin,win,dlbust,bust,20,0,17,185,0.394594595,0.032432432,0.508108108,0,0.006763115
18593,125,23099,10,7,0,0,0,17,10,4,10,0,0,24,nowin,win,dlbust,bust,20,0,17,219,0.438356164,0.050228311,0.575342466,1,0.308411257
18594,100,23100,11,7,0,0,0,18,10,8,0,0,0,18,nowin,push,push,push,10,0,18,190,0.452631579,0.036842105,0.594736842,3,0.888671154
18595,124,23100,4,10,0,9,0,23,10,8,0,0,0,18,nowin,loss,bust,plbust,0,10,14,202,0.47029703,0.064356436,0.584158416,3,0.899458193
18596,43,23100,8,6,0,10,0,24,10,8,0,0,0,18,nowin,loss,bust,plbust,0,10,14,192,0.40625,0.041666667,0.609375,2,0.576671372
18597,4,23100,11,10,0,0,0,21,10,8,0,0,0,18,win,win,plwin,beat,25,0,21,217,0.460829493,0.036866359,0.562211982,1,0.315432839
18598,136,23100,9,3,0,3,10,25,10,8,0,0,0,18,nowin,loss,bust,plbust,0,10,12,194,0.396907216,0.025773196,0.597938144,0,0.029452644
18599,113,23100,11,10,0,0,0,21,10,8,0,0,0,18,win,win,plwin,beat,25,0,21,199,0.407035176,0.055276382,0.668341709,2,0.620695264
18600,90,23101,10,10,0,0,0,20,10,9,0,0,0,19,nowin,win,plwin,beat,20,0,20,201,0.447761194,0.049751244,0.60199005,3,0.889945023
18601,124,23101,10,7,0,0,0,17,10,9,0,0,0,19,nowin,loss,beat,dlwin,0,10,17,202,0.47029703,0.064356436,0.584158416,3,0.899458193
18602,60,23101,9,4,0,8,0,21,10,9,0,0,0,19,nowin,win,plwin,beat,20,0,13,227,0.418502203,0.022026432,0.559471366,0,0.026496258
18603,110,23101,9,3,0,10,0,22,10,9,0,0,0,19,nowin,loss,bust,plbust,0,10,12,192,0.416666667,0.046875,0.557291667,0,0.025413132
18604,65,23101,9,6,0,7,0,22,10,9,0,0,0,19,nowin,loss,bust,plbust,0,10,15,203,0.492610837,0.054187192,0.571428571,3,0.913702814
18605,44,23101,10,3,0,10,0,23,10,9,0,0,0,19,nowin,loss,bust,plbust,0,10,13,219,0.433789954,0.050228311,0.534246575,1,0.285551035
18606,117,23102,10,10,0,0,0,20,7,10,0,0,0,17,nowin,win,plwin,beat,20,0,20,173,0.410404624,0.069364162,0.606936416,2,0.578610282
18607,14,23102,9,2,3,9,0,23,7,10,0,0,0,17,nowin,loss,bust,plbust,0,10,11,202,0.391089109,0.01980198,0.628712871,2,0.577264877
18608,150,23102,10,10,0,0,0,20,7,10,0,0,0,17,nowin,win,plwin,beat,20,0,20,192,0.401041667,0.036458333,0.567708333,0,0.023287458
18609,33,23102,4,4,10,0,0,18,7,10,0,0,0,17,nowin,win,plwin,beat,20,0,8,192,0.4375,0.057291667,0.625,2,0.616208916
18610,105,23102,10,10,0,0,0,20,7,10,0,0,0,17,nowin,win,plwin,beat,20,0,20,198,0.414141414,0.070707071,0.590909091,0,0.032889494
18611,39,23102,7,10,0,0,0,17,7,10,0,0,0,17,nowin,push,push,push,10,0,17,191,0.429319372,0.062827225,0.57591623,0,0.033760763
18612,11,23103,4,5,10,0,0,19,8,2,9,0,0,19,nowin,push,push,push,10,0,9,236,0.457627119,0.016949153,0.588983051,3,0.889015813
18613,112,23103,11,10,0,0,0,21,8,2,9,0,0,19,win,win,plwin,beat,25,0,21,203,0.448275862,0.054187192,0.600985222,3,0.889576933
18614,54,23103,10,5,0,10,0,25,8,2,9,0,0,19,nowin,loss,bust,plbust,0,10,15,185,0.437837838,0.032432432,0.556756757,1,0.29899854
18615,143,23103,4,8,0,4,2,18,8,2,9,0,0,19,nowin,loss,beat,dlwin,0,10,12,203,0.463054187,0.044334975,0.57635468,3,0.883143365
18616,100,23103,9,3,0,6,0,18,8,2,9,0,0,19,nowin,loss,beat,dlwin,0,10,12,190,0.452631579,0.036842105,0.594736842,3,0.888671154
18617,58,23103,2,8,3,2,10,25,8,2,9,0,0,19,nowin,loss,bust,plbust,0,10,10,195,0.430769231,0.041025641,0.584615385,2,0.580497586
18618,53,23104,6,5,4,1,10,26,8,11,0,0,0,19,nowin,loss,bust,plbust,0,10,11,250,0.372,0.064,0.564,0,0.013687345
18619,50,23104,5,6,10,0,0,21,8,11,0,0,0,19,nowin,win,plwin,beat,20,0,11,202,0.405940594,0.04950495,0.54950495,0,0.020296079
18620,82,23104,3,6,3,10,0,22,8,11,0,0,0,19,nowin,loss,bust,plbust,0,10,9,225,0.408888889,0.075555556,0.577777778,0,0.028101874
18621,30,23104,9,7,0,2,0,18,8,11,0,0,0,19,nowin,loss,beat,dlwin,0,10,16,206,0.393203883,0.033980583,0.601941748,0,0.029324648
18622,138,23104,10,11,0,0,0,21,8,11,0,0,0,19,win,win,plwin,beat,25,0,21,190,0.442105263,0.047368421,0.610526316,2,0.609711065
18623,150,23104,5,9,0,5,0,19,8,11,0,0,0,19,nowin,push,push,push,10,0,14,192,0.401041667,0.036458333,0.567708333,0,0.023287458
18624,76,23105,10,3,0,0,0,13,4,11,2,0,0,17,nowin,loss,beat,dlwin,0,10,13,189,0.534391534,0.079365079,0.608465608,3,1
18625,85,23105,9,10,0,0,0,19,4,11,2,0,0,17,nowin,win,plwin,beat,20,0,19,195,0.41025641,0.066666667,0.594871795,0,0.03269711
18626,3,23105,10,11,0,0,0,21,4,11,2,0,0,17,win,win,plwin,beat,25,0,21,190,0.431578947,0.026315789,0.542105263,1,0.288076384
18627,136,23105,7,2,10,0,0,19,4,11,2,0,0,17,nowin,win,plwin,beat,20,0,9,194,0.396907216,0.025773196,0.597938144,0,0.029452644
18628,124,23105,4,10,0,0,0,14,4,11,2,0,0,17,nowin,loss,beat,dlwin,0,10,14,202,0.47029703,0.064356436,0.584158416,3,0.899458193
18629,128,23105,3,10,0,0,0,13,4,11,2,0,0,17,nowin,loss,beat,dlwin,0,10,13,227,0.356828194,0.052863436,0.577092511,0,0.012352564
18630,66,23106,8,11,0,0,0,19,1,3,10,3,0,17,nowin,win,plwin,beat,20,0,19,217,0.456221198,0.064516129,0.626728111,3,0.924304367
18631,141,23106,10,2,0,10,0,22,1,3,10,3,0,17,nowin,loss,bust,plbust,0,10,12,202,0.420792079,0.074257426,0.564356436,0,0.028377851
18632,57,23106,6,9,0,8,0,23,1,3,10,3,0,17,nowin,loss,bust,plbust,0,10,15,192,0.46875,0.052083333,0.59375,3,0.907001181
18633,87,23106,6,7,0,10,0,23,1,3,10,3,0,17,nowin,loss,bust,plbust,0,10,13,202,0.405940594,0.054455446,0.628712871,2,0.590599801
18634,41,23106,7,8,0,8,0,23,1,3,10,3,0,17,nowin,loss,bust,plbust,0,10,15,192,0.364583333,0.036458333,0.520833333,0,0.00089702
18635,28,23106,6,10,0,1,0,17,1,3,10,3,0,17,nowin,push,push,push,10,0,16,199,0.422110553,0.045226131,0.542713568,1,0.282706618
18636,92,23107,9,10,0,0,0,19,3,9,5,0,0,17,nowin,win,plwin,beat,20,0,19,186,0.446236559,0.059139785,0.564516129,1,0.307826125
18637,3,23107,7,10,0,0,0,17,3,9,5,0,0,17,nowin,push,push,push,10,0,17,190,0.431578947,0.026315789,0.542105263,1,0.288076384
18638,48,23107,10,9,0,0,0,19,3,9,5,0,0,17,nowin,win,plwin,beat,20,0,19,203,0.413793103,0.019704433,0.600985222,2,0.577280801
18639,63,23107,9,8,0,0,0,17,3,9,5,0,0,17,nowin,push,push,push,10,0,17,216,0.467592593,0.037037037,0.62037037,3,0.931690496
18640,22,23107,10,8,0,0,0,18,3,9,5,0,0,17,nowin,win,plwin,beat,20,0,18,187,0.481283422,0.042780749,0.577540107,3,0.906128176
18641,18,23107,10,9,0,0,0,19,3,9,5,0,0,17,nowin,win,plwin,beat,20,0,19,182,0.461538462,0.043956044,0.587912088,3,0.892649374
18642,36,23108,11,3,1,0,0,15,2,10,8,0,0,20,nowin,loss,beat,dlwin,0,10,14,229,0.445414847,0.056768559,0.655021834,2,0.645370571
18643,91,23108,5,3,9,0,0,17,2,10,8,0,0,20,nowin,loss,beat,dlwin,0,10,8,194,0.417525773,0.046391753,0.515463918,1,0.266616552
18644,112,23108,6,4,10,0,0,20,2,10,8,0,0,20,nowin,push,push,push,10,0,10,203,0.448275862,0.054187192,0.600985222,3,0.889576933
18645,40,23108,2,3,8,0,0,13,2,10,8,0,0,20,nowin,loss,beat,dlwin,0,10,5,196,0.367346939,0.030612245,0.617346939,0,0.025358183
18646,136,23108,4,10,0,0,0,14,2,10,8,0,0,20,nowin,loss,beat,dlwin,0,10,14,194,0.396907216,0.025773196,0.597938144,0,0.029452644
18647,52,23108,5,9,0,0,0,14,2,10,8,0,0,20,nowin,loss,beat,dlwin,0,10,14,217,0.414746544,0.02764977,0.599078341,2,0.576736024
18648,55,23109,9,5,0,0,0,14,5,10,6,0,0,21,nowin,loss,beat,dlwin,0,10,14,191,0.371727749,0.057591623,0.54973822,0,0.01011347
18649,122,23109,10,10,0,0,0,20,5,10,6,0,0,21,nowin,loss,beat,dlwin,0,10,20,210,0.347619048,0.052380952,0.59047619,0,0.012873677
18650,19,23109,11,8,0,0,0,19,5,10,6,0,0,21,nowin,loss,beat,dlwin,0,10,19,237,0.41350211,0.054852321,0.628691983,2,0.597373826
18651,77,23109,10,11,0,0,0,21,5,10,6,0,0,21,win,push,push,push,10,0,21,200,0.455,0.04,0.62,3,0.916252116
18652,26,23109,10,4,0,0,0,14,5,10,6,0,0,21,nowin,loss,beat,dlwin,0,10,14,203,0.463054187,0.0591133,0.541871921,1,0.306802864
18653,143,23109,6,7,0,0,0,13,5,10,6,0,0,21,nowin,loss,beat,dlwin,0,10,13,203,0.463054187,0.044334975,0.57635468,3,0.883143365
18654,136,23110,10,6,0,5,0,21,7,11,0,0,0,18,nowin,win,plwin,beat,20,0,16,194,0.396907216,0.025773196,0.597938144,0,0.029452644
18655,31,23110,4,10,0,9,0,23,7,11,0,0,0,18,nowin,loss,bust,plbust,0,10,14,188,0.473404255,0.058510638,0.515957447,1,0.300306557
18656,71,23110,10,10,0,0,0,20,7,11,0,0,0,18,nowin,win,plwin,beat,20,0,20,193,0.352331606,0.046632124,0.585492228,0,0.013063661
18657,108,23110,8,6,0,8,0,22,7,11,0,0,0,18,nowin,loss,bust,plbust,0,10,14,193,0.435233161,0.056994819,0.559585492,1,0.298824795
18658,43,23110,5,6,1,9,0,21,7,11,0,0,0,18,nowin,win,plwin,beat,20,0,11,192,0.40625,0.041666667,0.609375,2,0.576671372
18659,71,23110,10,11,0,0,0,21,7,11,0,0,0,18,win,win,plwin,beat,25,0,21,193,0.352331606,0.046632124,0.585492228,0,0.013063661
18660,9,23111,4,4,10,0,0,18,10,7,0,0,0,17,nowin,win,plwin,beat,20,0,8,194,0.37628866,0.015463918,0.541237113,0,0.009396796
18661,58,23111,2,10,0,9,0,21,10,7,0,0,0,17,nowin,win,plwin,beat,20,0,12,195,0.430769231,0.041025641,0.584615385,2,0.580497586
18662,145,23111,10,6,0,8,0,24,10,7,0,0,0,17,nowin,loss,bust,plbust,0,10,16,188,0.441489362,0.031914894,0.622340426,2,0.617837093
18663,149,23111,7,10,0,0,0,17,10,7,0,0,0,17,nowin,push,push,push,10,0,17,225,0.457777778,0.057777778,0.648888889,2,0.651965595
18664,116,23111,11,10,0,0,0,21,10,7,0,0,0,17,win,win,plwin,beat,25,0,21,195,0.425641026,0.056410256,0.538461538,1,0.28273747
18665,53,23111,5,2,4,5,10,26,10,7,0,0,0,17,nowin,loss,bust,plbust,0,10,7,250,0.372,0.064,0.564,0,0.013687345
18666,22,23112,6,10,0,6,0,22,10,2,6,0,0,18,nowin,loss,bust,plbust,0,10,16,187,0.481283422,0.042780749,0.577540107,3,0.906128176
18667,3,23112,10,11,0,0,0,21,10,2,6,0,0,18,win,win,plwin,beat,25,0,21,190,0.431578947,0.026315789,0.542105263,1,0.288076384
18668,52,23112,3,2,9,10,0,24,10,2,6,0,0,18,nowin,loss,bust,plbust,0,10,5,217,0.414746544,0.02764977,0.599078341,2,0.576736024
18669,79,23112,5,10,0,3,0,18,10,2,6,0,0,18,nowin,push,push,push,10,0,15,211,0.436018957,0.028436019,0.672985782,2,0.650131054
18670,20,23112,8,5,0,10,0,23,10,2,6,0,0,18,nowin,loss,bust,plbust,0,10,13,186,0.456989247,0.037634409,0.537634409,1,0.301097108
18671,14,23112,4,10,0,8,0,22,10,2,6,0,0,18,nowin,loss,bust,plbust,0,10,14,202,0.391089109,0.01980198,0.628712871,2,0.577264877
18672,103,23113,10,11,0,0,0,21,3,10,4,0,0,17,win,win,plwin,beat,25,0,21,203,0.379310345,0.064039409,0.551724138,0,0.012869209
18673,81,23113,8,8,0,0,0,16,3,10,4,0,0,17,nowin,loss,beat,dlwin,0,10,16,182,0.395604396,0.043956044,0.60989011,2,0.567491261
18674,49,23113,4,3,9,0,0,16,3,10,4,0,0,17,nowin,loss,beat,dlwin,0,10,7,207,0.396135266,0.053140097,0.594202899,0,0.028306925
18675,104,23113,10,8,0,0,0,18,3,10,4,0,0,17,nowin,win,plwin,beat,20,0,18,209,0.363636364,0.052631579,0.593301435,0,0.018359419
18676,124,23113,10,10,0,0,0,20,3,10,4,0,0,17,nowin,win,plwin,beat,20,0,20,202,0.47029703,0.064356436,0.584158416,3,0.899458193
18677,137,23113,9,10,0,0,0,19,3,10,4,0,0,17,nowin,win,plwin,beat,20,0,19,194,0.417525773,0.046391753,0.536082474,1,0.276714602
18678,73,23114,10,8,0,0,0,18,2,2,10,10,0,24,nowin,win,dlbust,bust,20,0,18,181,0.375690608,0.011049724,0.596685083,0,0.022795773
18679,33,23114,11,10,0,0,0,21,2,2,10,10,0,24,win,win,dlbust,bust,25,0,21,192,0.4375,0.057291667,0.625,2,0.616208916
18680,25,23114,9,4,0,0,0,13,2,2,10,10,0,24,nowin,win,dlbust,bust,20,0,13,190,0.463157895,0.063157895,0.536842105,1,0.304401563
18681,75,23114,10,9,0,0,0,19,2,2,10,10,0,24,nowin,win,dlbust,bust,20,0,19,191,0.418848168,0.052356021,0.570680628,0,0.029344702
18682,109,23114,8,10,0,0,0,18,2,2,10,10,0,24,nowin,win,dlbust,bust,20,0,18,221,0.461538462,0.058823529,0.597285068,3,0.901830309
18683,104,23114,10,6,0,0,0,16,2,2,10,10,0,24,nowin,win,dlbust,bust,20,0,16,209,0.363636364,0.052631579,0.593301435,0,0.018359419
18684,118,23115,10,11,0,0,0,21,2,2,8,5,0,17,win,win,plwin,beat,25,0,21,216,0.393518519,0.037037037,0.555555556,0,0.018059873
18685,67,23115,10,6,0,0,0,16,2,2,8,5,0,17,nowin,loss,beat,dlwin,0,10,16,195,0.369230769,0.041025641,0.569230769,0,0.014139427
18686,50,23115,2,10,0,10,0,22,2,2,8,5,0,17,nowin,loss,bust,plbust,0,10,12,202,0.405940594,0.04950495,0.54950495,0,0.020296079
18687,103,23115,6,10,0,0,0,16,2,2,8,5,0,17,nowin,loss,beat,dlwin,0,10,16,203,0.379310345,0.064039409,0.551724138,0,0.012869209
18688,1,23115,3,4,4,4,0,15,2,2,8,5,0,17,nowin,loss,beat,dlwin,0,10,7,197,0.406091371,0.025380711,0.649746193,2,0.606186955
18689,19,23115,8,4,0,9,0,21,2,2,8,5,0,17,nowin,win,plwin,beat,20,0,12,237,0.41350211,0.054852321,0.628691983,2,0.597373826
18690,105,23116,6,10,0,0,0,16,5,6,5,7,0,23,nowin,win,dlbust,bust,20,0,16,198,0.414141414,0.070707071,0.590909091,0,0.032889494
18691,104,23116,7,8,0,0,0,15,5,6,5,7,0,23,nowin,win,dlbust,bust,20,0,15,209,0.363636364,0.052631579,0.593301435,0,0.018359419
18692,135,23116,8,4,0,0,0,12,5,6,5,7,0,23,nowin,win,dlbust,bust,20,0,12,179,0.391061453,0.067039106,0.586592179,0,0.024924662
18693,127,23116,7,10,0,0,0,17,5,6,5,7,0,23,nowin,win,dlbust,bust,20,0,17,201,0.402985075,0.029850746,0.60199005,0,0.032263937
18694,33,23116,10,6,0,0,0,16,5,6,5,7,0,23,nowin,win,dlbust,bust,20,0,16,192,0.4375,0.057291667,0.625,2,0.616208916
18695,73,23116,7,4,3,0,0,14,5,6,5,7,0,23,nowin,win,dlbust,bust,20,0,11,181,0.375690608,0.011049724,0.596685083,0,0.022795773
18696,6,23117,3,2,8,10,0,23,10,5,7,0,0,22,nowin,loss,bust,plbust,0,10,5,191,0.439790576,0.047120419,0.581151832,1,0.31211505
18697,7,23117,4,10,0,10,0,24,10,5,7,0,0,22,nowin,loss,bust,plbust,0,10,14,183,0.442622951,0.06010929,0.62295082,2,0.619303341
18698,112,23117,10,10,0,0,0,20,10,5,7,0,0,22,nowin,win,dlbust,bust,20,0,20,203,0.448275862,0.054187192,0.600985222,3,0.889576933
18699,73,23117,7,8,0,8,0,23,10,5,7,0,0,22,nowin,loss,bust,plbust,0,10,15,181,0.375690608,0.011049724,0.596685083,0,0.022795773
18700,149,23117,10,3,0,3,2,18,10,5,7,0,0,22,nowin,win,dlbust,bust,20,0,13,225,0.457777778,0.057777778,0.648888889,2,0.651965595
18701,46,23117,2,2,11,1,9,25,10,5,7,0,0,22,nowin,loss,bust,plbust,0,10,4,186,0.403225806,0.048387097,0.591397849,0,0.029742194
18702,17,23118,4,4,6,1,3,18,7,5,7,0,0,19,nowin,loss,beat,dlwin,0,10,8,171,0.444444444,0.070175439,0.555555556,1,0.302364894
18703,142,23118,9,8,0,0,0,17,7,5,7,0,0,19,nowin,loss,beat,dlwin,0,10,17,211,0.417061611,0.047393365,0.526066351,1,0.271531309
18704,126,23118,10,8,0,0,0,18,7,5,7,0,0,19,nowin,loss,beat,dlwin,0,10,18,188,0.457446809,0.074468085,0.60106383,3,0.900633203
18705,140,23118,10,2,0,10,0,22,7,5,7,0,0,19,nowin,loss,bust,plbust,0,10,12,210,0.466666667,0.023809524,0.604761905,3,0.915293335
18706,104,23118,8,3,2,6,0,19,7,5,7,0,0,19,nowin,push,push,push,10,0,11,209,0.363636364,0.052631579,0.593301435,0,0.018359419
18707,52,23118,8,11,0,0,0,19,7,5,7,0,0,19,nowin,push,push,push,10,0,19,217,0.414746544,0.02764977,0.599078341,2,0.576736024
18708,86,23119,11,9,0,0,0,20,4,1,7,5,0,17,nowin,win,plwin,beat,20,0,20,196,0.454081633,0.040816327,0.591836735,3,0.887566443
18709,113,23119,2,2,9,0,0,13,4,1,7,5,0,17,nowin,loss,beat,dlwin,0,10,4,199,0.407035176,0.055276382,0.668341709,2,0.620695264
18710,79,23119,8,9,0,0,0,17,4,1,7,5,0,17,nowin,push,push,push,10,0,17,211,0.436018957,0.028436019,0.672985782,2,0.650131054
18711,101,23119,7,6,0,0,0,13,4,1,7,5,0,17,nowin,loss,beat,dlwin,0,10,13,205,0.424390244,0.068292683,0.63902439,2,0.614740646
18712,79,23119,5,10,0,0,0,15,4,1,7,5,0,17,nowin,loss,beat,dlwin,0,10,15,211,0.436018957,0.028436019,0.672985782,2,0.650131054
18713,64,23119,10,10,0,0,0,20,4,1,7,5,0,17,nowin,win,plwin,beat,20,0,20,187,0.363636364,0.048128342,0.631016043,0,0.027594885
18714,107,23120,10,2,0,10,0,22,9,10,0,0,0,19,nowin,loss,bust,plbust,0,10,12,218,0.444954128,0.073394495,0.600917431,2,0.605210014
18715,77,23120,2,9,10,0,0,21,9,10,0,0,0,19,nowin,win,plwin,beat,20,0,11,200,0.455,0.04,0.62,3,0.916252116
18716,65,23120,9,3,0,4,9,25,9,10,0,0,0,19,nowin,loss,bust,plbust,0,10,12,203,0.492610837,0.054187192,0.571428571,3,0.913702814
18717,42,23120,10,8,0,0,0,18,9,10,0,0,0,19,nowin,loss,beat,dlwin,0,10,18,212,0.443396226,0.051886792,0.570754717,1,0.309181312
18718,3,23120,10,8,0,0,0,18,9,10,0,0,0,19,nowin,loss,beat,dlwin,0,10,18,190,0.431578947,0.026315789,0.542105263,1,0.288076384
18719,114,23120,6,10,0,9,0,25,9,10,0,0,0,19,nowin,loss,bust,plbust,0,10,16,198,0.47979798,0.025252525,0.611111111,3,0.937232995
18720,150,23121,11,10,0,0,0,21,4,10,7,0,0,21,win,push,push,push,10,0,21,192,0.401041667,0.036458333,0.567708333,0,0.023287458
18721,92,23121,3,11,5,0,0,19,4,10,7,0,0,21,nowin,loss,beat,dlwin,0,10,14,186,0.446236559,0.059139785,0.564516129,1,0.307826125
18722,68,23121,8,4,0,0,0,12,4,10,7,0,0,21,nowin,loss,beat,dlwin,0,10,12,205,0.434146341,0.029268293,0.6,2,0.59483189
18723,53,23121,4,4,3,10,0,21,4,10,7,0,0,21,nowin,push,push,push,10,0,8,250,0.372,0.064,0.564,0,0.013687345
18724,142,23121,10,7,0,0,0,17,4,10,7,0,0,21,nowin,loss,beat,dlwin,0,10,17,211,0.417061611,0.047393365,0.526066351,1,0.271531309
18725,68,23121,10,10,0,0,0,20,4,10,7,0,0,21,nowin,loss,beat,dlwin,0,10,20,205,0.434146341,0.029268293,0.6,2,0.59483189
18726,50,23122,6,10,0,9,0,25,10,8,0,0,0,18,nowin,loss,bust,plbust,0,10,16,202,0.405940594,0.04950495,0.54950495,0,0.020296079
18727,7,23122,4,7,3,10,0,24,10,8,0,0,0,18,nowin,loss,bust,plbust,0,10,11,183,0.442622951,0.06010929,0.62295082,2,0.619303341
18728,149,23122,7,6,0,10,0,23,10,8,0,0,0,18,nowin,loss,bust,plbust,0,10,13,225,0.457777778,0.057777778,0.648888889,2,0.651965595
18729,141,23122,10,10,0,0,0,20,10,8,0,0,0,18,nowin,win,plwin,beat,20,0,20,202,0.420792079,0.074257426,0.564356436,0,0.028377851
18730,94,23122,6,10,0,2,0,18,10,8,0,0,0,18,nowin,push,push,push,10,0,16,183,0.43715847,0.043715847,0.540983607,1,0.290866892
18731,63,23122,2,10,0,7,0,19,10,8,0,0,0,18,nowin,win,plwin,beat,20,0,12,216,0.467592593,0.037037037,0.62037037,3,0.931690496
18732,44,23123,3,10,0,0,0,13,4,10,10,0,0,24,nowin,win,dlbust,bust,20,0,13,219,0.433789954,0.050228311,0.534246575,1,0.285551035
18733,73,23123,2,10,0,0,0,12,4,10,10,0,0,24,nowin,win,dlbust,bust,20,0,12,181,0.375690608,0.011049724,0.596685083,0,0.022795773
18734,5,23123,3,2,6,10,0,21,4,10,10,0,0,24,nowin,win,dlbust,bust,20,0,5,203,0.42364532,0.02955665,0.596059113,2,0.582508076
18735,99,23123,3,10,0,0,0,13,4,10,10,0,0,24,nowin,win,dlbust,bust,20,0,13,207,0.47826087,0.062801932,0.637681159,3,0.961418446
18736,140,23123,10,10,0,0,0,20,4,10,10,0,0,24,nowin,win,dlbust,bust,20,0,20,210,0.466666667,0.023809524,0.604761905,3,0.915293335
18737,109,23123,10,10,0,0,0,20,4,10,10,0,0,24,nowin,win,dlbust,bust,20,0,20,221,0.461538462,0.058823529,0.597285068,3,0.901830309
18738,16,23124,5,9,0,0,0,14,4,2,10,10,0,26,nowin,win,dlbust,bust,20,0,14,220,0.427272727,0.081818182,0.6,2,0.588660176
18739,136,23124,6,3,8,0,0,17,4,2,10,10,0,26,nowin,win,dlbust,bust,20,0,9,194,0.396907216,0.025773196,0.597938144,0,0.029452644
18740,17,23124,10,10,0,0,0,20,4,2,10,10,0,26,nowin,win,dlbust,bust,20,0,20,171,0.444444444,0.070175439,0.555555556,1,0.302364894
18741,6,23124,5,10,0,0,0,15,4,2,10,10,0,26,nowin,win,dlbust,bust,20,0,15,191,0.439790576,0.047120419,0.581151832,1,0.31211505
18742,105,23124,10,3,0,0,0,13,4,2,10,10,0,26,nowin,win,dlbust,bust,20,0,13,198,0.414141414,0.070707071,0.590909091,0,0.032889494
18743,130,23124,8,6,0,0,0,14,4,2,10,10,0,26,nowin,win,dlbust,bust,20,0,14,219,0.410958904,0.03652968,0.566210046,0,0.025888739
18744,109,23125,9,6,0,9,0,24,10,4,9,0,0,23,nowin,loss,bust,plbust,0,10,15,221,0.461538462,0.058823529,0.597285068,3,0.901830309
18745,148,23125,10,10,0,0,0,20,10,4,9,0,0,23,nowin,win,dlbust,bust,20,0,20,204,0.401960784,0.078431373,0.593137255,0,0.029789521
18746,133,23125,5,10,0,9,0,24,10,4,9,0,0,23,nowin,loss,bust,plbust,0,10,15,201,0.47761194,0.064676617,0.611940299,3,0.935428111
18747,114,23125,4,6,10,0,0,20,10,4,9,0,0,23,nowin,win,dlbust,bust,20,0,10,198,0.47979798,0.025252525,0.611111111,3,0.937232995
18748,119,23125,5,10,0,8,0,23,10,4,9,0,0,23,nowin,loss,bust,plbust,0,10,15,190,0.405263158,0.068421053,0.515789474,0,0.011837158
18749,26,23125,4,9,0,10,0,23,10,4,9,0,0,23,nowin,loss,bust,plbust,0,10,13,203,0.463054187,0.0591133,0.541871921,1,0.306802864
18750,59,23126,2,10,0,0,0,12,6,10,10,0,0,26,nowin,win,dlbust,bust,20,0,12,228,0.429824561,0.048245614,0.543859649,1,0.287885446
18751,114,23126,2,10,0,0,0,12,6,10,10,0,0,26,nowin,win,dlbust,bust,20,0,12,198,0.47979798,0.025252525,0.611111111,3,0.937232995
18752,146,23126,2,1,9,0,0,12,6,10,10,0,0,26,nowin,win,dlbust,bust,20,0,3,221,0.43438914,0.040723982,0.542986425,1,0.290190091
18753,26,23126,10,10,0,0,0,20,6,10,10,0,0,26,nowin,win,dlbust,bust,20,0,20,203,0.463054187,0.0591133,0.541871921,1,0.306802864
18754,89,23126,5,6,10,0,0,21,6,10,10,0,0,26,nowin,win,dlbust,bust,20,0,11,212,0.537735849,0.047169811,0.594339623,3,0.990167191
18755,95,23126,3,2,10,0,0,15,6,10,10,0,0,26,nowin,win,dlbust,bust,20,0,5,218,0.412844037,0.04587156,0.559633028,0,0.024842385
18756,27,23127,10,6,0,0,0,16,5,10,10,0,0,25,nowin,win,dlbust,bust,20,0,16,178,0.370786517,0.016853933,0.573033708,0,0.015536309
18757,23,23127,1,6,5,0,0,12,5,10,10,0,0,25,nowin,win,dlbust,bust,20,0,7,208,0.427884615,0.0625,0.552884615,1,0.29114424
18758,74,23127,4,10,0,0,0,14,5,10,10,0,0,25,nowin,win,dlbust,bust,20,0,14,209,0.411483254,0.04784689,0.531100478,0,0.017448125
18759,134,23127,7,5,0,0,0,12,5,10,10,0,0,25,nowin,win,dlbust,bust,20,0,12,185,0.443243243,0.021621622,0.545945946,1,0.296939509
18760,146,23127,1,1,10,0,0,12,5,10,10,0,0,25,nowin,win,dlbust,bust,20,0,2,221,0.43438914,0.040723982,0.542986425,1,0.290190091
18761,9,23127,10,6,0,0,0,16,5,10,10,0,0,25,nowin,win,dlbust,bust,20,0,16,194,0.37628866,0.015463918,0.541237113,0,0.009396796
18762,24,23128,5,10,0,8,0,23,10,10,0,0,0,20,nowin,loss,bust,plbust,0,10,15,207,0.458937198,0.048309179,0.570048309,1,0.318138014
18763,133,23128,6,10,0,2,0,18,10,10,0,0,0,20,nowin,loss,beat,dlwin,0,10,16,201,0.47761194,0.064676617,0.611940299,3,0.935428111
18764,72,23128,10,11,0,0,0,21,10,10,0,0,0,20,win,win,plwin,beat,25,0,21,185,0.394594595,0.032432432,0.508108108,0,0.006763115
18765,52,23128,6,10,0,7,0,23,10,10,0,0,0,20,nowin,loss,bust,plbust,0,10,16,217,0.414746544,0.02764977,0.599078341,2,0.576736024
18766,139,23128,4,3,6,10,0,23,10,10,0,0,0,20,nowin,loss,bust,plbust,0,10,7,192,0.380208333,0.036458333,0.59375,0,0.023429169
18767,101,23128,1,1,10,10,0,22,10,10,0,0,0,20,nowin,loss,bust,plbust,0,10,2,205,0.424390244,0.068292683,0.63902439,2,0.614740646
18768,39,23129,8,9,0,0,0,17,6,2,10,0,0,18,nowin,loss,beat,dlwin,0,10,17,191,0.429319372,0.062827225,0.57591623,0,0.033760763
18769,122,23129,10,10,0,0,0,20,6,2,10,0,0,18,nowin,win,plwin,beat,20,0,20,210,0.347619048,0.052380952,0.59047619,0,0.012873677
18770,142,23129,7,9,0,0,0,16,6,2,10,0,0,18,nowin,loss,beat,dlwin,0,10,16,211,0.417061611,0.047393365,0.526066351,1,0.271531309
18771,96,23129,10,2,0,0,0,12,6,2,10,0,0,18,nowin,loss,beat,dlwin,0,10,12,190,0.468421053,0.057894737,0.584210526,3,0.897263354
18772,23,23129,10,7,0,0,0,17,6,2,10,0,0,18,nowin,loss,beat,dlwin,0,10,17,208,0.427884615,0.0625,0.552884615,1,0.29114424
18773,105,23129,10,2,0,0,0,12,6,2,10,0,0,18,nowin,loss,beat,dlwin,0,10,12,198,0.414141414,0.070707071,0.590909091,0,0.032889494
18774,99,23130,10,6,0,0,0,16,4,9,1,3,0,17,nowin,loss,beat,dlwin,0,10,16,207,0.47826087,0.062801932,0.637681159,3,0.961418446
18775,18,23130,10,2,0,0,0,12,4,9,1,3,0,17,nowin,loss,beat,dlwin,0,10,12,182,0.461538462,0.043956044,0.587912088,3,0.892649374
18776,64,23130,9,11,0,0,0,20,4,9,1,3,0,17,nowin,win,plwin,beat,20,0,20,187,0.363636364,0.048128342,0.631016043,0,0.027594885
18777,44,23130,11,5,3,0,0,19,4,9,1,3,0,17,nowin,win,plwin,beat,20,0,16,219,0.433789954,0.050228311,0.534246575,1,0.285551035
18778,90,23130,2,10,0,0,0,12,4,9,1,3,0,17,nowin,loss,beat,dlwin,0,10,12,201,0.447761194,0.049751244,0.60199005,3,0.889945023
18779,2,23130,10,9,0,0,0,19,4,9,1,3,0,17,nowin,win,plwin,beat,20,0,19,200,0.445,0.035,0.64,2,0.633962549
18780,19,23131,3,10,0,0,0,13,2,8,11,0,0,21,nowin,loss,beat,dlwin,0,10,13,237,0.41350211,0.054852321,0.628691983,2,0.597373826
18781,59,23131,5,8,0,0,0,13,2,8,11,0,0,21,nowin,loss,beat,dlwin,0,10,13,228,0.429824561,0.048245614,0.543859649,1,0.287885446
18782,142,23131,2,8,5,0,0,15,2,8,11,0,0,21,nowin,loss,beat,dlwin,0,10,10,211,0.417061611,0.047393365,0.526066351,1,0.271531309
18783,74,23131,10,3,0,0,0,13,2,8,11,0,0,21,nowin,loss,beat,dlwin,0,10,13,209,0.411483254,0.04784689,0.531100478,0,0.017448125
18784,132,23131,7,2,9,0,0,18,2,8,11,0,0,21,nowin,loss,beat,dlwin,0,10,9,194,0.412371134,0.036082474,0.649484536,2,0.611633238
18785,65,23131,10,10,0,0,0,20,2,8,11,0,0,21,nowin,loss,beat,dlwin,0,10,20,203,0.492610837,0.054187192,0.571428571,3,0.913702814
18786,120,23132,2,10,0,4,0,16,3,10,10,0,0,23,nowin,win,dlbust,bust,20,0,12,202,0.440594059,0.034653465,0.618811881,2,0.614441029
18787,150,23132,10,10,0,0,0,20,3,10,10,0,0,23,nowin,win,dlbust,bust,20,0,20,192,0.401041667,0.036458333,0.567708333,0,0.023287458
18788,134,23132,9,10,0,0,0,19,3,10,10,0,0,23,nowin,win,dlbust,bust,20,0,19,185,0.443243243,0.021621622,0.545945946,1,0.296939509
18789,50,23132,10,8,0,0,0,18,3,10,10,0,0,23,nowin,win,dlbust,bust,20,0,18,202,0.405940594,0.04950495,0.54950495,0,0.020296079
18790,103,23132,2,10,0,9,0,21,3,10,10,0,0,23,nowin,win,dlbust,bust,20,0,12,203,0.379310345,0.064039409,0.551724138,0,0.012869209
18791,13,23132,4,7,4,0,0,15,3,10,10,0,0,23,nowin,win,dlbust,bust,20,0,11,206,0.417475728,0.063106796,0.621359223,2,0.59555479
18792,14,23133,11,8,0,0,0,19,8,3,1,8,0,20,nowin,loss,beat,dlwin,0,10,19,202,0.391089109,0.01980198,0.628712871,2,0.577264877
18793,50,23133,8,11,0,0,0,19,8,3,1,8,0,20,nowin,loss,beat,dlwin,0,10,19,202,0.405940594,0.04950495,0.54950495,0,0.020296079
18794,129,23133,4,10,0,2,10,26,8,3,1,8,0,20,nowin,loss,bust,plbust,0,10,14,201,0.422885572,0.064676617,0.55721393,0,0.027255383
18795,63,23133,10,10,0,0,0,20,8,3,1,8,0,20,nowin,push,push,push,10,0,20,216,0.467592593,0.037037037,0.62037037,3,0.931690496
18796,50,23133,7,4,8,0,0,19,8,3,1,8,0,20,nowin,loss,beat,dlwin,0,10,11,202,0.405940594,0.04950495,0.54950495,0,0.020296079
18797,21,23133,10,8,0,0,0,18,8,3,1,8,0,20,nowin,loss,beat,dlwin,0,10,18,214,0.359813084,0.042056075,0.626168224,0,0.025263474
18798,26,23134,10,6,0,9,0,25,10,2,10,0,0,22,nowin,loss,bust,plbust,0,10,16,203,0.463054187,0.0591133,0.541871921,1,0.306802864
18799,84,23134,11,1,6,0,0,18,10,2,10,0,0,22,nowin,win,dlbust,bust,20,0,12,195,0.379487179,0.056410256,0.569230769,0,0.017209119
18800,44,23134,7,7,0,2,8,24,10,2,10,0,0,22,nowin,loss,bust,plbust,0,10,14,219,0.433789954,0.050228311,0.534246575,1,0.285551035
18801,116,23134,2,10,0,1,4,17,10,2,10,0,0,22,nowin,win,dlbust,bust,20,0,12,195,0.425641026,0.056410256,0.538461538,1,0.28273747
18802,67,23134,2,7,7,2,0,18,10,2,10,0,0,22,nowin,win,dlbust,bust,20,0,9,195,0.369230769,0.041025641,0.569230769,0,0.014139427
18803,121,23134,7,7,0,10,0,24,10,2,10,0,0,22,nowin,loss,bust,plbust,0,10,14,195,0.456410256,0.025641026,0.512820513,1,0.288597791
18804,107,23135,4,8,0,5,0,17,9,9,0,0,0,18,nowin,loss,beat,dlwin,0,10,12,218,0.444954128,0.073394495,0.600917431,2,0.605210014
18805,5,23135,10,9,0,0,0,19,9,9,0,0,0,18,nowin,win,plwin,beat,20,0,19,203,0.42364532,0.02955665,0.596059113,2,0.582508076
18806,140,23135,8,3,1,10,0,22,9,9,0,0,0,18,nowin,loss,bust,plbust,0,10,11,210,0.466666667,0.023809524,0.604761905,3,0.915293335
18807,102,23135,1,6,8,10,0,25,9,9,0,0,0,18,nowin,loss,bust,plbust,0,10,7,192,0.338541667,0.046875,0.5625,0,0.003306118
18808,11,23135,9,3,0,8,0,20,9,9,0,0,0,18,nowin,win,plwin,beat,20,0,12,236,0.457627119,0.016949153,0.588983051,3,0.889015813
18809,74,23135,6,3,10,0,0,19,9,9,0,0,0,18,nowin,win,plwin,beat,20,0,9,209,0.411483254,0.04784689,0.531100478,0,0.017448125
18810,147,23136,10,5,0,0,0,15,6,4,11,0,0,21,nowin,loss,beat,dlwin,0,10,15,205,0.380487805,0.014634146,0.536585366,0,0.00951447
18811,63,23136,10,10,0,0,0,20,6,4,11,0,0,21,nowin,loss,beat,dlwin,0,10,20,216,0.467592593,0.037037037,0.62037037,3,0.931690496
18812,97,23136,10,10,0,0,0,20,6,4,11,0,0,21,nowin,loss,beat,dlwin,0,10,20,182,0.450549451,0.06043956,0.692307692,2,0.677372279
18813,96,23136,5,10,0,0,0,15,6,4,11,0,0,21,nowin,loss,beat,dlwin,0,10,15,190,0.468421053,0.057894737,0.584210526,3,0.897263354
18814,148,23136,5,3,10,0,0,18,6,4,11,0,0,21,nowin,loss,beat,dlwin,0,10,8,204,0.401960784,0.078431373,0.593137255,0,0.029789521
18815,62,23136,9,10,0,0,0,19,6,4,11,0,0,21,nowin,loss,beat,dlwin,0,10,19,178,0.370786517,0.028089888,0.54494382,0,0.008657722
18816,22,23137,10,10,0,0,0,20,10,10,0,0,0,20,nowin,push,push,push,10,0,20,187,0.481283422,0.042780749,0.577540107,3,0.906128176
18817,83,23137,10,10,0,0,0,20,10,10,0,0,0,20,nowin,push,push,push,10,0,20,193,0.424870466,0.051813472,0.678756477,2,0.644360335
18818,39,23137,7,10,0,0,0,17,10,10,0,0,0,20,nowin,loss,beat,dlwin,0,10,17,191,0.429319372,0.062827225,0.57591623,0,0.033760763
18819,8,23137,10,3,0,10,0,23,10,10,0,0,0,20,nowin,loss,bust,plbust,0,10,13,181,0.44198895,0.071823204,0.596685083,2,0.599438402
18820,41,23137,10,11,0,0,0,21,10,10,0,0,0,20,win,win,plwin,beat,25,0,21,192,0.364583333,0.036458333,0.520833333,0,0.00089702
18821,18,23137,11,10,0,0,0,21,10,10,0,0,0,20,win,win,plwin,beat,25,0,21,182,0.461538462,0.043956044,0.587912088,3,0.892649374
18822,116,23138,7,7,0,7,0,21,10,8,0,0,0,18,nowin,win,plwin,beat,20,0,14,195,0.425641026,0.056410256,0.538461538,1,0.28273747
18823,104,23138,8,10,0,0,0,18,10,8,0,0,0,18,nowin,push,push,push,10,0,18,209,0.363636364,0.052631579,0.593301435,0,0.018359419
18824,48,23138,9,10,0,0,0,19,10,8,0,0,0,18,nowin,win,plwin,beat,20,0,19,203,0.413793103,0.019704433,0.600985222,2,0.577280801
18825,9,23138,4,5,5,2,4,20,10,8,0,0,0,18,nowin,win,plwin,beat,20,0,9,194,0.37628866,0.015463918,0.541237113,0,0.009396796
18826,139,23138,8,10,0,0,0,18,10,8,0,0,0,18,nowin,push,push,push,10,0,18,192,0.380208333,0.036458333,0.59375,0,0.023429169
18827,106,23138,4,10,0,10,0,24,10,8,0,0,0,18,nowin,loss,bust,plbust,0,10,14,192,0.411458333,0.026041667,0.557291667,0,0.023854304
18828,7,23139,10,10,0,0,0,20,2,5,6,9,0,22,nowin,win,dlbust,bust,20,0,20,183,0.442622951,0.06010929,0.62295082,2,0.619303341
18829,16,23139,10,9,0,0,0,19,2,5,6,9,0,22,nowin,win,dlbust,bust,20,0,19,220,0.427272727,0.081818182,0.6,2,0.588660176
18830,59,23139,10,8,0,0,0,18,2,5,6,9,0,22,nowin,win,dlbust,bust,20,0,18,228,0.429824561,0.048245614,0.543859649,1,0.287885446
18831,142,23139,10,10,0,0,0,20,2,5,6,9,0,22,nowin,win,dlbust,bust,20,0,20,211,0.417061611,0.047393365,0.526066351,1,0.271531309
18832,139,23139,5,9,0,0,0,14,2,5,6,9,0,22,nowin,win,dlbust,bust,20,0,14,192,0.380208333,0.036458333,0.59375,0,0.023429169
18833,88,23139,3,2,8,0,0,13,2,5,6,9,0,22,nowin,win,dlbust,bust,20,0,5,206,0.466019417,0.033980583,0.54368932,1,0.309467903
18834,2,23140,8,4,0,6,0,18,8,2,6,10,0,26,nowin,win,dlbust,bust,20,0,12,200,0.445,0.035,0.64,2,0.633962549
18835,100,23140,7,10,0,0,0,17,8,2,6,10,0,26,nowin,win,dlbust,bust,20,0,17,190,0.452631579,0.036842105,0.594736842,3,0.888671154
18836,91,23140,10,8,0,0,0,18,8,2,6,10,0,26,nowin,win,dlbust,bust,20,0,18,194,0.417525773,0.046391753,0.515463918,1,0.266616552
18837,106,23140,10,2,0,6,0,18,8,2,6,10,0,26,nowin,win,dlbust,bust,20,0,12,192,0.411458333,0.026041667,0.557291667,0,0.023854304
18838,132,23140,10,9,0,0,0,19,8,2,6,10,0,26,nowin,win,dlbust,bust,20,0,19,194,0.412371134,0.036082474,0.649484536,2,0.611633238
18839,143,23140,4,10,0,10,0,24,8,2,6,10,0,26,nowin,loss,bust,plbust,0,10,14,203,0.463054187,0.044334975,0.57635468,3,0.883143365
18840,21,23141,6,2,10,0,0,18,3,4,11,0,0,18,nowin,push,push,push,10,0,8,214,0.359813084,0.042056075,0.626168224,0,0.025263474
18841,13,23141,8,5,0,0,0,13,3,4,11,0,0,18,nowin,loss,beat,dlwin,0,10,13,206,0.417475728,0.063106796,0.621359223,2,0.59555479
18842,107,23141,11,3,7,0,0,21,3,4,11,0,0,18,nowin,win,plwin,beat,20,0,14,218,0.444954128,0.073394495,0.600917431,2,0.605210014
18843,19,23141,10,5,0,0,0,15,3,4,11,0,0,18,nowin,loss,beat,dlwin,0,10,15,237,0.41350211,0.054852321,0.628691983,2,0.597373826
18844,49,23141,9,9,0,0,0,18,3,4,11,0,0,18,nowin,push,push,push,10,0,18,207,0.396135266,0.053140097,0.594202899,0,0.028306925
18845,80,23141,10,8,0,0,0,18,3,4,11,0,0,18,nowin,push,push,push,10,0,18,186,0.419354839,0.059139785,0.623655914,2,0.59892924
18846,47,23142,6,10,0,0,0,16,3,4,3,3,6,19,nowin,loss,beat,dlwin,0,10,16,210,0.438095238,0.057142857,0.623809524,2,0.615868808
18847,93,23142,10,11,0,0,0,21,3,4,3,3,6,19,win,win,plwin,beat,25,0,21,175,0.485714286,0.051428571,0.548571429,1,0.323648091
18848,96,23142,11,10,0,0,0,21,3,4,3,3,6,19,win,win,plwin,beat,25,0,21,190,0.468421053,0.057894737,0.584210526,3,0.897263354
18849,57,23142,4,10,0,0,0,14,3,4,3,3,6,19,nowin,loss,beat,dlwin,0,10,14,192,0.46875,0.052083333,0.59375,3,0.907001181
18850,44,23142,10,10,0,0,0,20,3,4,3,3,6,19,nowin,win,plwin,beat,20,0,20,219,0.433789954,0.050228311,0.534246575,1,0.285551035
18851,123,23142,8,10,0,0,0,18,3,4,3,3,6,19,nowin,loss,beat,dlwin,0,10,18,205,0.43902439,0.034146341,0.614634146,2,0.609962544
18852,67,23143,10,5,0,10,0,25,8,10,0,0,0,18,nowin,loss,bust,plbust,0,10,15,195,0.369230769,0.041025641,0.569230769,0,0.014139427
18853,56,23143,10,10,0,0,0,20,8,10,0,0,0,18,nowin,win,plwin,beat,20,0,20,175,0.4,0.057142857,0.582857143,0,0.026685297
18854,1,23143,4,9,0,5,0,18,8,10,0,0,0,18,nowin,push,push,push,10,0,13,197,0.406091371,0.025380711,0.649746193,2,0.606186955
18855,85,23143,7,10,0,0,0,17,8,10,0,0,0,18,nowin,loss,beat,dlwin,0,10,17,195,0.41025641,0.066666667,0.594871795,0,0.03269711
18856,140,23143,10,2,0,8,0,20,8,10,0,0,0,18,nowin,win,plwin,beat,20,0,12,210,0.466666667,0.023809524,0.604761905,3,0.915293335
18857,53,23143,11,7,0,0,0,18,8,10,0,0,0,18,nowin,push,push,push,10,0,18,250,0.372,0.064,0.564,0,0.013687345
18858,5,23144,10,5,0,1,10,26,9,8,0,0,0,17,nowin,loss,bust,plbust,0,10,15,203,0.42364532,0.02955665,0.596059113,2,0.582508076
18859,120,23144,2,3,7,7,0,19,9,8,0,0,0,17,nowin,win,plwin,beat,20,0,5,202,0.440594059,0.034653465,0.618811881,2,0.614441029
18860,55,23144,11,10,0,0,0,21,9,8,0,0,0,17,win,win,plwin,beat,25,0,21,191,0.371727749,0.057591623,0.54973822,0,0.01011347
18861,101,23144,7,6,0,2,10,25,9,8,0,0,0,17,nowin,loss,bust,plbust,0,10,13,205,0.424390244,0.068292683,0.63902439,2,0.614740646
18862,149,23144,10,8,0,0,0,18,9,8,0,0,0,17,nowin,win,plwin,beat,20,0,18,225,0.457777778,0.057777778,0.648888889,2,0.651965595
18863,63,23144,2,3,10,10,0,25,9,8,0,0,0,17,nowin,loss,bust,plbust,0,10,5,216,0.467592593,0.037037037,0.62037037,3,0.931690496
18864,40,23145,9,10,0,0,0,19,3,5,7,7,0,22,nowin,win,dlbust,bust,20,0,19,196,0.367346939,0.030612245,0.617346939,0,0.025358183
18865,125,23145,1,5,7,0,0,13,3,5,7,7,0,22,nowin,win,dlbust,bust,20,0,6,219,0.438356164,0.050228311,0.575342466,1,0.308411257
18866,17,23145,5,4,5,0,0,14,3,5,7,7,0,22,nowin,win,dlbust,bust,20,0,9,171,0.444444444,0.070175439,0.555555556,1,0.302364894
18867,145,23145,7,9,0,0,0,16,3,5,7,7,0,22,nowin,win,dlbust,bust,20,0,16,188,0.441489362,0.031914894,0.622340426,2,0.617837093
18868,59,23145,5,11,3,0,0,19,3,5,7,7,0,22,nowin,win,dlbust,bust,20,0,16,228,0.429824561,0.048245614,0.543859649,1,0.287885446
18869,68,23145,10,7,0,0,0,17,3,5,7,7,0,22,nowin,win,dlbust,bust,20,0,17,205,0.434146341,0.029268293,0.6,2,0.59483189
18870,10,23146,5,1,10,0,0,16,4,3,3,10,0,20,nowin,loss,beat,dlwin,0,10,6,191,0.413612565,0.057591623,0.596858639,2,0.574087175
18871,59,23146,10,8,0,0,0,18,4,3,3,10,0,20,nowin,loss,beat,dlwin,0,10,18,228,0.429824561,0.048245614,0.543859649,1,0.287885446
18872,121,23146,8,6,0,0,0,14,4,3,3,10,0,20,nowin,loss,beat,dlwin,0,10,14,195,0.456410256,0.025641026,0.512820513,1,0.288597791
18873,83,23146,2,8,9,0,0,19,4,3,3,10,0,20,nowin,loss,beat,dlwin,0,10,10,193,0.424870466,0.051813472,0.678756477,2,0.644360335
18874,89,23146,10,11,0,0,0,21,4,3,3,10,0,20,win,win,plwin,beat,25,0,21,212,0.537735849,0.047169811,0.594339623,3,0.990167191
18875,55,23146,8,10,0,0,0,18,4,3,3,10,0,20,nowin,loss,beat,dlwin,0,10,18,191,0.371727749,0.057591623,0.54973822,0,0.01011347
18876,115,23147,4,2,9,0,0,15,4,7,10,0,0,21,nowin,loss,beat,dlwin,0,10,6,194,0.427835052,0.041237113,0.592783505,2,0.583863602
18877,22,23147,3,6,4,0,0,13,4,7,10,0,0,21,nowin,loss,beat,dlwin,0,10,9,187,0.481283422,0.042780749,0.577540107,3,0.906128176
18878,139,23147,9,10,0,0,0,19,4,7,10,0,0,21,nowin,loss,beat,dlwin,0,10,19,192,0.380208333,0.036458333,0.59375,0,0.023429169
18879,106,23147,2,2,2,1,6,13,4,7,10,0,0,21,nowin,loss,beat,dlwin,0,10,4,192,0.411458333,0.026041667,0.557291667,0,0.023854304
18880,81,23147,10,10,0,0,0,20,4,7,10,0,0,21,nowin,loss,beat,dlwin,0,10,20,182,0.395604396,0.043956044,0.60989011,2,0.567491261
18881,104,23147,10,8,0,0,0,18,4,7,10,0,0,21,nowin,loss,beat,dlwin,0,10,18,209,0.363636364,0.052631579,0.593301435,0,0.018359419
18882,1,23148,7,8,0,4,0,19,7,9,4,0,0,20,nowin,loss,beat,dlwin,0,10,15,197,0.406091371,0.025380711,0.649746193,2,0.606186955
18883,17,23148,10,10,0,0,0,20,7,9,4,0,0,20,nowin,push,push,push,10,0,20,171,0.444444444,0.070175439,0.555555556,1,0.302364894
18884,18,23148,4,10,0,10,0,24,7,9,4,0,0,20,nowin,loss,bust,plbust,0,10,14,182,0.461538462,0.043956044,0.587912088,3,0.892649374
18885,120,23148,9,4,0,10,0,23,7,9,4,0,0,20,nowin,loss,bust,plbust,0,10,13,202,0.440594059,0.034653465,0.618811881,2,0.614441029
18886,146,23148,10,10,0,0,0,20,7,9,4,0,0,20,nowin,push,push,push,10,0,20,221,0.43438914,0.040723982,0.542986425,1,0.290190091
18887,97,23148,1,3,9,10,0,23,7,9,4,0,0,20,nowin,loss,bust,plbust,0,10,4,182,0.450549451,0.06043956,0.692307692,2,0.677372279
18888,119,23149,10,10,0,0,0,20,5,4,9,0,0,18,nowin,win,plwin,beat,20,0,20,190,0.405263158,0.068421053,0.515789474,0,0.011837158
18889,102,23149,8,2,10,0,0,20,5,4,9,0,0,18,nowin,win,plwin,beat,20,0,10,192,0.338541667,0.046875,0.5625,0,0.003306118
18890,78,23149,10,8,0,0,0,18,5,4,9,0,0,18,nowin,push,push,push,10,0,18,201,0.517412935,0.034825871,0.587064677,3,0.95871112
18891,125,23149,5,7,0,0,0,12,5,4,9,0,0,18,nowin,loss,beat,dlwin,0,10,12,219,0.438356164,0.050228311,0.575342466,1,0.308411257
18892,116,23149,3,4,6,0,0,13,5,4,9,0,0,18,nowin,loss,beat,dlwin,0,10,7,195,0.425641026,0.056410256,0.538461538,1,0.28273747
18893,48,23149,5,3,10,0,0,18,5,4,9,0,0,18,nowin,push,push,push,10,0,8,203,0.413793103,0.019704433,0.600985222,2,0.577280801
18894,111,23150,2,6,10,0,0,18,10,2,9,0,0,21,nowin,loss,beat,dlwin,0,10,8,180,0.433333333,0.055555556,0.611111111,2,0.602264492
18895,65,23150,6,4,10,0,0,20,10,2,9,0,0,21,nowin,loss,beat,dlwin,0,10,10,203,0.492610837,0.054187192,0.571428571,3,0.913702814
18896,42,23150,7,10,0,0,0,17,10,2,9,0,0,21,nowin,loss,beat,dlwin,0,10,17,212,0.443396226,0.051886792,0.570754717,1,0.309181312
18897,97,23150,10,10,0,0,0,20,10,2,9,0,0,21,nowin,loss,beat,dlwin,0,10,20,182,0.450549451,0.06043956,0.692307692,2,0.677372279
18898,10,23150,8,2,7,0,0,17,10,2,9,0,0,21,nowin,loss,beat,dlwin,0,10,10,191,0.413612565,0.057591623,0.596858639,2,0.574087175
18899,85,23150,3,10,0,7,0,20,10,2,9,0,0,21,nowin,loss,beat,dlwin,0,10,13,195,0.41025641,0.066666667,0.594871795,0,0.03269711
18900,117,23151,2,10,0,0,0,12,4,7,8,0,0,19,nowin,loss,beat,dlwin,0,10,12,173,0.410404624,0.069364162,0.606936416,2,0.578610282
18901,39,23151,7,10,0,0,0,17,4,7,8,0,0,19,nowin,loss,beat,dlwin,0,10,17,191,0.429319372,0.062827225,0.57591623,0,0.033760763
18902,118,23151,10,7,0,0,0,17,4,7,8,0,0,19,nowin,loss,beat,dlwin,0,10,17,216,0.393518519,0.037037037,0.555555556,0,0.018059873
18903,93,23151,5,2,7,0,0,14,4,7,8,0,0,19,nowin,loss,beat,dlwin,0,10,7,175,0.485714286,0.051428571,0.548571429,1,0.323648091
18904,18,23151,7,10,0,0,0,17,4,7,8,0,0,19,nowin,loss,beat,dlwin,0,10,17,182,0.461538462,0.043956044,0.587912088,3,0.892649374
18905,61,23151,4,7,3,0,0,14,4,7,8,0,0,19,nowin,loss,beat,dlwin,0,10,11,194,0.427835052,0.077319588,0.603092784,2,0.591437139
18906,130,23152,11,3,4,0,0,18,7,2,10,0,0,19,nowin,loss,beat,dlwin,0,10,14,219,0.410958904,0.03652968,0.566210046,0,0.025888739
18907,6,23152,10,10,0,0,0,20,7,2,10,0,0,19,nowin,win,plwin,beat,20,0,20,191,0.439790576,0.047120419,0.581151832,1,0.31211505
18908,18,23152,11,9,0,0,0,20,7,2,10,0,0,19,nowin,win,plwin,beat,20,0,20,182,0.461538462,0.043956044,0.587912088,3,0.892649374
18909,23,23152,10,6,0,1,0,17,7,2,10,0,0,19,nowin,loss,beat,dlwin,0,10,16,208,0.427884615,0.0625,0.552884615,1,0.29114424
18910,68,23152,10,2,0,10,0,22,7,2,10,0,0,19,nowin,loss,bust,plbust,0,10,12,205,0.434146341,0.029268293,0.6,2,0.59483189
18911,23,23152,9,2,7,0,0,18,7,2,10,0,0,19,nowin,loss,beat,dlwin,0,10,11,208,0.427884615,0.0625,0.552884615,1,0.29114424
18912,87,23153,6,10,0,10,0,26,11,7,0,0,0,18,nowin,loss,bust,plbust,0,10,16,202,0.405940594,0.054455446,0.628712871,2,0.590599801
18913,47,23153,7,4,2,9,0,22,11,7,0,0,0,18,nowin,loss,bust,plbust,0,10,11,210,0.438095238,0.057142857,0.623809524,2,0.615868808
18914,30,23153,11,2,6,0,0,19,11,7,0,0,0,18,nowin,win,plwin,beat,20,0,13,206,0.393203883,0.033980583,0.601941748,0,0.029324648
18915,63,23153,9,10,0,0,0,19,11,7,0,0,0,18,nowin,win,plwin,beat,20,0,19,216,0.467592593,0.037037037,0.62037037,3,0.931690496
18916,8,23153,3,4,5,3,10,25,11,7,0,0,0,18,nowin,loss,bust,plbust,0,10,7,181,0.44198895,0.071823204,0.596685083,2,0.599438402
18917,1,23153,10,4,0,6,0,20,11,7,0,0,0,18,nowin,win,plwin,beat,20,0,14,197,0.406091371,0.025380711,0.649746193,2,0.606186955
18918,27,23154,10,6,0,6,0,22,10,10,0,0,0,20,nowin,loss,bust,plbust,0,10,16,178,0.370786517,0.016853933,0.573033708,0,0.015536309
18919,92,23154,10,10,0,0,0,20,10,10,0,0,0,20,nowin,push,push,push,10,0,20,186,0.446236559,0.059139785,0.564516129,1,0.307826125
18920,83,23154,7,2,4,9,0,22,10,10,0,0,0,20,nowin,loss,bust,plbust,0,10,9,193,0.424870466,0.051813472,0.678756477,2,0.644360335
18921,18,23154,10,4,0,10,0,24,10,10,0,0,0,20,nowin,loss,bust,plbust,0,10,14,182,0.461538462,0.043956044,0.587912088,3,0.892649374
18922,148,23154,5,9,0,10,0,24,10,10,0,0,0,20,nowin,loss,bust,plbust,0,10,14,204,0.401960784,0.078431373,0.593137255,0,0.029789521
18923,107,23154,10,8,0,0,0,18,10,10,0,0,0,20,nowin,loss,beat,dlwin,0,10,18,218,0.444954128,0.073394495,0.600917431,2,0.605210014
18924,19,23155,9,9,0,0,0,18,10,2,7,0,0,19,nowin,loss,beat,dlwin,0,10,18,237,0.41350211,0.054852321,0.628691983,2,0.597373826
18925,10,23155,6,10,0,1,0,17,10,2,7,0,0,19,nowin,loss,beat,dlwin,0,10,16,191,0.413612565,0.057591623,0.596858639,2,0.574087175
18926,130,23155,3,8,4,10,0,25,10,2,7,0,0,19,nowin,loss,bust,plbust,0,10,11,219,0.410958904,0.03652968,0.566210046,0,0.025888739
18927,123,23155,11,7,0,0,0,18,10,2,7,0,0,19,nowin,loss,beat,dlwin,0,10,18,205,0.43902439,0.034146341,0.614634146,2,0.609962544
18928,57,23155,10,9,0,0,0,19,10,2,7,0,0,19,nowin,push,push,push,10,0,19,192,0.46875,0.052083333,0.59375,3,0.907001181
18929,52,23155,4,8,0,10,0,22,10,2,7,0,0,19,nowin,loss,bust,plbust,0,10,12,217,0.414746544,0.02764977,0.599078341,2,0.576736024
18930,79,23156,10,10,0,0,0,20,8,4,10,0,0,22,nowin,win,dlbust,bust,20,0,20,211,0.436018957,0.028436019,0.672985782,2,0.650131054
18931,73,23156,10,11,0,0,0,21,8,4,10,0,0,22,win,win,dlbust,bust,25,0,21,181,0.375690608,0.011049724,0.596685083,0,0.022795773
18932,28,23156,5,8,0,8,0,21,8,4,10,0,0,22,nowin,win,dlbust,bust,20,0,13,199,0.422110553,0.045226131,0.542713568,1,0.282706618
18933,140,23156,11,8,0,0,0,19,8,4,10,0,0,22,nowin,win,dlbust,bust,20,0,19,210,0.466666667,0.023809524,0.604761905,3,0.915293335
18934,126,23156,10,2,0,1,9,22,8,4,10,0,0,22,nowin,loss,bust,plbust,0,10,12,188,0.457446809,0.074468085,0.60106383,3,0.900633203
18935,48,23156,10,4,0,8,0,22,8,4,10,0,0,22,nowin,loss,bust,plbust,0,10,14,203,0.413793103,0.019704433,0.600985222,2,0.577280801
18936,35,23157,4,4,2,4,0,14,2,8,10,0,0,20,nowin,loss,beat,dlwin,0,10,8,202,0.410891089,0.044554455,0.633663366,2,0.598681573
18937,62,23157,4,6,9,0,0,19,2,8,10,0,0,20,nowin,loss,beat,dlwin,0,10,10,178,0.370786517,0.028089888,0.54494382,0,0.008657722
18938,126,23157,10,8,0,0,0,18,2,8,10,0,0,20,nowin,loss,beat,dlwin,0,10,18,188,0.457446809,0.074468085,0.60106383,3,0.900633203
18939,55,23157,5,10,0,0,0,15,2,8,10,0,0,20,nowin,loss,beat,dlwin,0,10,15,191,0.371727749,0.057591623,0.54973822,0,0.01011347
18940,30,23157,3,10,0,0,0,13,2,8,10,0,0,20,nowin,loss,beat,dlwin,0,10,13,206,0.393203883,0.033980583,0.601941748,0,0.029324648
18941,42,23157,10,10,0,0,0,20,2,8,10,0,0,20,nowin,push,push,push,10,0,20,212,0.443396226,0.051886792,0.570754717,1,0.309181312
18942,17,23158,3,9,0,5,0,17,9,8,0,0,0,17,nowin,push,push,push,10,0,12,171,0.444444444,0.070175439,0.555555556,1,0.302364894
18943,49,23158,10,2,0,5,0,17,9,8,0,0,0,17,nowin,push,push,push,10,0,12,207,0.396135266,0.053140097,0.594202899,0,0.028306925
18944,60,23158,7,4,9,0,0,20,9,8,0,0,0,17,nowin,win,plwin,beat,20,0,11,227,0.418502203,0.022026432,0.559471366,0,0.026496258
18945,143,23158,3,8,1,8,0,20,9,8,0,0,0,17,nowin,win,plwin,beat,20,0,11,203,0.463054187,0.044334975,0.57635468,3,0.883143365
18946,70,23158,4,10,0,8,0,22,9,8,0,0,0,17,nowin,loss,bust,plbust,0,10,14,228,0.385964912,0.039473684,0.557017544,0,0.016157125
18947,20,23158,11,9,0,0,0,20,9,8,0,0,0,17,nowin,win,plwin,beat,20,0,20,186,0.456989247,0.037634409,0.537634409,1,0.301097108
18948,30,23159,11,7,0,0,0,18,10,10,0,0,0,20,nowin,loss,beat,dlwin,0,10,18,206,0.393203883,0.033980583,0.601941748,0,0.029324648
18949,58,23159,10,4,0,10,0,24,10,10,0,0,0,20,nowin,loss,bust,plbust,0,10,14,195,0.430769231,0.041025641,0.584615385,2,0.580497586
18950,102,23159,7,10,0,0,0,17,10,10,0,0,0,20,nowin,loss,beat,dlwin,0,10,17,192,0.338541667,0.046875,0.5625,0,0.003306118
18951,122,23159,10,10,0,0,0,20,10,10,0,0,0,20,nowin,push,push,push,10,0,20,210,0.347619048,0.052380952,0.59047619,0,0.012873677
18952,86,23159,10,10,0,0,0,20,10,10,0,0,0,20,nowin,push,push,push,10,0,20,196,0.454081633,0.040816327,0.591836735,3,0.887566443
18953,104,23159,2,10,0,3,2,17,10,10,0,0,0,20,nowin,loss,beat,dlwin,0,10,12,209,0.363636364,0.052631579,0.593301435,0,0.018359419
18954,38,23160,10,4,0,9,0,23,10,8,0,0,0,18,nowin,loss,bust,plbust,0,10,14,202,0.361386139,0.03960396,0.564356436,0,0.010597953
18955,139,23160,5,4,10,0,0,19,10,8,0,0,0,18,nowin,win,plwin,beat,20,0,9,192,0.380208333,0.036458333,0.59375,0,0.023429169
18956,24,23160,10,10,0,0,0,20,10,8,0,0,0,18,nowin,win,plwin,beat,20,0,20,207,0.458937198,0.048309179,0.570048309,1,0.318138014
18957,89,23160,2,10,0,9,0,21,10,8,0,0,0,18,nowin,win,plwin,beat,20,0,12,212,0.537735849,0.047169811,0.594339623,3,0.990167191
18958,51,23160,9,10,0,0,0,19,10,8,0,0,0,18,nowin,win,plwin,beat,20,0,19,189,0.529100529,0.068783069,0.608465608,3,0.993665715
18959,82,23160,9,2,5,10,0,26,10,8,0,0,0,18,nowin,loss,bust,plbust,0,10,11,225,0.408888889,0.075555556,0.577777778,0,0.028101874
18960,30,23161,3,7,10,0,0,20,9,3,5,0,0,17,nowin,win,plwin,beat,20,0,10,206,0.393203883,0.033980583,0.601941748,0,0.029324648
18961,32,23161,2,1,10,9,0,22,9,3,5,0,0,17,nowin,loss,bust,plbust,0,10,3,189,0.391534392,0.037037037,0.53968254,0,0.013579086
18962,144,23161,10,5,0,10,0,25,9,3,5,0,0,17,nowin,loss,bust,plbust,0,10,15,202,0.386138614,0.054455446,0.564356436,0,0.018006244
18963,36,23161,5,4,10,0,0,19,9,3,5,0,0,17,nowin,win,plwin,beat,20,0,9,229,0.445414847,0.056768559,0.655021834,2,0.645370571
18964,24,23161,10,10,0,0,0,20,9,3,5,0,0,17,nowin,win,plwin,beat,20,0,20,207,0.458937198,0.048309179,0.570048309,1,0.318138014
18965,125,23161,10,3,0,5,0,18,9,3,5,0,0,17,nowin,win,plwin,beat,20,0,13,219,0.438356164,0.050228311,0.575342466,1,0.308411257
18966,135,23162,5,2,4,2,4,17,7,3,5,8,0,23,nowin,win,dlbust,bust,20,0,7,179,0.391061453,0.067039106,0.586592179,0,0.024924662
18967,95,23162,3,10,0,8,0,21,7,3,5,8,0,23,nowin,win,dlbust,bust,20,0,13,218,0.412844037,0.04587156,0.559633028,0,0.024842385
18968,10,23162,10,10,0,0,0,20,7,3,5,8,0,23,nowin,win,dlbust,bust,20,0,20,191,0.413612565,0.057591623,0.596858639,2,0.574087175
18969,34,23162,10,5,0,7,0,22,7,3,5,8,0,23,nowin,loss,bust,plbust,0,10,15,202,0.5,0.079207921,0.618811881,3,0.968961434
18970,99,23162,2,11,1,4,0,18,7,3,5,8,0,23,nowin,win,dlbust,bust,20,0,13,207,0.47826087,0.062801932,0.637681159,3,0.961418446
18971,22,23162,3,7,10,0,0,20,7,3,5,8,0,23,nowin,win,dlbust,bust,20,0,10,187,0.481283422,0.042780749,0.577540107,3,0.906128176
18972,127,23163,7,8,0,0,0,15,3,7,9,0,0,19,nowin,loss,beat,dlwin,0,10,15,201,0.402985075,0.029850746,0.60199005,0,0.032263937
18973,88,23163,5,6,9,0,0,20,3,7,9,0,0,19,nowin,win,plwin,beat,20,0,11,206,0.466019417,0.033980583,0.54368932,1,0.309467903
18974,5,23163,5,6,1,8,0,20,3,7,9,0,0,19,nowin,win,plwin,beat,20,0,11,203,0.42364532,0.02955665,0.596059113,2,0.582508076
18975,54,23163,10,3,0,0,0,13,3,7,9,0,0,19,nowin,loss,beat,dlwin,0,10,13,185,0.437837838,0.032432432,0.556756757,1,0.29899854
18976,126,23163,10,10,0,0,0,20,3,7,9,0,0,19,nowin,win,plwin,beat,20,0,20,188,0.457446809,0.074468085,0.60106383,3,0.900633203
18977,5,23163,7,9,0,0,0,16,3,7,9,0,0,19,nowin,loss,beat,dlwin,0,10,16,203,0.42364532,0.02955665,0.596059113,2,0.582508076
18978,45,23164,6,7,0,0,0,13,4,11,3,0,0,18,nowin,loss,beat,dlwin,0,10,13,196,0.428571429,0.051020408,0.612244898,2,0.598821767
18979,99,23164,7,8,0,0,0,15,4,11,3,0,0,18,nowin,loss,beat,dlwin,0,10,15,207,0.47826087,0.062801932,0.637681159,3,0.961418446
18980,133,23164,11,8,0,0,0,19,4,11,3,0,0,18,nowin,win,plwin,beat,20,0,19,201,0.47761194,0.064676617,0.611940299,3,0.935428111
18981,33,23164,9,3,0,0,0,12,4,11,3,0,0,18,nowin,loss,beat,dlwin,0,10,12,192,0.4375,0.057291667,0.625,2,0.616208916
18982,48,23164,5,3,5,0,0,13,4,11,3,0,0,18,nowin,loss,beat,dlwin,0,10,8,203,0.413793103,0.019704433,0.600985222,2,0.577280801
18983,82,23164,3,3,3,6,0,15,4,11,3,0,0,18,nowin,loss,beat,dlwin,0,10,6,225,0.408888889,0.075555556,0.577777778,0,0.028101874
18984,19,23165,4,11,4,0,0,19,8,2,2,5,0,17,nowin,win,plwin,beat,20,0,15,237,0.41350211,0.054852321,0.628691983,2,0.597373826
18985,69,23165,6,6,0,2,1,15,8,2,2,5,0,17,nowin,loss,beat,dlwin,0,10,12,194,0.365979381,0.030927835,0.515463918,0,0
18986,128,23165,10,10,0,0,0,20,8,2,2,5,0,17,nowin,win,plwin,beat,20,0,20,227,0.356828194,0.052863436,0.577092511,0,0.012352564
18987,147,23165,7,8,0,6,0,21,8,2,2,5,0,17,nowin,win,plwin,beat,20,0,15,205,0.380487805,0.014634146,0.536585366,0,0.00951447
18988,131,23165,10,11,0,0,0,21,8,2,2,5,0,17,win,win,plwin,beat,25,0,21,217,0.410138249,0.069124424,0.543778802,0,0.02015021
18989,36,23165,3,4,6,7,0,20,8,2,2,5,0,17,nowin,win,plwin,beat,20,0,7,229,0.445414847,0.056768559,0.655021834,2,0.645370571
18990,85,23166,6,1,9,2,0,18,10,3,2,10,0,25,nowin,win,dlbust,bust,20,0,7,195,0.41025641,0.066666667,0.594871795,0,0.03269711
18991,72,23166,11,9,0,0,0,20,10,3,2,10,0,25,nowin,win,dlbust,bust,20,0,20,185,0.394594595,0.032432432,0.508108108,0,0.006763115
18992,71,23166,4,8,0,10,0,22,10,3,2,10,0,25,nowin,loss,bust,plbust,0,10,12,193,0.352331606,0.046632124,0.585492228,0,0.013063661
18993,127,23166,3,3,3,1,10,20,10,3,2,10,0,25,nowin,win,dlbust,bust,20,0,6,201,0.402985075,0.029850746,0.60199005,0,0.032263937
18994,143,23166,3,10,0,10,0,23,10,3,2,10,0,25,nowin,loss,bust,plbust,0,10,13,203,0.463054187,0.044334975,0.57635468,3,0.883143365
18995,55,23166,5,9,0,10,0,24,10,3,2,10,0,25,nowin,loss,bust,plbust,0,10,14,191,0.371727749,0.057591623,0.54973822,0,0.01011347
18996,60,23167,10,3,0,1,10,24,11,10,0,0,0,21,nowin,loss,bust,plbust,0,10,13,227,0.418502203,0.022026432,0.559471366,0,0.026496258
18997,31,23167,8,6,0,10,0,24,11,10,0,0,0,21,nowin,loss,bust,plbust,0,10,14,188,0.473404255,0.058510638,0.515957447,1,0.300306557
18998,5,23167,3,3,9,7,0,22,11,10,0,0,0,21,nowin,loss,bust,plbust,0,10,6,203,0.42364532,0.02955665,0.596059113,2,0.582508076
18999,119,23167,2,10,0,2,1,15,11,10,0,0,0,21,nowin,loss,beat,dlwin,0,10,12,190,0.405263158,0.068421053,0.515789474,0,0.011837158
19000,67,23167,9,8,0,0,0,17,11,10,0,0,0,21,nowin,loss,beat,dlwin,0,10,17,195,0.369230769,0.041025641,0.569230769,0,0.014139427
19001,144,23167,10,6,0,10,0,26,11,10,0,0,0,21,nowin,loss,bust,plbust,0,10,16,202,0.386138614,0.054455446,0.564356436,0,0.018006244
19002,90,23168,7,9,0,0,0,16,6,10,10,0,0,26,nowin,win,dlbust,bust,20,0,16,201,0.447761194,0.049751244,0.60199005,3,0.889945023
19003,65,23168,10,9,0,0,0,19,6,10,10,0,0,26,nowin,win,dlbust,bust,20,0,19,203,0.492610837,0.054187192,0.571428571,3,0.913702814
19004,78,23168,6,5,10,0,0,21,6,10,10,0,0,26,nowin,win,dlbust,bust,20,0,11,201,0.517412935,0.034825871,0.587064677,3,0.95871112
19005,13,23168,9,8,0,0,0,17,6,10,10,0,0,26,nowin,win,dlbust,bust,20,0,17,206,0.417475728,0.063106796,0.621359223,2,0.59555479
19006,83,23168,3,4,10,0,0,17,6,10,10,0,0,26,nowin,win,dlbust,bust,20,0,7,193,0.424870466,0.051813472,0.678756477,2,0.644360335
19007,141,23168,11,9,0,0,0,20,6,10,10,0,0,26,nowin,win,dlbust,bust,20,0,20,202,0.420792079,0.074257426,0.564356436,0,0.028377851
19008,1,23169,7,11,0,0,0,18,2,5,10,0,0,17,nowin,win,plwin,beat,20,0,18,197,0.406091371,0.025380711,0.649746193,2,0.606186955
19009,28,23169,3,10,0,0,0,13,2,5,10,0,0,17,nowin,loss,beat,dlwin,0,10,13,199,0.422110553,0.045226131,0.542713568,1,0.282706618
19010,23,23169,2,7,8,0,0,17,2,5,10,0,0,17,nowin,push,push,push,10,0,9,208,0.427884615,0.0625,0.552884615,1,0.29114424
19011,149,23169,2,5,6,0,0,13,2,5,10,0,0,17,nowin,loss,beat,dlwin,0,10,7,225,0.457777778,0.057777778,0.648888889,2,0.651965595
19012,57,23169,5,8,0,0,0,13,2,5,10,0,0,17,nowin,loss,beat,dlwin,0,10,13,192,0.46875,0.052083333,0.59375,3,0.907001181
19013,131,23169,10,10,0,0,0,20,2,5,10,0,0,17,nowin,win,plwin,beat,20,0,20,217,0.410138249,0.069124424,0.543778802,0,0.02015021
19014,57,23170,8,10,0,0,0,18,3,10,5,0,0,18,nowin,push,push,push,10,0,18,192,0.46875,0.052083333,0.59375,3,0.907001181
19015,133,23170,10,10,0,0,0,20,3,10,5,0,0,18,nowin,win,plwin,beat,20,0,20,201,0.47761194,0.064676617,0.611940299,3,0.935428111
19016,143,23170,10,7,0,0,0,17,3,10,5,0,0,18,nowin,loss,beat,dlwin,0,10,17,203,0.463054187,0.044334975,0.57635468,3,0.883143365
19017,127,23170,2,4,5,2,0,13,3,10,5,0,0,18,nowin,loss,beat,dlwin,0,10,6,201,0.402985075,0.029850746,0.60199005,0,0.032263937
19018,29,23170,10,8,0,0,0,18,3,10,5,0,0,18,nowin,push,push,push,10,0,18,189,0.44973545,0.058201058,0.544973545,1,0.300349439
19019,22,23170,4,6,7,0,0,17,3,10,5,0,0,18,nowin,loss,beat,dlwin,0,10,10,187,0.481283422,0.042780749,0.577540107,3,0.906128176
19020,11,23171,7,6,0,0,0,13,6,10,3,0,0,19,nowin,loss,beat,dlwin,0,10,13,236,0.457627119,0.016949153,0.588983051,3,0.889015813
19021,110,23171,10,6,0,0,0,16,6,10,3,0,0,19,nowin,loss,beat,dlwin,0,10,16,192,0.416666667,0.046875,0.557291667,0,0.025413132
19022,5,23171,6,10,0,0,0,16,6,10,3,0,0,19,nowin,loss,beat,dlwin,0,10,16,203,0.42364532,0.02955665,0.596059113,2,0.582508076
19023,2,23171,10,10,0,0,0,20,6,10,3,0,0,19,nowin,win,plwin,beat,20,0,20,200,0.445,0.035,0.64,2,0.633962549
19024,149,23171,3,10,0,0,0,13,6,10,3,0,0,19,nowin,loss,beat,dlwin,0,10,13,225,0.457777778,0.057777778,0.648888889,2,0.651965595
19025,98,23171,5,1,8,0,0,14,6,10,3,0,0,19,nowin,loss,beat,dlwin,0,10,6,220,0.422727273,0.054545455,0.55,1,0.28664435
19026,41,23172,3,10,0,0,0,13,6,3,10,0,0,19,nowin,loss,beat,dlwin,0,10,13,192,0.364583333,0.036458333,0.520833333,0,0.00089702
19027,14,23172,4,4,10,0,0,18,6,3,10,0,0,19,nowin,loss,beat,dlwin,0,10,8,202,0.391089109,0.01980198,0.628712871,2,0.577264877
19028,89,23172,8,10,0,0,0,18,6,3,10,0,0,19,nowin,loss,beat,dlwin,0,10,18,212,0.537735849,0.047169811,0.594339623,3,0.990167191
19029,69,23172,10,7,0,0,0,17,6,3,10,0,0,19,nowin,loss,beat,dlwin,0,10,17,194,0.365979381,0.030927835,0.515463918,0,0
19030,38,23172,3,3,3,2,8,19,6,3,10,0,0,19,nowin,push,push,push,10,0,6,202,0.361386139,0.03960396,0.564356436,0,0.010597953
19031,112,23172,10,3,0,0,0,13,6,3,10,0,0,19,nowin,loss,beat,dlwin,0,10,13,203,0.448275862,0.054187192,0.600985222,3,0.889576933
19032,36,23173,10,7,0,0,0,17,7,6,10,0,0,23,nowin,win,dlbust,bust,20,0,17,229,0.445414847,0.056768559,0.655021834,2,0.645370571
19033,15,23173,5,10,0,10,0,25,7,6,10,0,0,23,nowin,loss,bust,plbust,0,10,15,212,0.410377358,0.051886792,0.561320755,0,0.024517408
19034,89,23173,4,2,10,3,0,19,7,6,10,0,0,23,nowin,win,dlbust,bust,20,0,6,212,0.537735849,0.047169811,0.594339623,3,0.990167191
19035,97,23173,2,9,6,0,0,17,7,6,10,0,0,23,nowin,win,dlbust,bust,20,0,11,182,0.450549451,0.06043956,0.692307692,2,0.677372279
19036,142,23173,7,5,0,10,0,22,7,6,10,0,0,23,nowin,loss,bust,plbust,0,10,12,211,0.417061611,0.047393365,0.526066351,1,0.271531309
19037,11,23173,7,10,0,0,0,17,7,6,10,0,0,23,nowin,win,dlbust,bust,20,0,17,236,0.457627119,0.016949153,0.588983051,3,0.889015813
19038,102,23174,3,10,0,5,0,18,11,10,0,0,0,21,nowin,loss,beat,dlwin,0,10,13,192,0.338541667,0.046875,0.5625,0,0.003306118
19039,141,23174,4,9,0,5,0,18,11,10,0,0,0,21,nowin,loss,beat,dlwin,0,10,13,202,0.420792079,0.074257426,0.564356436,0,0.028377851
19040,111,23174,10,10,0,0,0,20,11,10,0,0,0,21,nowin,loss,beat,dlwin,0,10,20,180,0.433333333,0.055555556,0.611111111,2,0.602264492
19041,121,23174,9,6,0,4,0,19,11,10,0,0,0,21,nowin,loss,beat,dlwin,0,10,15,195,0.456410256,0.025641026,0.512820513,1,0.288597791
19042,80,23174,5,10,0,7,0,22,11,10,0,0,0,21,nowin,loss,bust,plbust,0,10,15,186,0.419354839,0.059139785,0.623655914,2,0.59892924
19043,119,23174,10,10,0,0,0,20,11,10,0,0,0,21,nowin,loss,beat,dlwin,0,10,20,190,0.405263158,0.068421053,0.515789474,0,0.011837158
19044,44,23175,4,4,8,8,0,24,11,7,0,0,0,18,nowin,loss,bust,plbust,0,10,8,219,0.433789954,0.050228311,0.534246575,1,0.285551035
19045,121,23175,6,10,0,3,0,19,11,7,0,0,0,18,nowin,win,plwin,beat,20,0,16,195,0.456410256,0.025641026,0.512820513,1,0.288597791
19046,54,23175,6,6,0,7,0,19,11,7,0,0,0,18,nowin,win,plwin,beat,20,0,12,185,0.437837838,0.032432432,0.556756757,1,0.29899854
19047,85,23175,9,10,0,0,0,19,11,7,0,0,0,18,nowin,win,plwin,beat,20,0,19,195,0.41025641,0.066666667,0.594871795,0,0.03269711
19048,126,23175,4,7,9,0,0,20,11,7,0,0,0,18,nowin,win,plwin,beat,20,0,11,188,0.457446809,0.074468085,0.60106383,3,0.900633203
19049,91,23175,10,2,0,1,3,16,11,7,0,0,0,18,nowin,loss,beat,dlwin,0,10,12,194,0.417525773,0.046391753,0.515463918,1,0.266616552
19050,68,23176,7,10,0,0,0,17,3,8,7,0,0,18,nowin,loss,beat,dlwin,0,10,17,205,0.434146341,0.029268293,0.6,2,0.59483189
19051,139,23176,11,8,0,0,0,19,3,8,7,0,0,18,nowin,win,plwin,beat,20,0,19,192,0.380208333,0.036458333,0.59375,0,0.023429169
19052,95,23176,5,10,0,0,0,15,3,8,7,0,0,18,nowin,loss,beat,dlwin,0,10,15,218,0.412844037,0.04587156,0.559633028,0,0.024842385
19053,138,23176,4,9,0,0,0,13,3,8,7,0,0,18,nowin,loss,beat,dlwin,0,10,13,190,0.442105263,0.047368421,0.610526316,2,0.609711065
19054,11,23176,9,10,0,0,0,19,3,8,7,0,0,18,nowin,win,plwin,beat,20,0,19,236,0.457627119,0.016949153,0.588983051,3,0.889015813
19055,16,23176,2,11,2,0,0,15,3,8,7,0,0,18,nowin,loss,beat,dlwin,0,10,13,220,0.427272727,0.081818182,0.6,2,0.588660176
19056,110,23177,8,3,8,0,0,19,5,5,2,6,0,18,nowin,win,plwin,beat,20,0,11,192,0.416666667,0.046875,0.557291667,0,0.025413132
19057,140,23177,5,1,10,0,0,16,5,5,2,6,0,18,nowin,loss,beat,dlwin,0,10,6,210,0.466666667,0.023809524,0.604761905,3,0.915293335
19058,124,23177,3,5,10,0,0,18,5,5,2,6,0,18,nowin,push,push,push,10,0,8,202,0.47029703,0.064356436,0.584158416,3,0.899458193
19059,117,23177,10,3,0,0,0,13,5,5,2,6,0,18,nowin,loss,beat,dlwin,0,10,13,173,0.410404624,0.069364162,0.606936416,2,0.578610282
19060,16,23177,1,5,7,0,0,13,5,5,2,6,0,18,nowin,loss,beat,dlwin,0,10,6,220,0.427272727,0.081818182,0.6,2,0.588660176
19061,118,23177,8,11,0,0,0,19,5,5,2,6,0,18,nowin,win,plwin,beat,20,0,19,216,0.393518519,0.037037037,0.555555556,0,0.018059873
19062,5,23178,3,7,9,0,0,19,10,5,1,9,0,25,nowin,win,dlbust,bust,20,0,10,203,0.42364532,0.02955665,0.596059113,2,0.582508076
19063,96,23178,3,10,0,10,0,23,10,5,1,9,0,25,nowin,loss,bust,plbust,0,10,13,190,0.468421053,0.057894737,0.584210526,3,0.897263354
19064,119,23178,3,2,4,4,6,19,10,5,1,9,0,25,nowin,win,dlbust,bust,20,0,5,190,0.405263158,0.068421053,0.515789474,0,0.011837158
19065,123,23178,9,2,10,0,0,21,10,5,1,9,0,25,nowin,win,dlbust,bust,20,0,11,205,0.43902439,0.034146341,0.614634146,2,0.609962544
19066,2,23178,2,2,10,8,0,22,10,5,1,9,0,25,nowin,loss,bust,plbust,0,10,4,200,0.445,0.035,0.64,2,0.633962549
19067,22,23178,4,10,0,2,5,21,10,5,1,9,0,25,nowin,win,dlbust,bust,20,0,14,187,0.481283422,0.042780749,0.577540107,3,0.906128176
19068,92,23179,8,3,9,0,0,20,10,10,0,0,0,20,nowin,push,push,push,10,0,11,186,0.446236559,0.059139785,0.564516129,1,0.307826125
19069,60,23179,8,9,0,0,0,17,10,10,0,0,0,20,nowin,loss,beat,dlwin,0,10,17,227,0.418502203,0.022026432,0.559471366,0,0.026496258
19070,110,23179,8,10,0,0,0,18,10,10,0,0,0,20,nowin,loss,beat,dlwin,0,10,18,192,0.416666667,0.046875,0.557291667,0,0.025413132
19071,46,23179,10,11,0,0,0,21,10,10,0,0,0,20,win,win,plwin,beat,25,0,21,186,0.403225806,0.048387097,0.591397849,0,0.029742194
19072,83,23179,10,11,0,0,0,21,10,10,0,0,0,20,win,win,plwin,beat,25,0,21,193,0.424870466,0.051813472,0.678756477,2,0.644360335
19073,124,23179,10,8,0,0,0,18,10,10,0,0,0,20,nowin,loss,beat,dlwin,0,10,18,202,0.47029703,0.064356436,0.584158416,3,0.899458193
19074,142,23180,8,2,7,0,0,17,6,10,10,0,0,26,nowin,win,dlbust,bust,20,0,10,211,0.417061611,0.047393365,0.526066351,1,0.271531309
19075,148,23180,3,3,8,0,0,14,6,10,10,0,0,26,nowin,win,dlbust,bust,20,0,6,204,0.401960784,0.078431373,0.593137255,0,0.029789521
19076,51,23180,4,6,2,0,0,12,6,10,10,0,0,26,nowin,win,dlbust,bust,20,0,10,189,0.529100529,0.068783069,0.608465608,3,0.993665715
19077,140,23180,7,10,0,0,0,17,6,10,10,0,0,26,nowin,win,dlbust,bust,20,0,17,210,0.466666667,0.023809524,0.604761905,3,0.915293335
19078,35,23180,4,7,9,0,0,20,6,10,10,0,0,26,nowin,win,dlbust,bust,20,0,11,202,0.410891089,0.044554455,0.633663366,2,0.598681573
19079,89,23180,10,8,0,0,0,18,6,10,10,0,0,26,nowin,win,dlbust,bust,20,0,18,212,0.537735849,0.047169811,0.594339623,3,0.990167191
19080,97,23181,10,10,0,0,0,20,10,6,6,0,0,22,nowin,win,dlbust,bust,20,0,20,182,0.450549451,0.06043956,0.692307692,2,0.677372279
19081,47,23181,9,11,0,0,0,20,10,6,6,0,0,22,nowin,win,dlbust,bust,20,0,20,210,0.438095238,0.057142857,0.623809524,2,0.615868808
19082,81,23181,1,6,10,0,0,17,10,6,6,0,0,22,nowin,win,dlbust,bust,20,0,7,182,0.395604396,0.043956044,0.60989011,2,0.567491261
19083,32,23181,5,9,0,3,0,17,10,6,6,0,0,22,nowin,win,dlbust,bust,20,0,14,189,0.391534392,0.037037037,0.53968254,0,0.013579086
19084,137,23181,10,11,0,0,0,21,10,6,6,0,0,22,win,win,dlbust,bust,25,0,21,194,0.417525773,0.046391753,0.536082474,1,0.276714602
19085,126,23181,3,10,0,4,0,17,10,6,6,0,0,22,nowin,win,dlbust,bust,20,0,13,188,0.457446809,0.074468085,0.60106383,3,0.900633203
19086,137,23182,9,4,0,10,0,23,10,10,0,0,0,20,nowin,loss,bust,plbust,0,10,13,194,0.417525773,0.046391753,0.536082474,1,0.276714602
19087,33,23182,10,6,0,10,0,26,10,10,0,0,0,20,nowin,loss,bust,plbust,0,10,16,192,0.4375,0.057291667,0.625,2,0.616208916
19088,123,23182,3,11,6,0,0,20,10,10,0,0,0,20,nowin,push,push,push,10,0,14,205,0.43902439,0.034146341,0.614634146,2,0.609962544
19089,59,23182,2,6,4,10,0,22,10,10,0,0,0,20,nowin,loss,bust,plbust,0,10,8,228,0.429824561,0.048245614,0.543859649,1,0.287885446
19090,49,23182,6,8,0,7,0,21,10,10,0,0,0,20,nowin,win,plwin,beat,20,0,14,207,0.396135266,0.053140097,0.594202899,0,0.028306925
19091,76,23182,10,9,0,0,0,19,10,10,0,0,0,20,nowin,loss,beat,dlwin,0,10,19,189,0.534391534,0.079365079,0.608465608,3,1
19092,15,23183,7,4,4,6,0,21,10,10,0,0,0,20,nowin,win,plwin,beat,20,0,11,212,0.410377358,0.051886792,0.561320755,0,0.024517408
19093,81,23183,9,7,0,10,0,26,10,10,0,0,0,20,nowin,loss,bust,plbust,0,10,16,182,0.395604396,0.043956044,0.60989011,2,0.567491261
19094,51,23183,5,4,9,0,0,18,10,10,0,0,0,20,nowin,loss,beat,dlwin,0,10,9,189,0.529100529,0.068783069,0.608465608,3,0.993665715
19095,74,23183,9,6,0,6,0,21,10,10,0,0,0,20,nowin,win,plwin,beat,20,0,15,209,0.411483254,0.04784689,0.531100478,0,0.017448125
19096,105,23183,3,3,10,8,0,24,10,10,0,0,0,20,nowin,loss,bust,plbust,0,10,6,198,0.414141414,0.070707071,0.590909091,0,0.032889494
19097,111,23183,5,2,9,7,0,23,10,10,0,0,0,20,nowin,loss,bust,plbust,0,10,7,180,0.433333333,0.055555556,0.611111111,2,0.602264492
19098,30,23184,9,3,0,0,0,12,5,10,7,0,0,22,nowin,win,dlbust,bust,20,0,12,206,0.393203883,0.033980583,0.601941748,0,0.029324648
19099,135,23184,9,6,0,0,0,15,5,10,7,0,0,22,nowin,win,dlbust,bust,20,0,15,179,0.391061453,0.067039106,0.586592179,0,0.024924662
19100,35,23184,10,10,0,0,0,20,5,10,7,0,0,22,nowin,win,dlbust,bust,20,0,20,202,0.410891089,0.044554455,0.633663366,2,0.598681573
19101,109,23184,7,10,0,0,0,17,5,10,7,0,0,22,nowin,win,dlbust,bust,20,0,17,221,0.461538462,0.058823529,0.597285068,3,0.901830309
19102,82,23184,3,10,0,0,0,13,5,10,7,0,0,22,nowin,win,dlbust,bust,20,0,13,225,0.408888889,0.075555556,0.577777778,0,0.028101874
19103,81,23184,9,6,0,0,0,15,5,10,7,0,0,22,nowin,win,dlbust,bust,20,0,15,182,0.395604396,0.043956044,0.60989011,2,0.567491261
19104,71,23185,2,10,0,2,1,15,10,7,0,0,0,17,nowin,loss,beat,dlwin,0,10,12,193,0.352331606,0.046632124,0.585492228,0,0.013063661
19105,47,23185,9,5,0,7,0,21,10,7,0,0,0,17,nowin,win,plwin,beat,20,0,14,210,0.438095238,0.057142857,0.623809524,2,0.615868808
19106,42,23185,5,1,10,6,0,22,10,7,0,0,0,17,nowin,loss,bust,plbust,0,10,6,212,0.443396226,0.051886792,0.570754717,1,0.309181312
19107,28,23185,10,10,0,0,0,20,10,7,0,0,0,17,nowin,win,plwin,beat,20,0,20,199,0.422110553,0.045226131,0.542713568,1,0.282706618
19108,140,23185,3,3,2,5,3,16,10,7,0,0,0,17,nowin,loss,beat,dlwin,0,10,6,210,0.466666667,0.023809524,0.604761905,3,0.915293335
19109,68,23185,7,10,0,0,0,17,10,7,0,0,0,17,nowin,push,push,push,10,0,17,205,0.434146341,0.029268293,0.6,2,0.59483189
19110,21,23186,11,10,0,0,0,21,3,4,6,10,0,23,win,win,dlbust,bust,25,0,21,214,0.359813084,0.042056075,0.626168224,0,0.025263474
19111,29,23186,11,10,0,0,0,21,3,4,6,10,0,23,win,win,dlbust,bust,25,0,21,189,0.44973545,0.058201058,0.544973545,1,0.300349439
19112,78,23186,6,10,0,0,0,16,3,4,6,10,0,23,nowin,win,dlbust,bust,20,0,16,201,0.517412935,0.034825871,0.587064677,3,0.95871112
19113,43,23186,10,2,0,1,0,13,3,4,6,10,0,23,nowin,win,dlbust,bust,20,0,12,192,0.40625,0.041666667,0.609375,2,0.576671372
19114,111,23186,5,6,2,0,0,13,3,4,6,10,0,23,nowin,win,dlbust,bust,20,0,11,180,0.433333333,0.055555556,0.611111111,2,0.602264492
19115,44,23186,10,10,0,0,0,20,3,4,6,10,0,23,nowin,win,dlbust,bust,20,0,20,219,0.433789954,0.050228311,0.534246575,1,0.285551035
19116,56,23187,10,9,0,0,0,19,5,8,3,10,0,26,nowin,win,dlbust,bust,20,0,19,175,0.4,0.057142857,0.582857143,0,0.026685297
19117,128,23187,10,5,0,0,0,15,5,8,3,10,0,26,nowin,win,dlbust,bust,20,0,15,227,0.356828194,0.052863436,0.577092511,0,0.012352564
19118,64,23187,8,2,10,0,0,20,5,8,3,10,0,26,nowin,win,dlbust,bust,20,0,10,187,0.363636364,0.048128342,0.631016043,0,0.027594885
19119,98,23187,4,8,0,0,0,12,5,8,3,10,0,26,nowin,win,dlbust,bust,20,0,12,220,0.422727273,0.054545455,0.55,1,0.28664435
19120,95,23187,4,10,0,0,0,14,5,8,3,10,0,26,nowin,win,dlbust,bust,20,0,14,218,0.412844037,0.04587156,0.559633028,0,0.024842385
19121,109,23187,10,3,0,0,0,13,5,8,3,10,0,26,nowin,win,dlbust,bust,20,0,13,221,0.461538462,0.058823529,0.597285068,3,0.901830309
19122,85,23188,8,3,10,0,0,21,2,10,10,0,0,22,nowin,win,dlbust,bust,20,0,11,195,0.41025641,0.066666667,0.594871795,0,0.03269711
19123,139,23188,7,10,0,0,0,17,2,10,10,0,0,22,nowin,win,dlbust,bust,20,0,17,192,0.380208333,0.036458333,0.59375,0,0.023429169
19124,9,23188,11,7,0,0,0,18,2,10,10,0,0,22,nowin,win,dlbust,bust,20,0,18,194,0.37628866,0.015463918,0.541237113,0,0.009396796
19125,31,23188,2,8,10,0,0,20,2,10,10,0,0,22,nowin,win,dlbust,bust,20,0,10,188,0.473404255,0.058510638,0.515957447,1,0.300306557
19126,83,23188,9,10,0,0,0,19,2,10,10,0,0,22,nowin,win,dlbust,bust,20,0,19,193,0.424870466,0.051813472,0.678756477,2,0.644360335
19127,35,23188,7,8,0,0,0,15,2,10,10,0,0,22,nowin,win,dlbust,bust,20,0,15,202,0.410891089,0.044554455,0.633663366,2,0.598681573
19128,34,23189,10,11,0,0,0,21,4,6,10,0,0,20,win,win,plwin,beat,25,0,21,202,0.5,0.079207921,0.618811881,3,0.968961434
19129,132,23189,10,10,0,0,0,20,4,6,10,0,0,20,nowin,push,push,push,10,0,20,194,0.412371134,0.036082474,0.649484536,2,0.611633238
19130,103,23189,9,3,0,0,0,12,4,6,10,0,0,20,nowin,loss,beat,dlwin,0,10,12,203,0.379310345,0.064039409,0.551724138,0,0.012869209
19131,149,23189,2,10,0,0,0,12,4,6,10,0,0,20,nowin,loss,beat,dlwin,0,10,12,225,0.457777778,0.057777778,0.648888889,2,0.651965595
19132,50,23189,2,10,0,0,0,12,4,6,10,0,0,20,nowin,loss,beat,dlwin,0,10,12,202,0.405940594,0.04950495,0.54950495,0,0.020296079
19133,17,23189,8,3,10,0,0,21,4,6,10,0,0,20,nowin,win,plwin,beat,20,0,11,171,0.444444444,0.070175439,0.555555556,1,0.302364894
19134,10,23190,10,11,0,0,0,21,6,4,10,0,0,20,win,win,plwin,beat,25,0,21,191,0.413612565,0.057591623,0.596858639,2,0.574087175
19135,106,23190,10,6,0,0,0,16,6,4,10,0,0,20,nowin,loss,beat,dlwin,0,10,16,192,0.411458333,0.026041667,0.557291667,0,0.023854304
19136,11,23190,9,5,0,0,0,14,6,4,10,0,0,20,nowin,loss,beat,dlwin,0,10,14,236,0.457627119,0.016949153,0.588983051,3,0.889015813
19137,6,23190,2,4,6,0,0,12,6,4,10,0,0,20,nowin,loss,beat,dlwin,0,10,6,191,0.439790576,0.047120419,0.581151832,1,0.31211505
19138,82,23190,11,10,0,0,0,21,6,4,10,0,0,20,win,win,plwin,beat,25,0,21,225,0.408888889,0.075555556,0.577777778,0,0.028101874
19139,32,23190,7,10,0,0,0,17,6,4,10,0,0,20,nowin,loss,beat,dlwin,0,10,17,189,0.391534392,0.037037037,0.53968254,0,0.013579086
19140,101,23191,8,11,0,0,0,19,3,5,8,3,0,19,nowin,push,push,push,10,0,19,205,0.424390244,0.068292683,0.63902439,2,0.614740646
19141,50,23191,11,10,0,0,0,21,3,5,8,3,0,19,win,win,plwin,beat,25,0,21,202,0.405940594,0.04950495,0.54950495,0,0.020296079
19142,95,23191,5,6,6,0,0,17,3,5,8,3,0,19,nowin,loss,beat,dlwin,0,10,11,218,0.412844037,0.04587156,0.559633028,0,0.024842385
19143,77,23191,10,6,0,0,0,16,3,5,8,3,0,19,nowin,loss,beat,dlwin,0,10,16,200,0.455,0.04,0.62,3,0.916252116
19144,23,23191,11,5,5,0,0,21,3,5,8,3,0,19,nowin,win,plwin,beat,20,0,16,208,0.427884615,0.0625,0.552884615,1,0.29114424
19145,12,23191,7,4,10,0,0,21,3,5,8,3,0,19,nowin,win,plwin,beat,20,0,11,189,0.470899471,0.015873016,0.613756614,3,0.929171178
19146,29,23192,4,10,0,10,0,24,10,10,0,0,0,20,nowin,loss,bust,plbust,0,10,14,189,0.44973545,0.058201058,0.544973545,1,0.300349439
19147,72,23192,5,9,0,7,0,21,10,10,0,0,0,20,nowin,win,plwin,beat,20,0,14,185,0.394594595,0.032432432,0.508108108,0,0.006763115
19148,51,23192,10,6,0,3,0,19,10,10,0,0,0,20,nowin,loss,beat,dlwin,0,10,16,189,0.529100529,0.068783069,0.608465608,3,0.993665715
19149,34,23192,7,10,0,0,0,17,10,10,0,0,0,20,nowin,loss,beat,dlwin,0,10,17,202,0.5,0.079207921,0.618811881,3,0.968961434
19150,57,23192,4,10,0,9,0,23,10,10,0,0,0,20,nowin,loss,bust,plbust,0,10,14,192,0.46875,0.052083333,0.59375,3,0.907001181
19151,113,23192,6,5,10,0,0,21,10,10,0,0,0,20,nowin,win,plwin,beat,20,0,11,199,0.407035176,0.055276382,0.668341709,2,0.620695264
19152,148,23193,10,6,0,0,0,16,6,11,0,0,0,17,nowin,loss,beat,dlwin,0,10,16,204,0.401960784,0.078431373,0.593137255,0,0.029789521
19153,16,23193,10,6,0,0,0,16,6,11,0,0,0,17,nowin,loss,beat,dlwin,0,10,16,220,0.427272727,0.081818182,0.6,2,0.588660176
19154,46,23193,10,8,0,0,0,18,6,11,0,0,0,17,nowin,win,plwin,beat,20,0,18,186,0.403225806,0.048387097,0.591397849,0,0.029742194
19155,106,23193,4,4,3,10,0,21,6,11,0,0,0,17,nowin,win,plwin,beat,20,0,8,192,0.411458333,0.026041667,0.557291667,0,0.023854304
19156,17,23193,7,7,0,0,0,14,6,11,0,0,0,17,nowin,loss,beat,dlwin,0,10,14,171,0.444444444,0.070175439,0.555555556,1,0.302364894
19157,28,23193,10,3,0,0,0,13,6,11,0,0,0,17,nowin,loss,beat,dlwin,0,10,13,199,0.422110553,0.045226131,0.542713568,1,0.282706618
19158,143,23194,9,8,0,0,0,17,10,3,10,0,0,23,nowin,win,dlbust,bust,20,0,17,203,0.463054187,0.044334975,0.57635468,3,0.883143365
19159,75,23194,10,2,0,10,0,22,10,3,10,0,0,23,nowin,loss,bust,plbust,0,10,12,191,0.418848168,0.052356021,0.570680628,0,0.029344702
19160,39,23194,9,8,0,0,0,17,10,3,10,0,0,23,nowin,win,dlbust,bust,20,0,17,191,0.429319372,0.062827225,0.57591623,0,0.033760763
19161,14,23194,10,4,0,3,0,17,10,3,10,0,0,23,nowin,win,dlbust,bust,20,0,14,202,0.391089109,0.01980198,0.628712871,2,0.577264877
19162,93,23194,10,10,0,0,0,20,10,3,10,0,0,23,nowin,win,dlbust,bust,20,0,20,175,0.485714286,0.051428571,0.548571429,1,0.323648091
19163,123,23194,10,5,0,6,0,21,10,3,10,0,0,23,nowin,win,dlbust,bust,20,0,15,205,0.43902439,0.034146341,0.614634146,2,0.609962544
19164,6,23195,2,6,8,0,0,16,2,8,2,10,0,22,nowin,win,dlbust,bust,20,0,8,191,0.439790576,0.047120419,0.581151832,1,0.31211505
19165,74,23195,3,10,0,0,0,13,2,8,2,10,0,22,nowin,win,dlbust,bust,20,0,13,209,0.411483254,0.04784689,0.531100478,0,0.017448125
19166,135,23195,9,5,0,0,0,14,2,8,2,10,0,22,nowin,win,dlbust,bust,20,0,14,179,0.391061453,0.067039106,0.586592179,0,0.024924662
19167,126,23195,10,11,0,0,0,21,2,8,2,10,0,22,win,win,dlbust,bust,25,0,21,188,0.457446809,0.074468085,0.60106383,3,0.900633203
19168,69,23195,10,6,0,0,0,16,2,8,2,10,0,22,nowin,win,dlbust,bust,20,0,16,194,0.365979381,0.030927835,0.515463918,0,0
19169,103,23195,7,5,0,6,0,18,2,8,2,10,0,22,nowin,win,dlbust,bust,20,0,12,203,0.379310345,0.064039409,0.551724138,0,0.012869209
19170,19,23196,5,7,0,6,0,18,3,8,6,0,0,17,nowin,win,plwin,beat,20,0,12,237,0.41350211,0.054852321,0.628691983,2,0.597373826
19171,16,23196,10,10,0,0,0,20,3,8,6,0,0,17,nowin,win,plwin,beat,20,0,20,220,0.427272727,0.081818182,0.6,2,0.588660176
19172,20,23196,5,6,5,0,0,16,3,8,6,0,0,17,nowin,loss,beat,dlwin,0,10,11,186,0.456989247,0.037634409,0.537634409,1,0.301097108
19173,24,23196,6,10,0,0,0,16,3,8,6,0,0,17,nowin,loss,beat,dlwin,0,10,16,207,0.458937198,0.048309179,0.570048309,1,0.318138014
19174,111,23196,8,4,0,10,0,22,3,8,6,0,0,17,nowin,loss,bust,plbust,0,10,12,180,0.433333333,0.055555556,0.611111111,2,0.602264492
19175,5,23196,5,1,10,0,0,16,3,8,6,0,0,17,nowin,loss,beat,dlwin,0,10,6,203,0.42364532,0.02955665,0.596059113,2,0.582508076
19176,98,23197,4,8,0,9,0,21,7,10,0,0,0,17,nowin,win,plwin,beat,20,0,12,220,0.422727273,0.054545455,0.55,1,0.28664435
19177,79,23197,10,8,0,0,0,18,7,10,0,0,0,17,nowin,win,plwin,beat,20,0,18,211,0.436018957,0.028436019,0.672985782,2,0.650131054
19178,130,23197,7,6,0,9,0,22,7,10,0,0,0,17,nowin,loss,bust,plbust,0,10,13,219,0.410958904,0.03652968,0.566210046,0,0.025888739
19179,35,23197,2,5,7,3,0,17,7,10,0,0,0,17,nowin,push,push,push,10,0,7,202,0.410891089,0.044554455,0.633663366,2,0.598681573
19180,66,23197,10,10,0,0,0,20,7,10,0,0,0,17,nowin,win,plwin,beat,20,0,20,217,0.456221198,0.064516129,0.626728111,3,0.924304367
19181,109,23197,10,9,0,0,0,19,7,10,0,0,0,17,nowin,win,plwin,beat,20,0,19,221,0.461538462,0.058823529,0.597285068,3,0.901830309
19182,10,23198,7,5,0,1,10,23,7,4,7,0,0,18,nowin,loss,bust,plbust,0,10,12,191,0.413612565,0.057591623,0.596858639,2,0.574087175
19183,48,23198,10,10,0,0,0,20,7,4,7,0,0,18,nowin,win,plwin,beat,20,0,20,203,0.413793103,0.019704433,0.600985222,2,0.577280801
19184,42,23198,11,10,0,0,0,21,7,4,7,0,0,18,win,win,plwin,beat,25,0,21,212,0.443396226,0.051886792,0.570754717,1,0.309181312
19185,7,23198,2,5,6,8,0,21,7,4,7,0,0,18,nowin,win,plwin,beat,20,0,7,183,0.442622951,0.06010929,0.62295082,2,0.619303341
19186,57,23198,8,4,0,10,0,22,7,4,7,0,0,18,nowin,loss,bust,plbust,0,10,12,192,0.46875,0.052083333,0.59375,3,0.907001181
19187,76,23198,10,10,0,0,0,20,7,4,7,0,0,18,nowin,win,plwin,beat,20,0,20,189,0.534391534,0.079365079,0.608465608,3,1
19188,33,23199,9,10,0,0,0,19,7,8,3,0,0,18,nowin,win,plwin,beat,20,0,19,192,0.4375,0.057291667,0.625,2,0.616208916
19189,24,23199,9,8,0,0,0,17,7,8,3,0,0,18,nowin,loss,beat,dlwin,0,10,17,207,0.458937198,0.048309179,0.570048309,1,0.318138014
19190,141,23199,5,9,0,10,0,24,7,8,3,0,0,18,nowin,loss,bust,plbust,0,10,14,202,0.420792079,0.074257426,0.564356436,0,0.028377851
19191,93,23199,11,3,7,0,0,21,7,8,3,0,0,18,nowin,win,plwin,beat,20,0,14,175,0.485714286,0.051428571,0.548571429,1,0.323648091
19192,54,23199,5,5,10,0,0,20,7,8,3,0,0,18,nowin,win,plwin,beat,20,0,10,185,0.437837838,0.032432432,0.556756757,1,0.29899854
19193,9,23199,10,2,0,10,0,22,7,8,3,0,0,18,nowin,loss,bust,plbust,0,10,12,194,0.37628866,0.015463918,0.541237113,0,0.009396796
19194,28,23200,7,10,0,0,0,17,10,10,0,0,0,20,nowin,loss,beat,dlwin,0,10,17,199,0.422110553,0.045226131,0.542713568,1,0.282706618
19195,97,23200,4,1,7,8,0,20,10,10,0,0,0,20,nowin,push,push,push,10,0,5,182,0.450549451,0.06043956,0.692307692,2,0.677372279
19196,119,23200,10,7,0,0,0,17,10,10,0,0,0,20,nowin,loss,beat,dlwin,0,10,17,190,0.405263158,0.068421053,0.515789474,0,0.011837158
19197,49,23200,10,6,0,7,0,23,10,10,0,0,0,20,nowin,loss,bust,plbust,0,10,16,207,0.396135266,0.053140097,0.594202899,0,0.028306925
19198,89,23200,7,3,7,0,0,17,10,10,0,0,0,20,nowin,loss,beat,dlwin,0,10,10,212,0.537735849,0.047169811,0.594339623,3,0.990167191
19199,94,23200,4,1,10,10,0,25,10,10,0,0,0,20,nowin,loss,bust,plbust,0,10,5,183,0.43715847,0.043715847,0.540983607,1,0.290866892
19200,34,23201,10,5,0,0,0,15,3,7,10,0,0,20,nowin,loss,beat,dlwin,0,10,15,202,0.5,0.079207921,0.618811881,3,0.968961434
19201,111,23201,3,8,3,0,0,14,3,7,10,0,0,20,nowin,loss,beat,dlwin,0,10,11,180,0.433333333,0.055555556,0.611111111,2,0.602264492
19202,11,23201,2,11,1,0,0,14,3,7,10,0,0,20,nowin,loss,beat,dlwin,0,10,13,236,0.457627119,0.016949153,0.588983051,3,0.889015813
19203,22,23201,10,10,0,0,0,20,3,7,10,0,0,20,nowin,push,push,push,10,0,20,187,0.481283422,0.042780749,0.577540107,3,0.906128176
19204,8,23201,8,11,0,0,0,19,3,7,10,0,0,20,nowin,loss,beat,dlwin,0,10,19,181,0.44198895,0.071823204,0.596685083,2,0.599438402
19205,142,23201,10,5,0,0,0,15,3,7,10,0,0,20,nowin,loss,beat,dlwin,0,10,15,211,0.417061611,0.047393365,0.526066351,1,0.271531309
19206,87,23202,10,10,0,0,0,20,10,2,8,0,0,20,nowin,push,push,push,10,0,20,202,0.405940594,0.054455446,0.628712871,2,0.590599801
19207,125,23202,9,6,0,10,0,25,10,2,8,0,0,20,nowin,loss,bust,plbust,0,10,15,219,0.438356164,0.050228311,0.575342466,1,0.308411257
19208,83,23202,6,7,0,10,0,23,10,2,8,0,0,20,nowin,loss,bust,plbust,0,10,13,193,0.424870466,0.051813472,0.678756477,2,0.644360335
19209,36,23202,8,8,0,10,0,26,10,2,8,0,0,20,nowin,loss,bust,plbust,0,10,16,229,0.445414847,0.056768559,0.655021834,2,0.645370571
19210,70,23202,4,10,0,2,2,18,10,2,8,0,0,20,nowin,loss,beat,dlwin,0,10,14,228,0.385964912,0.039473684,0.557017544,0,0.016157125
19211,74,23202,3,10,0,10,0,23,10,2,8,0,0,20,nowin,loss,bust,plbust,0,10,13,209,0.411483254,0.04784689,0.531100478,0,0.017448125
19212,4,23203,2,10,0,3,7,22,11,10,0,0,0,21,nowin,loss,bust,plbust,0,10,12,217,0.460829493,0.036866359,0.562211982,1,0.315432839
19213,84,23203,4,10,0,4,0,18,11,10,0,0,0,21,nowin,loss,beat,dlwin,0,10,14,195,0.379487179,0.056410256,0.569230769,0,0.017209119
19214,59,23203,10,10,0,0,0,20,11,10,0,0,0,21,nowin,loss,beat,dlwin,0,10,20,228,0.429824561,0.048245614,0.543859649,1,0.287885446
19215,53,23203,10,5,0,10,0,25,11,10,0,0,0,21,nowin,loss,bust,plbust,0,10,15,250,0.372,0.064,0.564,0,0.013687345
19216,87,23203,2,3,9,10,0,24,11,10,0,0,0,21,nowin,loss,bust,plbust,0,10,5,202,0.405940594,0.054455446,0.628712871,2,0.590599801
19217,13,23203,10,7,0,0,0,17,11,10,0,0,0,21,nowin,loss,beat,dlwin,0,10,17,206,0.417475728,0.063106796,0.621359223,2,0.59555479
19218,10,23204,10,9,0,0,0,19,6,10,10,0,0,26,nowin,win,dlbust,bust,20,0,19,191,0.413612565,0.057591623,0.596858639,2,0.574087175
19219,28,23204,8,3,3,0,0,14,6,10,10,0,0,26,nowin,win,dlbust,bust,20,0,11,199,0.422110553,0.045226131,0.542713568,1,0.282706618
19220,13,23204,9,9,0,0,0,18,6,10,10,0,0,26,nowin,win,dlbust,bust,20,0,18,206,0.417475728,0.063106796,0.621359223,2,0.59555479
19221,45,23204,9,5,0,0,0,14,6,10,10,0,0,26,nowin,win,dlbust,bust,20,0,14,196,0.428571429,0.051020408,0.612244898,2,0.598821767
19222,2,23204,10,10,0,0,0,20,6,10,10,0,0,26,nowin,win,dlbust,bust,20,0,20,200,0.445,0.035,0.64,2,0.633962549
19223,77,23204,9,3,0,0,0,12,6,10,10,0,0,26,nowin,win,dlbust,bust,20,0,12,200,0.455,0.04,0.62,3,0.916252116
19224,119,23205,5,10,0,0,0,15,3,5,4,6,0,18,nowin,loss,beat,dlwin,0,10,15,190,0.405263158,0.068421053,0.515789474,0,0.011837158
19225,82,23205,10,10,0,0,0,20,3,5,4,6,0,18,nowin,win,plwin,beat,20,0,20,225,0.408888889,0.075555556,0.577777778,0,0.028101874
19226,147,23205,4,5,10,0,0,19,3,5,4,6,0,18,nowin,win,plwin,beat,20,0,9,205,0.380487805,0.014634146,0.536585366,0,0.00951447
19227,123,23205,6,10,0,0,0,16,3,5,4,6,0,18,nowin,loss,beat,dlwin,0,10,16,205,0.43902439,0.034146341,0.614634146,2,0.609962544
19228,27,23205,2,8,4,0,0,14,3,5,4,6,0,18,nowin,loss,beat,dlwin,0,10,10,178,0.370786517,0.016853933,0.573033708,0,0.015536309
19229,59,23205,2,9,3,0,0,14,3,5,4,6,0,18,nowin,loss,beat,dlwin,0,10,11,228,0.429824561,0.048245614,0.543859649,1,0.287885446
19230,53,23206,10,8,0,0,0,18,2,2,6,10,0,20,nowin,loss,beat,dlwin,0,10,18,250,0.372,0.064,0.564,0,0.013687345
19231,33,23206,10,4,0,0,0,14,2,2,6,10,0,20,nowin,loss,beat,dlwin,0,10,14,192,0.4375,0.057291667,0.625,2,0.616208916
19232,6,23206,10,3,0,0,0,13,2,2,6,10,0,20,nowin,loss,beat,dlwin,0,10,13,191,0.439790576,0.047120419,0.581151832,1,0.31211505
19233,103,23206,5,10,0,0,0,15,2,2,6,10,0,20,nowin,loss,beat,dlwin,0,10,15,203,0.379310345,0.064039409,0.551724138,0,0.012869209
19234,57,23206,8,4,0,10,0,22,2,2,6,10,0,20,nowin,loss,bust,plbust,0,10,12,192,0.46875,0.052083333,0.59375,3,0.907001181
19235,4,23206,6,7,0,0,0,13,2,2,6,10,0,20,nowin,loss,beat,dlwin,0,10,13,217,0.460829493,0.036866359,0.562211982,1,0.315432839
19236,18,23207,2,10,0,10,0,22,10,6,6,0,0,22,nowin,loss,bust,plbust,0,10,12,182,0.461538462,0.043956044,0.587912088,3,0.892649374
19237,127,23207,4,4,3,4,10,25,10,6,6,0,0,22,nowin,loss,bust,plbust,0,10,8,201,0.402985075,0.029850746,0.60199005,0,0.032263937
19238,46,23207,10,5,0,2,0,17,10,6,6,0,0,22,nowin,win,dlbust,bust,20,0,15,186,0.403225806,0.048387097,0.591397849,0,0.029742194
19239,67,23207,2,6,8,10,0,26,10,6,6,0,0,22,nowin,loss,bust,plbust,0,10,8,195,0.369230769,0.041025641,0.569230769,0,0.014139427
19240,109,23207,9,10,0,0,0,19,10,6,6,0,0,22,nowin,win,dlbust,bust,20,0,19,221,0.461538462,0.058823529,0.597285068,3,0.901830309
19241,57,23207,10,10,0,0,0,20,10,6,6,0,0,22,nowin,win,dlbust,bust,20,0,20,192,0.46875,0.052083333,0.59375,3,0.907001181
19242,122,23208,11,10,0,0,0,21,6,10,6,0,0,22,win,win,dlbust,bust,25,0,21,210,0.347619048,0.052380952,0.59047619,0,0.012873677
19243,10,23208,3,8,6,0,0,17,6,10,6,0,0,22,nowin,win,dlbust,bust,20,0,11,191,0.413612565,0.057591623,0.596858639,2,0.574087175
19244,5,23208,10,7,0,0,0,17,6,10,6,0,0,22,nowin,win,dlbust,bust,20,0,17,203,0.42364532,0.02955665,0.596059113,2,0.582508076
19245,80,23208,6,5,8,0,0,19,6,10,6,0,0,22,nowin,win,dlbust,bust,20,0,11,186,0.419354839,0.059139785,0.623655914,2,0.59892924
19246,74,23208,10,4,0,0,0,14,6,10,6,0,0,22,nowin,win,dlbust,bust,20,0,14,209,0.411483254,0.04784689,0.531100478,0,0.017448125
19247,113,23208,2,5,8,0,0,15,6,10,6,0,0,22,nowin,win,dlbust,bust,20,0,7,199,0.407035176,0.055276382,0.668341709,2,0.620695264
19248,71,23209,10,7,0,0,0,17,5,8,7,0,0,20,nowin,loss,beat,dlwin,0,10,17,193,0.352331606,0.046632124,0.585492228,0,0.013063661
19249,82,23209,10,10,0,0,0,20,5,8,7,0,0,20,nowin,push,push,push,10,0,20,225,0.408888889,0.075555556,0.577777778,0,0.028101874
19250,110,23209,10,4,0,0,0,14,5,8,7,0,0,20,nowin,loss,beat,dlwin,0,10,14,192,0.416666667,0.046875,0.557291667,0,0.025413132
19251,51,23209,10,10,0,0,0,20,5,8,7,0,0,20,nowin,push,push,push,10,0,20,189,0.529100529,0.068783069,0.608465608,3,0.993665715
19252,147,23209,6,10,0,0,0,16,5,8,7,0,0,20,nowin,loss,beat,dlwin,0,10,16,205,0.380487805,0.014634146,0.536585366,0,0.00951447
19253,35,23209,10,11,0,0,0,21,5,8,7,0,0,20,win,win,plwin,beat,25,0,21,202,0.410891089,0.044554455,0.633663366,2,0.598681573
19254,139,23210,10,3,0,10,0,23,7,4,9,0,0,20,nowin,loss,bust,plbust,0,10,13,192,0.380208333,0.036458333,0.59375,0,0.023429169
19255,21,23210,10,7,0,0,0,17,7,4,9,0,0,20,nowin,loss,beat,dlwin,0,10,17,214,0.359813084,0.042056075,0.626168224,0,0.025263474
19256,146,23210,7,6,0,10,0,23,7,4,9,0,0,20,nowin,loss,bust,plbust,0,10,13,221,0.43438914,0.040723982,0.542986425,1,0.290190091
19257,147,23210,5,1,10,1,0,17,7,4,9,0,0,20,nowin,loss,beat,dlwin,0,10,6,205,0.380487805,0.014634146,0.536585366,0,0.00951447
19258,127,23210,2,5,4,6,0,17,7,4,9,0,0,20,nowin,loss,beat,dlwin,0,10,7,201,0.402985075,0.029850746,0.60199005,0,0.032263937
19259,87,23210,5,10,0,10,0,25,7,4,9,0,0,20,nowin,loss,bust,plbust,0,10,15,202,0.405940594,0.054455446,0.628712871,2,0.590599801
19260,71,23211,8,3,8,0,0,19,9,2,10,0,0,21,nowin,loss,beat,dlwin,0,10,11,193,0.352331606,0.046632124,0.585492228,0,0.013063661
19261,129,23211,6,10,0,7,0,23,9,2,10,0,0,21,nowin,loss,bust,plbust,0,10,16,201,0.422885572,0.064676617,0.55721393,0,0.027255383
19262,38,23211,2,10,0,3,10,25,9,2,10,0,0,21,nowin,loss,bust,plbust,0,10,12,202,0.361386139,0.03960396,0.564356436,0,0.010597953
19263,123,23211,3,10,0,10,0,23,9,2,10,0,0,21,nowin,loss,bust,plbust,0,10,13,205,0.43902439,0.034146341,0.614634146,2,0.609962544
19264,69,23211,10,9,0,0,0,19,9,2,10,0,0,21,nowin,loss,beat,dlwin,0,10,19,194,0.365979381,0.030927835,0.515463918,0,0
19265,103,23211,2,10,0,2,10,24,9,2,10,0,0,21,nowin,loss,bust,plbust,0,10,12,203,0.379310345,0.064039409,0.551724138,0,0.012869209
19266,98,23212,10,2,0,3,7,22,10,3,6,0,0,19,nowin,loss,bust,plbust,0,10,12,220,0.422727273,0.054545455,0.55,1,0.28664435
19267,10,23212,8,10,0,0,0,18,10,3,6,0,0,19,nowin,loss,beat,dlwin,0,10,18,191,0.413612565,0.057591623,0.596858639,2,0.574087175
19268,67,23212,3,5,10,0,0,18,10,3,6,0,0,19,nowin,loss,beat,dlwin,0,10,8,195,0.369230769,0.041025641,0.569230769,0,0.014139427
19269,94,23212,3,10,0,10,0,23,10,3,6,0,0,19,nowin,loss,bust,plbust,0,10,13,183,0.43715847,0.043715847,0.540983607,1,0.290866892
19270,123,23212,10,10,0,0,0,20,10,3,6,0,0,19,nowin,win,plwin,beat,20,0,20,205,0.43902439,0.034146341,0.614634146,2,0.609962544
19271,73,23212,10,3,0,10,0,23,10,3,6,0,0,19,nowin,loss,bust,plbust,0,10,13,181,0.375690608,0.011049724,0.596685083,0,0.022795773
19272,29,23213,10,2,0,10,0,22,10,5,9,0,0,24,nowin,loss,bust,plbust,0,10,12,189,0.44973545,0.058201058,0.544973545,1,0.300349439
19273,132,23213,10,10,0,0,0,20,10,5,9,0,0,24,nowin,win,dlbust,bust,20,0,20,194,0.412371134,0.036082474,0.649484536,2,0.611633238
19274,28,23213,8,5,0,3,10,26,10,5,9,0,0,24,nowin,loss,bust,plbust,0,10,13,199,0.422110553,0.045226131,0.542713568,1,0.282706618
19275,79,23213,8,9,0,0,0,17,10,5,9,0,0,24,nowin,win,dlbust,bust,20,0,17,211,0.436018957,0.028436019,0.672985782,2,0.650131054
19276,143,23213,2,10,0,6,0,18,10,5,9,0,0,24,nowin,win,dlbust,bust,20,0,12,203,0.463054187,0.044334975,0.57635468,3,0.883143365
19277,39,23213,10,10,0,0,0,20,10,5,9,0,0,24,nowin,win,dlbust,bust,20,0,20,191,0.429319372,0.062827225,0.57591623,0,0.033760763
19278,99,23214,6,1,10,0,0,17,6,3,4,4,0,17,nowin,push,push,push,10,0,7,207,0.47826087,0.062801932,0.637681159,3,0.961418446
19279,37,23214,7,10,0,0,0,17,6,3,4,4,0,17,nowin,push,push,push,10,0,17,208,0.394230769,0.038461538,0.581730769,0,0.024682772
19280,62,23214,2,4,8,0,0,14,6,3,4,4,0,17,nowin,loss,beat,dlwin,0,10,6,178,0.370786517,0.028089888,0.54494382,0,0.008657722
19281,119,23214,11,7,0,0,0,18,6,3,4,4,0,17,nowin,win,plwin,beat,20,0,18,190,0.405263158,0.068421053,0.515789474,0,0.011837158
19282,107,23214,10,8,0,0,0,18,6,3,4,4,0,17,nowin,win,plwin,beat,20,0,18,218,0.444954128,0.073394495,0.600917431,2,0.605210014
19283,104,23214,11,7,0,0,0,18,6,3,4,4,0,17,nowin,win,plwin,beat,20,0,18,209,0.363636364,0.052631579,0.593301435,0,0.018359419
19284,150,23215,2,10,0,10,0,22,9,10,0,0,0,19,nowin,loss,bust,plbust,0,10,12,192,0.401041667,0.036458333,0.567708333,0,0.023287458
19285,112,23215,9,2,1,9,0,21,9,10,0,0,0,19,nowin,win,plwin,beat,20,0,11,203,0.448275862,0.054187192,0.600985222,3,0.889576933
19286,5,23215,3,3,5,10,0,21,9,10,0,0,0,19,nowin,win,plwin,beat,20,0,6,203,0.42364532,0.02955665,0.596059113,2,0.582508076
19287,106,23215,7,8,0,10,0,25,9,10,0,0,0,19,nowin,loss,bust,plbust,0,10,15,192,0.411458333,0.026041667,0.557291667,0,0.023854304
19288,142,23215,4,7,10,0,0,21,9,10,0,0,0,19,nowin,win,plwin,beat,20,0,11,211,0.417061611,0.047393365,0.526066351,1,0.271531309
19289,99,23215,7,2,4,10,0,23,9,10,0,0,0,19,nowin,loss,bust,plbust,0,10,9,207,0.47826087,0.062801932,0.637681159,3,0.961418446
19290,24,23216,11,10,0,0,0,21,7,9,5,0,0,21,win,push,push,push,10,0,21,207,0.458937198,0.048309179,0.570048309,1,0.318138014
19291,125,23216,2,2,7,10,0,21,7,9,5,0,0,21,nowin,push,push,push,10,0,4,219,0.438356164,0.050228311,0.575342466,1,0.308411257
19292,102,23216,4,6,10,0,0,20,7,9,5,0,0,21,nowin,loss,beat,dlwin,0,10,10,192,0.338541667,0.046875,0.5625,0,0.003306118
19293,109,23216,5,2,2,3,10,22,7,9,5,0,0,21,nowin,loss,bust,plbust,0,10,7,221,0.461538462,0.058823529,0.597285068,3,0.901830309
19294,43,23216,6,10,0,6,0,22,7,9,5,0,0,21,nowin,loss,bust,plbust,0,10,16,192,0.40625,0.041666667,0.609375,2,0.576671372
19295,59,23216,1,5,9,3,0,18,7,9,5,0,0,21,nowin,loss,beat,dlwin,0,10,6,228,0.429824561,0.048245614,0.543859649,1,0.287885446
19296,136,23217,10,2,0,3,1,16,10,10,0,0,0,20,nowin,loss,beat,dlwin,0,10,12,194,0.396907216,0.025773196,0.597938144,0,0.029452644
19297,126,23217,10,11,0,0,0,21,10,10,0,0,0,20,win,win,plwin,beat,25,0,21,188,0.457446809,0.074468085,0.60106383,3,0.900633203
19298,115,23217,6,10,0,8,0,24,10,10,0,0,0,20,nowin,loss,bust,plbust,0,10,16,194,0.427835052,0.041237113,0.592783505,2,0.583863602
19299,104,23217,5,10,0,5,0,20,10,10,0,0,0,20,nowin,push,push,push,10,0,15,209,0.363636364,0.052631579,0.593301435,0,0.018359419
19300,49,23217,10,10,0,0,0,20,10,10,0,0,0,20,nowin,push,push,push,10,0,20,207,0.396135266,0.053140097,0.594202899,0,0.028306925
19301,13,23217,11,10,0,0,0,21,10,10,0,0,0,20,win,win,plwin,beat,25,0,21,206,0.417475728,0.063106796,0.621359223,2,0.59555479
19302,16,23218,2,10,0,3,1,16,10,5,10,0,0,25,nowin,win,dlbust,bust,20,0,12,220,0.427272727,0.081818182,0.6,2,0.588660176
19303,110,23218,5,10,0,8,0,23,10,5,10,0,0,25,nowin,loss,bust,plbust,0,10,15,192,0.416666667,0.046875,0.557291667,0,0.025413132
19304,110,23218,5,7,0,8,0,20,10,5,10,0,0,25,nowin,win,dlbust,bust,20,0,12,192,0.416666667,0.046875,0.557291667,0,0.025413132
19305,27,23218,5,6,2,3,7,23,10,5,10,0,0,25,nowin,loss,bust,plbust,0,10,11,178,0.370786517,0.016853933,0.573033708,0,0.015536309
19306,87,23218,10,10,0,0,0,20,10,5,10,0,0,25,nowin,win,dlbust,bust,20,0,20,202,0.405940594,0.054455446,0.628712871,2,0.590599801
19307,85,23218,9,4,0,4,0,17,10,5,10,0,0,25,nowin,win,dlbust,bust,20,0,13,195,0.41025641,0.066666667,0.594871795,0,0.03269711
19308,128,23219,6,2,10,0,0,18,7,11,0,0,0,18,nowin,push,push,push,10,0,8,227,0.356828194,0.052863436,0.577092511,0,0.012352564
19309,56,23219,1,5,7,9,0,22,7,11,0,0,0,18,nowin,loss,bust,plbust,0,10,6,175,0.4,0.057142857,0.582857143,0,0.026685297
19310,62,23219,4,10,0,2,7,23,7,11,0,0,0,18,nowin,loss,bust,plbust,0,10,14,178,0.370786517,0.028089888,0.54494382,0,0.008657722
19311,129,23219,9,11,0,0,0,20,7,11,0,0,0,18,nowin,win,plwin,beat,20,0,20,201,0.422885572,0.064676617,0.55721393,0,0.027255383
19312,83,23219,9,10,0,0,0,19,7,11,0,0,0,18,nowin,win,plwin,beat,20,0,19,193,0.424870466,0.051813472,0.678756477,2,0.644360335
19313,8,23219,1,6,9,1,0,17,7,11,0,0,0,18,nowin,loss,beat,dlwin,0,10,7,181,0.44198895,0.071823204,0.596685083,2,0.599438402
19314,141,23220,10,10,0,0,0,20,6,4,8,0,0,18,nowin,win,plwin,beat,20,0,20,202,0.420792079,0.074257426,0.564356436,0,0.028377851
19315,34,23220,11,10,0,0,0,21,6,4,8,0,0,18,win,win,plwin,beat,25,0,21,202,0.5,0.079207921,0.618811881,3,0.968961434
19316,116,23220,3,8,1,0,0,12,6,4,8,0,0,18,nowin,loss,beat,dlwin,0,10,11,195,0.425641026,0.056410256,0.538461538,1,0.28273747
19317,112,23220,10,10,0,0,0,20,6,4,8,0,0,18,nowin,win,plwin,beat,20,0,20,203,0.448275862,0.054187192,0.600985222,3,0.889576933
19318,143,23220,4,3,7,0,0,14,6,4,8,0,0,18,nowin,loss,beat,dlwin,0,10,7,203,0.463054187,0.044334975,0.57635468,3,0.883143365
19319,22,23220,6,10,0,0,0,16,6,4,8,0,0,18,nowin,loss,beat,dlwin,0,10,16,187,0.481283422,0.042780749,0.577540107,3,0.906128176
19320,30,23221,9,2,10,0,0,21,7,10,0,0,0,17,nowin,win,plwin,beat,20,0,11,206,0.393203883,0.033980583,0.601941748,0,0.029324648
19321,47,23221,1,6,8,6,0,21,7,10,0,0,0,17,nowin,win,plwin,beat,20,0,7,210,0.438095238,0.057142857,0.623809524,2,0.615868808
19322,96,23221,10,6,0,7,0,23,7,10,0,0,0,17,nowin,loss,bust,plbust,0,10,16,190,0.468421053,0.057894737,0.584210526,3,0.897263354
19323,38,23221,6,9,0,7,0,22,7,10,0,0,0,17,nowin,loss,bust,plbust,0,10,15,202,0.361386139,0.03960396,0.564356436,0,0.010597953
19324,103,23221,6,10,0,10,0,26,7,10,0,0,0,17,nowin,loss,bust,plbust,0,10,16,203,0.379310345,0.064039409,0.551724138,0,0.012869209
19325,144,23221,3,7,6,10,0,26,7,10,0,0,0,17,nowin,loss,bust,plbust,0,10,10,202,0.386138614,0.054455446,0.564356436,0,0.018006244
19326,6,23222,8,2,2,0,0,12,4,10,10,0,0,24,nowin,win,dlbust,bust,20,0,10,191,0.439790576,0.047120419,0.581151832,1,0.31211505
19327,28,23222,10,6,0,0,0,16,4,10,10,0,0,24,nowin,win,dlbust,bust,20,0,16,199,0.422110553,0.045226131,0.542713568,1,0.282706618
19328,114,23222,5,11,3,0,0,19,4,10,10,0,0,24,nowin,win,dlbust,bust,20,0,16,198,0.47979798,0.025252525,0.611111111,3,0.937232995
19329,68,23222,10,3,0,0,0,13,4,10,10,0,0,24,nowin,win,dlbust,bust,20,0,13,205,0.434146341,0.029268293,0.6,2,0.59483189
19330,110,23222,4,10,0,0,0,14,4,10,10,0,0,24,nowin,win,dlbust,bust,20,0,14,192,0.416666667,0.046875,0.557291667,0,0.025413132
19331,19,23222,10,10,0,0,0,20,4,10,10,0,0,24,nowin,win,dlbust,bust,20,0,20,237,0.41350211,0.054852321,0.628691983,2,0.597373826
19332,58,23223,3,8,10,0,0,21,10,5,10,0,0,25,nowin,win,dlbust,bust,20,0,11,195,0.430769231,0.041025641,0.584615385,2,0.580497586
19333,71,23223,11,1,4,1,0,17,10,5,10,0,0,25,nowin,win,dlbust,bust,20,0,12,193,0.352331606,0.046632124,0.585492228,0,0.013063661
19334,109,23223,10,9,0,0,0,19,10,5,10,0,0,25,nowin,win,dlbust,bust,20,0,19,221,0.461538462,0.058823529,0.597285068,3,0.901830309
19335,37,23223,10,10,0,0,0,20,10,5,10,0,0,25,nowin,win,dlbust,bust,20,0,20,208,0.394230769,0.038461538,0.581730769,0,0.024682772
19336,51,23223,5,2,10,0,0,17,10,5,10,0,0,25,nowin,win,dlbust,bust,20,0,7,189,0.529100529,0.068783069,0.608465608,3,0.993665715
19337,42,23223,10,7,0,0,0,17,10,5,10,0,0,25,nowin,win,dlbust,bust,20,0,17,212,0.443396226,0.051886792,0.570754717,1,0.309181312
19338,87,23224,9,10,0,0,0,19,4,9,10,0,0,23,nowin,win,dlbust,bust,20,0,19,202,0.405940594,0.054455446,0.628712871,2,0.590599801
19339,72,23224,4,10,0,0,0,14,4,9,10,0,0,23,nowin,win,dlbust,bust,20,0,14,185,0.394594595,0.032432432,0.508108108,0,0.006763115
19340,150,23224,3,4,10,0,0,17,4,9,10,0,0,23,nowin,win,dlbust,bust,20,0,7,192,0.401041667,0.036458333,0.567708333,0,0.023287458
19341,71,23224,2,8,2,0,0,12,4,9,10,0,0,23,nowin,win,dlbust,bust,20,0,10,193,0.352331606,0.046632124,0.585492228,0,0.013063661
19342,99,23224,8,6,0,0,0,14,4,9,10,0,0,23,nowin,win,dlbust,bust,20,0,14,207,0.47826087,0.062801932,0.637681159,3,0.961418446
19343,125,23224,3,10,0,0,0,13,4,9,10,0,0,23,nowin,win,dlbust,bust,20,0,13,219,0.438356164,0.050228311,0.575342466,1,0.308411257
19344,129,23225,8,4,0,0,0,12,6,4,5,10,0,25,nowin,win,dlbust,bust,20,0,12,201,0.422885572,0.064676617,0.55721393,0,0.027255383
19345,143,23225,10,9,0,0,0,19,6,4,5,10,0,25,nowin,win,dlbust,bust,20,0,19,203,0.463054187,0.044334975,0.57635468,3,0.883143365
19346,90,23225,5,9,0,0,0,14,6,4,5,10,0,25,nowin,win,dlbust,bust,20,0,14,201,0.447761194,0.049751244,0.60199005,3,0.889945023
19347,53,23225,1,5,6,0,0,12,6,4,5,10,0,25,nowin,win,dlbust,bust,20,0,6,250,0.372,0.064,0.564,0,0.013687345
19348,126,23225,10,10,0,0,0,20,6,4,5,10,0,25,nowin,win,dlbust,bust,20,0,20,188,0.457446809,0.074468085,0.60106383,3,0.900633203
19349,133,23225,8,4,0,0,0,12,6,4,5,10,0,25,nowin,win,dlbust,bust,20,0,12,201,0.47761194,0.064676617,0.611940299,3,0.935428111
19350,64,23226,10,10,0,0,0,20,11,4,1,5,0,21,nowin,loss,beat,dlwin,0,10,20,187,0.363636364,0.048128342,0.631016043,0,0.027594885
19351,64,23226,10,5,0,1,10,26,11,4,1,5,0,21,nowin,loss,bust,plbust,0,10,15,187,0.363636364,0.048128342,0.631016043,0,0.027594885
19352,81,23226,4,10,0,10,0,24,11,4,1,5,0,21,nowin,loss,bust,plbust,0,10,14,182,0.395604396,0.043956044,0.60989011,2,0.567491261
19353,19,23226,5,3,5,10,0,23,11,4,1,5,0,21,nowin,loss,bust,plbust,0,10,8,237,0.41350211,0.054852321,0.628691983,2,0.597373826
19354,4,23226,7,9,0,4,0,20,11,4,1,5,0,21,nowin,loss,beat,dlwin,0,10,16,217,0.460829493,0.036866359,0.562211982,1,0.315432839
19355,150,23226,10,10,0,0,0,20,11,4,1,5,0,21,nowin,loss,beat,dlwin,0,10,20,192,0.401041667,0.036458333,0.567708333,0,0.023287458
19356,111,23227,10,4,0,0,0,14,2,7,11,0,0,20,nowin,loss,beat,dlwin,0,10,14,180,0.433333333,0.055555556,0.611111111,2,0.602264492
19357,14,23227,3,10,0,0,0,13,2,7,11,0,0,20,nowin,loss,beat,dlwin,0,10,13,202,0.391089109,0.01980198,0.628712871,2,0.577264877
19358,45,23227,10,10,0,0,0,20,2,7,11,0,0,20,nowin,push,push,push,10,0,20,196,0.428571429,0.051020408,0.612244898,2,0.598821767
19359,72,23227,3,10,0,0,0,13,2,7,11,0,0,20,nowin,loss,beat,dlwin,0,10,13,185,0.394594595,0.032432432,0.508108108,0,0.006763115
19360,82,23227,5,1,10,0,0,16,2,7,11,0,0,20,nowin,loss,beat,dlwin,0,10,6,225,0.408888889,0.075555556,0.577777778,0,0.028101874
19361,11,23227,4,10,0,0,0,14,2,7,11,0,0,20,nowin,loss,beat,dlwin,0,10,14,236,0.457627119,0.016949153,0.588983051,3,0.889015813
19362,146,23228,10,2,0,10,0,22,11,3,4,0,0,18,nowin,loss,bust,plbust,0,10,12,221,0.43438914,0.040723982,0.542986425,1,0.290190091
19363,40,23228,10,6,0,2,0,18,11,3,4,0,0,18,nowin,push,push,push,10,0,16,196,0.367346939,0.030612245,0.617346939,0,0.025358183
19364,132,23228,10,9,0,0,0,19,11,3,4,0,0,18,nowin,win,plwin,beat,20,0,19,194,0.412371134,0.036082474,0.649484536,2,0.611633238
19365,78,23228,10,10,0,0,0,20,11,3,4,0,0,18,nowin,win,plwin,beat,20,0,20,201,0.517412935,0.034825871,0.587064677,3,0.95871112
19366,118,23228,10,5,0,10,0,25,11,3,4,0,0,18,nowin,loss,bust,plbust,0,10,15,216,0.393518519,0.037037037,0.555555556,0,0.018059873
19367,78,23228,5,2,5,4,5,21,11,3,4,0,0,18,nowin,win,plwin,beat,20,0,7,201,0.517412935,0.034825871,0.587064677,3,0.95871112
19368,53,23229,7,9,0,10,0,26,7,2,10,0,0,19,nowin,loss,bust,plbust,0,10,16,250,0.372,0.064,0.564,0,0.013687345
19369,48,23229,10,2,0,10,0,22,7,2,10,0,0,19,nowin,loss,bust,plbust,0,10,12,203,0.413793103,0.019704433,0.600985222,2,0.577280801
19370,42,23229,3,5,10,0,0,18,7,2,10,0,0,19,nowin,loss,beat,dlwin,0,10,8,212,0.443396226,0.051886792,0.570754717,1,0.309181312
19371,9,23229,8,10,0,0,0,18,7,2,10,0,0,19,nowin,loss,beat,dlwin,0,10,18,194,0.37628866,0.015463918,0.541237113,0,0.009396796
19372,114,23229,5,11,4,0,0,20,7,2,10,0,0,19,nowin,win,plwin,beat,20,0,16,198,0.47979798,0.025252525,0.611111111,3,0.937232995
19373,53,23229,5,3,11,0,0,19,7,2,10,0,0,19,nowin,push,push,push,10,0,8,250,0.372,0.064,0.564,0,0.013687345
19374,149,23230,8,10,0,0,0,18,11,6,0,0,0,17,nowin,win,plwin,beat,20,0,18,225,0.457777778,0.057777778,0.648888889,2,0.651965595
19375,18,23230,10,3,0,8,0,21,11,6,0,0,0,17,nowin,win,plwin,beat,20,0,13,182,0.461538462,0.043956044,0.587912088,3,0.892649374
19376,15,23230,2,9,10,0,0,21,11,6,0,0,0,17,nowin,win,plwin,beat,20,0,11,212,0.410377358,0.051886792,0.561320755,0,0.024517408
19377,88,23230,10,3,0,8,0,21,11,6,0,0,0,17,nowin,win,plwin,beat,20,0,13,206,0.466019417,0.033980583,0.54368932,1,0.309467903
19378,42,23230,5,10,0,1,7,23,11,6,0,0,0,17,nowin,loss,bust,plbust,0,10,15,212,0.443396226,0.051886792,0.570754717,1,0.309181312
19379,108,23230,6,11,4,0,0,21,11,6,0,0,0,17,nowin,win,plwin,beat,20,0,17,193,0.435233161,0.056994819,0.559585492,1,0.298824795
19380,50,23231,6,10,0,10,0,26,10,6,4,0,0,20,nowin,loss,bust,plbust,0,10,16,202,0.405940594,0.04950495,0.54950495,0,0.020296079
19381,111,23231,4,10,0,8,0,22,10,6,4,0,0,20,nowin,loss,bust,plbust,0,10,14,180,0.433333333,0.055555556,0.611111111,2,0.602264492
19382,131,23231,4,11,6,0,0,21,10,6,4,0,0,20,nowin,win,plwin,beat,20,0,15,217,0.410138249,0.069124424,0.543778802,0,0.02015021
19383,42,23231,7,9,0,8,0,24,10,6,4,0,0,20,nowin,loss,bust,plbust,0,10,16,212,0.443396226,0.051886792,0.570754717,1,0.309181312
19384,24,23231,3,10,0,9,0,22,10,6,4,0,0,20,nowin,loss,bust,plbust,0,10,13,207,0.458937198,0.048309179,0.570048309,1,0.318138014
19385,41,23231,5,3,11,0,0,19,10,6,4,0,0,20,nowin,loss,beat,dlwin,0,10,8,192,0.364583333,0.036458333,0.520833333,0,0.00089702
19386,134,23232,7,2,10,0,0,19,9,6,2,0,0,17,nowin,win,plwin,beat,20,0,9,185,0.443243243,0.021621622,0.545945946,1,0.296939509
19387,12,23232,1,6,5,10,0,22,9,6,2,0,0,17,nowin,loss,bust,plbust,0,10,7,189,0.470899471,0.015873016,0.613756614,3,0.929171178
19388,76,23232,10,5,0,10,0,25,9,6,2,0,0,17,nowin,loss,bust,plbust,0,10,15,189,0.534391534,0.079365079,0.608465608,3,1
19389,49,23232,5,10,0,7,0,22,9,6,2,0,0,17,nowin,loss,bust,plbust,0,10,15,207,0.396135266,0.053140097,0.594202899,0,0.028306925
19390,35,23232,6,7,0,4,0,17,9,6,2,0,0,17,nowin,push,push,push,10,0,13,202,0.410891089,0.044554455,0.633663366,2,0.598681573
19391,30,23232,1,1,10,7,0,19,9,6,2,0,0,17,nowin,win,plwin,beat,20,0,2,206,0.393203883,0.033980583,0.601941748,0,0.029324648
19392,13,23233,1,5,9,10,0,25,10,10,0,0,0,20,nowin,loss,bust,plbust,0,10,6,206,0.417475728,0.063106796,0.621359223,2,0.59555479
19393,20,23233,6,10,0,3,0,19,10,10,0,0,0,20,nowin,loss,beat,dlwin,0,10,16,186,0.456989247,0.037634409,0.537634409,1,0.301097108
19394,102,23233,10,10,0,0,0,20,10,10,0,0,0,20,nowin,push,push,push,10,0,20,192,0.338541667,0.046875,0.5625,0,0.003306118
19395,24,23233,11,10,0,0,0,21,10,10,0,0,0,20,win,win,plwin,beat,25,0,21,207,0.458937198,0.048309179,0.570048309,1,0.318138014
19396,87,23233,2,9,8,0,0,19,10,10,0,0,0,20,nowin,loss,beat,dlwin,0,10,11,202,0.405940594,0.054455446,0.628712871,2,0.590599801
19397,28,23233,7,10,0,0,0,17,10,10,0,0,0,20,nowin,loss,beat,dlwin,0,10,17,199,0.422110553,0.045226131,0.542713568,1,0.282706618
19398,1,23234,2,1,10,0,0,13,3,10,10,0,0,23,nowin,win,dlbust,bust,20,0,3,197,0.406091371,0.025380711,0.649746193,2,0.606186955
19399,21,23234,6,1,10,0,0,17,3,10,10,0,0,23,nowin,win,dlbust,bust,20,0,7,214,0.359813084,0.042056075,0.626168224,0,0.025263474
19400,83,23234,3,6,10,0,0,19,3,10,10,0,0,23,nowin,win,dlbust,bust,20,0,9,193,0.424870466,0.051813472,0.678756477,2,0.644360335
19401,124,23234,5,3,10,0,0,18,3,10,10,0,0,23,nowin,win,dlbust,bust,20,0,8,202,0.47029703,0.064356436,0.584158416,3,0.899458193
19402,125,23234,10,10,0,0,0,20,3,10,10,0,0,23,nowin,win,dlbust,bust,20,0,20,219,0.438356164,0.050228311,0.575342466,1,0.308411257
19403,112,23234,8,10,0,0,0,18,3,10,10,0,0,23,nowin,win,dlbust,bust,20,0,18,203,0.448275862,0.054187192,0.600985222,3,0.889576933
19404,87,23235,7,10,0,0,0,17,6,4,7,0,0,17,nowin,push,push,push,10,0,17,202,0.405940594,0.054455446,0.628712871,2,0.590599801
19405,47,23235,3,7,2,0,0,12,6,4,7,0,0,17,nowin,loss,beat,dlwin,0,10,10,210,0.438095238,0.057142857,0.623809524,2,0.615868808
19406,141,23235,10,10,0,0,0,20,6,4,7,0,0,17,nowin,win,plwin,beat,20,0,20,202,0.420792079,0.074257426,0.564356436,0,0.028377851
19407,60,23235,6,5,10,0,0,21,6,4,7,0,0,17,nowin,win,plwin,beat,20,0,11,227,0.418502203,0.022026432,0.559471366,0,0.026496258
19408,107,23235,10,4,0,0,0,14,6,4,7,0,0,17,nowin,loss,beat,dlwin,0,10,14,218,0.444954128,0.073394495,0.600917431,2,0.605210014
19409,10,23235,4,2,4,5,0,15,6,4,7,0,0,17,nowin,loss,beat,dlwin,0,10,6,191,0.413612565,0.057591623,0.596858639,2,0.574087175
19410,95,23236,10,3,0,10,0,23,8,5,10,0,0,23,nowin,loss,bust,plbust,0,10,13,218,0.412844037,0.04587156,0.559633028,0,0.024842385
19411,20,23236,2,5,10,0,0,17,8,5,10,0,0,23,nowin,win,dlbust,bust,20,0,7,186,0.456989247,0.037634409,0.537634409,1,0.301097108
19412,129,23236,10,3,0,7,0,20,8,5,10,0,0,23,nowin,win,dlbust,bust,20,0,13,201,0.422885572,0.064676617,0.55721393,0,0.027255383
19413,120,23236,11,10,0,0,0,21,8,5,10,0,0,23,win,win,dlbust,bust,25,0,21,202,0.440594059,0.034653465,0.618811881,2,0.614441029
19414,94,23236,10,2,0,4,5,21,8,5,10,0,0,23,nowin,win,dlbust,bust,20,0,12,183,0.43715847,0.043715847,0.540983607,1,0.290866892
19415,57,23236,4,8,0,10,0,22,8,5,10,0,0,23,nowin,loss,bust,plbust,0,10,12,192,0.46875,0.052083333,0.59375,3,0.907001181
19416,112,23237,10,7,0,0,0,17,4,3,8,10,0,25,nowin,win,dlbust,bust,20,0,17,203,0.448275862,0.054187192,0.600985222,3,0.889576933
19417,119,23237,10,11,0,0,0,21,4,3,8,10,0,25,win,win,dlbust,bust,25,0,21,190,0.405263158,0.068421053,0.515789474,0,0.011837158
19418,106,23237,5,8,0,0,0,13,4,3,8,10,0,25,nowin,win,dlbust,bust,20,0,13,192,0.411458333,0.026041667,0.557291667,0,0.023854304
19419,18,23237,9,6,0,0,0,15,4,3,8,10,0,25,nowin,win,dlbust,bust,20,0,15,182,0.461538462,0.043956044,0.587912088,3,0.892649374
19420,95,23237,5,10,0,0,0,15,4,3,8,10,0,25,nowin,win,dlbust,bust,20,0,15,218,0.412844037,0.04587156,0.559633028,0,0.024842385
19421,73,23237,1,3,10,0,0,14,4,3,8,10,0,25,nowin,win,dlbust,bust,20,0,4,181,0.375690608,0.011049724,0.596685083,0,0.022795773
19422,136,23238,5,6,5,0,0,16,5,8,1,5,0,19,nowin,loss,beat,dlwin,0,10,11,194,0.396907216,0.025773196,0.597938144,0,0.029452644
19423,135,23238,6,10,0,0,0,16,5,8,1,5,0,19,nowin,loss,beat,dlwin,0,10,16,179,0.391061453,0.067039106,0.586592179,0,0.024924662
19424,64,23238,10,7,0,0,0,17,5,8,1,5,0,19,nowin,loss,beat,dlwin,0,10,17,187,0.363636364,0.048128342,0.631016043,0,0.027594885
19425,52,23238,2,6,10,0,0,18,5,8,1,5,0,19,nowin,loss,beat,dlwin,0,10,8,217,0.414746544,0.02764977,0.599078341,2,0.576736024
19426,27,23238,6,4,7,0,0,17,5,8,1,5,0,19,nowin,loss,beat,dlwin,0,10,10,178,0.370786517,0.016853933,0.573033708,0,0.015536309
19427,3,23238,3,11,5,0,0,19,5,8,1,5,0,19,nowin,push,push,push,10,0,14,190,0.431578947,0.026315789,0.542105263,1,0.288076384
19428,18,23239,10,10,0,0,0,20,5,1,7,10,0,23,nowin,win,dlbust,bust,20,0,20,182,0.461538462,0.043956044,0.587912088,3,0.892649374
19429,95,23239,4,10,0,0,0,14,5,1,7,10,0,23,nowin,win,dlbust,bust,20,0,14,218,0.412844037,0.04587156,0.559633028,0,0.024842385
19430,80,23239,10,10,0,0,0,20,5,1,7,10,0,23,nowin,win,dlbust,bust,20,0,20,186,0.419354839,0.059139785,0.623655914,2,0.59892924
19431,127,23239,10,2,0,0,0,12,5,1,7,10,0,23,nowin,win,dlbust,bust,20,0,12,201,0.402985075,0.029850746,0.60199005,0,0.032263937
19432,60,23239,6,10,0,0,0,16,5,1,7,10,0,23,nowin,win,dlbust,bust,20,0,16,227,0.418502203,0.022026432,0.559471366,0,0.026496258
19433,108,23239,2,11,4,0,0,17,5,1,7,10,0,23,nowin,win,dlbust,bust,20,0,13,193,0.435233161,0.056994819,0.559585492,1,0.298824795
19434,81,23240,10,10,0,0,0,20,10,4,2,10,0,26,nowin,win,dlbust,bust,20,0,20,182,0.395604396,0.043956044,0.60989011,2,0.567491261
19435,76,23240,10,10,0,0,0,20,10,4,2,10,0,26,nowin,win,dlbust,bust,20,0,20,189,0.534391534,0.079365079,0.608465608,3,1
19436,59,23240,10,10,0,0,0,20,10,4,2,10,0,26,nowin,win,dlbust,bust,20,0,20,228,0.429824561,0.048245614,0.543859649,1,0.287885446
19437,110,23240,7,10,0,0,0,17,10,4,2,10,0,26,nowin,win,dlbust,bust,20,0,17,192,0.416666667,0.046875,0.557291667,0,0.025413132
19438,21,23240,8,9,0,0,0,17,10,4,2,10,0,26,nowin,win,dlbust,bust,20,0,17,214,0.359813084,0.042056075,0.626168224,0,0.025263474
19439,146,23240,6,5,9,0,0,20,10,4,2,10,0,26,nowin,win,dlbust,bust,20,0,11,221,0.43438914,0.040723982,0.542986425,1,0.290190091
19440,55,23241,3,6,5,10,0,24,8,7,9,0,0,24,nowin,loss,bust,plbust,0,10,9,191,0.371727749,0.057591623,0.54973822,0,0.01011347
19441,112,23241,2,2,9,4,0,17,8,7,9,0,0,24,nowin,win,dlbust,bust,20,0,4,203,0.448275862,0.054187192,0.600985222,3,0.889576933
19442,146,23241,10,3,0,10,0,23,8,7,9,0,0,24,nowin,loss,bust,plbust,0,10,13,221,0.43438914,0.040723982,0.542986425,1,0.290190091
19443,42,23241,10,4,0,4,0,18,8,7,9,0,0,24,nowin,win,dlbust,bust,20,0,14,212,0.443396226,0.051886792,0.570754717,1,0.309181312
19444,84,23241,3,10,0,3,10,26,8,7,9,0,0,24,nowin,loss,bust,plbust,0,10,13,195,0.379487179,0.056410256,0.569230769,0,0.017209119
19445,12,23241,5,4,3,10,0,22,8,7,9,0,0,24,nowin,loss,bust,plbust,0,10,9,189,0.470899471,0.015873016,0.613756614,3,0.929171178
19446,150,23242,6,3,3,9,0,21,11,1,9,0,0,21,nowin,push,push,push,10,0,9,192,0.401041667,0.036458333,0.567708333,0,0.023287458
19447,6,23242,5,10,0,6,0,21,11,1,9,0,0,21,nowin,push,push,push,10,0,15,191,0.439790576,0.047120419,0.581151832,1,0.31211505
19448,14,23242,3,10,0,10,0,23,11,1,9,0,0,21,nowin,loss,bust,plbust,0,10,13,202,0.391089109,0.01980198,0.628712871,2,0.577264877
19449,26,23242,7,5,0,6,0,18,11,1,9,0,0,21,nowin,loss,beat,dlwin,0,10,12,203,0.463054187,0.0591133,0.541871921,1,0.306802864
19450,19,23242,3,5,10,0,0,18,11,1,9,0,0,21,nowin,loss,beat,dlwin,0,10,8,237,0.41350211,0.054852321,0.628691983,2,0.597373826
19451,16,23242,4,4,10,0,0,18,11,1,9,0,0,21,nowin,loss,beat,dlwin,0,10,8,220,0.427272727,0.081818182,0.6,2,0.588660176
19452,8,23243,10,5,0,2,0,17,7,4,7,0,0,18,nowin,loss,beat,dlwin,0,10,15,181,0.44198895,0.071823204,0.596685083,2,0.599438402
19453,133,23243,4,4,4,4,3,19,7,4,7,0,0,18,nowin,win,plwin,beat,20,0,8,201,0.47761194,0.064676617,0.611940299,3,0.935428111
19454,70,23243,9,4,0,4,0,17,7,4,7,0,0,18,nowin,loss,beat,dlwin,0,10,13,228,0.385964912,0.039473684,0.557017544,0,0.016157125
19455,3,23243,10,4,0,10,0,24,7,4,7,0,0,18,nowin,loss,bust,plbust,0,10,14,190,0.431578947,0.026315789,0.542105263,1,0.288076384
19456,41,23243,10,2,0,2,3,17,7,4,7,0,0,18,nowin,loss,beat,dlwin,0,10,12,192,0.364583333,0.036458333,0.520833333,0,0.00089702
19457,25,23243,3,6,2,7,0,18,7,4,7,0,0,18,nowin,push,push,push,10,0,9,190,0.463157895,0.063157895,0.536842105,1,0.304401563
19458,87,23244,3,6,4,0,0,13,2,9,10,0,0,21,nowin,loss,beat,dlwin,0,10,9,202,0.405940594,0.054455446,0.628712871,2,0.590599801
19459,47,23244,1,6,10,0,0,17,2,9,10,0,0,21,nowin,loss,beat,dlwin,0,10,7,210,0.438095238,0.057142857,0.623809524,2,0.615868808
19460,50,23244,5,10,0,0,0,15,2,9,10,0,0,21,nowin,loss,beat,dlwin,0,10,15,202,0.405940594,0.04950495,0.54950495,0,0.020296079
19461,108,23244,10,10,0,0,0,20,2,9,10,0,0,21,nowin,loss,beat,dlwin,0,10,20,193,0.435233161,0.056994819,0.559585492,1,0.298824795
19462,133,23244,6,3,5,0,0,14,2,9,10,0,0,21,nowin,loss,beat,dlwin,0,10,9,201,0.47761194,0.064676617,0.611940299,3,0.935428111
19463,15,23244,5,10,0,0,0,15,2,9,10,0,0,21,nowin,loss,beat,dlwin,0,10,15,212,0.410377358,0.051886792,0.561320755,0,0.024517408
19464,24,23245,4,10,0,3,0,17,7,9,10,0,0,26,nowin,win,dlbust,bust,20,0,14,207,0.458937198,0.048309179,0.570048309,1,0.318138014
19465,118,23245,4,5,6,4,0,19,7,9,10,0,0,26,nowin,win,dlbust,bust,20,0,9,216,0.393518519,0.037037037,0.555555556,0,0.018059873
19466,93,23245,10,2,0,3,6,21,7,9,10,0,0,26,nowin,win,dlbust,bust,20,0,12,175,0.485714286,0.051428571,0.548571429,1,0.323648091
19467,136,23245,3,8,4,10,0,25,7,9,10,0,0,26,nowin,loss,bust,plbust,0,10,11,194,0.396907216,0.025773196,0.597938144,0,0.029452644
19468,44,23245,10,5,0,3,0,18,7,9,10,0,0,26,nowin,win,dlbust,bust,20,0,15,219,0.433789954,0.050228311,0.534246575,1,0.285551035
19469,135,23245,6,8,0,10,0,24,7,9,10,0,0,26,nowin,loss,bust,plbust,0,10,14,179,0.391061453,0.067039106,0.586592179,0,0.024924662
19470,19,23246,2,10,0,9,0,21,3,11,4,0,0,18,nowin,win,plwin,beat,20,0,12,237,0.41350211,0.054852321,0.628691983,2,0.597373826
19471,132,23246,4,7,8,0,0,19,3,11,4,0,0,18,nowin,win,plwin,beat,20,0,11,194,0.412371134,0.036082474,0.649484536,2,0.611633238
19472,67,23246,10,6,0,0,0,16,3,11,4,0,0,18,nowin,loss,beat,dlwin,0,10,16,195,0.369230769,0.041025641,0.569230769,0,0.014139427
19473,27,23246,10,5,0,0,0,15,3,11,4,0,0,18,nowin,loss,beat,dlwin,0,10,15,178,0.370786517,0.016853933,0.573033708,0,0.015536309
19474,21,23246,6,10,0,0,0,16,3,11,4,0,0,18,nowin,loss,beat,dlwin,0,10,16,214,0.359813084,0.042056075,0.626168224,0,0.025263474
19475,108,23246,9,10,0,0,0,19,3,11,4,0,0,18,nowin,win,plwin,beat,20,0,19,193,0.435233161,0.056994819,0.559585492,1,0.298824795
19476,100,23247,9,10,0,0,0,19,4,10,6,0,0,20,nowin,loss,beat,dlwin,0,10,19,190,0.452631579,0.036842105,0.594736842,3,0.888671154
19477,35,23247,10,4,0,0,0,14,4,10,6,0,0,20,nowin,loss,beat,dlwin,0,10,14,202,0.410891089,0.044554455,0.633663366,2,0.598681573
19478,130,23247,7,7,0,0,0,14,4,10,6,0,0,20,nowin,loss,beat,dlwin,0,10,14,219,0.410958904,0.03652968,0.566210046,0,0.025888739
19479,135,23247,5,9,0,0,0,14,4,10,6,0,0,20,nowin,loss,beat,dlwin,0,10,14,179,0.391061453,0.067039106,0.586592179,0,0.024924662
19480,76,23247,3,4,10,0,0,17,4,10,6,0,0,20,nowin,loss,beat,dlwin,0,10,7,189,0.534391534,0.079365079,0.608465608,3,1
19481,1,23247,10,10,0,0,0,20,4,10,6,0,0,20,nowin,push,push,push,10,0,20,197,0.406091371,0.025380711,0.649746193,2,0.606186955
19482,116,23248,3,5,9,0,0,17,5,10,10,0,0,25,nowin,win,dlbust,bust,20,0,8,195,0.425641026,0.056410256,0.538461538,1,0.28273747
19483,14,23248,2,7,10,0,0,19,5,10,10,0,0,25,nowin,win,dlbust,bust,20,0,9,202,0.391089109,0.01980198,0.628712871,2,0.577264877
19484,53,23248,6,8,0,0,0,14,5,10,10,0,0,25,nowin,win,dlbust,bust,20,0,14,250,0.372,0.064,0.564,0,0.013687345
19485,21,23248,11,1,1,0,0,13,5,10,10,0,0,25,nowin,win,dlbust,bust,20,0,12,214,0.359813084,0.042056075,0.626168224,0,0.025263474
19486,138,23248,10,4,0,0,0,14,5,10,10,0,0,25,nowin,win,dlbust,bust,20,0,14,190,0.442105263,0.047368421,0.610526316,2,0.609711065
19487,23,23248,4,3,3,10,0,20,5,10,10,0,0,25,nowin,win,dlbust,bust,20,0,7,208,0.427884615,0.0625,0.552884615,1,0.29114424
19488,79,23249,11,6,3,0,0,20,10,5,10,0,0,25,nowin,win,dlbust,bust,20,0,17,211,0.436018957,0.028436019,0.672985782,2,0.650131054
19489,95,23249,10,10,0,0,0,20,10,5,10,0,0,25,nowin,win,dlbust,bust,20,0,20,218,0.412844037,0.04587156,0.559633028,0,0.024842385
19490,85,23249,10,11,0,0,0,21,10,5,10,0,0,25,win,win,dlbust,bust,25,0,21,195,0.41025641,0.066666667,0.594871795,0,0.03269711
19491,61,23249,6,3,10,0,0,19,10,5,10,0,0,25,nowin,win,dlbust,bust,20,0,9,194,0.427835052,0.077319588,0.603092784,2,0.591437139
19492,96,23249,8,11,0,0,0,19,10,5,10,0,0,25,nowin,win,dlbust,bust,20,0,19,190,0.468421053,0.057894737,0.584210526,3,0.897263354
19493,97,23249,10,8,0,0,0,18,10,5,10,0,0,25,nowin,win,dlbust,bust,20,0,18,182,0.450549451,0.06043956,0.692307692,2,0.677372279
19494,104,23250,6,2,2,5,0,15,5,10,5,0,0,20,nowin,loss,beat,dlwin,0,10,8,209,0.363636364,0.052631579,0.593301435,0,0.018359419
19495,78,23250,8,10,0,0,0,18,5,10,5,0,0,20,nowin,loss,beat,dlwin,0,10,18,201,0.517412935,0.034825871,0.587064677,3,0.95871112
19496,19,23250,5,10,0,0,0,15,5,10,5,0,0,20,nowin,loss,beat,dlwin,0,10,15,237,0.41350211,0.054852321,0.628691983,2,0.597373826
19497,41,23250,7,5,0,0,0,12,5,10,5,0,0,20,nowin,loss,beat,dlwin,0,10,12,192,0.364583333,0.036458333,0.520833333,0,0.00089702
19498,9,23250,7,6,0,0,0,13,5,10,5,0,0,20,nowin,loss,beat,dlwin,0,10,13,194,0.37628866,0.015463918,0.541237113,0,0.009396796
19499,70,23250,2,10,0,0,0,12,5,10,5,0,0,20,nowin,loss,beat,dlwin,0,10,12,228,0.385964912,0.039473684,0.557017544,0,0.016157125
19500,65,23251,9,7,0,0,0,16,4,10,6,0,0,20,nowin,loss,beat,dlwin,0,10,16,203,0.492610837,0.054187192,0.571428571,3,0.913702814
19501,12,23251,10,3,0,0,0,13,4,10,6,0,0,20,nowin,loss,beat,dlwin,0,10,13,189,0.470899471,0.015873016,0.613756614,3,0.929171178
19502,146,23251,6,3,2,1,0,12,4,10,6,0,0,20,nowin,loss,beat,dlwin,0,10,9,221,0.43438914,0.040723982,0.542986425,1,0.290190091
19503,19,23251,2,4,10,0,0,16,4,10,6,0,0,20,nowin,loss,beat,dlwin,0,10,6,237,0.41350211,0.054852321,0.628691983,2,0.597373826
19504,95,23251,3,8,10,0,0,21,4,10,6,0,0,20,nowin,win,plwin,beat,20,0,11,218,0.412844037,0.04587156,0.559633028,0,0.024842385
19505,30,23251,7,10,0,0,0,17,4,10,6,0,0,20,nowin,loss,beat,dlwin,0,10,17,206,0.393203883,0.033980583,0.601941748,0,0.029324648
19506,21,23252,6,2,5,2,1,16,9,4,4,0,0,17,nowin,loss,beat,dlwin,0,10,8,214,0.359813084,0.042056075,0.626168224,0,0.025263474
19507,100,23252,10,10,0,0,0,20,9,4,4,0,0,17,nowin,win,plwin,beat,20,0,20,190,0.452631579,0.036842105,0.594736842,3,0.888671154
19508,148,23252,10,9,0,0,0,19,9,4,4,0,0,17,nowin,win,plwin,beat,20,0,19,204,0.401960784,0.078431373,0.593137255,0,0.029789521
19509,2,23252,6,10,0,6,0,22,9,4,4,0,0,17,nowin,loss,bust,plbust,0,10,16,200,0.445,0.035,0.64,2,0.633962549
19510,94,23252,7,10,0,0,0,17,9,4,4,0,0,17,nowin,push,push,push,10,0,17,183,0.43715847,0.043715847,0.540983607,1,0.290866892
19511,26,23252,8,10,0,0,0,18,9,4,4,0,0,17,nowin,win,plwin,beat,20,0,18,203,0.463054187,0.0591133,0.541871921,1,0.306802864
19512,35,23253,10,10,0,0,0,20,10,9,0,0,0,19,nowin,win,plwin,beat,20,0,20,202,0.410891089,0.044554455,0.633663366,2,0.598681573
19513,62,23253,6,6,0,4,2,18,10,9,0,0,0,19,nowin,loss,beat,dlwin,0,10,12,178,0.370786517,0.028089888,0.54494382,0,0.008657722
19514,77,23253,9,4,0,9,0,22,10,9,0,0,0,19,nowin,loss,bust,plbust,0,10,13,200,0.455,0.04,0.62,3,0.916252116
19515,67,23253,7,2,5,10,0,24,10,9,0,0,0,19,nowin,loss,bust,plbust,0,10,9,195,0.369230769,0.041025641,0.569230769,0,0.014139427
19516,136,23253,10,8,0,0,0,18,10,9,0,0,0,19,nowin,loss,beat,dlwin,0,10,18,194,0.396907216,0.025773196,0.597938144,0,0.029452644
19517,82,23253,3,3,5,2,3,16,10,9,0,0,0,19,nowin,loss,beat,dlwin,0,10,6,225,0.408888889,0.075555556,0.577777778,0,0.028101874
19518,117,23254,3,8,3,4,0,18,10,11,0,0,0,21,nowin,loss,beat,dlwin,0,10,11,173,0.410404624,0.069364162,0.606936416,2,0.578610282
19519,126,23254,10,5,0,9,0,24,10,11,0,0,0,21,nowin,loss,bust,plbust,0,10,15,188,0.457446809,0.074468085,0.60106383,3,0.900633203
19520,93,23254,10,8,0,0,0,18,10,11,0,0,0,21,nowin,loss,beat,dlwin,0,10,18,175,0.485714286,0.051428571,0.548571429,1,0.323648091
19521,110,23254,4,10,0,5,0,19,10,11,0,0,0,21,nowin,loss,beat,dlwin,0,10,14,192,0.416666667,0.046875,0.557291667,0,0.025413132
19522,128,23254,10,10,0,0,0,20,10,11,0,0,0,21,nowin,loss,beat,dlwin,0,10,20,227,0.356828194,0.052863436,0.577092511,0,0.012352564
19523,68,23254,3,4,10,0,0,17,10,11,0,0,0,21,nowin,loss,beat,dlwin,0,10,7,205,0.434146341,0.029268293,0.6,2,0.59483189
19524,149,23255,10,10,0,0,0,20,8,10,0,0,0,18,nowin,win,plwin,beat,20,0,20,225,0.457777778,0.057777778,0.648888889,2,0.651965595
19525,124,23255,4,1,7,8,0,20,8,10,0,0,0,18,nowin,win,plwin,beat,20,0,5,202,0.47029703,0.064356436,0.584158416,3,0.899458193
19526,26,23255,6,5,7,0,0,18,8,10,0,0,0,18,nowin,push,push,push,10,0,11,203,0.463054187,0.0591133,0.541871921,1,0.306802864
19527,22,23255,10,4,0,5,0,19,8,10,0,0,0,18,nowin,win,plwin,beat,20,0,14,187,0.481283422,0.042780749,0.577540107,3,0.906128176
19528,145,23255,7,7,0,5,0,19,8,10,0,0,0,18,nowin,win,plwin,beat,20,0,14,188,0.441489362,0.031914894,0.622340426,2,0.617837093
19529,9,23255,8,2,9,0,0,19,8,10,0,0,0,18,nowin,win,plwin,beat,20,0,10,194,0.37628866,0.015463918,0.541237113,0,0.009396796
19530,130,23256,5,8,0,0,0,13,3,10,10,0,0,23,nowin,win,dlbust,bust,20,0,13,219,0.410958904,0.03652968,0.566210046,0,0.025888739
19531,34,23256,4,2,2,10,0,18,3,10,10,0,0,23,nowin,win,dlbust,bust,20,0,6,202,0.5,0.079207921,0.618811881,3,0.968961434
19532,3,23256,10,7,0,0,0,17,3,10,10,0,0,23,nowin,win,dlbust,bust,20,0,17,190,0.431578947,0.026315789,0.542105263,1,0.288076384
19533,48,23256,2,10,0,6,0,18,3,10,10,0,0,23,nowin,win,dlbust,bust,20,0,12,203,0.413793103,0.019704433,0.600985222,2,0.577280801
19534,56,23256,10,2,0,6,0,18,3,10,10,0,0,23,nowin,win,dlbust,bust,20,0,12,175,0.4,0.057142857,0.582857143,0,0.026685297
19535,23,23256,1,3,10,0,0,14,3,10,10,0,0,23,nowin,win,dlbust,bust,20,0,4,208,0.427884615,0.0625,0.552884615,1,0.29114424
19536,108,23257,10,2,0,0,0,12,4,10,2,8,0,24,nowin,win,dlbust,bust,20,0,12,193,0.435233161,0.056994819,0.559585492,1,0.298824795
19537,6,23257,10,7,0,0,0,17,4,10,2,8,0,24,nowin,win,dlbust,bust,20,0,17,191,0.439790576,0.047120419,0.581151832,1,0.31211505
19538,117,23257,10,3,0,0,0,13,4,10,2,8,0,24,nowin,win,dlbust,bust,20,0,13,173,0.410404624,0.069364162,0.606936416,2,0.578610282
19539,116,23257,5,6,6,0,0,17,4,10,2,8,0,24,nowin,win,dlbust,bust,20,0,11,195,0.425641026,0.056410256,0.538461538,1,0.28273747
19540,70,23257,10,10,0,0,0,20,4,10,2,8,0,24,nowin,win,dlbust,bust,20,0,20,228,0.385964912,0.039473684,0.557017544,0,0.016157125
19541,14,23257,7,7,0,0,0,14,4,10,2,8,0,24,nowin,win,dlbust,bust,20,0,14,202,0.391089109,0.01980198,0.628712871,2,0.577264877
19542,108,23258,5,10,0,0,0,15,4,7,10,0,0,21,nowin,loss,beat,dlwin,0,10,15,193,0.435233161,0.056994819,0.559585492,1,0.298824795
19543,73,23258,9,6,0,0,0,15,4,7,10,0,0,21,nowin,loss,beat,dlwin,0,10,15,181,0.375690608,0.011049724,0.596685083,0,0.022795773
19544,129,23258,9,10,0,0,0,19,4,7,10,0,0,21,nowin,loss,beat,dlwin,0,10,19,201,0.422885572,0.064676617,0.55721393,0,0.027255383
19545,98,23258,9,10,0,0,0,19,4,7,10,0,0,21,nowin,loss,beat,dlwin,0,10,19,220,0.422727273,0.054545455,0.55,1,0.28664435
19546,94,23258,10,10,0,0,0,20,4,7,10,0,0,21,nowin,loss,beat,dlwin,0,10,20,183,0.43715847,0.043715847,0.540983607,1,0.290866892
19547,81,23258,10,11,0,0,0,21,4,7,10,0,0,21,win,push,push,push,10,0,21,182,0.395604396,0.043956044,0.60989011,2,0.567491261
19548,27,23259,2,3,2,10,0,17,7,5,7,0,0,19,nowin,loss,beat,dlwin,0,10,5,178,0.370786517,0.016853933,0.573033708,0,0.015536309
19549,118,23259,8,2,10,0,0,20,7,5,7,0,0,19,nowin,win,plwin,beat,20,0,10,216,0.393518519,0.037037037,0.555555556,0,0.018059873
19550,33,23259,3,8,10,0,0,21,7,5,7,0,0,19,nowin,win,plwin,beat,20,0,11,192,0.4375,0.057291667,0.625,2,0.616208916
19551,110,23259,6,5,7,0,0,18,7,5,7,0,0,19,nowin,loss,beat,dlwin,0,10,11,192,0.416666667,0.046875,0.557291667,0,0.025413132
19552,103,23259,9,6,0,10,0,25,7,5,7,0,0,19,nowin,loss,bust,plbust,0,10,15,203,0.379310345,0.064039409,0.551724138,0,0.012869209
19553,150,23259,10,3,0,2,10,25,7,5,7,0,0,19,nowin,loss,bust,plbust,0,10,13,192,0.401041667,0.036458333,0.567708333,0,0.023287458
19554,136,23260,6,9,0,4,0,19,10,10,0,0,0,20,nowin,loss,beat,dlwin,0,10,15,194,0.396907216,0.025773196,0.597938144,0,0.029452644
19555,104,23260,9,3,0,9,0,21,10,10,0,0,0,20,nowin,win,plwin,beat,20,0,12,209,0.363636364,0.052631579,0.593301435,0,0.018359419
19556,90,23260,10,10,0,0,0,20,10,10,0,0,0,20,nowin,push,push,push,10,0,20,201,0.447761194,0.049751244,0.60199005,3,0.889945023
19557,44,23260,10,3,0,2,10,25,10,10,0,0,0,20,nowin,loss,bust,plbust,0,10,13,219,0.433789954,0.050228311,0.534246575,1,0.285551035
19558,144,23260,10,10,0,0,0,20,10,10,0,0,0,20,nowin,push,push,push,10,0,20,202,0.386138614,0.054455446,0.564356436,0,0.018006244
19559,15,23260,8,10,0,0,0,18,10,10,0,0,0,20,nowin,loss,beat,dlwin,0,10,18,212,0.410377358,0.051886792,0.561320755,0,0.024517408
19560,126,23261,10,10,0,0,0,20,8,7,2,0,0,17,nowin,win,plwin,beat,20,0,20,188,0.457446809,0.074468085,0.60106383,3,0.900633203
19561,44,23261,6,5,8,0,0,19,8,7,2,0,0,17,nowin,win,plwin,beat,20,0,11,219,0.433789954,0.050228311,0.534246575,1,0.285551035
19562,8,23261,10,10,0,0,0,20,8,7,2,0,0,17,nowin,win,plwin,beat,20,0,20,181,0.44198895,0.071823204,0.596685083,2,0.599438402
19563,3,23261,4,10,0,8,0,22,8,7,2,0,0,17,nowin,loss,bust,plbust,0,10,14,190,0.431578947,0.026315789,0.542105263,1,0.288076384
19564,60,23261,8,10,0,0,0,18,8,7,2,0,0,17,nowin,win,plwin,beat,20,0,18,227,0.418502203,0.022026432,0.559471366,0,0.026496258
19565,29,23261,9,8,0,0,0,17,8,7,2,0,0,17,nowin,push,push,push,10,0,17,189,0.44973545,0.058201058,0.544973545,1,0.300349439
19566,78,23262,10,6,0,3,0,19,7,3,3,10,0,23,nowin,win,dlbust,bust,20,0,16,201,0.517412935,0.034825871,0.587064677,3,0.95871112
19567,66,23262,1,3,10,4,0,18,7,3,3,10,0,23,nowin,win,dlbust,bust,20,0,4,217,0.456221198,0.064516129,0.626728111,3,0.924304367
19568,36,23262,9,9,0,0,0,18,7,3,3,10,0,23,nowin,win,dlbust,bust,20,0,18,229,0.445414847,0.056768559,0.655021834,2,0.645370571
19569,65,23262,4,7,1,3,9,24,7,3,3,10,0,23,nowin,loss,bust,plbust,0,10,11,203,0.492610837,0.054187192,0.571428571,3,0.913702814
19570,61,23262,7,10,0,0,0,17,7,3,3,10,0,23,nowin,win,dlbust,bust,20,0,17,194,0.427835052,0.077319588,0.603092784,2,0.591437139
19571,102,23262,4,7,2,10,0,23,7,3,3,10,0,23,nowin,loss,bust,plbust,0,10,11,192,0.338541667,0.046875,0.5625,0,0.003306118
19572,117,23263,3,10,0,8,0,21,10,6,7,0,0,23,nowin,win,dlbust,bust,20,0,13,173,0.410404624,0.069364162,0.606936416,2,0.578610282
19573,57,23263,6,3,6,10,0,25,10,6,7,0,0,23,nowin,loss,bust,plbust,0,10,9,192,0.46875,0.052083333,0.59375,3,0.907001181
19574,20,23263,10,7,0,0,0,17,10,6,7,0,0,23,nowin,win,dlbust,bust,20,0,17,186,0.456989247,0.037634409,0.537634409,1,0.301097108
19575,113,23263,10,6,0,4,0,20,10,6,7,0,0,23,nowin,win,dlbust,bust,20,0,16,199,0.407035176,0.055276382,0.668341709,2,0.620695264
19576,135,23263,3,10,0,10,0,23,10,6,7,0,0,23,nowin,loss,bust,plbust,0,10,13,179,0.391061453,0.067039106,0.586592179,0,0.024924662
19577,47,23263,4,7,10,0,0,21,10,6,7,0,0,23,nowin,win,dlbust,bust,20,0,11,210,0.438095238,0.057142857,0.623809524,2,0.615868808
19578,88,23264,8,5,0,0,0,13,4,2,9,10,0,25,nowin,win,dlbust,bust,20,0,13,206,0.466019417,0.033980583,0.54368932,1,0.309467903
19579,134,23264,9,10,0,0,0,19,4,2,9,10,0,25,nowin,win,dlbust,bust,20,0,19,185,0.443243243,0.021621622,0.545945946,1,0.296939509
19580,94,23264,10,6,0,0,0,16,4,2,9,10,0,25,nowin,win,dlbust,bust,20,0,16,183,0.43715847,0.043715847,0.540983607,1,0.290866892
19581,27,23264,10,9,0,0,0,19,4,2,9,10,0,25,nowin,win,dlbust,bust,20,0,19,178,0.370786517,0.016853933,0.573033708,0,0.015536309
19582,85,23264,2,3,10,0,0,15,4,2,9,10,0,25,nowin,win,dlbust,bust,20,0,5,195,0.41025641,0.066666667,0.594871795,0,0.03269711
19583,57,23264,7,9,0,0,0,16,4,2,9,10,0,25,nowin,win,dlbust,bust,20,0,16,192,0.46875,0.052083333,0.59375,3,0.907001181
19584,54,23265,10,2,0,2,1,15,10,8,0,0,0,18,nowin,loss,beat,dlwin,0,10,12,185,0.437837838,0.032432432,0.556756757,1,0.29899854
19585,105,23265,6,10,0,1,0,17,10,8,0,0,0,18,nowin,loss,beat,dlwin,0,10,16,198,0.414141414,0.070707071,0.590909091,0,0.032889494
19586,146,23265,9,2,10,0,0,21,10,8,0,0,0,18,nowin,win,plwin,beat,20,0,11,221,0.43438914,0.040723982,0.542986425,1,0.290190091
19587,80,23265,10,6,0,10,0,26,10,8,0,0,0,18,nowin,loss,bust,plbust,0,10,16,186,0.419354839,0.059139785,0.623655914,2,0.59892924
19588,10,23265,2,7,4,4,0,17,10,8,0,0,0,18,nowin,loss,beat,dlwin,0,10,9,191,0.413612565,0.057591623,0.596858639,2,0.574087175
19589,91,23265,10,6,0,10,0,26,10,8,0,0,0,18,nowin,loss,bust,plbust,0,10,16,194,0.417525773,0.046391753,0.515463918,1,0.266616552
19590,82,23266,2,7,10,0,0,19,7,11,0,0,0,18,nowin,win,plwin,beat,20,0,9,225,0.408888889,0.075555556,0.577777778,0,0.028101874
19591,117,23266,9,6,0,4,0,19,7,11,0,0,0,18,nowin,win,plwin,beat,20,0,15,173,0.410404624,0.069364162,0.606936416,2,0.578610282
19592,33,23266,10,10,0,0,0,20,7,11,0,0,0,18,nowin,win,plwin,beat,20,0,20,192,0.4375,0.057291667,0.625,2,0.616208916
19593,41,23266,9,7,0,4,0,20,7,11,0,0,0,18,nowin,win,plwin,beat,20,0,16,192,0.364583333,0.036458333,0.520833333,0,0.00089702
19594,34,23266,6,10,0,1,0,17,7,11,0,0,0,18,nowin,loss,beat,dlwin,0,10,16,202,0.5,0.079207921,0.618811881,3,0.968961434
19595,65,23266,3,2,10,6,0,21,7,11,0,0,0,18,nowin,win,plwin,beat,20,0,5,203,0.492610837,0.054187192,0.571428571,3,0.913702814
19596,61,23267,7,5,0,4,10,26,8,9,0,0,0,17,nowin,loss,bust,plbust,0,10,12,194,0.427835052,0.077319588,0.603092784,2,0.591437139
19597,24,23267,4,10,0,10,0,24,8,9,0,0,0,17,nowin,loss,bust,plbust,0,10,14,207,0.458937198,0.048309179,0.570048309,1,0.318138014
19598,139,23267,7,10,0,0,0,17,8,9,0,0,0,17,nowin,push,push,push,10,0,17,192,0.380208333,0.036458333,0.59375,0,0.023429169
19599,4,23267,8,10,0,0,0,18,8,9,0,0,0,17,nowin,win,plwin,beat,20,0,18,217,0.460829493,0.036866359,0.562211982,1,0.315432839
19600,52,23267,3,10,0,7,0,20,8,9,0,0,0,17,nowin,win,plwin,beat,20,0,13,217,0.414746544,0.02764977,0.599078341,2,0.576736024
19601,112,23267,8,11,0,0,0,19,8,9,0,0,0,17,nowin,win,plwin,beat,20,0,19,203,0.448275862,0.054187192,0.600985222,3,0.889576933
19602,44,23268,10,7,0,0,0,17,8,7,3,0,0,18,nowin,loss,beat,dlwin,0,10,17,219,0.433789954,0.050228311,0.534246575,1,0.285551035
19603,25,23268,3,10,0,4,0,17,8,7,3,0,0,18,nowin,loss,beat,dlwin,0,10,13,190,0.463157895,0.063157895,0.536842105,1,0.304401563
19604,63,23268,2,10,0,7,0,19,8,7,3,0,0,18,nowin,win,plwin,beat,20,0,12,216,0.467592593,0.037037037,0.62037037,3,0.931690496
19605,15,23268,10,10,0,0,0,20,8,7,3,0,0,18,nowin,win,plwin,beat,20,0,20,212,0.410377358,0.051886792,0.561320755,0,0.024517408
19606,109,23268,10,3,0,1,2,16,8,7,3,0,0,18,nowin,loss,beat,dlwin,0,10,13,221,0.461538462,0.058823529,0.597285068,3,0.901830309
19607,58,23268,10,9,0,0,0,19,8,7,3,0,0,18,nowin,win,plwin,beat,20,0,19,195,0.430769231,0.041025641,0.584615385,2,0.580497586
19608,78,23269,8,10,0,0,0,18,3,10,1,8,0,22,nowin,win,dlbust,bust,20,0,18,201,0.517412935,0.034825871,0.587064677,3,0.95871112
19609,123,23269,10,10,0,0,0,20,3,10,1,8,0,22,nowin,win,dlbust,bust,20,0,20,205,0.43902439,0.034146341,0.614634146,2,0.609962544
19610,14,23269,4,6,7,0,0,17,3,10,1,8,0,22,nowin,win,dlbust,bust,20,0,10,202,0.391089109,0.01980198,0.628712871,2,0.577264877
19611,57,23269,9,6,0,0,0,15,3,10,1,8,0,22,nowin,win,dlbust,bust,20,0,15,192,0.46875,0.052083333,0.59375,3,0.907001181
19612,146,23269,8,5,0,0,0,13,3,10,1,8,0,22,nowin,win,dlbust,bust,20,0,13,221,0.43438914,0.040723982,0.542986425,1,0.290190091
19613,109,23269,10,11,0,0,0,21,3,10,1,8,0,22,win,win,dlbust,bust,25,0,21,221,0.461538462,0.058823529,0.597285068,3,0.901830309
19614,128,23270,10,6,0,10,0,26,10,10,0,0,0,20,nowin,loss,bust,plbust,0,10,16,227,0.356828194,0.052863436,0.577092511,0,0.012352564
19615,1,23270,6,3,4,3,9,25,10,10,0,0,0,20,nowin,loss,bust,plbust,0,10,9,197,0.406091371,0.025380711,0.649746193,2,0.606186955
19616,146,23270,4,7,10,0,0,21,10,10,0,0,0,20,nowin,win,plwin,beat,20,0,11,221,0.43438914,0.040723982,0.542986425,1,0.290190091
19617,144,23270,3,10,0,7,0,20,10,10,0,0,0,20,nowin,push,push,push,10,0,13,202,0.386138614,0.054455446,0.564356436,0,0.018006244
19618,33,23270,4,1,9,2,7,23,10,10,0,0,0,20,nowin,loss,bust,plbust,0,10,5,192,0.4375,0.057291667,0.625,2,0.616208916
19619,55,23270,7,3,9,0,0,19,10,10,0,0,0,20,nowin,loss,beat,dlwin,0,10,10,191,0.371727749,0.057591623,0.54973822,0,0.01011347
19620,148,23271,3,7,10,0,0,20,2,11,2,10,0,25,nowin,win,dlbust,bust,20,0,10,204,0.401960784,0.078431373,0.593137255,0,0.029789521
19621,63,23271,7,10,0,0,0,17,2,11,2,10,0,25,nowin,win,dlbust,bust,20,0,17,216,0.467592593,0.037037037,0.62037037,3,0.931690496
19622,24,23271,5,8,0,0,0,13,2,11,2,10,0,25,nowin,win,dlbust,bust,20,0,13,207,0.458937198,0.048309179,0.570048309,1,0.318138014
19623,109,23271,10,10,0,0,0,20,2,11,2,10,0,25,nowin,win,dlbust,bust,20,0,20,221,0.461538462,0.058823529,0.597285068,3,0.901830309
19624,108,23271,10,2,0,5,0,17,2,11,2,10,0,25,nowin,win,dlbust,bust,20,0,12,193,0.435233161,0.056994819,0.559585492,1,0.298824795
19625,123,23271,10,10,0,0,0,20,2,11,2,10,0,25,nowin,win,dlbust,bust,20,0,20,205,0.43902439,0.034146341,0.614634146,2,0.609962544
19626,136,23272,5,4,10,0,0,19,7,10,0,0,0,17,nowin,win,plwin,beat,20,0,9,194,0.396907216,0.025773196,0.597938144,0,0.029452644
19627,114,23272,4,10,0,10,0,24,7,10,0,0,0,17,nowin,loss,bust,plbust,0,10,14,198,0.47979798,0.025252525,0.611111111,3,0.937232995
19628,46,23272,10,10,0,0,0,20,7,10,0,0,0,17,nowin,win,plwin,beat,20,0,20,186,0.403225806,0.048387097,0.591397849,0,0.029742194
19629,98,23272,5,10,0,8,0,23,7,10,0,0,0,17,nowin,loss,bust,plbust,0,10,15,220,0.422727273,0.054545455,0.55,1,0.28664435
19630,90,23272,10,10,0,0,0,20,7,10,0,0,0,17,nowin,win,plwin,beat,20,0,20,201,0.447761194,0.049751244,0.60199005,3,0.889945023
19631,119,23272,5,10,0,10,0,25,7,10,0,0,0,17,nowin,loss,bust,plbust,0,10,15,190,0.405263158,0.068421053,0.515789474,0,0.011837158
19632,31,23273,7,5,0,0,0,12,6,10,2,0,0,18,nowin,loss,beat,dlwin,0,10,12,188,0.473404255,0.058510638,0.515957447,1,0.300306557
19633,47,23273,5,3,3,1,0,12,6,10,2,0,0,18,nowin,loss,beat,dlwin,0,10,8,210,0.438095238,0.057142857,0.623809524,2,0.615868808
19634,23,23273,5,7,0,0,0,12,6,10,2,0,0,18,nowin,loss,beat,dlwin,0,10,12,208,0.427884615,0.0625,0.552884615,1,0.29114424
19635,13,23273,8,9,0,0,0,17,6,10,2,0,0,18,nowin,loss,beat,dlwin,0,10,17,206,0.417475728,0.063106796,0.621359223,2,0.59555479
19636,6,23273,2,2,10,0,0,14,6,10,2,0,0,18,nowin,loss,beat,dlwin,0,10,4,191,0.439790576,0.047120419,0.581151832,1,0.31211505
19637,139,23273,10,11,0,0,0,21,6,10,2,0,0,18,win,win,plwin,beat,25,0,21,192,0.380208333,0.036458333,0.59375,0,0.023429169
19638,95,23274,10,4,0,10,0,24,8,9,0,0,0,17,nowin,loss,bust,plbust,0,10,14,218,0.412844037,0.04587156,0.559633028,0,0.024842385
19639,137,23274,7,6,0,4,0,17,8,9,0,0,0,17,nowin,push,push,push,10,0,13,194,0.417525773,0.046391753,0.536082474,1,0.276714602
19640,96,23274,10,5,0,7,0,22,8,9,0,0,0,17,nowin,loss,bust,plbust,0,10,15,190,0.468421053,0.057894737,0.584210526,3,0.897263354
19641,110,23274,10,10,0,0,0,20,8,9,0,0,0,17,nowin,win,plwin,beat,20,0,20,192,0.416666667,0.046875,0.557291667,0,0.025413132
19642,100,23274,9,10,0,0,0,19,8,9,0,0,0,17,nowin,win,plwin,beat,20,0,19,190,0.452631579,0.036842105,0.594736842,3,0.888671154
19643,14,23274,6,2,10,0,0,18,8,9,0,0,0,17,nowin,win,plwin,beat,20,0,8,202,0.391089109,0.01980198,0.628712871,2,0.577264877
19644,128,23275,11,9,0,0,0,20,4,6,4,4,0,18,nowin,win,plwin,beat,20,0,20,227,0.356828194,0.052863436,0.577092511,0,0.012352564
19645,11,23275,5,10,0,0,0,15,4,6,4,4,0,18,nowin,loss,beat,dlwin,0,10,15,236,0.457627119,0.016949153,0.588983051,3,0.889015813
19646,105,23275,6,2,6,0,0,14,4,6,4,4,0,18,nowin,loss,beat,dlwin,0,10,8,198,0.414141414,0.070707071,0.590909091,0,0.032889494
19647,9,23275,2,10,0,0,0,12,4,6,4,4,0,18,nowin,loss,beat,dlwin,0,10,12,194,0.37628866,0.015463918,0.541237113,0,0.009396796
19648,16,23275,3,10,0,0,0,13,4,6,4,4,0,18,nowin,loss,beat,dlwin,0,10,13,220,0.427272727,0.081818182,0.6,2,0.588660176
19649,74,23275,9,9,0,0,0,18,4,6,4,4,0,18,nowin,push,push,push,10,0,18,209,0.411483254,0.04784689,0.531100478,0,0.017448125
19650,106,23276,5,10,0,9,0,24,9,3,9,0,0,21,nowin,loss,bust,plbust,0,10,15,192,0.411458333,0.026041667,0.557291667,0,0.023854304
19651,88,23276,5,10,0,3,0,18,9,3,9,0,0,21,nowin,loss,beat,dlwin,0,10,15,206,0.466019417,0.033980583,0.54368932,1,0.309467903
19652,6,23276,8,10,0,0,0,18,9,3,9,0,0,21,nowin,loss,beat,dlwin,0,10,18,191,0.439790576,0.047120419,0.581151832,1,0.31211505
19653,35,23276,8,10,0,0,0,18,9,3,9,0,0,21,nowin,loss,beat,dlwin,0,10,18,202,0.410891089,0.044554455,0.633663366,2,0.598681573
19654,120,23276,7,11,0,0,0,18,9,3,9,0,0,21,nowin,loss,beat,dlwin,0,10,18,202,0.440594059,0.034653465,0.618811881,2,0.614441029
19655,138,23276,10,8,0,0,0,18,9,3,9,0,0,21,nowin,loss,beat,dlwin,0,10,18,190,0.442105263,0.047368421,0.610526316,2,0.609711065
19656,91,23277,10,7,0,0,0,17,4,8,3,5,0,20,nowin,loss,beat,dlwin,0,10,17,194,0.417525773,0.046391753,0.515463918,1,0.266616552
19657,52,23277,4,7,10,0,0,21,4,8,3,5,0,20,nowin,win,plwin,beat,20,0,11,217,0.414746544,0.02764977,0.599078341,2,0.576736024
19658,72,23277,6,1,8,0,0,15,4,8,3,5,0,20,nowin,loss,beat,dlwin,0,10,7,185,0.394594595,0.032432432,0.508108108,0,0.006763115
19659,102,23277,10,4,0,0,0,14,4,8,3,5,0,20,nowin,loss,beat,dlwin,0,10,14,192,0.338541667,0.046875,0.5625,0,0.003306118
19660,47,23277,8,10,0,0,0,18,4,8,3,5,0,20,nowin,loss,beat,dlwin,0,10,18,210,0.438095238,0.057142857,0.623809524,2,0.615868808
19661,134,23277,8,3,1,0,0,12,4,8,3,5,0,20,nowin,loss,beat,dlwin,0,10,11,185,0.443243243,0.021621622,0.545945946,1,0.296939509
19662,38,23278,5,9,0,0,0,14,4,8,4,3,0,19,nowin,loss,beat,dlwin,0,10,14,202,0.361386139,0.03960396,0.564356436,0,0.010597953
19663,83,23278,10,5,0,0,0,15,4,8,4,3,0,19,nowin,loss,beat,dlwin,0,10,15,193,0.424870466,0.051813472,0.678756477,2,0.644360335
19664,5,23278,5,6,10,0,0,21,4,8,4,3,0,19,nowin,win,plwin,beat,20,0,11,203,0.42364532,0.02955665,0.596059113,2,0.582508076
19665,99,23278,8,4,0,0,0,12,4,8,4,3,0,19,nowin,loss,beat,dlwin,0,10,12,207,0.47826087,0.062801932,0.637681159,3,0.961418446
19666,116,23278,10,10,0,0,0,20,4,8,4,3,0,19,nowin,win,plwin,beat,20,0,20,195,0.425641026,0.056410256,0.538461538,1,0.28273747
19667,16,23278,10,11,0,0,0,21,4,8,4,3,0,19,win,win,plwin,beat,25,0,21,220,0.427272727,0.081818182,0.6,2,0.588660176
19668,70,23279,10,7,0,0,0,17,11,8,0,0,0,19,nowin,loss,beat,dlwin,0,10,17,228,0.385964912,0.039473684,0.557017544,0,0.016157125
19669,137,23279,6,10,0,4,0,20,11,8,0,0,0,19,nowin,win,plwin,beat,20,0,16,194,0.417525773,0.046391753,0.536082474,1,0.276714602
19670,5,23279,10,2,0,5,0,17,11,8,0,0,0,19,nowin,loss,beat,dlwin,0,10,12,203,0.42364532,0.02955665,0.596059113,2,0.582508076
19671,97,23279,7,11,0,0,0,18,11,8,0,0,0,19,nowin,loss,beat,dlwin,0,10,18,182,0.450549451,0.06043956,0.692307692,2,0.677372279
19672,3,23279,10,2,0,4,2,18,11,8,0,0,0,19,nowin,loss,beat,dlwin,0,10,12,190,0.431578947,0.026315789,0.542105263,1,0.288076384
19673,100,23279,5,7,0,8,0,20,11,8,0,0,0,19,nowin,win,plwin,beat,20,0,12,190,0.452631579,0.036842105,0.594736842,3,0.888671154
19674,70,23280,11,8,0,0,0,19,10,10,0,0,0,20,nowin,loss,beat,dlwin,0,10,19,228,0.385964912,0.039473684,0.557017544,0,0.016157125
19675,4,23280,10,8,0,0,0,18,10,10,0,0,0,20,nowin,loss,beat,dlwin,0,10,18,217,0.460829493,0.036866359,0.562211982,1,0.315432839
19676,74,23280,10,3,0,5,0,18,10,10,0,0,0,20,nowin,loss,beat,dlwin,0,10,13,209,0.411483254,0.04784689,0.531100478,0,0.017448125
19677,46,23280,7,3,7,0,0,17,10,10,0,0,0,20,nowin,loss,beat,dlwin,0,10,10,186,0.403225806,0.048387097,0.591397849,0,0.029742194
19678,144,23280,10,10,0,0,0,20,10,10,0,0,0,20,nowin,push,push,push,10,0,20,202,0.386138614,0.054455446,0.564356436,0,0.018006244
19679,128,23280,8,9,0,0,0,17,10,10,0,0,0,20,nowin,loss,beat,dlwin,0,10,17,227,0.356828194,0.052863436,0.577092511,0,0.012352564
19680,92,23281,2,10,0,5,0,17,8,10,0,0,0,18,nowin,loss,beat,dlwin,0,10,12,186,0.446236559,0.059139785,0.564516129,1,0.307826125
19681,58,23281,6,10,0,6,0,22,8,10,0,0,0,18,nowin,loss,bust,plbust,0,10,16,195,0.430769231,0.041025641,0.584615385,2,0.580497586
19682,143,23281,8,10,0,0,0,18,8,10,0,0,0,18,nowin,push,push,push,10,0,18,203,0.463054187,0.044334975,0.57635468,3,0.883143365
19683,13,23281,2,8,11,0,0,21,8,10,0,0,0,18,nowin,win,plwin,beat,20,0,10,206,0.417475728,0.063106796,0.621359223,2,0.59555479
19684,46,23281,10,5,0,2,0,17,8,10,0,0,0,18,nowin,loss,beat,dlwin,0,10,15,186,0.403225806,0.048387097,0.591397849,0,0.029742194
19685,85,23281,10,6,0,7,0,23,8,10,0,0,0,18,nowin,loss,bust,plbust,0,10,16,195,0.41025641,0.066666667,0.594871795,0,0.03269711
19686,50,23282,1,4,9,0,0,14,4,9,10,0,0,23,nowin,win,dlbust,bust,20,0,5,202,0.405940594,0.04950495,0.54950495,0,0.020296079
19687,141,23282,7,2,7,0,0,16,4,9,10,0,0,23,nowin,win,dlbust,bust,20,0,9,202,0.420792079,0.074257426,0.564356436,0,0.028377851
19688,48,23282,3,10,0,0,0,13,4,9,10,0,0,23,nowin,win,dlbust,bust,20,0,13,203,0.413793103,0.019704433,0.600985222,2,0.577280801
19689,100,23282,5,6,4,0,0,15,4,9,10,0,0,23,nowin,win,dlbust,bust,20,0,11,190,0.452631579,0.036842105,0.594736842,3,0.888671154
19690,74,23282,10,4,0,0,0,14,4,9,10,0,0,23,nowin,win,dlbust,bust,20,0,14,209,0.411483254,0.04784689,0.531100478,0,0.017448125
19691,58,23282,3,6,8,0,0,17,4,9,10,0,0,23,nowin,win,dlbust,bust,20,0,9,195,0.430769231,0.041025641,0.584615385,2,0.580497586
19692,141,23283,9,10,0,0,0,19,3,2,7,5,0,17,nowin,win,plwin,beat,20,0,19,202,0.420792079,0.074257426,0.564356436,0,0.028377851
19693,64,23283,3,2,6,10,0,21,3,2,7,5,0,17,nowin,win,plwin,beat,20,0,5,187,0.363636364,0.048128342,0.631016043,0,0.027594885
19694,132,23283,10,10,0,0,0,20,3,2,7,5,0,17,nowin,win,plwin,beat,20,0,20,194,0.412371134,0.036082474,0.649484536,2,0.611633238
19695,133,23283,9,10,0,0,0,19,3,2,7,5,0,17,nowin,win,plwin,beat,20,0,19,201,0.47761194,0.064676617,0.611940299,3,0.935428111
19696,128,23283,10,4,0,0,0,14,3,2,7,5,0,17,nowin,loss,beat,dlwin,0,10,14,227,0.356828194,0.052863436,0.577092511,0,0.012352564
19697,32,23283,1,3,10,0,0,14,3,2,7,5,0,17,nowin,loss,beat,dlwin,0,10,4,189,0.391534392,0.037037037,0.53968254,0,0.013579086
19698,3,23284,8,6,0,4,0,18,10,10,0,0,0,20,nowin,loss,beat,dlwin,0,10,14,190,0.431578947,0.026315789,0.542105263,1,0.288076384
19699,51,23284,10,4,0,1,10,25,10,10,0,0,0,20,nowin,loss,bust,plbust,0,10,14,189,0.529100529,0.068783069,0.608465608,3,0.993665715
19700,123,23284,5,5,3,10,0,23,10,10,0,0,0,20,nowin,loss,bust,plbust,0,10,10,205,0.43902439,0.034146341,0.614634146,2,0.609962544
19701,106,23284,4,10,0,4,0,18,10,10,0,0,0,20,nowin,loss,beat,dlwin,0,10,14,192,0.411458333,0.026041667,0.557291667,0,0.023854304
19702,16,23284,3,6,11,0,0,20,10,10,0,0,0,20,nowin,push,push,push,10,0,9,220,0.427272727,0.081818182,0.6,2,0.588660176
19703,9,23284,10,8,0,0,0,18,10,10,0,0,0,20,nowin,loss,beat,dlwin,0,10,18,194,0.37628866,0.015463918,0.541237113,0,0.009396796
19704,42,23285,2,4,4,6,0,16,6,8,3,0,0,17,nowin,loss,beat,dlwin,0,10,6,212,0.443396226,0.051886792,0.570754717,1,0.309181312
19705,109,23285,2,10,0,0,0,12,6,8,3,0,0,17,nowin,loss,beat,dlwin,0,10,12,221,0.461538462,0.058823529,0.597285068,3,0.901830309
19706,84,23285,8,10,0,0,0,18,6,8,3,0,0,17,nowin,win,plwin,beat,20,0,18,195,0.379487179,0.056410256,0.569230769,0,0.017209119
19707,18,23285,11,7,0,0,0,18,6,8,3,0,0,17,nowin,win,plwin,beat,20,0,18,182,0.461538462,0.043956044,0.587912088,3,0.892649374
19708,29,23285,11,5,2,0,0,18,6,8,3,0,0,17,nowin,win,plwin,beat,20,0,16,189,0.44973545,0.058201058,0.544973545,1,0.300349439
19709,92,23285,10,6,0,0,0,16,6,8,3,0,0,17,nowin,loss,beat,dlwin,0,10,16,186,0.446236559,0.059139785,0.564516129,1,0.307826125
19710,139,23286,11,10,0,0,0,21,8,4,4,10,0,26,win,win,dlbust,bust,25,0,21,192,0.380208333,0.036458333,0.59375,0,0.023429169
19711,110,23286,4,5,10,0,0,19,8,4,4,10,0,26,nowin,win,dlbust,bust,20,0,9,192,0.416666667,0.046875,0.557291667,0,0.025413132
19712,4,23286,10,3,0,8,0,21,8,4,4,10,0,26,nowin,win,dlbust,bust,20,0,13,217,0.460829493,0.036866359,0.562211982,1,0.315432839
19713,93,23286,7,6,0,6,0,19,8,4,4,10,0,26,nowin,win,dlbust,bust,20,0,13,175,0.485714286,0.051428571,0.548571429,1,0.323648091
19714,117,23286,10,10,0,0,0,20,8,4,4,10,0,26,nowin,win,dlbust,bust,20,0,20,173,0.410404624,0.069364162,0.606936416,2,0.578610282
19715,124,23286,7,10,0,0,0,17,8,4,4,10,0,26,nowin,win,dlbust,bust,20,0,17,202,0.47029703,0.064356436,0.584158416,3,0.899458193
19716,28,23287,6,7,0,0,0,13,2,4,9,8,0,23,nowin,win,dlbust,bust,20,0,13,199,0.422110553,0.045226131,0.542713568,1,0.282706618
19717,20,23287,2,3,3,8,0,16,2,4,9,8,0,23,nowin,win,dlbust,bust,20,0,5,186,0.456989247,0.037634409,0.537634409,1,0.301097108
19718,71,23287,11,10,0,0,0,21,2,4,9,8,0,23,win,win,dlbust,bust,25,0,21,193,0.352331606,0.046632124,0.585492228,0,0.013063661
19719,71,23287,4,9,0,0,0,13,2,4,9,8,0,23,nowin,win,dlbust,bust,20,0,13,193,0.352331606,0.046632124,0.585492228,0,0.013063661
19720,27,23287,10,8,0,0,0,18,2,4,9,8,0,23,nowin,win,dlbust,bust,20,0,18,178,0.370786517,0.016853933,0.573033708,0,0.015536309
19721,67,23287,2,10,0,3,0,15,2,4,9,8,0,23,nowin,win,dlbust,bust,20,0,12,195,0.369230769,0.041025641,0.569230769,0,0.014139427
19722,127,23288,10,9,0,0,0,19,2,3,4,2,1,12,nowin,win,plwin,beat,20,0,19,201,0.402985075,0.029850746,0.60199005,0,0.032263937
19723,72,23288,6,6,0,6,0,18,2,3,4,2,1,12,nowin,win,plwin,beat,20,0,12,185,0.394594595,0.032432432,0.508108108,0,0.006763115
19724,110,23288,10,9,0,0,0,19,2,3,4,2,1,12,nowin,win,plwin,beat,20,0,19,192,0.416666667,0.046875,0.557291667,0,0.025413132
19725,99,23288,10,2,0,6,0,18,2,3,4,2,1,12,nowin,win,plwin,beat,20,0,12,207,0.47826087,0.062801932,0.637681159,3,0.961418446
19726,60,23288,8,6,0,0,0,14,2,3,4,2,1,12,nowin,win,plwin,beat,20,0,14,227,0.418502203,0.022026432,0.559471366,0,0.026496258
19727,145,23288,9,9,0,0,0,18,2,3,4,2,1,12,nowin,win,plwin,beat,20,0,18,188,0.441489362,0.031914894,0.622340426,2,0.617837093
19728,72,23289,9,10,0,0,0,19,5,1,9,10,0,25,nowin,win,dlbust,bust,20,0,19,185,0.394594595,0.032432432,0.508108108,0,0.006763115
19729,71,23289,8,6,0,0,0,14,5,1,9,10,0,25,nowin,win,dlbust,bust,20,0,14,193,0.352331606,0.046632124,0.585492228,0,0.013063661
19730,115,23289,5,10,0,0,0,15,5,1,9,10,0,25,nowin,win,dlbust,bust,20,0,15,194,0.427835052,0.041237113,0.592783505,2,0.583863602
19731,29,23289,8,6,0,0,0,14,5,1,9,10,0,25,nowin,win,dlbust,bust,20,0,14,189,0.44973545,0.058201058,0.544973545,1,0.300349439
19732,40,23289,9,7,0,0,0,16,5,1,9,10,0,25,nowin,win,dlbust,bust,20,0,16,196,0.367346939,0.030612245,0.617346939,0,0.025358183
19733,85,23289,11,10,0,0,0,21,5,1,9,10,0,25,win,win,dlbust,bust,25,0,21,195,0.41025641,0.066666667,0.594871795,0,0.03269711
19734,114,23290,10,10,0,0,0,20,3,6,8,0,0,17,nowin,win,plwin,beat,20,0,20,198,0.47979798,0.025252525,0.611111111,3,0.937232995
19735,28,23290,10,2,0,10,0,22,3,6,8,0,0,17,nowin,loss,bust,plbust,0,10,12,199,0.422110553,0.045226131,0.542713568,1,0.282706618
19736,108,23290,9,3,0,6,0,18,3,6,8,0,0,17,nowin,win,plwin,beat,20,0,12,193,0.435233161,0.056994819,0.559585492,1,0.298824795
19737,90,23290,7,4,7,0,0,18,3,6,8,0,0,17,nowin,win,plwin,beat,20,0,11,201,0.447761194,0.049751244,0.60199005,3,0.889945023
19738,45,23290,8,3,8,0,0,19,3,6,8,0,0,17,nowin,win,plwin,beat,20,0,11,196,0.428571429,0.051020408,0.612244898,2,0.598821767
19739,46,23290,10,10,0,0,0,20,3,6,8,0,0,17,nowin,win,plwin,beat,20,0,20,186,0.403225806,0.048387097,0.591397849,0,0.029742194
19740,81,23291,10,2,0,5,0,17,7,7,9,0,0,23,nowin,win,dlbust,bust,20,0,12,182,0.395604396,0.043956044,0.60989011,2,0.567491261
19741,62,23291,9,6,0,2,0,17,7,7,9,0,0,23,nowin,win,dlbust,bust,20,0,15,178,0.370786517,0.028089888,0.54494382,0,0.008657722
19742,57,23291,9,11,0,0,0,20,7,7,9,0,0,23,nowin,win,dlbust,bust,20,0,20,192,0.46875,0.052083333,0.59375,3,0.907001181
19743,44,23291,9,7,0,5,0,21,7,7,9,0,0,23,nowin,win,dlbust,bust,20,0,16,219,0.433789954,0.050228311,0.534246575,1,0.285551035
19744,40,23291,2,4,9,10,0,25,7,7,9,0,0,23,nowin,loss,bust,plbust,0,10,6,196,0.367346939,0.030612245,0.617346939,0,0.025358183
19745,55,23291,10,9,0,0,0,19,7,7,9,0,0,23,nowin,win,dlbust,bust,20,0,19,191,0.371727749,0.057591623,0.54973822,0,0.01011347
19746,23,23292,10,10,0,0,0,20,10,2,4,1,0,17,nowin,win,plwin,beat,20,0,20,208,0.427884615,0.0625,0.552884615,1,0.29114424
19747,98,23292,10,9,0,0,0,19,10,2,4,1,0,17,nowin,win,plwin,beat,20,0,19,220,0.422727273,0.054545455,0.55,1,0.28664435
19748,66,23292,10,5,0,5,0,20,10,2,4,1,0,17,nowin,win,plwin,beat,20,0,15,217,0.456221198,0.064516129,0.626728111,3,0.924304367
19749,15,23292,10,10,0,0,0,20,10,2,4,1,0,17,nowin,win,plwin,beat,20,0,20,212,0.410377358,0.051886792,0.561320755,0,0.024517408
19750,27,23292,3,5,2,1,6,17,10,2,4,1,0,17,nowin,push,push,push,10,0,8,178,0.370786517,0.016853933,0.573033708,0,0.015536309
19751,100,23292,4,10,0,7,0,21,10,2,4,1,0,17,nowin,win,plwin,beat,20,0,14,190,0.452631579,0.036842105,0.594736842,3,0.888671154
19752,134,23293,2,6,10,0,0,18,6,9,10,0,0,25,nowin,win,dlbust,bust,20,0,8,185,0.443243243,0.021621622,0.545945946,1,0.296939509
19753,81,23293,3,3,9,0,0,15,6,9,10,0,0,25,nowin,win,dlbust,bust,20,0,6,182,0.395604396,0.043956044,0.60989011,2,0.567491261
19754,87,23293,9,9,0,0,0,18,6,9,10,0,0,25,nowin,win,dlbust,bust,20,0,18,202,0.405940594,0.054455446,0.628712871,2,0.590599801
19755,74,23293,4,8,0,0,0,12,6,9,10,0,0,25,nowin,win,dlbust,bust,20,0,12,209,0.411483254,0.04784689,0.531100478,0,0.017448125
19756,68,23293,10,9,0,0,0,19,6,9,10,0,0,25,nowin,win,dlbust,bust,20,0,19,205,0.434146341,0.029268293,0.6,2,0.59483189
19757,135,23293,2,7,3,0,0,12,6,9,10,0,0,25,nowin,win,dlbust,bust,20,0,9,179,0.391061453,0.067039106,0.586592179,0,0.024924662
19758,47,23294,11,8,0,0,0,19,9,4,10,0,0,23,nowin,win,dlbust,bust,20,0,19,210,0.438095238,0.057142857,0.623809524,2,0.615868808
19759,64,23294,10,10,0,0,0,20,9,4,10,0,0,23,nowin,win,dlbust,bust,20,0,20,187,0.363636364,0.048128342,0.631016043,0,0.027594885
19760,128,23294,10,8,0,0,0,18,9,4,10,0,0,23,nowin,win,dlbust,bust,20,0,18,227,0.356828194,0.052863436,0.577092511,0,0.012352564
19761,65,23294,11,10,0,0,0,21,9,4,10,0,0,23,win,win,dlbust,bust,25,0,21,203,0.492610837,0.054187192,0.571428571,3,0.913702814
19762,150,23294,10,6,0,6,0,22,9,4,10,0,0,23,nowin,loss,bust,plbust,0,10,16,192,0.401041667,0.036458333,0.567708333,0,0.023287458
19763,1,23294,10,8,0,0,0,18,9,4,10,0,0,23,nowin,win,dlbust,bust,20,0,18,197,0.406091371,0.025380711,0.649746193,2,0.606186955
19764,105,23295,5,10,0,0,0,15,3,2,11,5,0,21,nowin,loss,beat,dlwin,0,10,15,198,0.414141414,0.070707071,0.590909091,0,0.032889494
19765,128,23295,10,5,0,0,0,15,3,2,11,5,0,21,nowin,loss,beat,dlwin,0,10,15,227,0.356828194,0.052863436,0.577092511,0,0.012352564
19766,26,23295,10,10,0,0,0,20,3,2,11,5,0,21,nowin,loss,beat,dlwin,0,10,20,203,0.463054187,0.0591133,0.541871921,1,0.306802864
19767,43,23295,10,9,0,0,0,19,3,2,11,5,0,21,nowin,loss,beat,dlwin,0,10,19,192,0.40625,0.041666667,0.609375,2,0.576671372
19768,101,23295,11,5,5,0,0,21,3,2,11,5,0,21,nowin,push,push,push,10,0,16,205,0.424390244,0.068292683,0.63902439,2,0.614740646
19769,104,23295,10,10,0,0,0,20,3,2,11,5,0,21,nowin,loss,beat,dlwin,0,10,20,209,0.363636364,0.052631579,0.593301435,0,0.018359419
19770,17,23296,5,10,0,4,0,19,7,11,0,0,0,18,nowin,win,plwin,beat,20,0,15,171,0.444444444,0.070175439,0.555555556,1,0.302364894
19771,71,23296,6,2,10,0,0,18,7,11,0,0,0,18,nowin,push,push,push,10,0,8,193,0.352331606,0.046632124,0.585492228,0,0.013063661
19772,69,23296,2,2,6,5,10,25,7,11,0,0,0,18,nowin,loss,bust,plbust,0,10,4,194,0.365979381,0.030927835,0.515463918,0,0
19773,61,23296,10,10,0,0,0,20,7,11,0,0,0,18,nowin,win,plwin,beat,20,0,20,194,0.427835052,0.077319588,0.603092784,2,0.591437139
19774,36,23296,5,5,10,0,0,20,7,11,0,0,0,18,nowin,win,plwin,beat,20,0,10,229,0.445414847,0.056768559,0.655021834,2,0.645370571
19775,7,23296,8,8,0,5,0,21,7,11,0,0,0,18,nowin,win,plwin,beat,20,0,16,183,0.442622951,0.06010929,0.62295082,2,0.619303341
19776,75,23297,11,6,4,0,0,21,6,9,10,0,0,25,nowin,win,dlbust,bust,20,0,17,191,0.418848168,0.052356021,0.570680628,0,0.029344702
19777,92,23297,9,10,0,0,0,19,6,9,10,0,0,25,nowin,win,dlbust,bust,20,0,19,186,0.446236559,0.059139785,0.564516129,1,0.307826125
19778,89,23297,10,9,0,0,0,19,6,9,10,0,0,25,nowin,win,dlbust,bust,20,0,19,212,0.537735849,0.047169811,0.594339623,3,0.990167191
19779,137,23297,10,10,0,0,0,20,6,9,10,0,0,25,nowin,win,dlbust,bust,20,0,20,194,0.417525773,0.046391753,0.536082474,1,0.276714602
19780,96,23297,6,10,0,0,0,16,6,9,10,0,0,25,nowin,win,dlbust,bust,20,0,16,190,0.468421053,0.057894737,0.584210526,3,0.897263354
19781,77,23297,6,8,0,0,0,14,6,9,10,0,0,25,nowin,win,dlbust,bust,20,0,14,200,0.455,0.04,0.62,3,0.916252116
19782,72,23298,4,9,0,4,0,17,10,2,6,0,0,18,nowin,loss,beat,dlwin,0,10,13,185,0.394594595,0.032432432,0.508108108,0,0.006763115
19783,7,23298,11,7,0,0,0,18,10,2,6,0,0,18,nowin,push,push,push,10,0,18,183,0.442622951,0.06010929,0.62295082,2,0.619303341
19784,73,23298,11,3,3,0,0,17,10,2,6,0,0,18,nowin,loss,beat,dlwin,0,10,14,181,0.375690608,0.011049724,0.596685083,0,0.022795773
19785,98,23298,3,7,6,3,0,19,10,2,6,0,0,18,nowin,win,plwin,beat,20,0,10,220,0.422727273,0.054545455,0.55,1,0.28664435
19786,89,23298,10,10,0,0,0,20,10,2,6,0,0,18,nowin,win,plwin,beat,20,0,20,212,0.537735849,0.047169811,0.594339623,3,0.990167191
19787,117,23298,7,11,0,0,0,18,10,2,6,0,0,18,nowin,push,push,push,10,0,18,173,0.410404624,0.069364162,0.606936416,2,0.578610282
19788,54,23299,5,5,10,0,0,20,5,10,10,0,0,25,nowin,win,dlbust,bust,20,0,10,185,0.437837838,0.032432432,0.556756757,1,0.29899854
19789,55,23299,6,10,0,0,0,16,5,10,10,0,0,25,nowin,win,dlbust,bust,20,0,16,191,0.371727749,0.057591623,0.54973822,0,0.01011347
19790,90,23299,7,10,0,0,0,17,5,10,10,0,0,25,nowin,win,dlbust,bust,20,0,17,201,0.447761194,0.049751244,0.60199005,3,0.889945023
19791,59,23299,10,10,0,0,0,20,5,10,10,0,0,25,nowin,win,dlbust,bust,20,0,20,228,0.429824561,0.048245614,0.543859649,1,0.287885446
19792,16,23299,10,8,0,0,0,18,5,10,10,0,0,25,nowin,win,dlbust,bust,20,0,18,220,0.427272727,0.081818182,0.6,2,0.588660176
19793,19,23299,2,10,0,0,0,12,5,10,10,0,0,25,nowin,win,dlbust,bust,20,0,12,237,0.41350211,0.054852321,0.628691983,2,0.597373826
19794,33,23300,2,10,0,8,0,20,10,8,0,0,0,18,nowin,win,plwin,beat,20,0,12,192,0.4375,0.057291667,0.625,2,0.616208916
19795,83,23300,10,9,0,0,0,19,10,8,0,0,0,18,nowin,win,plwin,beat,20,0,19,193,0.424870466,0.051813472,0.678756477,2,0.644360335
19796,37,23300,10,10,0,0,0,20,10,8,0,0,0,18,nowin,win,plwin,beat,20,0,20,208,0.394230769,0.038461538,0.581730769,0,0.024682772
19797,96,23300,10,11,0,0,0,21,10,8,0,0,0,18,win,win,plwin,beat,25,0,21,190,0.468421053,0.057894737,0.584210526,3,0.897263354
19798,35,23300,5,4,10,0,0,19,10,8,0,0,0,18,nowin,win,plwin,beat,20,0,9,202,0.410891089,0.044554455,0.633663366,2,0.598681573
19799,39,23300,10,6,0,10,0,26,10,8,0,0,0,18,nowin,loss,bust,plbust,0,10,16,191,0.429319372,0.062827225,0.57591623,0,0.033760763
19800,89,23301,10,5,0,7,0,22,8,10,0,0,0,18,nowin,loss,bust,plbust,0,10,15,212,0.537735849,0.047169811,0.594339623,3,0.990167191
19801,71,23301,2,10,0,10,0,22,8,10,0,0,0,18,nowin,loss,bust,plbust,0,10,12,193,0.352331606,0.046632124,0.585492228,0,0.013063661
19802,110,23301,10,2,0,10,0,22,8,10,0,0,0,18,nowin,loss,bust,plbust,0,10,12,192,0.416666667,0.046875,0.557291667,0,0.025413132
19803,4,23301,4,8,0,1,10,23,8,10,0,0,0,18,nowin,loss,bust,plbust,0,10,12,217,0.460829493,0.036866359,0.562211982,1,0.315432839
19804,101,23301,6,4,3,2,4,19,8,10,0,0,0,18,nowin,win,plwin,beat,20,0,10,205,0.424390244,0.068292683,0.63902439,2,0.614740646
19805,60,23301,10,11,0,0,0,21,8,10,0,0,0,18,win,win,plwin,beat,25,0,21,227,0.418502203,0.022026432,0.559471366,0,0.026496258
19806,115,23302,2,9,9,0,0,20,6,4,6,4,0,20,nowin,push,push,push,10,0,11,194,0.427835052,0.041237113,0.592783505,2,0.583863602
19807,93,23302,2,10,0,0,0,12,6,4,6,4,0,20,nowin,loss,beat,dlwin,0,10,12,175,0.485714286,0.051428571,0.548571429,1,0.323648091
19808,127,23302,11,5,1,0,0,17,6,4,6,4,0,20,nowin,loss,beat,dlwin,0,10,16,201,0.402985075,0.029850746,0.60199005,0,0.032263937
19809,141,23302,10,6,0,0,0,16,6,4,6,4,0,20,nowin,loss,beat,dlwin,0,10,16,202,0.420792079,0.074257426,0.564356436,0,0.028377851
19810,108,23302,10,4,0,0,0,14,6,4,6,4,0,20,nowin,loss,beat,dlwin,0,10,14,193,0.435233161,0.056994819,0.559585492,1,0.298824795
19811,121,23302,2,7,10,0,0,19,6,4,6,4,0,20,nowin,loss,beat,dlwin,0,10,9,195,0.456410256,0.025641026,0.512820513,1,0.288597791
19812,1,23303,7,8,0,7,0,22,7,10,0,0,0,17,nowin,loss,bust,plbust,0,10,15,197,0.406091371,0.025380711,0.649746193,2,0.606186955
19813,95,23303,3,9,0,10,0,22,7,10,0,0,0,17,nowin,loss,bust,plbust,0,10,12,218,0.412844037,0.04587156,0.559633028,0,0.024842385
19814,125,23303,10,6,0,10,0,26,7,10,0,0,0,17,nowin,loss,bust,plbust,0,10,16,219,0.438356164,0.050228311,0.575342466,1,0.308411257
19815,108,23303,10,11,0,0,0,21,7,10,0,0,0,17,win,win,plwin,beat,25,0,21,193,0.435233161,0.056994819,0.559585492,1,0.298824795
19816,81,23303,9,7,0,10,0,26,7,10,0,0,0,17,nowin,loss,bust,plbust,0,10,16,182,0.395604396,0.043956044,0.60989011,2,0.567491261
19817,41,23303,2,11,4,0,0,17,7,10,0,0,0,17,nowin,push,push,push,10,0,13,192,0.364583333,0.036458333,0.520833333,0,0.00089702
19818,17,23304,6,7,0,5,0,18,8,3,1,3,8,23,nowin,win,dlbust,bust,20,0,13,171,0.444444444,0.070175439,0.555555556,1,0.302364894
19819,112,23304,9,4,0,6,0,19,8,3,1,3,8,23,nowin,win,dlbust,bust,20,0,13,203,0.448275862,0.054187192,0.600985222,3,0.889576933
19820,148,23304,10,11,0,0,0,21,8,3,1,3,8,23,win,win,dlbust,bust,25,0,21,204,0.401960784,0.078431373,0.593137255,0,0.029789521
19821,55,23304,10,9,0,0,0,19,8,3,1,3,8,23,nowin,win,dlbust,bust,20,0,19,191,0.371727749,0.057591623,0.54973822,0,0.01011347
19822,114,23304,11,8,0,0,0,19,8,3,1,3,8,23,nowin,win,dlbust,bust,20,0,19,198,0.47979798,0.025252525,0.611111111,3,0.937232995
19823,11,23304,4,2,5,3,10,24,8,3,1,3,8,23,nowin,loss,bust,plbust,0,10,6,236,0.457627119,0.016949153,0.588983051,3,0.889015813
19824,118,23305,2,10,0,7,0,19,10,8,0,0,0,18,nowin,win,plwin,beat,20,0,12,216,0.393518519,0.037037037,0.555555556,0,0.018059873
19825,131,23305,6,7,0,3,5,21,10,8,0,0,0,18,nowin,win,plwin,beat,20,0,13,217,0.410138249,0.069124424,0.543778802,0,0.02015021
19826,113,23305,5,7,0,2,3,17,10,8,0,0,0,18,nowin,loss,beat,dlwin,0,10,12,199,0.407035176,0.055276382,0.668341709,2,0.620695264
19827,76,23305,10,11,0,0,0,21,10,8,0,0,0,18,win,win,plwin,beat,25,0,21,189,0.534391534,0.079365079,0.608465608,3,1
19828,69,23305,10,10,0,0,0,20,10,8,0,0,0,18,nowin,win,plwin,beat,20,0,20,194,0.365979381,0.030927835,0.515463918,0,0
19829,7,23305,8,10,0,0,0,18,10,8,0,0,0,18,nowin,push,push,push,10,0,18,183,0.442622951,0.06010929,0.62295082,2,0.619303341
19830,13,23306,11,10,0,0,0,21,10,4,3,0,0,17,win,win,plwin,beat,25,0,21,206,0.417475728,0.063106796,0.621359223,2,0.59555479
19831,143,23306,8,10,0,0,0,18,10,4,3,0,0,17,nowin,win,plwin,beat,20,0,18,203,0.463054187,0.044334975,0.57635468,3,0.883143365
19832,105,23306,7,4,7,0,0,18,10,4,3,0,0,17,nowin,win,plwin,beat,20,0,11,198,0.414141414,0.070707071,0.590909091,0,0.032889494
19833,24,23306,4,10,0,3,0,17,10,4,3,0,0,17,nowin,push,push,push,10,0,14,207,0.458937198,0.048309179,0.570048309,1,0.318138014
19834,114,23306,9,6,0,4,0,19,10,4,3,0,0,17,nowin,win,plwin,beat,20,0,15,198,0.47979798,0.025252525,0.611111111,3,0.937232995
19835,75,23306,3,6,9,0,0,18,10,4,3,0,0,17,nowin,win,plwin,beat,20,0,9,191,0.418848168,0.052356021,0.570680628,0,0.029344702
19836,75,23307,9,3,0,0,0,12,5,10,10,0,0,25,nowin,win,dlbust,bust,20,0,12,191,0.418848168,0.052356021,0.570680628,0,0.029344702
19837,17,23307,2,10,0,0,0,12,5,10,10,0,0,25,nowin,win,dlbust,bust,20,0,12,171,0.444444444,0.070175439,0.555555556,1,0.302364894
19838,64,23307,4,11,4,0,0,19,5,10,10,0,0,25,nowin,win,dlbust,bust,20,0,15,187,0.363636364,0.048128342,0.631016043,0,0.027594885
19839,16,23307,10,10,0,0,0,20,5,10,10,0,0,25,nowin,win,dlbust,bust,20,0,20,220,0.427272727,0.081818182,0.6,2,0.588660176
19840,126,23307,10,10,0,0,0,20,5,10,10,0,0,25,nowin,win,dlbust,bust,20,0,20,188,0.457446809,0.074468085,0.60106383,3,0.900633203
19841,33,23307,5,7,0,0,0,12,5,10,10,0,0,25,nowin,win,dlbust,bust,20,0,12,192,0.4375,0.057291667,0.625,2,0.616208916
19842,148,23308,7,10,0,0,0,17,8,4,1,10,0,23,nowin,win,dlbust,bust,20,0,17,204,0.401960784,0.078431373,0.593137255,0,0.029789521
19843,14,23308,11,6,2,0,0,19,8,4,1,10,0,23,nowin,win,dlbust,bust,20,0,17,202,0.391089109,0.01980198,0.628712871,2,0.577264877
19844,101,23308,10,9,0,0,0,19,8,4,1,10,0,23,nowin,win,dlbust,bust,20,0,19,205,0.424390244,0.068292683,0.63902439,2,0.614740646
19845,148,23308,8,7,0,2,0,17,8,4,1,10,0,23,nowin,win,dlbust,bust,20,0,15,204,0.401960784,0.078431373,0.593137255,0,0.029789521
19846,144,23308,10,10,0,0,0,20,8,4,1,10,0,23,nowin,win,dlbust,bust,20,0,20,202,0.386138614,0.054455446,0.564356436,0,0.018006244
19847,138,23308,8,5,0,10,0,23,8,4,1,10,0,23,nowin,loss,bust,plbust,0,10,13,190,0.442105263,0.047368421,0.610526316,2,0.609711065
19848,83,23309,2,6,10,0,0,18,9,6,10,0,0,25,nowin,win,dlbust,bust,20,0,8,193,0.424870466,0.051813472,0.678756477,2,0.644360335
19849,121,23309,10,9,0,0,0,19,9,6,10,0,0,25,nowin,win,dlbust,bust,20,0,19,195,0.456410256,0.025641026,0.512820513,1,0.288597791
19850,91,23309,8,10,0,0,0,18,9,6,10,0,0,25,nowin,win,dlbust,bust,20,0,18,194,0.417525773,0.046391753,0.515463918,1,0.266616552
19851,134,23309,10,10,0,0,0,20,9,6,10,0,0,25,nowin,win,dlbust,bust,20,0,20,185,0.443243243,0.021621622,0.545945946,1,0.296939509
19852,116,23309,9,3,0,4,10,26,9,6,10,0,0,25,nowin,loss,bust,plbust,0,10,12,195,0.425641026,0.056410256,0.538461538,1,0.28273747
19853,130,23309,3,10,0,3,10,26,9,6,10,0,0,25,nowin,loss,bust,plbust,0,10,13,219,0.410958904,0.03652968,0.566210046,0,0.025888739
19854,95,23310,10,2,0,7,0,19,10,11,0,0,0,21,nowin,loss,beat,dlwin,0,10,12,218,0.412844037,0.04587156,0.559633028,0,0.024842385
19855,147,23310,3,10,0,8,0,21,10,11,0,0,0,21,nowin,push,push,push,10,0,13,205,0.380487805,0.014634146,0.536585366,0,0.00951447
19856,20,23310,10,6,0,8,0,24,10,11,0,0,0,21,nowin,loss,bust,plbust,0,10,16,186,0.456989247,0.037634409,0.537634409,1,0.301097108
19857,101,23310,4,10,0,1,8,23,10,11,0,0,0,21,nowin,loss,bust,plbust,0,10,14,205,0.424390244,0.068292683,0.63902439,2,0.614740646
19858,32,23310,11,10,0,0,0,21,10,11,0,0,0,21,win,push,push,push,10,0,21,189,0.391534392,0.037037037,0.53968254,0,0.013579086
19859,7,23310,7,5,0,9,0,21,10,11,0,0,0,21,nowin,push,push,push,10,0,12,183,0.442622951,0.06010929,0.62295082,2,0.619303341
19860,52,23311,3,2,8,2,10,25,7,10,0,0,0,17,nowin,loss,bust,plbust,0,10,5,217,0.414746544,0.02764977,0.599078341,2,0.576736024
19861,13,23311,11,10,0,0,0,21,7,10,0,0,0,17,win,win,plwin,beat,25,0,21,206,0.417475728,0.063106796,0.621359223,2,0.59555479
19862,33,23311,4,9,0,10,0,23,7,10,0,0,0,17,nowin,loss,bust,plbust,0,10,13,192,0.4375,0.057291667,0.625,2,0.616208916
19863,16,23311,2,10,0,5,0,17,7,10,0,0,0,17,nowin,push,push,push,10,0,12,220,0.427272727,0.081818182,0.6,2,0.588660176
19864,26,23311,9,3,0,1,2,15,7,10,0,0,0,17,nowin,loss,beat,dlwin,0,10,12,203,0.463054187,0.0591133,0.541871921,1,0.306802864
19865,56,23311,4,9,0,3,10,26,7,10,0,0,0,17,nowin,loss,bust,plbust,0,10,13,175,0.4,0.057142857,0.582857143,0,0.026685297
19866,26,23312,6,10,0,0,0,16,3,10,1,5,0,19,nowin,loss,beat,dlwin,0,10,16,203,0.463054187,0.0591133,0.541871921,1,0.306802864
19867,1,23312,7,10,0,0,0,17,3,10,1,5,0,19,nowin,loss,beat,dlwin,0,10,17,197,0.406091371,0.025380711,0.649746193,2,0.606186955
19868,23,23312,2,7,5,0,0,14,3,10,1,5,0,19,nowin,loss,beat,dlwin,0,10,9,208,0.427884615,0.0625,0.552884615,1,0.29114424
19869,127,23312,2,10,0,8,0,20,3,10,1,5,0,19,nowin,win,plwin,beat,20,0,12,201,0.402985075,0.029850746,0.60199005,0,0.032263937
19870,69,23312,11,1,5,0,0,17,3,10,1,5,0,19,nowin,loss,beat,dlwin,0,10,12,194,0.365979381,0.030927835,0.515463918,0,0
19871,132,23312,10,11,0,0,0,21,3,10,1,5,0,19,win,win,plwin,beat,25,0,21,194,0.412371134,0.036082474,0.649484536,2,0.611633238
19872,105,23313,10,10,0,0,0,20,10,6,10,0,0,26,nowin,win,dlbust,bust,20,0,20,198,0.414141414,0.070707071,0.590909091,0,0.032889494
19873,118,23313,11,3,4,0,0,18,10,6,10,0,0,26,nowin,win,dlbust,bust,20,0,14,216,0.393518519,0.037037037,0.555555556,0,0.018059873
19874,100,23313,4,11,5,0,0,20,10,6,10,0,0,26,nowin,win,dlbust,bust,20,0,15,190,0.452631579,0.036842105,0.594736842,3,0.888671154
19875,1,23313,4,10,0,3,0,17,10,6,10,0,0,26,nowin,win,dlbust,bust,20,0,14,197,0.406091371,0.025380711,0.649746193,2,0.606186955
19876,105,23313,2,10,0,1,8,21,10,6,10,0,0,26,nowin,win,dlbust,bust,20,0,12,198,0.414141414,0.070707071,0.590909091,0,0.032889494
19877,67,23313,4,10,0,9,0,23,10,6,10,0,0,26,nowin,loss,bust,plbust,0,10,14,195,0.369230769,0.041025641,0.569230769,0,0.014139427
19878,60,23314,6,2,10,0,0,18,2,10,1,4,0,17,nowin,win,plwin,beat,20,0,8,227,0.418502203,0.022026432,0.559471366,0,0.026496258
19879,96,23314,2,1,10,0,0,13,2,10,1,4,0,17,nowin,loss,beat,dlwin,0,10,3,190,0.468421053,0.057894737,0.584210526,3,0.897263354
19880,5,23314,8,4,0,1,0,13,2,10,1,4,0,17,nowin,loss,beat,dlwin,0,10,12,203,0.42364532,0.02955665,0.596059113,2,0.582508076
19881,145,23314,4,4,8,0,0,16,2,10,1,4,0,17,nowin,loss,beat,dlwin,0,10,8,188,0.441489362,0.031914894,0.622340426,2,0.617837093
19882,147,23314,2,10,0,4,0,16,2,10,1,4,0,17,nowin,loss,beat,dlwin,0,10,12,205,0.380487805,0.014634146,0.536585366,0,0.00951447
19883,121,23314,10,3,0,0,0,13,2,10,1,4,0,17,nowin,loss,beat,dlwin,0,10,13,195,0.456410256,0.025641026,0.512820513,1,0.288597791
19884,150,23315,8,11,0,0,0,19,10,10,0,0,0,20,nowin,loss,beat,dlwin,0,10,19,192,0.401041667,0.036458333,0.567708333,0,0.023287458
19885,14,23315,10,10,0,0,0,20,10,10,0,0,0,20,nowin,push,push,push,10,0,20,202,0.391089109,0.01980198,0.628712871,2,0.577264877
19886,63,23315,2,9,8,0,0,19,10,10,0,0,0,20,nowin,loss,beat,dlwin,0,10,11,216,0.467592593,0.037037037,0.62037037,3,0.931690496
19887,23,23315,9,3,0,10,0,22,10,10,0,0,0,20,nowin,loss,bust,plbust,0,10,12,208,0.427884615,0.0625,0.552884615,1,0.29114424
19888,22,23315,6,10,0,10,0,26,10,10,0,0,0,20,nowin,loss,bust,plbust,0,10,16,187,0.481283422,0.042780749,0.577540107,3,0.906128176
19889,133,23315,8,10,0,0,0,18,10,10,0,0,0,20,nowin,loss,beat,dlwin,0,10,18,201,0.47761194,0.064676617,0.611940299,3,0.935428111
19890,47,23316,3,10,0,5,0,18,1,4,10,9,0,24,nowin,win,dlbust,bust,20,0,13,210,0.438095238,0.057142857,0.623809524,2,0.615868808
19891,139,23316,9,5,0,10,0,24,1,4,10,9,0,24,nowin,loss,bust,plbust,0,10,14,192,0.380208333,0.036458333,0.59375,0,0.023429169
19892,58,23316,8,2,10,0,0,20,1,4,10,9,0,24,nowin,win,dlbust,bust,20,0,10,195,0.430769231,0.041025641,0.584615385,2,0.580497586
19893,88,23316,7,10,0,0,0,17,1,4,10,9,0,24,nowin,win,dlbust,bust,20,0,17,206,0.466019417,0.033980583,0.54368932,1,0.309467903
19894,10,23316,10,10,0,0,0,20,1,4,10,9,0,24,nowin,win,dlbust,bust,20,0,20,191,0.413612565,0.057591623,0.596858639,2,0.574087175
19895,50,23316,6,10,0,1,0,17,1,4,10,9,0,24,nowin,win,dlbust,bust,20,0,16,202,0.405940594,0.04950495,0.54950495,0,0.020296079
19896,130,23317,3,11,7,0,0,21,8,2,2,2,10,24,nowin,win,dlbust,bust,20,0,14,219,0.410958904,0.03652968,0.566210046,0,0.025888739
19897,120,23317,10,11,0,0,0,21,8,2,2,2,10,24,win,win,dlbust,bust,25,0,21,202,0.440594059,0.034653465,0.618811881,2,0.614441029
19898,118,23317,10,6,0,2,0,18,8,2,2,2,10,24,nowin,win,dlbust,bust,20,0,16,216,0.393518519,0.037037037,0.555555556,0,0.018059873
19899,82,23317,10,10,0,0,0,20,8,2,2,2,10,24,nowin,win,dlbust,bust,20,0,20,225,0.408888889,0.075555556,0.577777778,0,0.028101874
19900,113,23317,10,4,0,10,0,24,8,2,2,2,10,24,nowin,loss,bust,plbust,0,10,14,199,0.407035176,0.055276382,0.668341709,2,0.620695264
19901,106,23317,7,10,0,0,0,17,8,2,2,2,10,24,nowin,win,dlbust,bust,20,0,17,192,0.411458333,0.026041667,0.557291667,0,0.023854304
19902,136,23318,6,10,0,7,0,23,8,8,4,0,0,20,nowin,loss,bust,plbust,0,10,16,194,0.396907216,0.025773196,0.597938144,0,0.029452644
19903,12,23318,10,8,0,0,0,18,8,8,4,0,0,20,nowin,loss,beat,dlwin,0,10,18,189,0.470899471,0.015873016,0.613756614,3,0.929171178
19904,128,23318,10,9,0,0,0,19,8,8,4,0,0,20,nowin,loss,beat,dlwin,0,10,19,227,0.356828194,0.052863436,0.577092511,0,0.012352564
19905,112,23318,3,6,3,7,0,19,8,8,4,0,0,20,nowin,loss,beat,dlwin,0,10,9,203,0.448275862,0.054187192,0.600985222,3,0.889576933
19906,75,23318,5,10,0,5,0,20,8,8,4,0,0,20,nowin,push,push,push,10,0,15,191,0.418848168,0.052356021,0.570680628,0,0.029344702
19907,63,23318,8,3,9,0,0,20,8,8,4,0,0,20,nowin,push,push,push,10,0,11,216,0.467592593,0.037037037,0.62037037,3,0.931690496
19908,17,23319,2,4,7,4,0,17,9,5,7,0,0,21,nowin,loss,beat,dlwin,0,10,6,171,0.444444444,0.070175439,0.555555556,1,0.302364894
19909,105,23319,7,10,0,0,0,17,9,5,7,0,0,21,nowin,loss,beat,dlwin,0,10,17,198,0.414141414,0.070707071,0.590909091,0,0.032889494
19910,116,23319,8,10,0,0,0,18,9,5,7,0,0,21,nowin,loss,beat,dlwin,0,10,18,195,0.425641026,0.056410256,0.538461538,1,0.28273747
19911,52,23319,8,4,0,2,10,24,9,5,7,0,0,21,nowin,loss,bust,plbust,0,10,12,217,0.414746544,0.02764977,0.599078341,2,0.576736024
19912,117,23319,10,7,0,0,0,17,9,5,7,0,0,21,nowin,loss,beat,dlwin,0,10,17,173,0.410404624,0.069364162,0.606936416,2,0.578610282
19913,81,23319,4,3,10,0,0,17,9,5,7,0,0,21,nowin,loss,beat,dlwin,0,10,7,182,0.395604396,0.043956044,0.60989011,2,0.567491261
19914,129,23320,4,10,0,6,0,20,10,3,3,7,0,23,nowin,win,dlbust,bust,20,0,14,201,0.422885572,0.064676617,0.55721393,0,0.027255383
19915,140,23320,7,8,0,4,0,19,10,3,3,7,0,23,nowin,win,dlbust,bust,20,0,15,210,0.466666667,0.023809524,0.604761905,3,0.915293335
19916,110,23320,5,6,9,0,0,20,10,3,3,7,0,23,nowin,win,dlbust,bust,20,0,11,192,0.416666667,0.046875,0.557291667,0,0.025413132
19917,117,23320,10,10,0,0,0,20,10,3,3,7,0,23,nowin,win,dlbust,bust,20,0,20,173,0.410404624,0.069364162,0.606936416,2,0.578610282
19918,125,23320,2,10,0,5,0,17,10,3,3,7,0,23,nowin,win,dlbust,bust,20,0,12,219,0.438356164,0.050228311,0.575342466,1,0.308411257
19919,39,23320,6,3,6,9,0,24,10,3,3,7,0,23,nowin,loss,bust,plbust,0,10,9,191,0.429319372,0.062827225,0.57591623,0,0.033760763
19920,65,23321,11,4,6,0,0,21,7,7,4,0,0,18,nowin,win,plwin,beat,20,0,15,203,0.492610837,0.054187192,0.571428571,3,0.913702814
19921,125,23321,6,3,11,0,0,20,7,7,4,0,0,18,nowin,win,plwin,beat,20,0,9,219,0.438356164,0.050228311,0.575342466,1,0.308411257
19922,68,23321,9,9,0,0,0,18,7,7,4,0,0,18,nowin,push,push,push,10,0,18,205,0.434146341,0.029268293,0.6,2,0.59483189
19923,85,23321,10,6,0,8,0,24,7,7,4,0,0,18,nowin,loss,bust,plbust,0,10,16,195,0.41025641,0.066666667,0.594871795,0,0.03269711
19924,25,23321,10,6,0,10,0,26,7,7,4,0,0,18,nowin,loss,bust,plbust,0,10,16,190,0.463157895,0.063157895,0.536842105,1,0.304401563
19925,101,23321,2,7,10,0,0,19,7,7,4,0,0,18,nowin,win,plwin,beat,20,0,9,205,0.424390244,0.068292683,0.63902439,2,0.614740646
19926,68,23322,10,2,0,10,0,22,10,11,0,0,0,21,nowin,loss,bust,plbust,0,10,12,205,0.434146341,0.029268293,0.6,2,0.59483189
19927,28,23322,10,2,0,8,0,20,10,11,0,0,0,21,nowin,loss,beat,dlwin,0,10,12,199,0.422110553,0.045226131,0.542713568,1,0.282706618
19928,24,23322,6,2,10,0,0,18,10,11,0,0,0,21,nowin,loss,beat,dlwin,0,10,8,207,0.458937198,0.048309179,0.570048309,1,0.318138014
19929,42,23322,10,7,0,0,0,17,10,11,0,0,0,21,nowin,loss,beat,dlwin,0,10,17,212,0.443396226,0.051886792,0.570754717,1,0.309181312
19930,96,23322,7,4,9,0,0,20,10,11,0,0,0,21,nowin,loss,beat,dlwin,0,10,11,190,0.468421053,0.057894737,0.584210526,3,0.897263354
19931,117,23322,9,10,0,0,0,19,10,11,0,0,0,21,nowin,loss,beat,dlwin,0,10,19,173,0.410404624,0.069364162,0.606936416,2,0.578610282
19932,33,23323,10,10,0,0,0,20,10,10,0,0,0,20,nowin,push,push,push,10,0,20,192,0.4375,0.057291667,0.625,2,0.616208916
19933,131,23323,4,10,0,6,0,20,10,10,0,0,0,20,nowin,push,push,push,10,0,14,217,0.410138249,0.069124424,0.543778802,0,0.02015021
19934,116,23323,10,6,0,3,0,19,10,10,0,0,0,20,nowin,loss,beat,dlwin,0,10,16,195,0.425641026,0.056410256,0.538461538,1,0.28273747
19935,31,23323,4,10,0,1,1,16,10,10,0,0,0,20,nowin,loss,beat,dlwin,0,10,14,188,0.473404255,0.058510638,0.515957447,1,0.300306557
19936,32,23323,6,7,0,7,0,20,10,10,0,0,0,20,nowin,push,push,push,10,0,13,189,0.391534392,0.037037037,0.53968254,0,0.013579086
19937,40,23323,10,10,0,0,0,20,10,10,0,0,0,20,nowin,push,push,push,10,0,20,196,0.367346939,0.030612245,0.617346939,0,0.025358183
19938,103,23324,7,11,0,0,0,18,10,11,0,0,0,21,nowin,loss,beat,dlwin,0,10,18,203,0.379310345,0.064039409,0.551724138,0,0.012869209
19939,86,23324,7,7,0,10,0,24,10,11,0,0,0,21,nowin,loss,bust,plbust,0,10,14,196,0.454081633,0.040816327,0.591836735,3,0.887566443
19940,96,23324,11,7,0,0,0,18,10,11,0,0,0,21,nowin,loss,beat,dlwin,0,10,18,190,0.468421053,0.057894737,0.584210526,3,0.897263354
19941,8,23324,10,4,0,2,8,24,10,11,0,0,0,21,nowin,loss,bust,plbust,0,10,14,181,0.44198895,0.071823204,0.596685083,2,0.599438402
19942,23,23324,6,8,0,6,0,20,10,11,0,0,0,21,nowin,loss,beat,dlwin,0,10,14,208,0.427884615,0.0625,0.552884615,1,0.29114424
19943,61,23324,10,6,0,8,0,24,10,11,0,0,0,21,nowin,loss,bust,plbust,0,10,16,194,0.427835052,0.077319588,0.603092784,2,0.591437139
19944,80,23325,10,10,0,0,0,20,10,10,0,0,0,20,nowin,push,push,push,10,0,20,186,0.419354839,0.059139785,0.623655914,2,0.59892924
19945,140,23325,3,2,10,2,0,17,10,10,0,0,0,20,nowin,loss,beat,dlwin,0,10,5,210,0.466666667,0.023809524,0.604761905,3,0.915293335
19946,139,23325,5,10,0,1,6,22,10,10,0,0,0,20,nowin,loss,bust,plbust,0,10,15,192,0.380208333,0.036458333,0.59375,0,0.023429169
19947,121,23325,10,7,0,0,0,17,10,10,0,0,0,20,nowin,loss,beat,dlwin,0,10,17,195,0.456410256,0.025641026,0.512820513,1,0.288597791
19948,87,23325,10,10,0,0,0,20,10,10,0,0,0,20,nowin,push,push,push,10,0,20,202,0.405940594,0.054455446,0.628712871,2,0.590599801
19949,123,23325,5,10,0,10,0,25,10,10,0,0,0,20,nowin,loss,bust,plbust,0,10,15,205,0.43902439,0.034146341,0.614634146,2,0.609962544
19950,136,23326,5,1,10,0,0,16,5,2,10,0,0,17,nowin,loss,beat,dlwin,0,10,6,194,0.396907216,0.025773196,0.597938144,0,0.029452644
19951,21,23326,10,8,0,0,0,18,5,2,10,0,0,17,nowin,win,plwin,beat,20,0,18,214,0.359813084,0.042056075,0.626168224,0,0.025263474
19952,146,23326,4,1,10,0,0,15,5,2,10,0,0,17,nowin,loss,beat,dlwin,0,10,5,221,0.43438914,0.040723982,0.542986425,1,0.290190091
19953,24,23326,10,10,0,0,0,20,5,2,10,0,0,17,nowin,win,plwin,beat,20,0,20,207,0.458937198,0.048309179,0.570048309,1,0.318138014
19954,75,23326,7,11,0,0,0,18,5,2,10,0,0,17,nowin,win,plwin,beat,20,0,18,191,0.418848168,0.052356021,0.570680628,0,0.029344702
19955,136,23326,2,4,9,0,0,15,5,2,10,0,0,17,nowin,loss,beat,dlwin,0,10,6,194,0.396907216,0.025773196,0.597938144,0,0.029452644
19956,121,23327,11,8,0,0,0,19,2,2,10,10,0,24,nowin,win,dlbust,bust,20,0,19,195,0.456410256,0.025641026,0.512820513,1,0.288597791
19957,117,23327,9,9,0,0,0,18,2,2,10,10,0,24,nowin,win,dlbust,bust,20,0,18,173,0.410404624,0.069364162,0.606936416,2,0.578610282
19958,62,23327,10,3,0,0,0,13,2,2,10,10,0,24,nowin,win,dlbust,bust,20,0,13,178,0.370786517,0.028089888,0.54494382,0,0.008657722
19959,39,23327,9,8,0,0,0,17,2,2,10,10,0,24,nowin,win,dlbust,bust,20,0,17,191,0.429319372,0.062827225,0.57591623,0,0.033760763
19960,32,23327,4,10,0,0,0,14,2,2,10,10,0,24,nowin,win,dlbust,bust,20,0,14,189,0.391534392,0.037037037,0.53968254,0,0.013579086
19961,141,23327,1,3,10,0,0,14,2,2,10,10,0,24,nowin,win,dlbust,bust,20,0,4,202,0.420792079,0.074257426,0.564356436,0,0.028377851
19962,19,23328,5,2,10,0,0,17,3,2,10,1,5,21,nowin,loss,beat,dlwin,0,10,7,237,0.41350211,0.054852321,0.628691983,2,0.597373826
19963,5,23328,5,6,4,0,0,15,3,2,10,1,5,21,nowin,loss,beat,dlwin,0,10,11,203,0.42364532,0.02955665,0.596059113,2,0.582508076
19964,74,23328,4,9,0,0,0,13,3,2,10,1,5,21,nowin,loss,beat,dlwin,0,10,13,209,0.411483254,0.04784689,0.531100478,0,0.017448125
19965,110,23328,4,10,0,0,0,14,3,2,10,1,5,21,nowin,loss,beat,dlwin,0,10,14,192,0.416666667,0.046875,0.557291667,0,0.025413132
19966,140,23328,4,7,9,0,0,20,3,2,10,1,5,21,nowin,loss,beat,dlwin,0,10,11,210,0.466666667,0.023809524,0.604761905,3,0.915293335
19967,9,23328,8,9,0,0,0,17,3,2,10,1,5,21,nowin,loss,beat,dlwin,0,10,17,194,0.37628866,0.015463918,0.541237113,0,0.009396796
19968,75,23329,9,7,0,0,0,16,6,6,3,6,0,21,nowin,loss,beat,dlwin,0,10,16,191,0.418848168,0.052356021,0.570680628,0,0.029344702
19969,117,23329,11,10,0,0,0,21,6,6,3,6,0,21,win,push,push,push,10,0,21,173,0.410404624,0.069364162,0.606936416,2,0.578610282
19970,70,23329,10,10,0,0,0,20,6,6,3,6,0,21,nowin,loss,beat,dlwin,0,10,20,228,0.385964912,0.039473684,0.557017544,0,0.016157125
19971,36,23329,10,10,0,0,0,20,6,6,3,6,0,21,nowin,loss,beat,dlwin,0,10,20,229,0.445414847,0.056768559,0.655021834,2,0.645370571
19972,9,23329,10,10,0,0,0,20,6,6,3,6,0,21,nowin,loss,beat,dlwin,0,10,20,194,0.37628866,0.015463918,0.541237113,0,0.009396796
19973,76,23329,5,8,0,0,0,13,6,6,3,6,0,21,nowin,loss,beat,dlwin,0,10,13,189,0.534391534,0.079365079,0.608465608,3,1
19974,105,23330,11,7,0,0,0,18,10,7,0,0,0,17,nowin,win,plwin,beat,20,0,18,198,0.414141414,0.070707071,0.590909091,0,0.032889494
19975,142,23330,10,10,0,0,0,20,10,7,0,0,0,17,nowin,win,plwin,beat,20,0,20,211,0.417061611,0.047393365,0.526066351,1,0.271531309
19976,92,23330,10,5,0,10,0,25,10,7,0,0,0,17,nowin,loss,bust,plbust,0,10,15,186,0.446236559,0.059139785,0.564516129,1,0.307826125
19977,145,23330,10,7,0,0,0,17,10,7,0,0,0,17,nowin,push,push,push,10,0,17,188,0.441489362,0.031914894,0.622340426,2,0.617837093
19978,113,23330,10,10,0,0,0,20,10,7,0,0,0,17,nowin,win,plwin,beat,20,0,20,199,0.407035176,0.055276382,0.668341709,2,0.620695264
19979,23,23330,9,2,10,0,0,21,10,7,0,0,0,17,nowin,win,plwin,beat,20,0,11,208,0.427884615,0.0625,0.552884615,1,0.29114424
19980,46,23331,10,2,0,8,0,20,10,5,2,0,0,17,nowin,win,plwin,beat,20,0,12,186,0.403225806,0.048387097,0.591397849,0,0.029742194
19981,105,23331,10,5,0,1,10,26,10,5,2,0,0,17,nowin,loss,bust,plbust,0,10,15,198,0.414141414,0.070707071,0.590909091,0,0.032889494
19982,19,23331,7,10,0,0,0,17,10,5,2,0,0,17,nowin,push,push,push,10,0,17,237,0.41350211,0.054852321,0.628691983,2,0.597373826
19983,105,23331,10,10,0,0,0,20,10,5,2,0,0,17,nowin,win,plwin,beat,20,0,20,198,0.414141414,0.070707071,0.590909091,0,0.032889494
19984,140,23331,7,6,0,1,10,24,10,5,2,0,0,17,nowin,loss,bust,plbust,0,10,13,210,0.466666667,0.023809524,0.604761905,3,0.915293335
19985,87,23331,4,5,4,2,10,25,10,5,2,0,0,17,nowin,loss,bust,plbust,0,10,9,202,0.405940594,0.054455446,0.628712871,2,0.590599801
19986,87,23332,10,10,0,0,0,20,10,9,0,0,0,19,nowin,win,plwin,beat,20,0,20,202,0.405940594,0.054455446,0.628712871,2,0.590599801
19987,110,23332,4,9,0,6,0,19,10,9,0,0,0,19,nowin,push,push,push,10,0,13,192,0.416666667,0.046875,0.557291667,0,0.025413132
19988,13,23332,2,5,6,10,0,23,10,9,0,0,0,19,nowin,loss,bust,plbust,0,10,7,206,0.417475728,0.063106796,0.621359223,2,0.59555479
19989,149,23332,4,10,0,5,0,19,10,9,0,0,0,19,nowin,push,push,push,10,0,14,225,0.457777778,0.057777778,0.648888889,2,0.651965595
19990,99,23332,10,10,0,0,0,20,10,9,0,0,0,19,nowin,win,plwin,beat,20,0,20,207,0.47826087,0.062801932,0.637681159,3,0.961418446
19991,101,23332,11,4,6,0,0,21,10,9,0,0,0,19,nowin,win,plwin,beat,20,0,15,205,0.424390244,0.068292683,0.63902439,2,0.614740646
19992,149,23333,7,6,0,2,4,19,7,9,10,0,0,26,nowin,win,dlbust,bust,20,0,13,225,0.457777778,0.057777778,0.648888889,2,0.651965595
19993,100,23333,3,9,0,6,0,18,7,9,10,0,0,26,nowin,win,dlbust,bust,20,0,12,190,0.452631579,0.036842105,0.594736842,3,0.888671154
19994,3,23333,3,5,6,1,3,18,7,9,10,0,0,26,nowin,win,dlbust,bust,20,0,8,190,0.431578947,0.026315789,0.542105263,1,0.288076384
19995,36,23333,2,4,10,5,0,21,7,9,10,0,0,26,nowin,win,dlbust,bust,20,0,6,229,0.445414847,0.056768559,0.655021834,2,0.645370571
19996,143,23333,10,9,0,0,0,19,7,9,10,0,0,26,nowin,win,dlbust,bust,20,0,19,203,0.463054187,0.044334975,0.57635468,3,0.883143365
19997,134,23333,8,10,0,0,0,18,7,9,10,0,0,26,nowin,win,dlbust,bust,20,0,18,185,0.443243243,0.021621622,0.545945946,1,0.296939509
19998,35,23334,7,7,0,7,0,21,7,9,8,0,0,24,nowin,win,dlbust,bust,20,0,14,202,0.410891089,0.044554455,0.633663366,2,0.598681573
19999,34,23334,8,9,0,0,0,17,7,9,8,0,0,24,nowin,win,dlbust,bust,20,0,17,202,0.5,0.079207921,0.618811881,3,0.968961434
20000,63,23334,8,10,0,0,0,18,7,9,8,0,0,24,nowin,win,dlbust,bust,20,0,18,216,0.467592593,0.037037037,0.62037037,3,0.931690496
20001,99,23334,2,9,9,0,0,20,7,9,8,0,0,24,nowin,win,dlbust,bust,20,0,11,207,0.47826087,0.062801932,0.637681159,3,0.961418446
20002,26,23334,8,5,0,6,0,19,7,9,8,0,0,24,nowin,win,dlbust,bust,20,0,13,203,0.463054187,0.0591133,0.541871921,1,0.306802864
20003,127,23334,7,10,0,0,0,17,7,9,8,0,0,24,nowin,win,dlbust,bust,20,0,17,201,0.402985075,0.029850746,0.60199005,0,0.032263937
20004,28,23335,6,5,9,0,0,20,10,6,5,0,0,21,nowin,loss,beat,dlwin,0,10,11,199,0.422110553,0.045226131,0.542713568,1,0.282706618
20005,88,23335,2,10,0,10,0,22,10,6,5,0,0,21,nowin,loss,bust,plbust,0,10,12,206,0.466019417,0.033980583,0.54368932,1,0.309467903
20006,23,23335,6,7,0,6,0,19,10,6,5,0,0,21,nowin,loss,beat,dlwin,0,10,13,208,0.427884615,0.0625,0.552884615,1,0.29114424
20007,40,23335,4,10,0,5,0,19,10,6,5,0,0,21,nowin,loss,beat,dlwin,0,10,14,196,0.367346939,0.030612245,0.617346939,0,0.025358183
20008,22,23335,6,10,0,2,0,18,10,6,5,0,0,21,nowin,loss,beat,dlwin,0,10,16,187,0.481283422,0.042780749,0.577540107,3,0.906128176
20009,61,23335,10,3,0,10,0,23,10,6,5,0,0,21,nowin,loss,bust,plbust,0,10,13,194,0.427835052,0.077319588,0.603092784,2,0.591437139
20010,142,23336,11,10,0,0,0,21,10,4,5,0,0,19,win,win,plwin,beat,25,0,21,211,0.417061611,0.047393365,0.526066351,1,0.271531309
20011,42,23336,10,9,0,0,0,19,10,4,5,0,0,19,nowin,push,push,push,10,0,19,212,0.443396226,0.051886792,0.570754717,1,0.309181312
20012,143,23336,7,3,8,0,0,18,10,4,5,0,0,19,nowin,loss,beat,dlwin,0,10,10,203,0.463054187,0.044334975,0.57635468,3,0.883143365
20013,131,23336,10,8,0,0,0,18,10,4,5,0,0,19,nowin,loss,beat,dlwin,0,10,18,217,0.410138249,0.069124424,0.543778802,0,0.02015021
20014,21,23336,5,9,0,10,0,24,10,4,5,0,0,19,nowin,loss,bust,plbust,0,10,14,214,0.359813084,0.042056075,0.626168224,0,0.025263474
20015,39,23336,10,7,0,0,0,17,10,4,5,0,0,19,nowin,loss,beat,dlwin,0,10,17,191,0.429319372,0.062827225,0.57591623,0,0.033760763
20016,14,23337,4,3,5,9,0,21,11,3,6,0,0,20,nowin,win,plwin,beat,20,0,7,202,0.391089109,0.01980198,0.628712871,2,0.577264877
20017,141,23337,2,7,4,10,0,23,11,3,6,0,0,20,nowin,loss,bust,plbust,0,10,9,202,0.420792079,0.074257426,0.564356436,0,0.028377851
20018,106,23337,11,7,0,0,0,18,11,3,6,0,0,20,nowin,loss,beat,dlwin,0,10,18,192,0.411458333,0.026041667,0.557291667,0,0.023854304
20019,127,23337,6,10,0,2,0,18,11,3,6,0,0,20,nowin,loss,beat,dlwin,0,10,16,201,0.402985075,0.029850746,0.60199005,0,0.032263937
20020,80,23337,8,3,2,4,0,17,11,3,6,0,0,20,nowin,loss,beat,dlwin,0,10,11,186,0.419354839,0.059139785,0.623655914,2,0.59892924
20021,70,23337,3,10,0,10,0,23,11,3,6,0,0,20,nowin,loss,bust,plbust,0,10,13,228,0.385964912,0.039473684,0.557017544,0,0.016157125
20022,149,23338,8,2,7,0,0,17,8,2,2,7,0,19,nowin,loss,beat,dlwin,0,10,10,225,0.457777778,0.057777778,0.648888889,2,0.651965595
20023,103,23338,6,7,0,4,0,17,8,2,2,7,0,19,nowin,loss,beat,dlwin,0,10,13,203,0.379310345,0.064039409,0.551724138,0,0.012869209
20024,121,23338,4,9,0,5,0,18,8,2,2,7,0,19,nowin,loss,beat,dlwin,0,10,13,195,0.456410256,0.025641026,0.512820513,1,0.288597791
20025,32,23338,8,7,0,10,0,25,8,2,2,7,0,19,nowin,loss,bust,plbust,0,10,15,189,0.391534392,0.037037037,0.53968254,0,0.013579086
20026,73,23338,10,10,0,0,0,20,8,2,2,7,0,19,nowin,win,plwin,beat,20,0,20,181,0.375690608,0.011049724,0.596685083,0,0.022795773
20027,128,23338,10,10,0,0,0,20,8,2,2,7,0,19,nowin,win,plwin,beat,20,0,20,227,0.356828194,0.052863436,0.577092511,0,0.012352564
20028,115,23339,7,5,0,0,0,12,6,9,2,0,0,17,nowin,loss,beat,dlwin,0,10,12,194,0.427835052,0.041237113,0.592783505,2,0.583863602
20029,8,23339,10,10,0,0,0,20,6,9,2,0,0,17,nowin,win,plwin,beat,20,0,20,181,0.44198895,0.071823204,0.596685083,2,0.599438402
20030,75,23339,10,10,0,0,0,20,6,9,2,0,0,17,nowin,win,plwin,beat,20,0,20,191,0.418848168,0.052356021,0.570680628,0,0.029344702
20031,67,23339,9,5,0,0,0,14,6,9,2,0,0,17,nowin,loss,beat,dlwin,0,10,14,195,0.369230769,0.041025641,0.569230769,0,0.014139427
20032,23,23339,2,2,10,0,0,14,6,9,2,0,0,17,nowin,loss,beat,dlwin,0,10,4,208,0.427884615,0.0625,0.552884615,1,0.29114424
20033,60,23339,10,10,0,0,0,20,6,9,2,0,0,17,nowin,win,plwin,beat,20,0,20,227,0.418502203,0.022026432,0.559471366,0,0.026496258
20034,131,23340,4,4,10,0,0,18,8,2,10,0,0,20,nowin,loss,beat,dlwin,0,10,8,217,0.410138249,0.069124424,0.543778802,0,0.02015021
20035,29,23340,10,2,0,7,0,19,8,2,10,0,0,20,nowin,loss,beat,dlwin,0,10,12,189,0.44973545,0.058201058,0.544973545,1,0.300349439
20036,16,23340,11,10,0,0,0,21,8,2,10,0,0,20,win,win,plwin,beat,25,0,21,220,0.427272727,0.081818182,0.6,2,0.588660176
20037,140,23340,10,10,0,0,0,20,8,2,10,0,0,20,nowin,push,push,push,10,0,20,210,0.466666667,0.023809524,0.604761905,3,0.915293335
20038,90,23340,10,11,0,0,0,21,8,2,10,0,0,20,win,win,plwin,beat,25,0,21,201,0.447761194,0.049751244,0.60199005,3,0.889945023
20039,70,23340,8,6,0,6,0,20,8,2,10,0,0,20,nowin,push,push,push,10,0,14,228,0.385964912,0.039473684,0.557017544,0,0.016157125
20040,144,23341,10,4,0,2,6,22,10,8,0,0,0,18,nowin,loss,bust,plbust,0,10,14,202,0.386138614,0.054455446,0.564356436,0,0.018006244
20041,147,23341,7,7,0,1,8,23,10,8,0,0,0,18,nowin,loss,bust,plbust,0,10,14,205,0.380487805,0.014634146,0.536585366,0,0.00951447
20042,19,23341,4,11,6,0,0,21,10,8,0,0,0,18,nowin,win,plwin,beat,20,0,15,237,0.41350211,0.054852321,0.628691983,2,0.597373826
20043,41,23341,7,10,0,0,0,17,10,8,0,0,0,18,nowin,loss,beat,dlwin,0,10,17,192,0.364583333,0.036458333,0.520833333,0,0.00089702
20044,36,23341,1,5,6,10,0,22,10,8,0,0,0,18,nowin,loss,bust,plbust,0,10,6,229,0.445414847,0.056768559,0.655021834,2,0.645370571
20045,103,23341,11,3,5,0,0,19,10,8,0,0,0,18,nowin,win,plwin,beat,20,0,14,203,0.379310345,0.064039409,0.551724138,0,0.012869209
20046,88,23342,11,2,6,0,0,19,4,5,10,0,0,19,nowin,push,push,push,10,0,13,206,0.466019417,0.033980583,0.54368932,1,0.309467903
20047,77,23342,10,6,0,0,0,16,4,5,10,0,0,19,nowin,loss,beat,dlwin,0,10,16,200,0.455,0.04,0.62,3,0.916252116
20048,49,23342,9,10,0,0,0,19,4,5,10,0,0,19,nowin,push,push,push,10,0,19,207,0.396135266,0.053140097,0.594202899,0,0.028306925
20049,47,23342,2,7,7,0,0,16,4,5,10,0,0,19,nowin,loss,beat,dlwin,0,10,9,210,0.438095238,0.057142857,0.623809524,2,0.615868808
20050,83,23342,4,6,8,0,0,18,4,5,10,0,0,19,nowin,loss,beat,dlwin,0,10,10,193,0.424870466,0.051813472,0.678756477,2,0.644360335
20051,85,23342,9,6,0,0,0,15,4,5,10,0,0,19,nowin,loss,beat,dlwin,0,10,15,195,0.41025641,0.066666667,0.594871795,0,0.03269711
20052,61,23343,11,3,3,0,0,17,8,5,5,0,0,18,nowin,loss,beat,dlwin,0,10,14,194,0.427835052,0.077319588,0.603092784,2,0.591437139
20053,83,23343,10,10,0,0,0,20,8,5,5,0,0,18,nowin,win,plwin,beat,20,0,20,193,0.424870466,0.051813472,0.678756477,2,0.644360335
20054,51,23343,10,10,0,0,0,20,8,5,5,0,0,18,nowin,win,plwin,beat,20,0,20,189,0.529100529,0.068783069,0.608465608,3,0.993665715
20055,115,23343,4,3,6,2,8,23,8,5,5,0,0,18,nowin,loss,bust,plbust,0,10,7,194,0.427835052,0.041237113,0.592783505,2,0.583863602
20056,8,23343,7,10,0,0,0,17,8,5,5,0,0,18,nowin,loss,beat,dlwin,0,10,17,181,0.44198895,0.071823204,0.596685083,2,0.599438402
20057,143,23343,10,10,0,0,0,20,8,5,5,0,0,18,nowin,win,plwin,beat,20,0,20,203,0.463054187,0.044334975,0.57635468,3,0.883143365
20058,9,23344,3,4,3,9,0,19,6,2,4,1,6,19,nowin,push,push,push,10,0,7,194,0.37628866,0.015463918,0.541237113,0,0.009396796
20059,129,23344,1,3,10,0,0,14,6,2,4,1,6,19,nowin,loss,beat,dlwin,0,10,4,201,0.422885572,0.064676617,0.55721393,0,0.027255383
20060,23,23344,8,7,0,0,0,15,6,2,4,1,6,19,nowin,loss,beat,dlwin,0,10,15,208,0.427884615,0.0625,0.552884615,1,0.29114424
20061,114,23344,6,6,0,0,0,12,6,2,4,1,6,19,nowin,loss,beat,dlwin,0,10,12,198,0.47979798,0.025252525,0.611111111,3,0.937232995
20062,23,23344,8,10,0,0,0,18,6,2,4,1,6,19,nowin,loss,beat,dlwin,0,10,18,208,0.427884615,0.0625,0.552884615,1,0.29114424
20063,75,23344,10,9,0,0,0,19,6,2,4,1,6,19,nowin,push,push,push,10,0,19,191,0.418848168,0.052356021,0.570680628,0,0.029344702
20064,124,23345,4,2,10,6,0,22,10,2,10,0,0,22,nowin,loss,bust,plbust,0,10,6,202,0.47029703,0.064356436,0.584158416,3,0.899458193
20065,43,23345,3,10,0,2,6,21,10,2,10,0,0,22,nowin,win,dlbust,bust,20,0,13,192,0.40625,0.041666667,0.609375,2,0.576671372
20066,31,23345,2,7,10,0,0,19,10,2,10,0,0,22,nowin,win,dlbust,bust,20,0,9,188,0.473404255,0.058510638,0.515957447,1,0.300306557
20067,73,23345,4,6,4,10,0,24,10,2,10,0,0,22,nowin,loss,bust,plbust,0,10,10,181,0.375690608,0.011049724,0.596685083,0,0.022795773
20068,136,23345,10,11,0,0,0,21,10,2,10,0,0,22,win,win,dlbust,bust,25,0,21,194,0.396907216,0.025773196,0.597938144,0,0.029452644
20069,21,23345,10,10,0,0,0,20,10,2,10,0,0,22,nowin,win,dlbust,bust,20,0,20,214,0.359813084,0.042056075,0.626168224,0,0.025263474
20070,124,23346,9,10,0,0,0,19,10,4,2,10,0,26,nowin,win,dlbust,bust,20,0,19,202,0.47029703,0.064356436,0.584158416,3,0.899458193
20071,117,23346,7,2,2,10,0,21,10,4,2,10,0,26,nowin,win,dlbust,bust,20,0,9,173,0.410404624,0.069364162,0.606936416,2,0.578610282
20072,64,23346,2,5,7,10,0,24,10,4,2,10,0,26,nowin,loss,bust,plbust,0,10,7,187,0.363636364,0.048128342,0.631016043,0,0.027594885
20073,134,23346,3,2,5,7,0,17,10,4,2,10,0,26,nowin,win,dlbust,bust,20,0,5,185,0.443243243,0.021621622,0.545945946,1,0.296939509
20074,60,23346,9,4,0,10,0,23,10,4,2,10,0,26,nowin,loss,bust,plbust,0,10,13,227,0.418502203,0.022026432,0.559471366,0,0.026496258
20075,28,23346,10,10,0,0,0,20,10,4,2,10,0,26,nowin,win,dlbust,bust,20,0,20,199,0.422110553,0.045226131,0.542713568,1,0.282706618
20076,58,23347,4,2,9,6,0,21,10,2,7,0,0,19,nowin,win,plwin,beat,20,0,6,195,0.430769231,0.041025641,0.584615385,2,0.580497586
20077,54,23347,6,10,0,9,0,25,10,2,7,0,0,19,nowin,loss,bust,plbust,0,10,16,185,0.437837838,0.032432432,0.556756757,1,0.29899854
20078,38,23347,7,5,0,10,0,22,10,2,7,0,0,19,nowin,loss,bust,plbust,0,10,12,202,0.361386139,0.03960396,0.564356436,0,0.010597953
20079,16,23347,7,5,0,10,0,22,10,2,7,0,0,19,nowin,loss,bust,plbust,0,10,12,220,0.427272727,0.081818182,0.6,2,0.588660176
20080,45,23347,10,5,0,10,0,25,10,2,7,0,0,19,nowin,loss,bust,plbust,0,10,15,196,0.428571429,0.051020408,0.612244898,2,0.598821767
20081,63,23347,11,1,8,0,0,20,10,2,7,0,0,19,nowin,win,plwin,beat,20,0,12,216,0.467592593,0.037037037,0.62037037,3,0.931690496
20082,139,23348,8,4,0,1,6,19,10,10,0,0,0,20,nowin,loss,beat,dlwin,0,10,12,192,0.380208333,0.036458333,0.59375,0,0.023429169
20083,115,23348,7,9,0,3,0,19,10,10,0,0,0,20,nowin,loss,beat,dlwin,0,10,16,194,0.427835052,0.041237113,0.592783505,2,0.583863602
20084,73,23348,10,3,0,9,0,22,10,10,0,0,0,20,nowin,loss,bust,plbust,0,10,13,181,0.375690608,0.011049724,0.596685083,0,0.022795773
20085,131,23348,3,10,0,2,10,25,10,10,0,0,0,20,nowin,loss,bust,plbust,0,10,13,217,0.410138249,0.069124424,0.543778802,0,0.02015021
20086,116,23348,5,6,5,5,0,21,10,10,0,0,0,20,nowin,win,plwin,beat,20,0,11,195,0.425641026,0.056410256,0.538461538,1,0.28273747
20087,6,23348,2,9,2,2,1,16,10,10,0,0,0,20,nowin,loss,beat,dlwin,0,10,11,191,0.439790576,0.047120419,0.581151832,1,0.31211505
20088,106,23349,7,3,10,0,0,20,4,11,3,0,0,18,nowin,win,plwin,beat,20,0,10,192,0.411458333,0.026041667,0.557291667,0,0.023854304
20089,42,23349,10,5,0,0,0,15,4,11,3,0,0,18,nowin,loss,beat,dlwin,0,10,15,212,0.443396226,0.051886792,0.570754717,1,0.309181312
20090,51,23349,6,3,9,0,0,18,4,11,3,0,0,18,nowin,push,push,push,10,0,9,189,0.529100529,0.068783069,0.608465608,3,0.993665715
20091,69,23349,2,9,4,0,0,15,4,11,3,0,0,18,nowin,loss,beat,dlwin,0,10,11,194,0.365979381,0.030927835,0.515463918,0,0
20092,131,23349,6,3,2,5,0,16,4,11,3,0,0,18,nowin,loss,beat,dlwin,0,10,9,217,0.410138249,0.069124424,0.543778802,0,0.02015021
20093,109,23349,9,10,0,0,0,19,4,11,3,0,0,18,nowin,win,plwin,beat,20,0,19,221,0.461538462,0.058823529,0.597285068,3,0.901830309
20094,4,23350,10,10,0,0,0,20,10,8,0,0,0,18,nowin,win,plwin,beat,20,0,20,217,0.460829493,0.036866359,0.562211982,1,0.315432839
20095,11,23350,11,9,0,0,0,20,10,8,0,0,0,18,nowin,win,plwin,beat,20,0,20,236,0.457627119,0.016949153,0.588983051,3,0.889015813
20096,20,23350,10,5,0,10,0,25,10,8,0,0,0,18,nowin,loss,bust,plbust,0,10,15,186,0.456989247,0.037634409,0.537634409,1,0.301097108
20097,107,23350,2,1,10,8,0,21,10,8,0,0,0,18,nowin,win,plwin,beat,20,0,3,218,0.444954128,0.073394495,0.600917431,2,0.605210014
20098,142,23350,9,2,3,7,0,21,10,8,0,0,0,18,nowin,win,plwin,beat,20,0,11,211,0.417061611,0.047393365,0.526066351,1,0.271531309
20099,13,23350,1,5,10,2,0,18,10,8,0,0,0,18,nowin,push,push,push,10,0,6,206,0.417475728,0.063106796,0.621359223,2,0.59555479
20100,133,23351,10,10,0,0,0,20,10,3,10,0,0,23,nowin,win,dlbust,bust,20,0,20,201,0.47761194,0.064676617,0.611940299,3,0.935428111
20101,38,23351,4,10,0,4,0,18,10,3,10,0,0,23,nowin,win,dlbust,bust,20,0,14,202,0.361386139,0.03960396,0.564356436,0,0.010597953
20102,139,23351,3,10,0,8,0,21,10,3,10,0,0,23,nowin,win,dlbust,bust,20,0,13,192,0.380208333,0.036458333,0.59375,0,0.023429169
20103,14,23351,9,9,0,0,0,18,10,3,10,0,0,23,nowin,win,dlbust,bust,20,0,18,202,0.391089109,0.01980198,0.628712871,2,0.577264877
20104,52,23351,6,4,9,0,0,19,10,3,10,0,0,23,nowin,win,dlbust,bust,20,0,10,217,0.414746544,0.02764977,0.599078341,2,0.576736024
20105,26,23351,7,10,0,0,0,17,10,3,10,0,0,23,nowin,win,dlbust,bust,20,0,17,203,0.463054187,0.0591133,0.541871921,1,0.306802864
20106,81,23352,4,5,3,0,0,12,4,1,10,9,0,24,nowin,win,dlbust,bust,20,0,9,182,0.395604396,0.043956044,0.60989011,2,0.567491261
20107,63,23352,5,9,0,0,0,14,4,1,10,9,0,24,nowin,win,dlbust,bust,20,0,14,216,0.467592593,0.037037037,0.62037037,3,0.931690496
20108,12,23352,8,9,0,0,0,17,4,1,10,9,0,24,nowin,win,dlbust,bust,20,0,17,189,0.470899471,0.015873016,0.613756614,3,0.929171178
20109,95,23352,8,10,0,0,0,18,4,1,10,9,0,24,nowin,win,dlbust,bust,20,0,18,218,0.412844037,0.04587156,0.559633028,0,0.024842385
20110,113,23352,4,4,5,0,0,13,4,1,10,9,0,24,nowin,win,dlbust,bust,20,0,8,199,0.407035176,0.055276382,0.668341709,2,0.620695264
20111,53,23352,10,9,0,0,0,19,4,1,10,9,0,24,nowin,win,dlbust,bust,20,0,19,250,0.372,0.064,0.564,0,0.013687345
20112,61,23353,10,10,0,0,0,20,3,8,10,0,0,21,nowin,loss,beat,dlwin,0,10,20,194,0.427835052,0.077319588,0.603092784,2,0.591437139
20113,43,23353,10,5,0,0,0,15,3,8,10,0,0,21,nowin,loss,beat,dlwin,0,10,15,192,0.40625,0.041666667,0.609375,2,0.576671372
20114,13,23353,2,8,4,0,0,14,3,8,10,0,0,21,nowin,loss,beat,dlwin,0,10,10,206,0.417475728,0.063106796,0.621359223,2,0.59555479
20115,12,23353,10,5,0,0,0,15,3,8,10,0,0,21,nowin,loss,beat,dlwin,0,10,15,189,0.470899471,0.015873016,0.613756614,3,0.929171178
20116,142,23353,8,10,0,0,0,18,3,8,10,0,0,21,nowin,loss,beat,dlwin,0,10,18,211,0.417061611,0.047393365,0.526066351,1,0.271531309
20117,143,23353,10,10,0,0,0,20,3,8,10,0,0,21,nowin,loss,beat,dlwin,0,10,20,203,0.463054187,0.044334975,0.57635468,3,0.883143365
20118,149,23354,4,2,6,8,0,20,9,9,0,0,0,18,nowin,win,plwin,beat,20,0,6,225,0.457777778,0.057777778,0.648888889,2,0.651965595
20119,23,23354,10,7,0,0,0,17,9,9,0,0,0,18,nowin,loss,beat,dlwin,0,10,17,208,0.427884615,0.0625,0.552884615,1,0.29114424
20120,83,23354,10,11,0,0,0,21,9,9,0,0,0,18,win,win,plwin,beat,25,0,21,193,0.424870466,0.051813472,0.678756477,2,0.644360335
20121,128,23354,5,5,3,10,0,23,9,9,0,0,0,18,nowin,loss,bust,plbust,0,10,10,227,0.356828194,0.052863436,0.577092511,0,0.012352564
20122,63,23354,10,2,0,7,0,19,9,9,0,0,0,18,nowin,win,plwin,beat,20,0,12,216,0.467592593,0.037037037,0.62037037,3,0.931690496
20123,43,23354,3,2,7,10,0,22,9,9,0,0,0,18,nowin,loss,bust,plbust,0,10,5,192,0.40625,0.041666667,0.609375,2,0.576671372
20124,3,23355,6,11,4,0,0,21,8,5,7,0,0,20,nowin,win,plwin,beat,20,0,17,190,0.431578947,0.026315789,0.542105263,1,0.288076384
20125,126,23355,6,9,0,10,0,25,8,5,7,0,0,20,nowin,loss,bust,plbust,0,10,15,188,0.457446809,0.074468085,0.60106383,3,0.900633203
20126,77,23355,3,10,0,2,10,25,8,5,7,0,0,20,nowin,loss,bust,plbust,0,10,13,200,0.455,0.04,0.62,3,0.916252116
20127,45,23355,10,10,0,0,0,20,8,5,7,0,0,20,nowin,push,push,push,10,0,20,196,0.428571429,0.051020408,0.612244898,2,0.598821767
20128,105,23355,11,10,0,0,0,21,8,5,7,0,0,20,win,win,plwin,beat,25,0,21,198,0.414141414,0.070707071,0.590909091,0,0.032889494
20129,1,23355,10,3,0,10,0,23,8,5,7,0,0,20,nowin,loss,bust,plbust,0,10,13,197,0.406091371,0.025380711,0.649746193,2,0.606186955
20130,83,23356,11,8,0,0,0,19,5,5,6,10,0,26,nowin,win,dlbust,bust,20,0,19,193,0.424870466,0.051813472,0.678756477,2,0.644360335
20131,109,23356,10,2,0,0,0,12,5,5,6,10,0,26,nowin,win,dlbust,bust,20,0,12,221,0.461538462,0.058823529,0.597285068,3,0.901830309
20132,121,23356,2,11,3,0,0,16,5,5,6,10,0,26,nowin,win,dlbust,bust,20,0,13,195,0.456410256,0.025641026,0.512820513,1,0.288597791
20133,13,23356,3,10,0,0,0,13,5,5,6,10,0,26,nowin,win,dlbust,bust,20,0,13,206,0.417475728,0.063106796,0.621359223,2,0.59555479
20134,31,23356,10,4,0,0,0,14,5,5,6,10,0,26,nowin,win,dlbust,bust,20,0,14,188,0.473404255,0.058510638,0.515957447,1,0.300306557
20135,108,23356,2,1,10,0,0,13,5,5,6,10,0,26,nowin,win,dlbust,bust,20,0,3,193,0.435233161,0.056994819,0.559585492,1,0.298824795
20136,110,23357,6,10,0,10,0,26,7,2,11,0,0,20,nowin,loss,bust,plbust,0,10,16,192,0.416666667,0.046875,0.557291667,0,0.025413132
20137,93,23357,10,4,0,10,0,24,7,2,11,0,0,20,nowin,loss,bust,plbust,0,10,14,175,0.485714286,0.051428571,0.548571429,1,0.323648091
20138,38,23357,10,3,0,10,0,23,7,2,11,0,0,20,nowin,loss,bust,plbust,0,10,13,202,0.361386139,0.03960396,0.564356436,0,0.010597953
20139,77,23357,6,6,0,2,10,24,7,2,11,0,0,20,nowin,loss,bust,plbust,0,10,12,200,0.455,0.04,0.62,3,0.916252116
20140,36,23357,8,11,0,0,0,19,7,2,11,0,0,20,nowin,loss,beat,dlwin,0,10,19,229,0.445414847,0.056768559,0.655021834,2,0.645370571
20141,63,23357,2,2,10,7,0,21,7,2,11,0,0,20,nowin,win,plwin,beat,20,0,4,216,0.467592593,0.037037037,0.62037037,3,0.931690496
20142,67,23358,10,4,0,0,0,14,3,3,9,6,0,21,nowin,loss,beat,dlwin,0,10,14,195,0.369230769,0.041025641,0.569230769,0,0.014139427
20143,75,23358,2,7,11,0,0,20,3,3,9,6,0,21,nowin,loss,beat,dlwin,0,10,9,191,0.418848168,0.052356021,0.570680628,0,0.029344702
20144,35,23358,10,10,0,0,0,20,3,3,9,6,0,21,nowin,loss,beat,dlwin,0,10,20,202,0.410891089,0.044554455,0.633663366,2,0.598681573
20145,119,23358,4,3,4,10,0,21,3,3,9,6,0,21,nowin,push,push,push,10,0,7,190,0.405263158,0.068421053,0.515789474,0,0.011837158
20146,119,23358,6,10,0,0,0,16,3,3,9,6,0,21,nowin,loss,beat,dlwin,0,10,16,190,0.405263158,0.068421053,0.515789474,0,0.011837158
20147,144,23358,9,10,0,0,0,19,3,3,9,6,0,21,nowin,loss,beat,dlwin,0,10,19,202,0.386138614,0.054455446,0.564356436,0,0.018006244
20148,81,23359,11,1,5,0,0,17,10,5,10,0,0,25,nowin,win,dlbust,bust,20,0,12,182,0.395604396,0.043956044,0.60989011,2,0.567491261
20149,24,23359,5,9,0,7,0,21,10,5,10,0,0,25,nowin,win,dlbust,bust,20,0,14,207,0.458937198,0.048309179,0.570048309,1,0.318138014
20150,64,23359,9,6,0,9,0,24,10,5,10,0,0,25,nowin,loss,bust,plbust,0,10,15,187,0.363636364,0.048128342,0.631016043,0,0.027594885
20151,48,23359,10,10,0,0,0,20,10,5,10,0,0,25,nowin,win,dlbust,bust,20,0,20,203,0.413793103,0.019704433,0.600985222,2,0.577280801
20152,108,23359,9,5,0,10,0,24,10,5,10,0,0,25,nowin,loss,bust,plbust,0,10,14,193,0.435233161,0.056994819,0.559585492,1,0.298824795
20153,29,23359,8,5,0,10,0,23,10,5,10,0,0,25,nowin,loss,bust,plbust,0,10,13,189,0.44973545,0.058201058,0.544973545,1,0.300349439
20154,140,23360,7,10,0,0,0,17,10,10,0,0,0,20,nowin,loss,beat,dlwin,0,10,17,210,0.466666667,0.023809524,0.604761905,3,0.915293335
20155,70,23360,5,10,0,5,0,20,10,10,0,0,0,20,nowin,push,push,push,10,0,15,228,0.385964912,0.039473684,0.557017544,0,0.016157125
20156,1,23360,2,3,6,10,0,21,10,10,0,0,0,20,nowin,win,plwin,beat,20,0,5,197,0.406091371,0.025380711,0.649746193,2,0.606186955
20157,127,23360,10,10,0,0,0,20,10,10,0,0,0,20,nowin,push,push,push,10,0,20,201,0.402985075,0.029850746,0.60199005,0,0.032263937
20158,40,23360,10,10,0,0,0,20,10,10,0,0,0,20,nowin,push,push,push,10,0,20,196,0.367346939,0.030612245,0.617346939,0,0.025358183
20159,66,23360,3,5,4,10,0,22,10,10,0,0,0,20,nowin,loss,bust,plbust,0,10,8,217,0.456221198,0.064516129,0.626728111,3,0.924304367
20160,97,23361,10,7,0,0,0,17,3,10,9,0,0,22,nowin,win,dlbust,bust,20,0,17,182,0.450549451,0.06043956,0.692307692,2,0.677372279
20161,127,23361,7,6,0,0,0,13,3,10,9,0,0,22,nowin,win,dlbust,bust,20,0,13,201,0.402985075,0.029850746,0.60199005,0,0.032263937
20162,82,23361,10,11,0,0,0,21,3,10,9,0,0,22,win,win,dlbust,bust,25,0,21,225,0.408888889,0.075555556,0.577777778,0,0.028101874
20163,6,23361,7,10,0,0,0,17,3,10,9,0,0,22,nowin,win,dlbust,bust,20,0,17,191,0.439790576,0.047120419,0.581151832,1,0.31211505
20164,117,23361,8,11,0,0,0,19,3,10,9,0,0,22,nowin,win,dlbust,bust,20,0,19,173,0.410404624,0.069364162,0.606936416,2,0.578610282
20165,137,23361,9,10,0,0,0,19,3,10,9,0,0,22,nowin,win,dlbust,bust,20,0,19,194,0.417525773,0.046391753,0.536082474,1,0.276714602
20166,150,23362,11,10,0,0,0,21,11,8,0,0,0,19,win,win,plwin,beat,25,0,21,192,0.401041667,0.036458333,0.567708333,0,0.023287458
20167,35,23362,4,6,8,0,0,18,11,8,0,0,0,19,nowin,loss,beat,dlwin,0,10,10,202,0.410891089,0.044554455,0.633663366,2,0.598681573
20168,142,23362,10,10,0,0,0,20,11,8,0,0,0,19,nowin,win,plwin,beat,20,0,20,211,0.417061611,0.047393365,0.526066351,1,0.271531309
20169,68,23362,10,7,0,0,0,17,11,8,0,0,0,19,nowin,loss,beat,dlwin,0,10,17,205,0.434146341,0.029268293,0.6,2,0.59483189
20170,43,23362,10,10,0,0,0,20,11,8,0,0,0,19,nowin,win,plwin,beat,20,0,20,192,0.40625,0.041666667,0.609375,2,0.576671372
20171,83,23362,10,3,0,8,0,21,11,8,0,0,0,19,nowin,win,plwin,beat,20,0,13,193,0.424870466,0.051813472,0.678756477,2,0.644360335
20172,100,23363,3,8,10,0,0,21,11,10,0,0,0,21,nowin,push,push,push,10,0,11,190,0.452631579,0.036842105,0.594736842,3,0.888671154
20173,118,23363,1,4,7,9,0,21,11,10,0,0,0,21,nowin,push,push,push,10,0,5,216,0.393518519,0.037037037,0.555555556,0,0.018059873
20174,118,23363,7,9,0,1,0,17,11,10,0,0,0,21,nowin,loss,beat,dlwin,0,10,16,216,0.393518519,0.037037037,0.555555556,0,0.018059873
20175,46,23363,3,9,0,10,0,22,11,10,0,0,0,21,nowin,loss,bust,plbust,0,10,12,186,0.403225806,0.048387097,0.591397849,0,0.029742194
20176,121,23363,1,2,10,5,0,18,11,10,0,0,0,21,nowin,loss,beat,dlwin,0,10,3,195,0.456410256,0.025641026,0.512820513,1,0.288597791
20177,65,23363,5,4,10,0,0,19,11,10,0,0,0,21,nowin,loss,beat,dlwin,0,10,9,203,0.492610837,0.054187192,0.571428571,3,0.913702814
20178,127,23364,2,11,8,0,0,21,2,7,10,0,0,19,nowin,win,plwin,beat,20,0,13,201,0.402985075,0.029850746,0.60199005,0,0.032263937
20179,44,23364,9,3,0,5,0,17,2,7,10,0,0,19,nowin,loss,beat,dlwin,0,10,12,219,0.433789954,0.050228311,0.534246575,1,0.285551035
20180,71,23364,10,7,0,0,0,17,2,7,10,0,0,19,nowin,loss,beat,dlwin,0,10,17,193,0.352331606,0.046632124,0.585492228,0,0.013063661
20181,25,23364,11,9,0,0,0,20,2,7,10,0,0,19,nowin,win,plwin,beat,20,0,20,190,0.463157895,0.063157895,0.536842105,1,0.304401563
20182,41,23364,2,8,10,0,0,20,2,7,10,0,0,19,nowin,win,plwin,beat,20,0,10,192,0.364583333,0.036458333,0.520833333,0,0.00089702
20183,89,23364,9,8,0,0,0,17,2,7,10,0,0,19,nowin,loss,beat,dlwin,0,10,17,212,0.537735849,0.047169811,0.594339623,3,0.990167191
20184,69,23365,10,10,0,0,0,20,8,3,10,0,0,21,nowin,loss,beat,dlwin,0,10,20,194,0.365979381,0.030927835,0.515463918,0,0
20185,31,23365,7,10,0,0,0,17,8,3,10,0,0,21,nowin,loss,beat,dlwin,0,10,17,188,0.473404255,0.058510638,0.515957447,1,0.300306557
20186,94,23365,8,10,0,0,0,18,8,3,10,0,0,21,nowin,loss,beat,dlwin,0,10,18,183,0.43715847,0.043715847,0.540983607,1,0.290866892
20187,40,23365,9,2,3,8,0,22,8,3,10,0,0,21,nowin,loss,bust,plbust,0,10,11,196,0.367346939,0.030612245,0.617346939,0,0.025358183
20188,139,23365,4,6,10,0,0,20,8,3,10,0,0,21,nowin,loss,beat,dlwin,0,10,10,192,0.380208333,0.036458333,0.59375,0,0.023429169
20189,101,23365,5,8,0,6,0,19,8,3,10,0,0,21,nowin,loss,beat,dlwin,0,10,13,205,0.424390244,0.068292683,0.63902439,2,0.614740646
20190,46,23366,10,10,0,0,0,20,1,5,6,10,0,22,nowin,win,dlbust,bust,20,0,20,186,0.403225806,0.048387097,0.591397849,0,0.029742194
20191,81,23366,9,10,0,0,0,19,1,5,6,10,0,22,nowin,win,dlbust,bust,20,0,19,182,0.395604396,0.043956044,0.60989011,2,0.567491261
20192,111,23366,2,3,4,5,10,24,1,5,6,10,0,22,nowin,loss,bust,plbust,0,10,5,180,0.433333333,0.055555556,0.611111111,2,0.602264492
20193,109,23366,6,1,9,4,0,20,1,5,6,10,0,22,nowin,win,dlbust,bust,20,0,7,221,0.461538462,0.058823529,0.597285068,3,0.901830309
20194,84,23366,8,4,0,10,0,22,1,5,6,10,0,22,nowin,loss,bust,plbust,0,10,12,195,0.379487179,0.056410256,0.569230769,0,0.017209119
20195,20,23366,2,4,3,5,2,16,1,5,6,10,0,22,nowin,win,dlbust,bust,20,0,6,186,0.456989247,0.037634409,0.537634409,1,0.301097108
20196,79,23367,4,10,0,10,0,24,11,9,0,0,0,20,nowin,loss,bust,plbust,0,10,14,211,0.436018957,0.028436019,0.672985782,2,0.650131054
20197,11,23367,5,4,4,3,10,26,11,9,0,0,0,20,nowin,loss,bust,plbust,0,10,9,236,0.457627119,0.016949153,0.588983051,3,0.889015813
20198,48,23367,6,9,0,10,0,25,11,9,0,0,0,20,nowin,loss,bust,plbust,0,10,15,203,0.413793103,0.019704433,0.600985222,2,0.577280801
20199,76,23367,10,11,0,0,0,21,11,9,0,0,0,20,win,win,plwin,beat,25,0,21,189,0.534391534,0.079365079,0.608465608,3,1
20200,100,23367,10,10,0,0,0,20,11,9,0,0,0,20,nowin,push,push,push,10,0,20,190,0.452631579,0.036842105,0.594736842,3,0.888671154
20201,81,23367,10,10,0,0,0,20,11,9,0,0,0,20,nowin,push,push,push,10,0,20,182,0.395604396,0.043956044,0.60989011,2,0.567491261
20202,54,23368,8,8,0,0,0,16,6,10,8,0,0,24,nowin,win,dlbust,bust,20,0,16,185,0.437837838,0.032432432,0.556756757,1,0.29899854
20203,87,23368,11,9,0,0,0,20,6,10,8,0,0,24,nowin,win,dlbust,bust,20,0,20,202,0.405940594,0.054455446,0.628712871,2,0.590599801
20204,27,23368,11,9,0,0,0,20,6,10,8,0,0,24,nowin,win,dlbust,bust,20,0,20,178,0.370786517,0.016853933,0.573033708,0,0.015536309
20205,136,23368,3,1,10,0,0,14,6,10,8,0,0,24,nowin,win,dlbust,bust,20,0,4,194,0.396907216,0.025773196,0.597938144,0,0.029452644
20206,20,23368,2,4,2,9,0,17,6,10,8,0,0,24,nowin,win,dlbust,bust,20,0,6,186,0.456989247,0.037634409,0.537634409,1,0.301097108
20207,76,23368,2,10,0,0,0,12,6,10,8,0,0,24,nowin,win,dlbust,bust,20,0,12,189,0.534391534,0.079365079,0.608465608,3,1
20208,74,23369,10,4,0,4,0,18,9,5,9,0,0,23,nowin,win,dlbust,bust,20,0,14,209,0.411483254,0.04784689,0.531100478,0,0.017448125
20209,125,23369,8,3,10,0,0,21,9,5,9,0,0,23,nowin,win,dlbust,bust,20,0,11,219,0.438356164,0.050228311,0.575342466,1,0.308411257
20210,34,23369,10,6,0,8,0,24,9,5,9,0,0,23,nowin,loss,bust,plbust,0,10,16,202,0.5,0.079207921,0.618811881,3,0.968961434
20211,136,23369,9,4,0,8,0,21,9,5,9,0,0,23,nowin,win,dlbust,bust,20,0,13,194,0.396907216,0.025773196,0.597938144,0,0.029452644
20212,38,23369,7,9,0,3,0,19,9,5,9,0,0,23,nowin,win,dlbust,bust,20,0,16,202,0.361386139,0.03960396,0.564356436,0,0.010597953
20213,30,23369,10,3,0,5,0,18,9,5,9,0,0,23,nowin,win,dlbust,bust,20,0,13,206,0.393203883,0.033980583,0.601941748,0,0.029324648
20214,139,23370,9,4,0,10,0,23,9,8,0,0,0,17,nowin,loss,bust,plbust,0,10,13,192,0.380208333,0.036458333,0.59375,0,0.023429169
20215,68,23370,10,10,0,0,0,20,9,8,0,0,0,17,nowin,win,plwin,beat,20,0,20,205,0.434146341,0.029268293,0.6,2,0.59483189
20216,60,23370,2,9,1,10,0,22,9,8,0,0,0,17,nowin,loss,bust,plbust,0,10,11,227,0.418502203,0.022026432,0.559471366,0,0.026496258
20217,67,23370,10,10,0,0,0,20,9,8,0,0,0,17,nowin,win,plwin,beat,20,0,20,195,0.369230769,0.041025641,0.569230769,0,0.014139427
20218,114,23370,10,8,0,0,0,18,9,8,0,0,0,17,nowin,win,plwin,beat,20,0,18,198,0.47979798,0.025252525,0.611111111,3,0.937232995
20219,8,23370,10,9,0,0,0,19,9,8,0,0,0,17,nowin,win,plwin,beat,20,0,19,181,0.44198895,0.071823204,0.596685083,2,0.599438402
20220,148,23371,4,7,4,7,0,22,10,2,10,0,0,22,nowin,loss,bust,plbust,0,10,11,204,0.401960784,0.078431373,0.593137255,0,0.029789521
20221,97,23371,3,3,11,0,0,17,10,2,10,0,0,22,nowin,win,dlbust,bust,20,0,6,182,0.450549451,0.06043956,0.692307692,2,0.677372279
20222,122,23371,3,4,3,3,10,23,10,2,10,0,0,22,nowin,loss,bust,plbust,0,10,7,210,0.347619048,0.052380952,0.59047619,0,0.012873677
20223,27,23371,9,7,0,3,0,19,10,2,10,0,0,22,nowin,win,dlbust,bust,20,0,16,178,0.370786517,0.016853933,0.573033708,0,0.015536309
20224,83,23371,4,9,0,10,0,23,10,2,10,0,0,22,nowin,loss,bust,plbust,0,10,13,193,0.424870466,0.051813472,0.678756477,2,0.644360335
20225,66,23371,7,6,0,4,0,17,10,2,10,0,0,22,nowin,win,dlbust,bust,20,0,13,217,0.456221198,0.064516129,0.626728111,3,0.924304367
20226,118,23372,9,8,0,0,0,17,10,7,0,0,0,17,nowin,push,push,push,10,0,17,216,0.393518519,0.037037037,0.555555556,0,0.018059873
20227,146,23372,10,10,0,0,0,20,10,7,0,0,0,17,nowin,win,plwin,beat,20,0,20,221,0.43438914,0.040723982,0.542986425,1,0.290190091
20228,107,23372,10,10,0,0,0,20,10,7,0,0,0,17,nowin,win,plwin,beat,20,0,20,218,0.444954128,0.073394495,0.600917431,2,0.605210014
20229,123,23372,3,3,10,10,0,26,10,7,0,0,0,17,nowin,loss,bust,plbust,0,10,6,205,0.43902439,0.034146341,0.614634146,2,0.609962544
20230,99,23372,10,11,0,0,0,21,10,7,0,0,0,17,win,win,plwin,beat,25,0,21,207,0.47826087,0.062801932,0.637681159,3,0.961418446
20231,10,23372,11,9,0,0,0,20,10,7,0,0,0,17,nowin,win,plwin,beat,20,0,20,191,0.413612565,0.057591623,0.596858639,2,0.574087175
20232,33,23373,3,10,0,0,0,13,5,10,1,3,0,19,nowin,loss,beat,dlwin,0,10,13,192,0.4375,0.057291667,0.625,2,0.616208916
20233,128,23373,6,6,0,0,0,12,5,10,1,3,0,19,nowin,loss,beat,dlwin,0,10,12,227,0.356828194,0.052863436,0.577092511,0,0.012352564
20234,55,23373,11,10,0,0,0,21,5,10,1,3,0,19,win,win,plwin,beat,25,0,21,191,0.371727749,0.057591623,0.54973822,0,0.01011347
20235,11,23373,9,4,0,0,0,13,5,10,1,3,0,19,nowin,loss,beat,dlwin,0,10,13,236,0.457627119,0.016949153,0.588983051,3,0.889015813
20236,117,23373,8,10,0,0,0,18,5,10,1,3,0,19,nowin,loss,beat,dlwin,0,10,18,173,0.410404624,0.069364162,0.606936416,2,0.578610282
20237,115,23373,10,5,0,0,0,15,5,10,1,3,0,19,nowin,loss,beat,dlwin,0,10,15,194,0.427835052,0.041237113,0.592783505,2,0.583863602
20238,106,23374,10,10,0,0,0,20,9,9,0,0,0,18,nowin,win,plwin,beat,20,0,20,192,0.411458333,0.026041667,0.557291667,0,0.023854304
20239,34,23374,10,7,0,0,0,17,9,9,0,0,0,18,nowin,loss,beat,dlwin,0,10,17,202,0.5,0.079207921,0.618811881,3,0.968961434
20240,122,23374,10,4,0,6,0,20,9,9,0,0,0,18,nowin,win,plwin,beat,20,0,14,210,0.347619048,0.052380952,0.59047619,0,0.012873677
20241,150,23374,8,2,8,0,0,18,9,9,0,0,0,18,nowin,push,push,push,10,0,10,192,0.401041667,0.036458333,0.567708333,0,0.023287458
20242,15,23374,3,4,7,3,0,17,9,9,0,0,0,18,nowin,loss,beat,dlwin,0,10,7,212,0.410377358,0.051886792,0.561320755,0,0.024517408
20243,54,23374,10,10,0,0,0,20,9,9,0,0,0,18,nowin,win,plwin,beat,20,0,20,185,0.437837838,0.032432432,0.556756757,1,0.29899854
20244,38,23375,4,8,0,3,1,16,10,2,9,0,0,21,nowin,loss,beat,dlwin,0,10,12,202,0.361386139,0.03960396,0.564356436,0,0.010597953
20245,72,23375,5,3,9,0,0,17,10,2,9,0,0,21,nowin,loss,beat,dlwin,0,10,8,185,0.394594595,0.032432432,0.508108108,0,0.006763115
20246,14,23375,7,11,0,0,0,18,10,2,9,0,0,21,nowin,loss,beat,dlwin,0,10,18,202,0.391089109,0.01980198,0.628712871,2,0.577264877
20247,111,23375,10,10,0,0,0,20,10,2,9,0,0,21,nowin,loss,beat,dlwin,0,10,20,180,0.433333333,0.055555556,0.611111111,2,0.602264492
20248,135,23375,10,10,0,0,0,20,10,2,9,0,0,21,nowin,loss,beat,dlwin,0,10,20,179,0.391061453,0.067039106,0.586592179,0,0.024924662
20249,96,23375,4,10,0,2,9,25,10,2,9,0,0,21,nowin,loss,bust,plbust,0,10,14,190,0.468421053,0.057894737,0.584210526,3,0.897263354
20250,56,23376,10,8,0,0,0,18,3,5,8,1,0,17,nowin,win,plwin,beat,20,0,18,175,0.4,0.057142857,0.582857143,0,0.026685297
20251,140,23376,10,8,0,0,0,18,3,5,8,1,0,17,nowin,win,plwin,beat,20,0,18,210,0.466666667,0.023809524,0.604761905,3,0.915293335
20252,105,23376,10,4,0,0,0,14,3,5,8,1,0,17,nowin,loss,beat,dlwin,0,10,14,198,0.414141414,0.070707071,0.590909091,0,0.032889494
20253,68,23376,5,10,0,0,0,15,3,5,8,1,0,17,nowin,loss,beat,dlwin,0,10,15,205,0.434146341,0.029268293,0.6,2,0.59483189
20254,73,23376,10,9,0,0,0,19,3,5,8,1,0,17,nowin,win,plwin,beat,20,0,19,181,0.375690608,0.011049724,0.596685083,0,0.022795773
20255,101,23376,4,9,0,0,0,13,3,5,8,1,0,17,nowin,loss,beat,dlwin,0,10,13,205,0.424390244,0.068292683,0.63902439,2,0.614740646
20256,67,23377,3,6,10,0,0,19,11,10,0,0,0,21,nowin,loss,beat,dlwin,0,10,9,195,0.369230769,0.041025641,0.569230769,0,0.014139427
20257,77,23377,10,10,0,0,0,20,11,10,0,0,0,21,nowin,loss,beat,dlwin,0,10,20,200,0.455,0.04,0.62,3,0.916252116
20258,120,23377,6,10,0,10,0,26,11,10,0,0,0,21,nowin,loss,bust,plbust,0,10,16,202,0.440594059,0.034653465,0.618811881,2,0.614441029
20259,76,23377,9,8,0,0,0,17,11,10,0,0,0,21,nowin,loss,beat,dlwin,0,10,17,189,0.534391534,0.079365079,0.608465608,3,1
20260,146,23377,2,6,4,7,0,19,11,10,0,0,0,21,nowin,loss,beat,dlwin,0,10,8,221,0.43438914,0.040723982,0.542986425,1,0.290190091
20261,2,23377,8,4,0,7,0,19,11,10,0,0,0,21,nowin,loss,beat,dlwin,0,10,12,200,0.445,0.035,0.64,2,0.633962549
20262,62,23378,7,7,0,1,9,24,7,4,8,0,0,19,nowin,loss,bust,plbust,0,10,14,178,0.370786517,0.028089888,0.54494382,0,0.008657722
20263,136,23378,10,10,0,0,0,20,7,4,8,0,0,19,nowin,win,plwin,beat,20,0,20,194,0.396907216,0.025773196,0.597938144,0,0.029452644
20264,111,23378,10,3,0,8,0,21,7,4,8,0,0,19,nowin,win,plwin,beat,20,0,13,180,0.433333333,0.055555556,0.611111111,2,0.602264492
20265,33,23378,9,2,3,10,0,24,7,4,8,0,0,19,nowin,loss,bust,plbust,0,10,11,192,0.4375,0.057291667,0.625,2,0.616208916
20266,3,23378,3,5,10,0,0,18,7,4,8,0,0,19,nowin,loss,beat,dlwin,0,10,8,190,0.431578947,0.026315789,0.542105263,1,0.288076384
20267,35,23378,1,2,10,8,0,21,7,4,8,0,0,19,nowin,win,plwin,beat,20,0,3,202,0.410891089,0.044554455,0.633663366,2,0.598681573
20268,23,23379,4,10,0,0,0,14,3,8,10,0,0,21,nowin,loss,beat,dlwin,0,10,14,208,0.427884615,0.0625,0.552884615,1,0.29114424
20269,86,23379,6,10,0,0,0,16,3,8,10,0,0,21,nowin,loss,beat,dlwin,0,10,16,196,0.454081633,0.040816327,0.591836735,3,0.887566443
20270,102,23379,5,7,0,10,0,22,3,8,10,0,0,21,nowin,loss,bust,plbust,0,10,12,192,0.338541667,0.046875,0.5625,0,0.003306118
20271,86,23379,10,4,0,0,0,14,3,8,10,0,0,21,nowin,loss,beat,dlwin,0,10,14,196,0.454081633,0.040816327,0.591836735,3,0.887566443
20272,126,23379,9,4,0,0,0,13,3,8,10,0,0,21,nowin,loss,beat,dlwin,0,10,13,188,0.457446809,0.074468085,0.60106383,3,0.900633203
20273,122,23379,8,6,0,0,0,14,3,8,10,0,0,21,nowin,loss,beat,dlwin,0,10,14,210,0.347619048,0.052380952,0.59047619,0,0.012873677
20274,70,23380,9,2,3,0,0,14,2,10,4,7,0,23,nowin,win,dlbust,bust,20,0,11,228,0.385964912,0.039473684,0.557017544,0,0.016157125
20275,95,23380,7,11,0,0,0,18,2,10,4,7,0,23,nowin,win,dlbust,bust,20,0,18,218,0.412844037,0.04587156,0.559633028,0,0.024842385
20276,21,23380,7,11,0,0,0,18,2,10,4,7,0,23,nowin,win,dlbust,bust,20,0,18,214,0.359813084,0.042056075,0.626168224,0,0.025263474
20277,82,23380,10,6,0,0,0,16,2,10,4,7,0,23,nowin,win,dlbust,bust,20,0,16,225,0.408888889,0.075555556,0.577777778,0,0.028101874
20278,149,23380,9,3,0,1,0,13,2,10,4,7,0,23,nowin,win,dlbust,bust,20,0,12,225,0.457777778,0.057777778,0.648888889,2,0.651965595
20279,46,23380,10,6,0,0,0,16,2,10,4,7,0,23,nowin,win,dlbust,bust,20,0,16,186,0.403225806,0.048387097,0.591397849,0,0.029742194
20280,144,23381,10,6,0,10,0,26,9,11,0,0,0,20,nowin,loss,bust,plbust,0,10,16,202,0.386138614,0.054455446,0.564356436,0,0.018006244
20281,71,23381,9,2,3,10,0,24,9,11,0,0,0,20,nowin,loss,bust,plbust,0,10,11,193,0.352331606,0.046632124,0.585492228,0,0.013063661
20282,134,23381,8,8,0,5,0,21,9,11,0,0,0,20,nowin,win,plwin,beat,20,0,16,185,0.443243243,0.021621622,0.545945946,1,0.296939509
20283,67,23381,11,8,0,0,0,19,9,11,0,0,0,20,nowin,loss,beat,dlwin,0,10,19,195,0.369230769,0.041025641,0.569230769,0,0.014139427
20284,26,23381,10,8,0,0,0,18,9,11,0,0,0,20,nowin,loss,beat,dlwin,0,10,18,203,0.463054187,0.0591133,0.541871921,1,0.306802864
20285,95,23381,11,10,0,0,0,21,9,11,0,0,0,20,win,win,plwin,beat,25,0,21,218,0.412844037,0.04587156,0.559633028,0,0.024842385
20286,50,23382,10,4,0,10,0,24,7,8,7,0,0,22,nowin,loss,bust,plbust,0,10,14,202,0.405940594,0.04950495,0.54950495,0,0.020296079
20287,61,23382,3,3,9,9,0,24,7,8,7,0,0,22,nowin,loss,bust,plbust,0,10,6,194,0.427835052,0.077319588,0.603092784,2,0.591437139
20288,7,23382,2,7,10,0,0,19,7,8,7,0,0,22,nowin,win,dlbust,bust,20,0,9,183,0.442622951,0.06010929,0.62295082,2,0.619303341
20289,139,23382,9,11,0,0,0,20,7,8,7,0,0,22,nowin,win,dlbust,bust,20,0,20,192,0.380208333,0.036458333,0.59375,0,0.023429169
20290,115,23382,9,10,0,0,0,19,7,8,7,0,0,22,nowin,win,dlbust,bust,20,0,19,194,0.427835052,0.041237113,0.592783505,2,0.583863602
20291,6,23382,8,11,0,0,0,19,7,8,7,0,0,22,nowin,win,dlbust,bust,20,0,19,191,0.439790576,0.047120419,0.581151832,1,0.31211505
20292,22,23383,5,6,8,0,0,19,8,6,8,0,0,22,nowin,win,dlbust,bust,20,0,11,187,0.481283422,0.042780749,0.577540107,3,0.906128176
20293,18,23383,10,10,0,0,0,20,8,6,8,0,0,22,nowin,win,dlbust,bust,20,0,20,182,0.461538462,0.043956044,0.587912088,3,0.892649374
20294,94,23383,10,10,0,0,0,20,8,6,8,0,0,22,nowin,win,dlbust,bust,20,0,20,183,0.43715847,0.043715847,0.540983607,1,0.290866892
20295,12,23383,6,5,10,0,0,21,8,6,8,0,0,22,nowin,win,dlbust,bust,20,0,11,189,0.470899471,0.015873016,0.613756614,3,0.929171178
20296,119,23383,10,9,0,0,0,19,8,6,8,0,0,22,nowin,win,dlbust,bust,20,0,19,190,0.405263158,0.068421053,0.515789474,0,0.011837158
20297,89,23383,4,2,3,10,0,19,8,6,8,0,0,22,nowin,win,dlbust,bust,20,0,6,212,0.537735849,0.047169811,0.594339623,3,0.990167191
20298,92,23384,9,10,0,0,0,19,7,2,11,0,0,20,nowin,loss,beat,dlwin,0,10,19,186,0.446236559,0.059139785,0.564516129,1,0.307826125
20299,39,23384,11,10,0,0,0,21,7,2,11,0,0,20,win,win,plwin,beat,25,0,21,191,0.429319372,0.062827225,0.57591623,0,0.033760763
20300,7,23384,10,3,0,1,4,18,7,2,11,0,0,20,nowin,loss,beat,dlwin,0,10,13,183,0.442622951,0.06010929,0.62295082,2,0.619303341
20301,75,23384,1,4,10,6,0,21,7,2,11,0,0,20,nowin,win,plwin,beat,20,0,5,191,0.418848168,0.052356021,0.570680628,0,0.029344702
20302,144,23384,10,11,0,0,0,21,7,2,11,0,0,20,win,win,plwin,beat,25,0,21,202,0.386138614,0.054455446,0.564356436,0,0.018006244
20303,88,23384,9,6,0,5,0,20,7,2,11,0,0,20,nowin,push,push,push,10,0,15,206,0.466019417,0.033980583,0.54368932,1,0.309467903
20304,35,23385,8,2,7,0,0,17,10,9,0,0,0,19,nowin,loss,beat,dlwin,0,10,10,202,0.410891089,0.044554455,0.633663366,2,0.598681573
20305,8,23385,1,6,8,7,0,22,10,9,0,0,0,19,nowin,loss,bust,plbust,0,10,7,181,0.44198895,0.071823204,0.596685083,2,0.599438402
20306,66,23385,10,10,0,0,0,20,10,9,0,0,0,19,nowin,win,plwin,beat,20,0,20,217,0.456221198,0.064516129,0.626728111,3,0.924304367
20307,61,23385,2,10,0,10,0,22,10,9,0,0,0,19,nowin,loss,bust,plbust,0,10,12,194,0.427835052,0.077319588,0.603092784,2,0.591437139
20308,105,23385,10,8,0,0,0,18,10,9,0,0,0,19,nowin,loss,beat,dlwin,0,10,18,198,0.414141414,0.070707071,0.590909091,0,0.032889494
20309,52,23385,5,10,0,7,0,22,10,9,0,0,0,19,nowin,loss,bust,plbust,0,10,15,217,0.414746544,0.02764977,0.599078341,2,0.576736024
20310,97,23386,10,8,0,0,0,18,3,4,5,1,8,21,nowin,loss,beat,dlwin,0,10,18,182,0.450549451,0.06043956,0.692307692,2,0.677372279
20311,115,23386,8,10,0,0,0,18,3,4,5,1,8,21,nowin,loss,beat,dlwin,0,10,18,194,0.427835052,0.041237113,0.592783505,2,0.583863602
20312,138,23386,2,7,3,3,0,15,3,4,5,1,8,21,nowin,loss,beat,dlwin,0,10,9,190,0.442105263,0.047368421,0.610526316,2,0.609711065
20313,36,23386,10,10,0,0,0,20,3,4,5,1,8,21,nowin,loss,beat,dlwin,0,10,20,229,0.445414847,0.056768559,0.655021834,2,0.645370571
20314,50,23386,10,10,0,0,0,20,3,4,5,1,8,21,nowin,loss,beat,dlwin,0,10,20,202,0.405940594,0.04950495,0.54950495,0,0.020296079
20315,94,23386,10,11,0,0,0,21,3,4,5,1,8,21,win,push,push,push,10,0,21,183,0.43715847,0.043715847,0.540983607,1,0.290866892
20316,33,23387,10,9,0,0,0,19,8,7,3,0,0,18,nowin,win,plwin,beat,20,0,19,192,0.4375,0.057291667,0.625,2,0.616208916
20317,10,23387,7,4,6,0,0,17,8,7,3,0,0,18,nowin,loss,beat,dlwin,0,10,11,191,0.413612565,0.057591623,0.596858639,2,0.574087175
20318,148,23387,8,10,0,0,0,18,8,7,3,0,0,18,nowin,push,push,push,10,0,18,204,0.401960784,0.078431373,0.593137255,0,0.029789521
20319,39,23387,7,10,0,0,0,17,8,7,3,0,0,18,nowin,loss,beat,dlwin,0,10,17,191,0.429319372,0.062827225,0.57591623,0,0.033760763
20320,84,23387,8,2,10,0,0,20,8,7,3,0,0,18,nowin,win,plwin,beat,20,0,10,195,0.379487179,0.056410256,0.569230769,0,0.017209119
20321,4,23387,6,3,3,3,6,21,8,7,3,0,0,18,nowin,win,plwin,beat,20,0,9,217,0.460829493,0.036866359,0.562211982,1,0.315432839
20322,106,23388,4,6,5,8,0,23,11,7,0,0,0,18,nowin,loss,bust,plbust,0,10,10,192,0.411458333,0.026041667,0.557291667,0,0.023854304
20323,34,23388,10,4,0,5,0,19,11,7,0,0,0,18,nowin,win,plwin,beat,20,0,14,202,0.5,0.079207921,0.618811881,3,0.968961434
20324,46,23388,8,5,0,7,0,20,11,7,0,0,0,18,nowin,win,plwin,beat,20,0,13,186,0.403225806,0.048387097,0.591397849,0,0.029742194
20325,39,23388,4,5,10,0,0,19,11,7,0,0,0,18,nowin,win,plwin,beat,20,0,9,191,0.429319372,0.062827225,0.57591623,0,0.033760763
20326,135,23388,9,10,0,0,0,19,11,7,0,0,0,18,nowin,win,plwin,beat,20,0,19,179,0.391061453,0.067039106,0.586592179,0,0.024924662
20327,82,23388,5,7,0,5,0,17,11,7,0,0,0,18,nowin,loss,beat,dlwin,0,10,12,225,0.408888889,0.075555556,0.577777778,0,0.028101874
20328,96,23389,10,8,0,0,0,18,2,2,7,10,0,21,nowin,loss,beat,dlwin,0,10,18,190,0.468421053,0.057894737,0.584210526,3,0.897263354
20329,21,23389,8,10,0,0,0,18,2,2,7,10,0,21,nowin,loss,beat,dlwin,0,10,18,214,0.359813084,0.042056075,0.626168224,0,0.025263474
20330,41,23389,4,2,10,0,0,16,2,2,7,10,0,21,nowin,loss,beat,dlwin,0,10,6,192,0.364583333,0.036458333,0.520833333,0,0.00089702
20331,23,23389,5,10,0,0,0,15,2,2,7,10,0,21,nowin,loss,beat,dlwin,0,10,15,208,0.427884615,0.0625,0.552884615,1,0.29114424
20332,132,23389,6,10,0,0,0,16,2,2,7,10,0,21,nowin,loss,beat,dlwin,0,10,16,194,0.412371134,0.036082474,0.649484536,2,0.611633238
20333,118,23389,10,8,0,0,0,18,2,2,7,10,0,21,nowin,loss,beat,dlwin,0,10,18,216,0.393518519,0.037037037,0.555555556,0,0.018059873
20334,74,23390,10,7,0,0,0,17,4,2,10,9,0,25,nowin,win,dlbust,bust,20,0,17,209,0.411483254,0.04784689,0.531100478,0,0.017448125
20335,41,23390,5,7,0,0,0,12,4,2,10,9,0,25,nowin,win,dlbust,bust,20,0,12,192,0.364583333,0.036458333,0.520833333,0,0.00089702
20336,14,23390,10,10,0,0,0,20,4,2,10,9,0,25,nowin,win,dlbust,bust,20,0,20,202,0.391089109,0.01980198,0.628712871,2,0.577264877
20337,16,23390,10,7,0,0,0,17,4,2,10,9,0,25,nowin,win,dlbust,bust,20,0,17,220,0.427272727,0.081818182,0.6,2,0.588660176
20338,145,23390,5,3,10,0,0,18,4,2,10,9,0,25,nowin,win,dlbust,bust,20,0,8,188,0.441489362,0.031914894,0.622340426,2,0.617837093
20339,43,23390,2,10,0,0,0,12,4,2,10,9,0,25,nowin,win,dlbust,bust,20,0,12,192,0.40625,0.041666667,0.609375,2,0.576671372
20340,137,23391,10,7,0,0,0,17,1,3,10,10,0,24,nowin,win,dlbust,bust,20,0,17,194,0.417525773,0.046391753,0.536082474,1,0.276714602
20341,60,23391,3,3,7,6,0,19,1,3,10,10,0,24,nowin,win,dlbust,bust,20,0,6,227,0.418502203,0.022026432,0.559471366,0,0.026496258
20342,13,23391,10,3,0,10,0,23,1,3,10,10,0,24,nowin,loss,bust,plbust,0,10,13,206,0.417475728,0.063106796,0.621359223,2,0.59555479
20343,80,23391,9,10,0,0,0,19,1,3,10,10,0,24,nowin,win,dlbust,bust,20,0,19,186,0.419354839,0.059139785,0.623655914,2,0.59892924
20344,74,23391,6,10,0,9,0,25,1,3,10,10,0,24,nowin,loss,bust,plbust,0,10,16,209,0.411483254,0.04784689,0.531100478,0,0.017448125
20345,21,23391,10,10,0,0,0,20,1,3,10,10,0,24,nowin,win,dlbust,bust,20,0,20,214,0.359813084,0.042056075,0.626168224,0,0.025263474
20346,22,23392,11,3,5,0,0,19,10,10,0,0,0,20,nowin,loss,beat,dlwin,0,10,14,187,0.481283422,0.042780749,0.577540107,3,0.906128176
20347,11,23392,10,3,0,1,6,20,10,10,0,0,0,20,nowin,push,push,push,10,0,13,236,0.457627119,0.016949153,0.588983051,3,0.889015813
20348,78,23392,4,6,7,0,0,17,10,10,0,0,0,20,nowin,loss,beat,dlwin,0,10,10,201,0.517412935,0.034825871,0.587064677,3,0.95871112
20349,97,23392,7,11,0,0,0,18,10,10,0,0,0,20,nowin,loss,beat,dlwin,0,10,18,182,0.450549451,0.06043956,0.692307692,2,0.677372279
20350,58,23392,6,4,3,3,1,17,10,10,0,0,0,20,nowin,loss,beat,dlwin,0,10,10,195,0.430769231,0.041025641,0.584615385,2,0.580497586
20351,100,23392,5,4,5,2,8,24,10,10,0,0,0,20,nowin,loss,bust,plbust,0,10,9,190,0.452631579,0.036842105,0.594736842,3,0.888671154
20352,4,23393,10,4,0,2,10,26,7,7,1,5,0,20,nowin,loss,bust,plbust,0,10,14,217,0.460829493,0.036866359,0.562211982,1,0.315432839
20353,2,23393,10,8,0,0,0,18,7,7,1,5,0,20,nowin,loss,beat,dlwin,0,10,18,200,0.445,0.035,0.64,2,0.633962549
20354,17,23393,10,10,0,0,0,20,7,7,1,5,0,20,nowin,push,push,push,10,0,20,171,0.444444444,0.070175439,0.555555556,1,0.302364894
20355,30,23393,8,3,7,0,0,18,7,7,1,5,0,20,nowin,loss,beat,dlwin,0,10,11,206,0.393203883,0.033980583,0.601941748,0,0.029324648
20356,109,23393,10,9,0,0,0,19,7,7,1,5,0,20,nowin,loss,beat,dlwin,0,10,19,221,0.461538462,0.058823529,0.597285068,3,0.901830309
20357,34,23393,10,6,0,5,0,21,7,7,1,5,0,20,nowin,win,plwin,beat,20,0,16,202,0.5,0.079207921,0.618811881,3,0.968961434
20358,71,23394,10,10,0,0,0,20,2,4,9,9,0,24,nowin,win,dlbust,bust,20,0,20,193,0.352331606,0.046632124,0.585492228,0,0.013063661
20359,140,23394,3,11,6,0,0,20,2,4,9,9,0,24,nowin,win,dlbust,bust,20,0,14,210,0.466666667,0.023809524,0.604761905,3,0.915293335
20360,81,23394,10,3,0,0,0,13,2,4,9,9,0,24,nowin,win,dlbust,bust,20,0,13,182,0.395604396,0.043956044,0.60989011,2,0.567491261
20361,84,23394,2,7,10,0,0,19,2,4,9,9,0,24,nowin,win,dlbust,bust,20,0,9,195,0.379487179,0.056410256,0.569230769,0,0.017209119
20362,140,23394,7,4,1,5,0,17,2,4,9,9,0,24,nowin,win,dlbust,bust,20,0,11,210,0.466666667,0.023809524,0.604761905,3,0.915293335
20363,49,23394,6,10,0,0,0,16,2,4,9,9,0,24,nowin,win,dlbust,bust,20,0,16,207,0.396135266,0.053140097,0.594202899,0,0.028306925
20364,15,23395,11,10,0,0,0,21,7,3,10,0,0,20,win,win,plwin,beat,25,0,21,212,0.410377358,0.051886792,0.561320755,0,0.024517408
20365,76,23395,8,6,0,7,0,21,7,3,10,0,0,20,nowin,win,plwin,beat,20,0,14,189,0.534391534,0.079365079,0.608465608,3,1
20366,112,23395,6,6,0,10,0,22,7,3,10,0,0,20,nowin,loss,bust,plbust,0,10,12,203,0.448275862,0.054187192,0.600985222,3,0.889576933
20367,8,23395,10,6,0,10,0,26,7,3,10,0,0,20,nowin,loss,bust,plbust,0,10,16,181,0.44198895,0.071823204,0.596685083,2,0.599438402
20368,8,23395,10,5,0,10,0,25,7,3,10,0,0,20,nowin,loss,bust,plbust,0,10,15,181,0.44198895,0.071823204,0.596685083,2,0.599438402
20369,112,23395,2,7,2,8,0,19,7,3,10,0,0,20,nowin,loss,beat,dlwin,0,10,9,203,0.448275862,0.054187192,0.600985222,3,0.889576933
20370,48,23396,3,5,11,0,0,19,4,10,4,0,0,18,nowin,win,plwin,beat,20,0,8,203,0.413793103,0.019704433,0.600985222,2,0.577280801
20371,114,23396,8,10,0,0,0,18,4,10,4,0,0,18,nowin,push,push,push,10,0,18,198,0.47979798,0.025252525,0.611111111,3,0.937232995
20372,99,23396,4,10,0,0,0,14,4,10,4,0,0,18,nowin,loss,beat,dlwin,0,10,14,207,0.47826087,0.062801932,0.637681159,3,0.961418446
20373,93,23396,2,10,0,0,0,12,4,10,4,0,0,18,nowin,loss,beat,dlwin,0,10,12,175,0.485714286,0.051428571,0.548571429,1,0.323648091
20374,112,23396,10,10,0,0,0,20,4,10,4,0,0,18,nowin,win,plwin,beat,20,0,20,203,0.448275862,0.054187192,0.600985222,3,0.889576933
20375,48,23396,6,10,0,0,0,16,4,10,4,0,0,18,nowin,loss,beat,dlwin,0,10,16,203,0.413793103,0.019704433,0.600985222,2,0.577280801
20376,24,23397,9,6,0,10,0,25,11,10,0,0,0,21,nowin,loss,bust,plbust,0,10,15,207,0.458937198,0.048309179,0.570048309,1,0.318138014
20377,43,23397,6,10,0,5,0,21,11,10,0,0,0,21,nowin,push,push,push,10,0,16,192,0.40625,0.041666667,0.609375,2,0.576671372
20378,11,23397,3,10,0,4,0,17,11,10,0,0,0,21,nowin,loss,beat,dlwin,0,10,13,236,0.457627119,0.016949153,0.588983051,3,0.889015813
20379,108,23397,10,6,0,5,0,21,11,10,0,0,0,21,nowin,push,push,push,10,0,16,193,0.435233161,0.056994819,0.559585492,1,0.298824795
20380,65,23397,10,9,0,0,0,19,11,10,0,0,0,21,nowin,loss,beat,dlwin,0,10,19,203,0.492610837,0.054187192,0.571428571,3,0.913702814
20381,60,23397,10,8,0,0,0,18,11,10,0,0,0,21,nowin,loss,beat,dlwin,0,10,18,227,0.418502203,0.022026432,0.559471366,0,0.026496258
20382,148,23398,4,9,0,0,0,13,2,9,2,8,0,21,nowin,loss,beat,dlwin,0,10,13,204,0.401960784,0.078431373,0.593137255,0,0.029789521
20383,105,23398,10,3,0,0,0,13,2,9,2,8,0,21,nowin,loss,beat,dlwin,0,10,13,198,0.414141414,0.070707071,0.590909091,0,0.032889494
20384,32,23398,9,6,0,0,0,15,2,9,2,8,0,21,nowin,loss,beat,dlwin,0,10,15,189,0.391534392,0.037037037,0.53968254,0,0.013579086
20385,121,23398,2,7,10,0,0,19,2,9,2,8,0,21,nowin,loss,beat,dlwin,0,10,9,195,0.456410256,0.025641026,0.512820513,1,0.288597791
20386,144,23398,3,1,10,0,0,14,2,9,2,8,0,21,nowin,loss,beat,dlwin,0,10,4,202,0.386138614,0.054455446,0.564356436,0,0.018006244
20387,111,23398,10,7,0,0,0,17,2,9,2,8,0,21,nowin,loss,beat,dlwin,0,10,17,180,0.433333333,0.055555556,0.611111111,2,0.602264492
20388,71,23399,8,6,0,1,10,25,10,10,0,0,0,20,nowin,loss,bust,plbust,0,10,14,193,0.352331606,0.046632124,0.585492228,0,0.013063661
20389,31,23399,10,10,0,0,0,20,10,10,0,0,0,20,nowin,push,push,push,10,0,20,188,0.473404255,0.058510638,0.515957447,1,0.300306557
20390,133,23399,4,3,10,0,0,17,10,10,0,0,0,20,nowin,loss,beat,dlwin,0,10,7,201,0.47761194,0.064676617,0.611940299,3,0.935428111
20391,17,23399,10,2,0,6,0,18,10,10,0,0,0,20,nowin,loss,beat,dlwin,0,10,12,171,0.444444444,0.070175439,0.555555556,1,0.302364894
20392,20,23399,10,4,0,7,0,21,10,10,0,0,0,20,nowin,win,plwin,beat,20,0,14,186,0.456989247,0.037634409,0.537634409,1,0.301097108
20393,6,23399,10,9,0,0,0,19,10,10,0,0,0,20,nowin,loss,beat,dlwin,0,10,19,191,0.439790576,0.047120419,0.581151832,1,0.31211505
20394,88,23400,3,10,0,9,0,22,7,7,10,0,0,24,nowin,loss,bust,plbust,0,10,13,206,0.466019417,0.033980583,0.54368932,1,0.309467903
20395,16,23400,6,7,0,10,0,23,7,7,10,0,0,24,nowin,loss,bust,plbust,0,10,13,220,0.427272727,0.081818182,0.6,2,0.588660176
20396,49,23400,3,10,0,3,8,24,7,7,10,0,0,24,nowin,loss,bust,plbust,0,10,13,207,0.396135266,0.053140097,0.594202899,0,0.028306925
20397,94,23400,8,9,0,0,0,17,7,7,10,0,0,24,nowin,win,dlbust,bust,20,0,17,183,0.43715847,0.043715847,0.540983607,1,0.290866892
20398,19,23400,11,4,6,0,0,21,7,7,10,0,0,24,nowin,win,dlbust,bust,20,0,15,237,0.41350211,0.054852321,0.628691983,2,0.597373826
20399,46,23400,10,5,0,10,0,25,7,7,10,0,0,24,nowin,loss,bust,plbust,0,10,15,186,0.403225806,0.048387097,0.591397849,0,0.029742194
20400,140,23401,8,10,0,0,0,18,8,10,0,0,0,18,nowin,push,push,push,10,0,18,210,0.466666667,0.023809524,0.604761905,3,0.915293335
20401,46,23401,8,10,0,0,0,18,8,10,0,0,0,18,nowin,push,push,push,10,0,18,186,0.403225806,0.048387097,0.591397849,0,0.029742194
20402,79,23401,3,2,5,10,0,20,8,10,0,0,0,18,nowin,win,plwin,beat,20,0,5,211,0.436018957,0.028436019,0.672985782,2,0.650131054
20403,53,23401,3,8,5,10,0,26,8,10,0,0,0,18,nowin,loss,bust,plbust,0,10,11,250,0.372,0.064,0.564,0,0.013687345
20404,103,23401,10,8,0,0,0,18,8,10,0,0,0,18,nowin,push,push,push,10,0,18,203,0.379310345,0.064039409,0.551724138,0,0.012869209
20405,132,23401,8,3,10,0,0,21,8,10,0,0,0,18,nowin,win,plwin,beat,20,0,11,194,0.412371134,0.036082474,0.649484536,2,0.611633238
20406,46,23402,9,4,0,0,0,13,3,4,10,0,0,17,nowin,loss,beat,dlwin,0,10,13,186,0.403225806,0.048387097,0.591397849,0,0.029742194
20407,10,23402,10,11,0,0,0,21,3,4,10,0,0,17,win,win,plwin,beat,25,0,21,191,0.413612565,0.057591623,0.596858639,2,0.574087175
20408,2,23402,10,10,0,0,0,20,3,4,10,0,0,17,nowin,win,plwin,beat,20,0,20,200,0.445,0.035,0.64,2,0.633962549
20409,57,23402,10,8,0,0,0,18,3,4,10,0,0,17,nowin,win,plwin,beat,20,0,18,192,0.46875,0.052083333,0.59375,3,0.907001181
20410,59,23402,10,11,0,0,0,21,3,4,10,0,0,17,win,win,plwin,beat,25,0,21,228,0.429824561,0.048245614,0.543859649,1,0.287885446
20411,36,23402,9,5,0,0,0,14,3,4,10,0,0,17,nowin,loss,beat,dlwin,0,10,14,229,0.445414847,0.056768559,0.655021834,2,0.645370571
20412,44,23403,4,10,0,5,0,19,10,8,0,0,0,18,nowin,win,plwin,beat,20,0,14,219,0.433789954,0.050228311,0.534246575,1,0.285551035
20413,24,23403,11,10,0,0,0,21,10,8,0,0,0,18,win,win,plwin,beat,25,0,21,207,0.458937198,0.048309179,0.570048309,1,0.318138014
20414,105,23403,6,10,0,6,0,22,10,8,0,0,0,18,nowin,loss,bust,plbust,0,10,16,198,0.414141414,0.070707071,0.590909091,0,0.032889494
20415,106,23403,3,8,10,0,0,21,10,8,0,0,0,18,nowin,win,plwin,beat,20,0,11,192,0.411458333,0.026041667,0.557291667,0,0.023854304
20416,21,23403,10,11,0,0,0,21,10,8,0,0,0,18,win,win,plwin,beat,25,0,21,214,0.359813084,0.042056075,0.626168224,0,0.025263474
20417,22,23403,10,5,0,2,0,17,10,8,0,0,0,18,nowin,loss,beat,dlwin,0,10,15,187,0.481283422,0.042780749,0.577540107,3,0.906128176
20418,18,23404,8,10,0,0,0,18,9,8,0,0,0,17,nowin,win,plwin,beat,20,0,18,182,0.461538462,0.043956044,0.587912088,3,0.892649374
20419,135,23404,3,9,0,4,8,24,9,8,0,0,0,17,nowin,loss,bust,plbust,0,10,12,179,0.391061453,0.067039106,0.586592179,0,0.024924662
20420,63,23404,11,9,0,0,0,20,9,8,0,0,0,17,nowin,win,plwin,beat,20,0,20,216,0.467592593,0.037037037,0.62037037,3,0.931690496
20421,138,23404,10,7,0,0,0,17,9,8,0,0,0,17,nowin,push,push,push,10,0,17,190,0.442105263,0.047368421,0.610526316,2,0.609711065
20422,37,23404,10,2,0,10,0,22,9,8,0,0,0,17,nowin,loss,bust,plbust,0,10,12,208,0.394230769,0.038461538,0.581730769,0,0.024682772
20423,52,23404,8,8,0,10,0,26,9,8,0,0,0,17,nowin,loss,bust,plbust,0,10,16,217,0.414746544,0.02764977,0.599078341,2,0.576736024
20424,9,23405,10,3,0,0,0,13,6,10,4,0,0,20,nowin,loss,beat,dlwin,0,10,13,194,0.37628866,0.015463918,0.541237113,0,0.009396796
20425,42,23405,2,5,11,0,0,18,6,10,4,0,0,20,nowin,loss,beat,dlwin,0,10,7,212,0.443396226,0.051886792,0.570754717,1,0.309181312
20426,114,23405,8,7,0,0,0,15,6,10,4,0,0,20,nowin,loss,beat,dlwin,0,10,15,198,0.47979798,0.025252525,0.611111111,3,0.937232995
20427,3,23405,9,11,0,0,0,20,6,10,4,0,0,20,nowin,push,push,push,10,0,20,190,0.431578947,0.026315789,0.542105263,1,0.288076384
20428,74,23405,9,8,0,0,0,17,6,10,4,0,0,20,nowin,loss,beat,dlwin,0,10,17,209,0.411483254,0.04784689,0.531100478,0,0.017448125
20429,142,23405,5,2,10,0,0,17,6,10,4,0,0,20,nowin,loss,beat,dlwin,0,10,7,211,0.417061611,0.047393365,0.526066351,1,0.271531309
20430,118,23406,10,7,0,0,0,17,10,11,0,0,0,21,nowin,loss,beat,dlwin,0,10,17,216,0.393518519,0.037037037,0.555555556,0,0.018059873
20431,15,23406,5,7,0,2,5,19,10,11,0,0,0,21,nowin,loss,beat,dlwin,0,10,12,212,0.410377358,0.051886792,0.561320755,0,0.024517408
20432,48,23406,5,10,0,8,0,23,10,11,0,0,0,21,nowin,loss,bust,plbust,0,10,15,203,0.413793103,0.019704433,0.600985222,2,0.577280801
20433,30,23406,11,8,0,0,0,19,10,11,0,0,0,21,nowin,loss,beat,dlwin,0,10,19,206,0.393203883,0.033980583,0.601941748,0,0.029324648
20434,68,23406,10,4,0,1,1,16,10,11,0,0,0,21,nowin,loss,beat,dlwin,0,10,14,205,0.434146341,0.029268293,0.6,2,0.59483189
20435,9,23406,10,10,0,0,0,20,10,11,0,0,0,21,nowin,loss,beat,dlwin,0,10,20,194,0.37628866,0.015463918,0.541237113,0,0.009396796
20436,56,23407,10,10,0,0,0,20,5,10,10,0,0,25,nowin,win,dlbust,bust,20,0,20,175,0.4,0.057142857,0.582857143,0,0.026685297
20437,11,23407,8,10,0,0,0,18,5,10,10,0,0,25,nowin,win,dlbust,bust,20,0,18,236,0.457627119,0.016949153,0.588983051,3,0.889015813
20438,45,23407,8,4,0,0,0,12,5,10,10,0,0,25,nowin,win,dlbust,bust,20,0,12,196,0.428571429,0.051020408,0.612244898,2,0.598821767
20439,82,23407,5,6,3,0,0,14,5,10,10,0,0,25,nowin,win,dlbust,bust,20,0,11,225,0.408888889,0.075555556,0.577777778,0,0.028101874
20440,93,23407,10,6,0,0,0,16,5,10,10,0,0,25,nowin,win,dlbust,bust,20,0,16,175,0.485714286,0.051428571,0.548571429,1,0.323648091
20441,120,23407,3,10,0,0,0,13,5,10,10,0,0,25,nowin,win,dlbust,bust,20,0,13,202,0.440594059,0.034653465,0.618811881,2,0.614441029
20442,144,23408,4,4,10,0,0,18,6,3,3,2,10,24,nowin,win,dlbust,bust,20,0,8,202,0.386138614,0.054455446,0.564356436,0,0.018006244
20443,144,23408,2,2,11,0,0,15,6,3,3,2,10,24,nowin,win,dlbust,bust,20,0,4,202,0.386138614,0.054455446,0.564356436,0,0.018006244
20444,36,23408,10,4,0,0,0,14,6,3,3,2,10,24,nowin,win,dlbust,bust,20,0,14,229,0.445414847,0.056768559,0.655021834,2,0.645370571
20445,6,23408,8,2,8,0,0,18,6,3,3,2,10,24,nowin,win,dlbust,bust,20,0,10,191,0.439790576,0.047120419,0.581151832,1,0.31211505
20446,91,23408,9,5,0,0,0,14,6,3,3,2,10,24,nowin,win,dlbust,bust,20,0,14,194,0.417525773,0.046391753,0.515463918,1,0.266616552
20447,138,23408,10,3,0,0,0,13,6,3,3,2,10,24,nowin,win,dlbust,bust,20,0,13,190,0.442105263,0.047368421,0.610526316,2,0.609711065
20448,9,23409,8,9,0,0,0,17,5,3,3,3,5,19,nowin,loss,beat,dlwin,0,10,17,194,0.37628866,0.015463918,0.541237113,0,0.009396796
20449,102,23409,6,5,8,0,0,19,5,3,3,3,5,19,nowin,push,push,push,10,0,11,192,0.338541667,0.046875,0.5625,0,0.003306118
20450,48,23409,10,2,0,0,0,12,5,3,3,3,5,19,nowin,loss,beat,dlwin,0,10,12,203,0.413793103,0.019704433,0.600985222,2,0.577280801
20451,27,23409,2,9,10,0,0,21,5,3,3,3,5,19,nowin,win,plwin,beat,20,0,11,178,0.370786517,0.016853933,0.573033708,0,0.015536309
20452,145,23409,10,10,0,0,0,20,5,3,3,3,5,19,nowin,win,plwin,beat,20,0,20,188,0.441489362,0.031914894,0.622340426,2,0.617837093
20453,141,23409,6,7,0,0,0,13,5,3,3,3,5,19,nowin,loss,beat,dlwin,0,10,13,202,0.420792079,0.074257426,0.564356436,0,0.028377851
20454,26,23410,4,7,10,0,0,21,10,3,10,0,0,23,nowin,win,dlbust,bust,20,0,11,203,0.463054187,0.0591133,0.541871921,1,0.306802864
20455,49,23410,4,9,0,3,6,22,10,3,10,0,0,23,nowin,loss,bust,plbust,0,10,13,207,0.396135266,0.053140097,0.594202899,0,0.028306925
20456,100,23410,4,9,0,10,0,23,10,3,10,0,0,23,nowin,loss,bust,plbust,0,10,13,190,0.452631579,0.036842105,0.594736842,3,0.888671154
20457,123,23410,6,8,0,2,10,26,10,3,10,0,0,23,nowin,loss,bust,plbust,0,10,14,205,0.43902439,0.034146341,0.614634146,2,0.609962544
20458,1,23410,10,10,0,0,0,20,10,3,10,0,0,23,nowin,win,dlbust,bust,20,0,20,197,0.406091371,0.025380711,0.649746193,2,0.606186955
20459,70,23410,7,8,0,10,0,25,10,3,10,0,0,23,nowin,loss,bust,plbust,0,10,15,228,0.385964912,0.039473684,0.557017544,0,0.016157125
20460,37,23411,11,10,0,0,0,21,5,7,7,0,0,19,win,win,plwin,beat,25,0,21,208,0.394230769,0.038461538,0.581730769,0,0.024682772
20461,21,23411,2,10,0,0,0,12,5,7,7,0,0,19,nowin,loss,beat,dlwin,0,10,12,214,0.359813084,0.042056075,0.626168224,0,0.025263474
20462,20,23411,5,10,0,0,0,15,5,7,7,0,0,19,nowin,loss,beat,dlwin,0,10,15,186,0.456989247,0.037634409,0.537634409,1,0.301097108
20463,18,23411,4,10,0,0,0,14,5,7,7,0,0,19,nowin,loss,beat,dlwin,0,10,14,182,0.461538462,0.043956044,0.587912088,3,0.892649374
20464,1,23411,7,3,10,0,0,20,5,7,7,0,0,19,nowin,win,plwin,beat,20,0,10,197,0.406091371,0.025380711,0.649746193,2,0.606186955
20465,136,23411,10,4,0,0,0,14,5,7,7,0,0,19,nowin,loss,beat,dlwin,0,10,14,194,0.396907216,0.025773196,0.597938144,0,0.029452644
20466,21,23412,11,7,0,0,0,18,10,6,10,0,0,26,nowin,win,dlbust,bust,20,0,18,214,0.359813084,0.042056075,0.626168224,0,0.025263474
20467,115,23412,2,9,10,0,0,21,10,6,10,0,0,26,nowin,win,dlbust,bust,20,0,11,194,0.427835052,0.041237113,0.592783505,2,0.583863602
20468,89,23412,5,10,0,10,0,25,10,6,10,0,0,26,nowin,loss,bust,plbust,0,10,15,212,0.537735849,0.047169811,0.594339623,3,0.990167191
20469,108,23412,4,5,10,0,0,19,10,6,10,0,0,26,nowin,win,dlbust,bust,20,0,9,193,0.435233161,0.056994819,0.559585492,1,0.298824795
20470,129,23412,11,1,1,10,0,23,10,6,10,0,0,26,nowin,loss,bust,plbust,0,10,12,201,0.422885572,0.064676617,0.55721393,0,0.027255383
20471,53,23412,7,2,10,0,0,19,10,6,10,0,0,26,nowin,win,dlbust,bust,20,0,9,250,0.372,0.064,0.564,0,0.013687345
20472,93,23413,8,9,0,0,0,17,9,3,6,0,0,18,nowin,loss,beat,dlwin,0,10,17,175,0.485714286,0.051428571,0.548571429,1,0.323648091
20473,27,23413,2,5,4,4,1,16,9,3,6,0,0,18,nowin,loss,beat,dlwin,0,10,7,178,0.370786517,0.016853933,0.573033708,0,0.015536309
20474,8,23413,2,10,0,10,0,22,9,3,6,0,0,18,nowin,loss,bust,plbust,0,10,12,181,0.44198895,0.071823204,0.596685083,2,0.599438402
20475,2,23413,10,10,0,0,0,20,9,3,6,0,0,18,nowin,win,plwin,beat,20,0,20,200,0.445,0.035,0.64,2,0.633962549
20476,149,23413,6,3,5,1,2,17,9,3,6,0,0,18,nowin,loss,beat,dlwin,0,10,9,225,0.457777778,0.057777778,0.648888889,2,0.651965595
20477,13,23413,2,10,0,1,1,14,9,3,6,0,0,18,nowin,loss,beat,dlwin,0,10,12,206,0.417475728,0.063106796,0.621359223,2,0.59555479
20478,23,23414,6,10,0,0,0,16,3,4,11,0,0,18,nowin,loss,beat,dlwin,0,10,16,208,0.427884615,0.0625,0.552884615,1,0.29114424
20479,146,23414,6,6,0,4,0,16,3,4,11,0,0,18,nowin,loss,beat,dlwin,0,10,12,221,0.43438914,0.040723982,0.542986425,1,0.290190091
20480,110,23414,2,2,10,0,0,14,3,4,11,0,0,18,nowin,loss,beat,dlwin,0,10,4,192,0.416666667,0.046875,0.557291667,0,0.025413132
20481,21,23414,2,9,6,0,0,17,3,4,11,0,0,18,nowin,loss,beat,dlwin,0,10,11,214,0.359813084,0.042056075,0.626168224,0,0.025263474
20482,24,23414,8,2,10,0,0,20,3,4,11,0,0,18,nowin,win,plwin,beat,20,0,10,207,0.458937198,0.048309179,0.570048309,1,0.318138014
20483,107,23414,8,3,9,0,0,20,3,4,11,0,0,18,nowin,win,plwin,beat,20,0,11,218,0.444954128,0.073394495,0.600917431,2,0.605210014
20484,65,23415,10,10,0,0,0,20,5,10,2,0,0,17,nowin,win,plwin,beat,20,0,20,203,0.492610837,0.054187192,0.571428571,3,0.913702814
20485,48,23415,10,10,0,0,0,20,5,10,2,0,0,17,nowin,win,plwin,beat,20,0,20,203,0.413793103,0.019704433,0.600985222,2,0.577280801
20486,134,23415,6,2,10,0,0,18,5,10,2,0,0,17,nowin,win,plwin,beat,20,0,8,185,0.443243243,0.021621622,0.545945946,1,0.296939509
20487,95,23415,11,9,0,0,0,20,5,10,2,0,0,17,nowin,win,plwin,beat,20,0,20,218,0.412844037,0.04587156,0.559633028,0,0.024842385
20488,93,23415,2,10,0,0,0,12,5,10,2,0,0,17,nowin,loss,beat,dlwin,0,10,12,175,0.485714286,0.051428571,0.548571429,1,0.323648091
20489,86,23415,7,10,0,0,0,17,5,10,2,0,0,17,nowin,push,push,push,10,0,17,196,0.454081633,0.040816327,0.591836735,3,0.887566443
20490,119,23416,10,9,0,0,0,19,11,8,0,0,0,19,nowin,push,push,push,10,0,19,190,0.405263158,0.068421053,0.515789474,0,0.011837158
20491,145,23416,10,3,0,7,0,20,11,8,0,0,0,19,nowin,win,plwin,beat,20,0,13,188,0.441489362,0.031914894,0.622340426,2,0.617837093
20492,116,23416,4,10,0,1,3,18,11,8,0,0,0,19,nowin,loss,beat,dlwin,0,10,14,195,0.425641026,0.056410256,0.538461538,1,0.28273747
20493,90,23416,5,7,0,8,0,20,11,8,0,0,0,19,nowin,win,plwin,beat,20,0,12,201,0.447761194,0.049751244,0.60199005,3,0.889945023
20494,133,23416,10,6,0,8,0,24,11,8,0,0,0,19,nowin,loss,bust,plbust,0,10,16,201,0.47761194,0.064676617,0.611940299,3,0.935428111
20495,69,23416,11,10,0,0,0,21,11,8,0,0,0,19,win,win,plwin,beat,25,0,21,194,0.365979381,0.030927835,0.515463918,0,0
20496,24,23417,10,9,0,0,0,19,6,10,10,0,0,26,nowin,win,dlbust,bust,20,0,19,207,0.458937198,0.048309179,0.570048309,1,0.318138014
20497,67,23417,2,10,0,0,0,12,6,10,10,0,0,26,nowin,win,dlbust,bust,20,0,12,195,0.369230769,0.041025641,0.569230769,0,0.014139427
20498,90,23417,4,10,0,0,0,14,6,10,10,0,0,26,nowin,win,dlbust,bust,20,0,14,201,0.447761194,0.049751244,0.60199005,3,0.889945023
20499,63,23417,2,5,11,0,0,18,6,10,10,0,0,26,nowin,win,dlbust,bust,20,0,7,216,0.467592593,0.037037037,0.62037037,3,0.931690496
20500,37,23417,10,10,0,0,0,20,6,10,10,0,0,26,nowin,win,dlbust,bust,20,0,20,208,0.394230769,0.038461538,0.581730769,0,0.024682772
20501,90,23417,4,7,6,0,0,17,6,10,10,0,0,26,nowin,win,dlbust,bust,20,0,11,201,0.447761194,0.049751244,0.60199005,3,0.889945023
20502,69,23418,4,4,8,6,0,22,10,10,0,0,0,20,nowin,loss,bust,plbust,0,10,8,194,0.365979381,0.030927835,0.515463918,0,0
20503,78,23418,3,10,0,3,10,26,10,10,0,0,0,20,nowin,loss,bust,plbust,0,10,13,201,0.517412935,0.034825871,0.587064677,3,0.95871112
20504,38,23418,11,10,0,0,0,21,10,10,0,0,0,20,win,win,plwin,beat,25,0,21,202,0.361386139,0.03960396,0.564356436,0,0.010597953
20505,97,23418,8,9,0,0,0,17,10,10,0,0,0,20,nowin,loss,beat,dlwin,0,10,17,182,0.450549451,0.06043956,0.692307692,2,0.677372279
20506,137,23418,9,11,0,0,0,20,10,10,0,0,0,20,nowin,push,push,push,10,0,20,194,0.417525773,0.046391753,0.536082474,1,0.276714602
20507,54,23418,2,7,2,6,0,17,10,10,0,0,0,20,nowin,loss,beat,dlwin,0,10,9,185,0.437837838,0.032432432,0.556756757,1,0.29899854
20508,109,23419,3,9,0,10,0,22,2,6,2,5,10,25,nowin,loss,bust,plbust,0,10,12,221,0.461538462,0.058823529,0.597285068,3,0.901830309
20509,47,23419,7,3,10,0,0,20,2,6,2,5,10,25,nowin,win,dlbust,bust,20,0,10,210,0.438095238,0.057142857,0.623809524,2,0.615868808
20510,149,23419,6,10,0,0,0,16,2,6,2,5,10,25,nowin,win,dlbust,bust,20,0,16,225,0.457777778,0.057777778,0.648888889,2,0.651965595
20511,4,23419,4,10,0,0,0,14,2,6,2,5,10,25,nowin,win,dlbust,bust,20,0,14,217,0.460829493,0.036866359,0.562211982,1,0.315432839
20512,138,23419,6,10,0,0,0,16,2,6,2,5,10,25,nowin,win,dlbust,bust,20,0,16,190,0.442105263,0.047368421,0.610526316,2,0.609711065
20513,62,23419,5,7,0,1,0,13,2,6,2,5,10,25,nowin,win,dlbust,bust,20,0,12,178,0.370786517,0.028089888,0.54494382,0,0.008657722
20514,35,23420,3,10,0,2,6,21,7,3,2,5,0,17,nowin,win,plwin,beat,20,0,13,202,0.410891089,0.044554455,0.633663366,2,0.598681573
20515,69,23420,7,8,0,1,1,17,7,3,2,5,0,17,nowin,push,push,push,10,0,15,194,0.365979381,0.030927835,0.515463918,0,0
20516,106,23420,6,3,10,0,0,19,7,3,2,5,0,17,nowin,win,plwin,beat,20,0,9,192,0.411458333,0.026041667,0.557291667,0,0.023854304
20517,90,23420,10,10,0,0,0,20,7,3,2,5,0,17,nowin,win,plwin,beat,20,0,20,201,0.447761194,0.049751244,0.60199005,3,0.889945023
20518,58,23420,3,7,4,10,0,24,7,3,2,5,0,17,nowin,loss,bust,plbust,0,10,10,195,0.430769231,0.041025641,0.584615385,2,0.580497586
20519,93,23420,2,10,0,6,0,18,7,3,2,5,0,17,nowin,win,plwin,beat,20,0,12,175,0.485714286,0.051428571,0.548571429,1,0.323648091
20520,82,23421,10,4,0,6,0,20,10,4,1,4,0,19,nowin,win,plwin,beat,20,0,14,225,0.408888889,0.075555556,0.577777778,0,0.028101874
20521,53,23421,3,10,0,10,0,23,10,4,1,4,0,19,nowin,loss,bust,plbust,0,10,13,250,0.372,0.064,0.564,0,0.013687345
20522,76,23421,6,10,0,8,0,24,10,4,1,4,0,19,nowin,loss,bust,plbust,0,10,16,189,0.534391534,0.079365079,0.608465608,3,1
20523,81,23421,8,7,0,10,0,25,10,4,1,4,0,19,nowin,loss,bust,plbust,0,10,15,182,0.395604396,0.043956044,0.60989011,2,0.567491261
20524,84,23421,10,5,0,2,0,17,10,4,1,4,0,19,nowin,loss,beat,dlwin,0,10,15,195,0.379487179,0.056410256,0.569230769,0,0.017209119
20525,38,23421,10,2,0,7,0,19,10,4,1,4,0,19,nowin,push,push,push,10,0,12,202,0.361386139,0.03960396,0.564356436,0,0.010597953
20526,56,23422,8,2,10,0,0,20,5,8,1,6,0,20,nowin,push,push,push,10,0,10,175,0.4,0.057142857,0.582857143,0,0.026685297
20527,20,23422,8,10,0,0,0,18,5,8,1,6,0,20,nowin,loss,beat,dlwin,0,10,18,186,0.456989247,0.037634409,0.537634409,1,0.301097108
20528,26,23422,10,10,0,0,0,20,5,8,1,6,0,20,nowin,push,push,push,10,0,20,203,0.463054187,0.0591133,0.541871921,1,0.306802864
20529,24,23422,2,10,0,0,0,12,5,8,1,6,0,20,nowin,loss,beat,dlwin,0,10,12,207,0.458937198,0.048309179,0.570048309,1,0.318138014
20530,136,23422,7,10,0,0,0,17,5,8,1,6,0,20,nowin,loss,beat,dlwin,0,10,17,194,0.396907216,0.025773196,0.597938144,0,0.029452644
20531,26,23422,2,3,9,0,0,14,5,8,1,6,0,20,nowin,loss,beat,dlwin,0,10,5,203,0.463054187,0.0591133,0.541871921,1,0.306802864
20532,49,23423,6,1,10,0,0,17,9,3,1,10,0,23,nowin,win,dlbust,bust,20,0,7,207,0.396135266,0.053140097,0.594202899,0,0.028306925
20533,66,23423,4,10,0,4,0,18,9,3,1,10,0,23,nowin,win,dlbust,bust,20,0,14,217,0.456221198,0.064516129,0.626728111,3,0.924304367
20534,136,23423,8,10,0,0,0,18,9,3,1,10,0,23,nowin,win,dlbust,bust,20,0,18,194,0.396907216,0.025773196,0.597938144,0,0.029452644
20535,3,23423,10,3,0,9,0,22,9,3,1,10,0,23,nowin,loss,bust,plbust,0,10,13,190,0.431578947,0.026315789,0.542105263,1,0.288076384
20536,140,23423,4,2,11,0,0,17,9,3,1,10,0,23,nowin,win,dlbust,bust,20,0,6,210,0.466666667,0.023809524,0.604761905,3,0.915293335
20537,105,23423,11,2,1,10,0,24,9,3,1,10,0,23,nowin,loss,bust,plbust,0,10,13,198,0.414141414,0.070707071,0.590909091,0,0.032889494
20538,104,23424,7,3,11,0,0,21,10,10,0,0,0,20,nowin,win,plwin,beat,20,0,10,209,0.363636364,0.052631579,0.593301435,0,0.018359419
20539,89,23424,9,3,0,9,0,21,10,10,0,0,0,20,nowin,win,plwin,beat,20,0,12,212,0.537735849,0.047169811,0.594339623,3,0.990167191
20540,69,23424,10,2,0,6,0,18,10,10,0,0,0,20,nowin,loss,beat,dlwin,0,10,12,194,0.365979381,0.030927835,0.515463918,0,0
20541,69,23424,8,4,0,2,5,19,10,10,0,0,0,20,nowin,loss,beat,dlwin,0,10,12,194,0.365979381,0.030927835,0.515463918,0,0
20542,31,23424,10,6,0,10,0,26,10,10,0,0,0,20,nowin,loss,bust,plbust,0,10,16,188,0.473404255,0.058510638,0.515957447,1,0.300306557
20543,143,23424,10,4,0,1,4,19,10,10,0,0,0,20,nowin,loss,beat,dlwin,0,10,14,203,0.463054187,0.044334975,0.57635468,3,0.883143365
20544,32,23425,6,2,7,1,4,20,7,10,0,0,0,17,nowin,win,plwin,beat,20,0,8,189,0.391534392,0.037037037,0.53968254,0,0.013579086
20545,133,23425,4,8,0,10,0,22,7,10,0,0,0,17,nowin,loss,bust,plbust,0,10,12,201,0.47761194,0.064676617,0.611940299,3,0.935428111
20546,16,23425,10,10,0,0,0,20,7,10,0,0,0,17,nowin,win,plwin,beat,20,0,20,220,0.427272727,0.081818182,0.6,2,0.588660176
20547,44,23425,8,9,0,0,0,17,7,10,0,0,0,17,nowin,push,push,push,10,0,17,219,0.433789954,0.050228311,0.534246575,1,0.285551035
20548,146,23425,4,5,9,0,0,18,7,10,0,0,0,17,nowin,win,plwin,beat,20,0,9,221,0.43438914,0.040723982,0.542986425,1,0.290190091
20549,29,23425,10,4,0,4,0,18,7,10,0,0,0,17,nowin,win,plwin,beat,20,0,14,189,0.44973545,0.058201058,0.544973545,1,0.300349439
20550,82,23426,3,10,0,10,0,23,7,7,10,0,0,24,nowin,loss,bust,plbust,0,10,13,225,0.408888889,0.075555556,0.577777778,0,0.028101874
20551,92,23426,11,10,0,0,0,21,7,7,10,0,0,24,win,win,dlbust,bust,25,0,21,186,0.446236559,0.059139785,0.564516129,1,0.307826125
20552,94,23426,7,8,0,10,0,25,7,7,10,0,0,24,nowin,loss,bust,plbust,0,10,15,183,0.43715847,0.043715847,0.540983607,1,0.290866892
20553,136,23426,10,8,0,0,0,18,7,7,10,0,0,24,nowin,win,dlbust,bust,20,0,18,194,0.396907216,0.025773196,0.597938144,0,0.029452644
20554,123,23426,10,9,0,0,0,19,7,7,10,0,0,24,nowin,win,dlbust,bust,20,0,19,205,0.43902439,0.034146341,0.614634146,2,0.609962544
20555,45,23426,8,9,0,0,0,17,7,7,10,0,0,24,nowin,win,dlbust,bust,20,0,17,196,0.428571429,0.051020408,0.612244898,2,0.598821767
20556,82,23427,3,10,0,10,0,23,7,9,3,0,0,19,nowin,loss,bust,plbust,0,10,13,225,0.408888889,0.075555556,0.577777778,0,0.028101874
20557,134,23427,8,5,0,8,0,21,7,9,3,0,0,19,nowin,win,plwin,beat,20,0,13,185,0.443243243,0.021621622,0.545945946,1,0.296939509
20558,84,23427,9,11,0,0,0,20,7,9,3,0,0,19,nowin,win,plwin,beat,20,0,20,195,0.379487179,0.056410256,0.569230769,0,0.017209119
20559,83,23427,10,11,0,0,0,21,7,9,3,0,0,19,win,win,plwin,beat,25,0,21,193,0.424870466,0.051813472,0.678756477,2,0.644360335
20560,77,23427,9,2,10,0,0,21,7,9,3,0,0,19,nowin,win,plwin,beat,20,0,11,200,0.455,0.04,0.62,3,0.916252116
20561,89,23427,9,10,0,0,0,19,7,9,3,0,0,19,nowin,push,push,push,10,0,19,212,0.537735849,0.047169811,0.594339623,3,0.990167191
20562,26,23428,10,10,0,0,0,20,7,8,1,10,0,26,nowin,win,dlbust,bust,20,0,20,203,0.463054187,0.0591133,0.541871921,1,0.306802864
20563,143,23428,10,11,0,0,0,21,7,8,1,10,0,26,win,win,dlbust,bust,25,0,21,203,0.463054187,0.044334975,0.57635468,3,0.883143365
20564,121,23428,8,4,0,2,4,18,7,8,1,10,0,26,nowin,win,dlbust,bust,20,0,12,195,0.456410256,0.025641026,0.512820513,1,0.288597791
20565,133,23428,5,7,0,8,0,20,7,8,1,10,0,26,nowin,win,dlbust,bust,20,0,12,201,0.47761194,0.064676617,0.611940299,3,0.935428111
20566,70,23428,10,5,0,10,0,25,7,8,1,10,0,26,nowin,loss,bust,plbust,0,10,15,228,0.385964912,0.039473684,0.557017544,0,0.016157125
20567,135,23428,10,11,0,0,0,21,7,8,1,10,0,26,win,win,dlbust,bust,25,0,21,179,0.391061453,0.067039106,0.586592179,0,0.024924662
20568,96,23429,10,10,0,0,0,20,10,10,0,0,0,20,nowin,push,push,push,10,0,20,190,0.468421053,0.057894737,0.584210526,3,0.897263354
20569,22,23429,5,5,10,0,0,20,10,10,0,0,0,20,nowin,push,push,push,10,0,10,187,0.481283422,0.042780749,0.577540107,3,0.906128176
20570,122,23429,10,5,0,9,0,24,10,10,0,0,0,20,nowin,loss,bust,plbust,0,10,15,210,0.347619048,0.052380952,0.59047619,0,0.012873677
20571,44,23429,10,10,0,0,0,20,10,10,0,0,0,20,nowin,push,push,push,10,0,20,219,0.433789954,0.050228311,0.534246575,1,0.285551035
20572,131,23429,3,8,10,0,0,21,10,10,0,0,0,20,nowin,win,plwin,beat,20,0,11,217,0.410138249,0.069124424,0.543778802,0,0.02015021
20573,108,23429,7,8,0,10,0,25,10,10,0,0,0,20,nowin,loss,bust,plbust,0,10,15,193,0.435233161,0.056994819,0.559585492,1,0.298824795
20574,21,23430,2,7,5,5,0,19,10,3,10,0,0,23,nowin,win,dlbust,bust,20,0,9,214,0.359813084,0.042056075,0.626168224,0,0.025263474
20575,84,23430,10,6,0,5,0,21,10,3,10,0,0,23,nowin,win,dlbust,bust,20,0,16,195,0.379487179,0.056410256,0.569230769,0,0.017209119
20576,2,23430,6,4,10,0,0,20,10,3,10,0,0,23,nowin,win,dlbust,bust,20,0,10,200,0.445,0.035,0.64,2,0.633962549
20577,116,23430,4,10,0,2,9,25,10,3,10,0,0,23,nowin,loss,bust,plbust,0,10,14,195,0.425641026,0.056410256,0.538461538,1,0.28273747
20578,13,23430,10,10,0,0,0,20,10,3,10,0,0,23,nowin,win,dlbust,bust,20,0,20,206,0.417475728,0.063106796,0.621359223,2,0.59555479
20579,75,23430,3,4,10,0,0,17,10,3,10,0,0,23,nowin,win,dlbust,bust,20,0,7,191,0.418848168,0.052356021,0.570680628,0,0.029344702
20580,91,23431,10,6,0,10,0,26,10,4,10,0,0,24,nowin,loss,bust,plbust,0,10,16,194,0.417525773,0.046391753,0.515463918,1,0.266616552
20581,77,23431,4,8,0,7,0,19,10,4,10,0,0,24,nowin,win,dlbust,bust,20,0,12,200,0.455,0.04,0.62,3,0.916252116
20582,47,23431,10,10,0,0,0,20,10,4,10,0,0,24,nowin,win,dlbust,bust,20,0,20,210,0.438095238,0.057142857,0.623809524,2,0.615868808
20583,50,23431,10,4,0,10,0,24,10,4,10,0,0,24,nowin,loss,bust,plbust,0,10,14,202,0.405940594,0.04950495,0.54950495,0,0.020296079
20584,54,23431,10,5,0,8,0,23,10,4,10,0,0,24,nowin,loss,bust,plbust,0,10,15,185,0.437837838,0.032432432,0.556756757,1,0.29899854
20585,5,23431,5,7,0,10,0,22,10,4,10,0,0,24,nowin,loss,bust,plbust,0,10,12,203,0.42364532,0.02955665,0.596059113,2,0.582508076
20586,5,23432,9,4,0,10,0,23,1,2,9,4,10,26,nowin,loss,bust,plbust,0,10,13,203,0.42364532,0.02955665,0.596059113,2,0.582508076
20587,17,23432,7,10,0,0,0,17,1,2,9,4,10,26,nowin,win,dlbust,bust,20,0,17,171,0.444444444,0.070175439,0.555555556,1,0.302364894
20588,130,23432,6,8,0,6,0,20,1,2,9,4,10,26,nowin,win,dlbust,bust,20,0,14,219,0.410958904,0.03652968,0.566210046,0,0.025888739
20589,6,23432,11,10,0,0,0,21,1,2,9,4,10,26,win,win,dlbust,bust,25,0,21,191,0.439790576,0.047120419,0.581151832,1,0.31211505
20590,91,23432,8,3,3,4,0,18,1,2,9,4,10,26,nowin,win,dlbust,bust,20,0,11,194,0.417525773,0.046391753,0.515463918,1,0.266616552
20591,2,23432,4,5,11,0,0,20,1,2,9,4,10,26,nowin,win,dlbust,bust,20,0,9,200,0.445,0.035,0.64,2,0.633962549
20592,93,23433,10,10,0,0,0,20,6,10,9,0,0,25,nowin,win,dlbust,bust,20,0,20,175,0.485714286,0.051428571,0.548571429,1,0.323648091
20593,27,23433,5,6,7,0,0,18,6,10,9,0,0,25,nowin,win,dlbust,bust,20,0,11,178,0.370786517,0.016853933,0.573033708,0,0.015536309
20594,58,23433,8,10,0,0,0,18,6,10,9,0,0,25,nowin,win,dlbust,bust,20,0,18,195,0.430769231,0.041025641,0.584615385,2,0.580497586
20595,34,23433,2,3,5,8,0,18,6,10,9,0,0,25,nowin,win,dlbust,bust,20,0,5,202,0.5,0.079207921,0.618811881,3,0.968961434
20596,11,23433,4,8,0,0,0,12,6,10,9,0,0,25,nowin,win,dlbust,bust,20,0,12,236,0.457627119,0.016949153,0.588983051,3,0.889015813
20597,27,23433,7,2,10,0,0,19,6,10,9,0,0,25,nowin,win,dlbust,bust,20,0,9,178,0.370786517,0.016853933,0.573033708,0,0.015536309
20598,132,23434,6,9,0,3,0,18,9,2,7,0,0,18,nowin,push,push,push,10,0,15,194,0.412371134,0.036082474,0.649484536,2,0.611633238
20599,6,23434,8,10,0,0,0,18,9,2,7,0,0,18,nowin,push,push,push,10,0,18,191,0.439790576,0.047120419,0.581151832,1,0.31211505
20600,46,23434,3,6,4,1,1,15,9,2,7,0,0,18,nowin,loss,beat,dlwin,0,10,9,186,0.403225806,0.048387097,0.591397849,0,0.029742194
20601,24,23434,8,4,0,7,0,19,9,2,7,0,0,18,nowin,win,plwin,beat,20,0,12,207,0.458937198,0.048309179,0.570048309,1,0.318138014
20602,25,23434,3,11,7,0,0,21,9,2,7,0,0,18,nowin,win,plwin,beat,20,0,14,190,0.463157895,0.063157895,0.536842105,1,0.304401563
20603,131,23434,7,11,0,0,0,18,9,2,7,0,0,18,nowin,push,push,push,10,0,18,217,0.410138249,0.069124424,0.543778802,0,0.02015021
20604,13,23435,8,3,7,0,0,18,3,3,4,10,0,20,nowin,loss,beat,dlwin,0,10,11,206,0.417475728,0.063106796,0.621359223,2,0.59555479
20605,132,23435,10,7,0,0,0,17,3,3,4,10,0,20,nowin,loss,beat,dlwin,0,10,17,194,0.412371134,0.036082474,0.649484536,2,0.611633238
20606,103,23435,10,7,0,0,0,17,3,3,4,10,0,20,nowin,loss,beat,dlwin,0,10,17,203,0.379310345,0.064039409,0.551724138,0,0.012869209
20607,5,23435,10,11,0,0,0,21,3,3,4,10,0,20,win,win,plwin,beat,25,0,21,203,0.42364532,0.02955665,0.596059113,2,0.582508076
20608,68,23435,10,7,0,0,0,17,3,3,4,10,0,20,nowin,loss,beat,dlwin,0,10,17,205,0.434146341,0.029268293,0.6,2,0.59483189
20609,34,23435,10,10,0,0,0,20,3,3,4,10,0,20,nowin,push,push,push,10,0,20,202,0.5,0.079207921,0.618811881,3,0.968961434
20610,70,23436,10,8,0,0,0,18,7,10,0,0,0,17,nowin,win,plwin,beat,20,0,18,228,0.385964912,0.039473684,0.557017544,0,0.016157125
20611,44,23436,5,6,6,0,0,17,7,10,0,0,0,17,nowin,push,push,push,10,0,11,219,0.433789954,0.050228311,0.534246575,1,0.285551035
20612,116,23436,2,7,8,0,0,17,7,10,0,0,0,17,nowin,push,push,push,10,0,9,195,0.425641026,0.056410256,0.538461538,1,0.28273747
20613,105,23436,10,11,0,0,0,21,7,10,0,0,0,17,win,win,plwin,beat,25,0,21,198,0.414141414,0.070707071,0.590909091,0,0.032889494
20614,115,23436,10,4,0,8,0,22,7,10,0,0,0,17,nowin,loss,bust,plbust,0,10,14,194,0.427835052,0.041237113,0.592783505,2,0.583863602
20615,29,23436,7,2,7,10,0,26,7,10,0,0,0,17,nowin,loss,bust,plbust,0,10,9,189,0.44973545,0.058201058,0.544973545,1,0.300349439
20616,55,23437,5,6,4,5,0,20,10,2,10,0,0,22,nowin,win,dlbust,bust,20,0,11,191,0.371727749,0.057591623,0.54973822,0,0.01011347
20617,92,23437,3,7,10,0,0,20,10,2,10,0,0,22,nowin,win,dlbust,bust,20,0,10,186,0.446236559,0.059139785,0.564516129,1,0.307826125
20618,147,23437,4,2,6,10,0,22,10,2,10,0,0,22,nowin,loss,bust,plbust,0,10,6,205,0.380487805,0.014634146,0.536585366,0,0.00951447
20619,12,23437,6,3,9,0,0,18,10,2,10,0,0,22,nowin,win,dlbust,bust,20,0,9,189,0.470899471,0.015873016,0.613756614,3,0.929171178
20620,26,23437,10,7,0,0,0,17,10,2,10,0,0,22,nowin,win,dlbust,bust,20,0,17,203,0.463054187,0.0591133,0.541871921,1,0.306802864
20621,70,23437,10,11,0,0,0,21,10,2,10,0,0,22,win,win,dlbust,bust,25,0,21,228,0.385964912,0.039473684,0.557017544,0,0.016157125
20622,7,23438,10,8,0,0,0,18,6,8,6,0,0,20,nowin,loss,beat,dlwin,0,10,18,183,0.442622951,0.06010929,0.62295082,2,0.619303341
20623,58,23438,9,3,0,0,0,12,6,8,6,0,0,20,nowin,loss,beat,dlwin,0,10,12,195,0.430769231,0.041025641,0.584615385,2,0.580497586
20624,118,23438,7,8,0,0,0,15,6,8,6,0,0,20,nowin,loss,beat,dlwin,0,10,15,216,0.393518519,0.037037037,0.555555556,0,0.018059873
20625,14,23438,10,9,0,0,0,19,6,8,6,0,0,20,nowin,loss,beat,dlwin,0,10,19,202,0.391089109,0.01980198,0.628712871,2,0.577264877
20626,84,23438,10,6,0,0,0,16,6,8,6,0,0,20,nowin,loss,beat,dlwin,0,10,16,195,0.379487179,0.056410256,0.569230769,0,0.017209119
20627,135,23438,2,2,7,2,0,13,6,8,6,0,0,20,nowin,loss,beat,dlwin,0,10,4,179,0.391061453,0.067039106,0.586592179,0,0.024924662
20628,131,23439,9,5,0,10,0,24,10,9,0,0,0,19,nowin,loss,bust,plbust,0,10,14,217,0.410138249,0.069124424,0.543778802,0,0.02015021
20629,4,23439,7,4,2,5,0,18,10,9,0,0,0,19,nowin,loss,beat,dlwin,0,10,11,217,0.460829493,0.036866359,0.562211982,1,0.315432839
20630,107,23439,1,5,9,3,0,18,10,9,0,0,0,19,nowin,loss,beat,dlwin,0,10,6,218,0.444954128,0.073394495,0.600917431,2,0.605210014
20631,116,23439,10,9,0,0,0,19,10,9,0,0,0,19,nowin,push,push,push,10,0,19,195,0.425641026,0.056410256,0.538461538,1,0.28273747
20632,13,23439,10,10,0,0,0,20,10,9,0,0,0,19,nowin,win,plwin,beat,20,0,20,206,0.417475728,0.063106796,0.621359223,2,0.59555479
20633,115,23439,5,10,0,10,0,25,10,9,0,0,0,19,nowin,loss,bust,plbust,0,10,15,194,0.427835052,0.041237113,0.592783505,2,0.583863602
20634,43,23440,10,7,0,0,0,17,9,3,8,0,0,20,nowin,loss,beat,dlwin,0,10,17,192,0.40625,0.041666667,0.609375,2,0.576671372
20635,89,23440,6,4,9,0,0,19,9,3,8,0,0,20,nowin,loss,beat,dlwin,0,10,10,212,0.537735849,0.047169811,0.594339623,3,0.990167191
20636,25,23440,8,10,0,0,0,18,9,3,8,0,0,20,nowin,loss,beat,dlwin,0,10,18,190,0.463157895,0.063157895,0.536842105,1,0.304401563
20637,5,23440,2,4,2,10,0,18,9,3,8,0,0,20,nowin,loss,beat,dlwin,0,10,6,203,0.42364532,0.02955665,0.596059113,2,0.582508076
20638,50,23440,10,3,0,8,0,21,9,3,8,0,0,20,nowin,win,plwin,beat,20,0,13,202,0.405940594,0.04950495,0.54950495,0,0.020296079
20639,48,23440,10,4,0,2,10,26,9,3,8,0,0,20,nowin,loss,bust,plbust,0,10,14,203,0.413793103,0.019704433,0.600985222,2,0.577280801
20640,96,23441,1,5,6,7,0,19,7,10,0,0,0,17,nowin,win,plwin,beat,20,0,6,190,0.468421053,0.057894737,0.584210526,3,0.897263354
20641,24,23441,4,10,0,9,0,23,7,10,0,0,0,17,nowin,loss,bust,plbust,0,10,14,207,0.458937198,0.048309179,0.570048309,1,0.318138014
20642,120,23441,5,9,0,10,0,24,7,10,0,0,0,17,nowin,loss,bust,plbust,0,10,14,202,0.440594059,0.034653465,0.618811881,2,0.614441029
20643,45,23441,11,10,0,0,0,21,7,10,0,0,0,17,win,win,plwin,beat,25,0,21,196,0.428571429,0.051020408,0.612244898,2,0.598821767
20644,53,23441,10,10,0,0,0,20,7,10,0,0,0,17,nowin,win,plwin,beat,20,0,20,250,0.372,0.064,0.564,0,0.013687345
20645,37,23441,10,5,0,10,0,25,7,10,0,0,0,17,nowin,loss,bust,plbust,0,10,15,208,0.394230769,0.038461538,0.581730769,0,0.024682772
20646,70,23442,6,7,0,10,0,23,9,10,0,0,0,19,nowin,loss,bust,plbust,0,10,13,228,0.385964912,0.039473684,0.557017544,0,0.016157125
20647,83,23442,8,10,0,0,0,18,9,10,0,0,0,19,nowin,loss,beat,dlwin,0,10,18,193,0.424870466,0.051813472,0.678756477,2,0.644360335
20648,14,23442,11,9,0,0,0,20,9,10,0,0,0,19,nowin,win,plwin,beat,20,0,20,202,0.391089109,0.01980198,0.628712871,2,0.577264877
20649,94,23442,10,10,0,0,0,20,9,10,0,0,0,19,nowin,win,plwin,beat,20,0,20,183,0.43715847,0.043715847,0.540983607,1,0.290866892
20650,54,23442,8,4,0,10,0,22,9,10,0,0,0,19,nowin,loss,bust,plbust,0,10,12,185,0.437837838,0.032432432,0.556756757,1,0.29899854
20651,117,23442,10,4,0,7,0,21,9,10,0,0,0,19,nowin,win,plwin,beat,20,0,14,173,0.410404624,0.069364162,0.606936416,2,0.578610282
20652,99,23443,10,4,0,0,0,14,3,10,10,0,0,23,nowin,win,dlbust,bust,20,0,14,207,0.47826087,0.062801932,0.637681159,3,0.961418446
20653,1,23443,11,10,0,0,0,21,3,10,10,0,0,23,win,win,dlbust,bust,25,0,21,197,0.406091371,0.025380711,0.649746193,2,0.606186955
20654,132,23443,10,9,0,0,0,19,3,10,10,0,0,23,nowin,win,dlbust,bust,20,0,19,194,0.412371134,0.036082474,0.649484536,2,0.611633238
20655,104,23443,9,10,0,0,0,19,3,10,10,0,0,23,nowin,win,dlbust,bust,20,0,19,209,0.363636364,0.052631579,0.593301435,0,0.018359419
20656,65,23443,1,5,6,10,0,22,3,10,10,0,0,23,nowin,loss,bust,plbust,0,10,6,203,0.492610837,0.054187192,0.571428571,3,0.913702814
20657,114,23443,4,4,6,0,0,14,3,10,10,0,0,23,nowin,win,dlbust,bust,20,0,8,198,0.47979798,0.025252525,0.611111111,3,0.937232995
20658,58,23444,6,10,0,0,0,16,3,3,4,2,4,16,nowin,push,push,push,10,0,16,195,0.430769231,0.041025641,0.584615385,2,0.580497586
20659,134,23444,2,6,10,0,0,18,3,3,4,2,4,16,nowin,win,plwin,beat,20,0,8,185,0.443243243,0.021621622,0.545945946,1,0.296939509
20660,148,23444,7,7,0,0,0,14,3,3,4,2,4,16,nowin,loss,beat,dlwin,0,10,14,204,0.401960784,0.078431373,0.593137255,0,0.029789521
20661,47,23444,9,5,0,0,0,14,3,3,4,2,4,16,nowin,loss,beat,dlwin,0,10,14,210,0.438095238,0.057142857,0.623809524,2,0.615868808
20662,31,23444,6,11,1,0,0,18,3,3,4,2,4,16,nowin,win,plwin,beat,20,0,17,188,0.473404255,0.058510638,0.515957447,1,0.300306557
20663,122,23444,5,10,0,0,0,15,3,3,4,2,4,16,nowin,loss,beat,dlwin,0,10,15,210,0.347619048,0.052380952,0.59047619,0,0.012873677
20664,11,23445,5,8,0,8,0,21,7,2,5,10,0,24,nowin,win,dlbust,bust,20,0,13,236,0.457627119,0.016949153,0.588983051,3,0.889015813
20665,15,23445,9,11,0,0,0,20,7,2,5,10,0,24,nowin,win,dlbust,bust,20,0,20,212,0.410377358,0.051886792,0.561320755,0,0.024517408
20666,13,23445,8,10,0,0,0,18,7,2,5,10,0,24,nowin,win,dlbust,bust,20,0,18,206,0.417475728,0.063106796,0.621359223,2,0.59555479
20667,46,23445,4,6,10,0,0,20,7,2,5,10,0,24,nowin,win,dlbust,bust,20,0,10,186,0.403225806,0.048387097,0.591397849,0,0.029742194
20668,63,23445,5,4,10,0,0,19,7,2,5,10,0,24,nowin,win,dlbust,bust,20,0,9,216,0.467592593,0.037037037,0.62037037,3,0.931690496
20669,108,23445,4,3,10,0,0,17,7,2,5,10,0,24,nowin,win,dlbust,bust,20,0,7,193,0.435233161,0.056994819,0.559585492,1,0.298824795
20670,43,23446,11,2,8,0,0,21,10,2,2,10,0,24,nowin,win,dlbust,bust,20,0,13,192,0.40625,0.041666667,0.609375,2,0.576671372
20671,87,23446,6,6,0,10,0,22,10,2,2,10,0,24,nowin,loss,bust,plbust,0,10,12,202,0.405940594,0.054455446,0.628712871,2,0.590599801
20672,94,23446,3,10,0,10,0,23,10,2,2,10,0,24,nowin,loss,bust,plbust,0,10,13,183,0.43715847,0.043715847,0.540983607,1,0.290866892
20673,133,23446,7,11,0,0,0,18,10,2,2,10,0,24,nowin,win,dlbust,bust,20,0,18,201,0.47761194,0.064676617,0.611940299,3,0.935428111
20674,96,23446,2,3,10,9,0,24,10,2,2,10,0,24,nowin,loss,bust,plbust,0,10,5,190,0.468421053,0.057894737,0.584210526,3,0.897263354
20675,124,23446,10,4,0,7,0,21,10,2,2,10,0,24,nowin,win,dlbust,bust,20,0,14,202,0.47029703,0.064356436,0.584158416,3,0.899458193
20676,150,23447,7,10,0,0,0,17,10,11,0,0,0,21,nowin,loss,beat,dlwin,0,10,17,192,0.401041667,0.036458333,0.567708333,0,0.023287458
20677,77,23447,10,8,0,0,0,18,10,11,0,0,0,21,nowin,loss,beat,dlwin,0,10,18,200,0.455,0.04,0.62,3,0.916252116
20678,100,23447,8,10,0,0,0,18,10,11,0,0,0,21,nowin,loss,beat,dlwin,0,10,18,190,0.452631579,0.036842105,0.594736842,3,0.888671154
20679,89,23447,3,3,2,1,2,11,10,11,0,0,0,21,nowin,loss,beat,dlwin,0,10,6,212,0.537735849,0.047169811,0.594339623,3,0.990167191
20680,59,23447,4,1,10,8,0,23,10,11,0,0,0,21,nowin,loss,bust,plbust,0,10,5,228,0.429824561,0.048245614,0.543859649,1,0.287885446
20681,131,23447,10,10,0,0,0,20,10,11,0,0,0,21,nowin,loss,beat,dlwin,0,10,20,217,0.410138249,0.069124424,0.543778802,0,0.02015021
20682,10,23448,10,4,0,4,0,18,10,10,0,0,0,20,nowin,loss,beat,dlwin,0,10,14,191,0.413612565,0.057591623,0.596858639,2,0.574087175
20683,101,23448,4,10,0,10,0,24,10,10,0,0,0,20,nowin,loss,bust,plbust,0,10,14,205,0.424390244,0.068292683,0.63902439,2,0.614740646
20684,26,23448,2,10,0,3,6,21,10,10,0,0,0,20,nowin,win,plwin,beat,20,0,12,203,0.463054187,0.0591133,0.541871921,1,0.306802864
20685,109,23448,4,3,4,10,0,21,10,10,0,0,0,20,nowin,win,plwin,beat,20,0,7,221,0.461538462,0.058823529,0.597285068,3,0.901830309
20686,33,23448,7,5,0,6,0,18,10,10,0,0,0,20,nowin,loss,beat,dlwin,0,10,12,192,0.4375,0.057291667,0.625,2,0.616208916
20687,105,23448,4,7,10,0,0,21,10,10,0,0,0,20,nowin,win,plwin,beat,20,0,11,198,0.414141414,0.070707071,0.590909091,0,0.032889494
20688,59,23449,5,3,8,10,0,26,11,10,0,0,0,21,nowin,loss,bust,plbust,0,10,8,228,0.429824561,0.048245614,0.543859649,1,0.287885446
20689,78,23449,8,3,10,0,0,21,11,10,0,0,0,21,nowin,push,push,push,10,0,11,201,0.517412935,0.034825871,0.587064677,3,0.95871112
20690,130,23449,10,6,0,3,0,19,11,10,0,0,0,21,nowin,loss,beat,dlwin,0,10,16,219,0.410958904,0.03652968,0.566210046,0,0.025888739
20691,3,23449,3,9,0,6,0,18,11,10,0,0,0,21,nowin,loss,beat,dlwin,0,10,12,190,0.431578947,0.026315789,0.542105263,1,0.288076384
20692,30,23449,10,4,0,10,0,24,11,10,0,0,0,21,nowin,loss,bust,plbust,0,10,14,206,0.393203883,0.033980583,0.601941748,0,0.029324648
20693,23,23449,4,8,0,10,0,22,11,10,0,0,0,21,nowin,loss,bust,plbust,0,10,12,208,0.427884615,0.0625,0.552884615,1,0.29114424
20694,110,23450,11,2,5,0,0,18,3,5,11,0,0,19,nowin,loss,beat,dlwin,0,10,13,192,0.416666667,0.046875,0.557291667,0,0.025413132
20695,20,23450,2,8,9,0,0,19,3,5,11,0,0,19,nowin,push,push,push,10,0,10,186,0.456989247,0.037634409,0.537634409,1,0.301097108
20696,112,23450,8,7,0,0,0,15,3,5,11,0,0,19,nowin,loss,beat,dlwin,0,10,15,203,0.448275862,0.054187192,0.600985222,3,0.889576933
20697,98,23450,9,10,0,0,0,19,3,5,11,0,0,19,nowin,push,push,push,10,0,19,220,0.422727273,0.054545455,0.55,1,0.28664435
20698,16,23450,10,8,0,0,0,18,3,5,11,0,0,19,nowin,loss,beat,dlwin,0,10,18,220,0.427272727,0.081818182,0.6,2,0.588660176
20699,64,23450,4,1,10,0,0,15,3,5,11,0,0,19,nowin,loss,beat,dlwin,0,10,5,187,0.363636364,0.048128342,0.631016043,0,0.027594885
20700,86,23451,7,10,0,0,0,17,5,9,8,0,0,22,nowin,win,dlbust,bust,20,0,17,196,0.454081633,0.040816327,0.591836735,3,0.887566443
20701,4,23451,10,4,0,0,0,14,5,9,8,0,0,22,nowin,win,dlbust,bust,20,0,14,217,0.460829493,0.036866359,0.562211982,1,0.315432839
20702,117,23451,3,10,0,0,0,13,5,9,8,0,0,22,nowin,win,dlbust,bust,20,0,13,173,0.410404624,0.069364162,0.606936416,2,0.578610282
20703,129,23451,4,4,10,0,0,18,5,9,8,0,0,22,nowin,win,dlbust,bust,20,0,8,201,0.422885572,0.064676617,0.55721393,0,0.027255383
20704,142,23451,10,6,0,0,0,16,5,9,8,0,0,22,nowin,win,dlbust,bust,20,0,16,211,0.417061611,0.047393365,0.526066351,1,0.271531309
20705,148,23451,10,11,0,0,0,21,5,9,8,0,0,22,win,win,dlbust,bust,25,0,21,204,0.401960784,0.078431373,0.593137255,0,0.029789521
20706,129,23452,10,6,0,10,0,26,11,10,0,0,0,21,nowin,loss,bust,plbust,0,10,16,201,0.422885572,0.064676617,0.55721393,0,0.027255383
20707,125,23452,8,2,5,6,0,21,11,10,0,0,0,21,nowin,push,push,push,10,0,10,219,0.438356164,0.050228311,0.575342466,1,0.308411257
20708,128,23452,9,7,0,10,0,26,11,10,0,0,0,21,nowin,loss,bust,plbust,0,10,16,227,0.356828194,0.052863436,0.577092511,0,0.012352564
20709,89,23452,10,11,0,0,0,21,11,10,0,0,0,21,win,push,push,push,10,0,21,212,0.537735849,0.047169811,0.594339623,3,0.990167191
20710,71,23452,4,6,10,0,0,20,11,10,0,0,0,21,nowin,loss,beat,dlwin,0,10,10,193,0.352331606,0.046632124,0.585492228,0,0.013063661
20711,105,23452,11,10,0,0,0,21,11,10,0,0,0,21,win,push,push,push,10,0,21,198,0.414141414,0.070707071,0.590909091,0,0.032889494
20712,77,23453,7,10,0,0,0,17,11,3,1,4,0,19,nowin,loss,beat,dlwin,0,10,17,200,0.455,0.04,0.62,3,0.916252116
20713,149,23453,7,10,0,0,0,17,11,3,1,4,0,19,nowin,loss,beat,dlwin,0,10,17,225,0.457777778,0.057777778,0.648888889,2,0.651965595
20714,97,23453,10,6,0,9,0,25,11,3,1,4,0,19,nowin,loss,bust,plbust,0,10,16,182,0.450549451,0.06043956,0.692307692,2,0.677372279
20715,102,23453,4,10,0,3,0,17,11,3,1,4,0,19,nowin,loss,beat,dlwin,0,10,14,192,0.338541667,0.046875,0.5625,0,0.003306118
20716,21,23453,10,5,0,1,10,26,11,3,1,4,0,19,nowin,loss,bust,plbust,0,10,15,214,0.359813084,0.042056075,0.626168224,0,0.025263474
20717,63,23453,10,8,0,0,0,18,11,3,1,4,0,19,nowin,loss,beat,dlwin,0,10,18,216,0.467592593,0.037037037,0.62037037,3,0.931690496
20718,14,23454,11,10,0,0,0,21,8,10,0,0,0,18,win,win,plwin,beat,25,0,21,202,0.391089109,0.01980198,0.628712871,2,0.577264877
20719,79,23454,11,9,0,0,0,20,8,10,0,0,0,18,nowin,win,plwin,beat,20,0,20,211,0.436018957,0.028436019,0.672985782,2,0.650131054
20720,51,23454,3,4,3,2,8,20,8,10,0,0,0,18,nowin,win,plwin,beat,20,0,7,189,0.529100529,0.068783069,0.608465608,3,0.993665715
20721,59,23454,4,9,0,10,0,23,8,10,0,0,0,18,nowin,loss,bust,plbust,0,10,13,228,0.429824561,0.048245614,0.543859649,1,0.287885446
20722,110,23454,10,8,0,0,0,18,8,10,0,0,0,18,nowin,push,push,push,10,0,18,192,0.416666667,0.046875,0.557291667,0,0.025413132
20723,122,23454,10,10,0,0,0,20,8,10,0,0,0,18,nowin,win,plwin,beat,20,0,20,210,0.347619048,0.052380952,0.59047619,0,0.012873677
20724,111,23455,9,3,0,8,0,20,9,3,6,0,0,18,nowin,win,plwin,beat,20,0,12,180,0.433333333,0.055555556,0.611111111,2,0.602264492
20725,46,23455,10,9,0,0,0,19,9,3,6,0,0,18,nowin,win,plwin,beat,20,0,19,186,0.403225806,0.048387097,0.591397849,0,0.029742194
20726,121,23455,9,9,0,0,0,18,9,3,6,0,0,18,nowin,push,push,push,10,0,18,195,0.456410256,0.025641026,0.512820513,1,0.288597791
20727,107,23455,10,8,0,0,0,18,9,3,6,0,0,18,nowin,push,push,push,10,0,18,218,0.444954128,0.073394495,0.600917431,2,0.605210014
20728,47,23455,2,3,4,4,1,14,9,3,6,0,0,18,nowin,loss,beat,dlwin,0,10,5,210,0.438095238,0.057142857,0.623809524,2,0.615868808
20729,87,23455,10,8,0,0,0,18,9,3,6,0,0,18,nowin,push,push,push,10,0,18,202,0.405940594,0.054455446,0.628712871,2,0.590599801
20730,1,23456,3,8,6,0,0,17,6,10,2,0,0,18,nowin,loss,beat,dlwin,0,10,11,197,0.406091371,0.025380711,0.649746193,2,0.606186955
20731,50,23456,7,8,0,0,0,15,6,10,2,0,0,18,nowin,loss,beat,dlwin,0,10,15,202,0.405940594,0.04950495,0.54950495,0,0.020296079
20732,103,23456,10,10,0,0,0,20,6,10,2,0,0,18,nowin,win,plwin,beat,20,0,20,203,0.379310345,0.064039409,0.551724138,0,0.012869209
20733,61,23456,11,10,0,0,0,21,6,10,2,0,0,18,win,win,plwin,beat,25,0,21,194,0.427835052,0.077319588,0.603092784,2,0.591437139
20734,71,23456,2,10,0,0,0,12,6,10,2,0,0,18,nowin,loss,beat,dlwin,0,10,12,193,0.352331606,0.046632124,0.585492228,0,0.013063661
20735,42,23456,4,8,0,0,0,12,6,10,2,0,0,18,nowin,loss,beat,dlwin,0,10,12,212,0.443396226,0.051886792,0.570754717,1,0.309181312
20736,54,23457,10,4,0,7,0,21,11,10,0,0,0,21,nowin,push,push,push,10,0,14,185,0.437837838,0.032432432,0.556756757,1,0.29899854
20737,31,23457,7,8,0,10,0,25,11,10,0,0,0,21,nowin,loss,bust,plbust,0,10,15,188,0.473404255,0.058510638,0.515957447,1,0.300306557
20738,71,23457,7,10,0,0,0,17,11,10,0,0,0,21,nowin,loss,beat,dlwin,0,10,17,193,0.352331606,0.046632124,0.585492228,0,0.013063661
20739,121,23457,11,10,0,0,0,21,11,10,0,0,0,21,win,push,push,push,10,0,21,195,0.456410256,0.025641026,0.512820513,1,0.288597791
20740,32,23457,2,10,0,8,0,20,11,10,0,0,0,21,nowin,loss,beat,dlwin,0,10,12,189,0.391534392,0.037037037,0.53968254,0,0.013579086
20741,102,23457,3,10,0,6,0,19,11,10,0,0,0,21,nowin,loss,beat,dlwin,0,10,13,192,0.338541667,0.046875,0.5625,0,0.003306118
20742,21,23458,4,10,0,0,0,14,6,10,10,0,0,26,nowin,win,dlbust,bust,20,0,14,214,0.359813084,0.042056075,0.626168224,0,0.025263474
20743,20,23458,5,9,0,0,0,14,6,10,10,0,0,26,nowin,win,dlbust,bust,20,0,14,186,0.456989247,0.037634409,0.537634409,1,0.301097108
20744,47,23458,4,2,3,10,0,19,6,10,10,0,0,26,nowin,win,dlbust,bust,20,0,6,210,0.438095238,0.057142857,0.623809524,2,0.615868808
20745,25,23458,10,11,0,0,0,21,6,10,10,0,0,26,win,win,dlbust,bust,25,0,21,190,0.463157895,0.063157895,0.536842105,1,0.304401563
20746,84,23458,9,8,0,0,0,17,6,10,10,0,0,26,nowin,win,dlbust,bust,20,0,17,195,0.379487179,0.056410256,0.569230769,0,0.017209119
20747,18,23458,10,3,0,0,0,13,6,10,10,0,0,26,nowin,win,dlbust,bust,20,0,13,182,0.461538462,0.043956044,0.587912088,3,0.892649374
20748,140,23459,10,10,0,0,0,20,10,8,0,0,0,18,nowin,win,plwin,beat,20,0,20,210,0.466666667,0.023809524,0.604761905,3,0.915293335
20749,72,23459,2,10,0,6,0,18,10,8,0,0,0,18,nowin,push,push,push,10,0,12,185,0.394594595,0.032432432,0.508108108,0,0.006763115
20750,26,23459,10,10,0,0,0,20,10,8,0,0,0,18,nowin,win,plwin,beat,20,0,20,203,0.463054187,0.0591133,0.541871921,1,0.306802864
20751,121,23459,2,8,9,0,0,19,10,8,0,0,0,18,nowin,win,plwin,beat,20,0,10,195,0.456410256,0.025641026,0.512820513,1,0.288597791
20752,44,23459,10,11,0,0,0,21,10,8,0,0,0,18,win,win,plwin,beat,25,0,21,219,0.433789954,0.050228311,0.534246575,1,0.285551035
20753,60,23459,11,7,0,0,0,18,10,8,0,0,0,18,nowin,push,push,push,10,0,18,227,0.418502203,0.022026432,0.559471366,0,0.026496258
20754,25,23460,9,6,0,0,0,15,3,8,5,10,0,26,nowin,win,dlbust,bust,20,0,15,190,0.463157895,0.063157895,0.536842105,1,0.304401563
20755,28,23460,9,10,0,0,0,19,3,8,5,10,0,26,nowin,win,dlbust,bust,20,0,19,199,0.422110553,0.045226131,0.542713568,1,0.282706618
20756,109,23460,10,8,0,0,0,18,3,8,5,10,0,26,nowin,win,dlbust,bust,20,0,18,221,0.461538462,0.058823529,0.597285068,3,0.901830309
20757,120,23460,6,5,10,0,0,21,3,8,5,10,0,26,nowin,win,dlbust,bust,20,0,11,202,0.440594059,0.034653465,0.618811881,2,0.614441029
20758,8,23460,7,3,5,0,0,15,3,8,5,10,0,26,nowin,win,dlbust,bust,20,0,10,181,0.44198895,0.071823204,0.596685083,2,0.599438402
20759,146,23460,11,9,0,0,0,20,3,8,5,10,0,26,nowin,win,dlbust,bust,20,0,20,221,0.43438914,0.040723982,0.542986425,1,0.290190091
20760,86,23461,11,10,0,0,0,21,11,4,1,8,0,24,win,win,dlbust,bust,25,0,21,196,0.454081633,0.040816327,0.591836735,3,0.887566443
20761,134,23461,10,7,0,0,0,17,11,4,1,8,0,24,nowin,win,dlbust,bust,20,0,17,185,0.443243243,0.021621622,0.545945946,1,0.296939509
20762,76,23461,10,6,0,4,0,20,11,4,1,8,0,24,nowin,win,dlbust,bust,20,0,16,189,0.534391534,0.079365079,0.608465608,3,1
20763,94,23461,3,6,5,10,0,24,11,4,1,8,0,24,nowin,loss,bust,plbust,0,10,9,183,0.43715847,0.043715847,0.540983607,1,0.290866892
20764,22,23461,6,8,0,3,0,17,11,4,1,8,0,24,nowin,win,dlbust,bust,20,0,14,187,0.481283422,0.042780749,0.577540107,3,0.906128176
20765,80,23461,3,6,3,10,0,22,11,4,1,8,0,24,nowin,loss,bust,plbust,0,10,9,186,0.419354839,0.059139785,0.623655914,2,0.59892924
20766,86,23462,4,2,5,10,0,21,10,3,1,10,0,24,nowin,win,dlbust,bust,20,0,6,196,0.454081633,0.040816327,0.591836735,3,0.887566443
20767,81,23462,5,10,0,9,0,24,10,3,1,10,0,24,nowin,loss,bust,plbust,0,10,15,182,0.395604396,0.043956044,0.60989011,2,0.567491261
20768,137,23462,7,8,0,9,0,24,10,3,1,10,0,24,nowin,loss,bust,plbust,0,10,15,194,0.417525773,0.046391753,0.536082474,1,0.276714602
20769,33,23462,5,3,5,4,0,17,10,3,1,10,0,24,nowin,win,dlbust,bust,20,0,8,192,0.4375,0.057291667,0.625,2,0.616208916
20770,12,23462,8,10,0,0,0,18,10,3,1,10,0,24,nowin,win,dlbust,bust,20,0,18,189,0.470899471,0.015873016,0.613756614,3,0.929171178
20771,113,23462,10,10,0,0,0,20,10,3,1,10,0,24,nowin,win,dlbust,bust,20,0,20,199,0.407035176,0.055276382,0.668341709,2,0.620695264
20772,106,23463,3,3,3,10,0,19,6,3,7,8,0,24,nowin,win,dlbust,bust,20,0,6,192,0.411458333,0.026041667,0.557291667,0,0.023854304
20773,89,23463,10,10,0,0,0,20,6,3,7,8,0,24,nowin,win,dlbust,bust,20,0,20,212,0.537735849,0.047169811,0.594339623,3,0.990167191
20774,86,23463,4,10,0,0,0,14,6,3,7,8,0,24,nowin,win,dlbust,bust,20,0,14,196,0.454081633,0.040816327,0.591836735,3,0.887566443
20775,81,23463,4,7,10,0,0,21,6,3,7,8,0,24,nowin,win,dlbust,bust,20,0,11,182,0.395604396,0.043956044,0.60989011,2,0.567491261
20776,8,23463,10,11,0,0,0,21,6,3,7,8,0,24,win,win,dlbust,bust,25,0,21,181,0.44198895,0.071823204,0.596685083,2,0.599438402
20777,103,23463,10,8,0,0,0,18,6,3,7,8,0,24,nowin,win,dlbust,bust,20,0,18,203,0.379310345,0.064039409,0.551724138,0,0.012869209
20778,71,23464,8,3,10,0,0,21,11,9,0,0,0,20,nowin,win,plwin,beat,20,0,11,193,0.352331606,0.046632124,0.585492228,0,0.013063661
20779,140,23464,10,5,0,3,0,18,11,9,0,0,0,20,nowin,loss,beat,dlwin,0,10,15,210,0.466666667,0.023809524,0.604761905,3,0.915293335
20780,79,23464,3,6,9,0,0,18,11,9,0,0,0,20,nowin,loss,beat,dlwin,0,10,9,211,0.436018957,0.028436019,0.672985782,2,0.650131054
20781,133,23464,3,5,3,6,0,17,11,9,0,0,0,20,nowin,loss,beat,dlwin,0,10,8,201,0.47761194,0.064676617,0.611940299,3,0.935428111
20782,72,23464,8,10,0,0,0,18,11,9,0,0,0,20,nowin,loss,beat,dlwin,0,10,18,185,0.394594595,0.032432432,0.508108108,0,0.006763115
20783,109,23464,2,10,0,9,0,21,11,9,0,0,0,20,nowin,win,plwin,beat,20,0,12,221,0.461538462,0.058823529,0.597285068,3,0.901830309
20784,129,23465,1,5,8,0,0,14,4,10,1,2,0,17,nowin,loss,beat,dlwin,0,10,6,201,0.422885572,0.064676617,0.55721393,0,0.027255383
20785,143,23465,10,6,0,0,0,16,4,10,1,2,0,17,nowin,loss,beat,dlwin,0,10,16,203,0.463054187,0.044334975,0.57635468,3,0.883143365
20786,37,23465,8,7,0,0,0,15,4,10,1,2,0,17,nowin,loss,beat,dlwin,0,10,15,208,0.394230769,0.038461538,0.581730769,0,0.024682772
20787,82,23465,10,10,0,0,0,20,4,10,1,2,0,17,nowin,win,plwin,beat,20,0,20,225,0.408888889,0.075555556,0.577777778,0,0.028101874
20788,78,23465,11,10,0,0,0,21,4,10,1,2,0,17,win,win,plwin,beat,25,0,21,201,0.517412935,0.034825871,0.587064677,3,0.95871112
20789,14,23465,7,10,0,0,0,17,4,10,1,2,0,17,nowin,push,push,push,10,0,17,202,0.391089109,0.01980198,0.628712871,2,0.577264877
20790,108,23466,6,6,0,10,0,22,9,4,10,0,0,23,nowin,loss,bust,plbust,0,10,12,193,0.435233161,0.056994819,0.559585492,1,0.298824795
20791,19,23466,5,6,2,10,0,23,9,4,10,0,0,23,nowin,loss,bust,plbust,0,10,11,237,0.41350211,0.054852321,0.628691983,2,0.597373826
20792,54,23466,10,10,0,0,0,20,9,4,10,0,0,23,nowin,win,dlbust,bust,20,0,20,185,0.437837838,0.032432432,0.556756757,1,0.29899854
20793,78,23466,5,4,10,0,0,19,9,4,10,0,0,23,nowin,win,dlbust,bust,20,0,9,201,0.517412935,0.034825871,0.587064677,3,0.95871112
20794,77,23466,5,6,8,0,0,19,9,4,10,0,0,23,nowin,win,dlbust,bust,20,0,11,200,0.455,0.04,0.62,3,0.916252116
20795,53,23466,11,10,0,0,0,21,9,4,10,0,0,23,win,win,dlbust,bust,25,0,21,250,0.372,0.064,0.564,0,0.013687345
20796,19,23467,8,5,0,9,0,22,10,11,0,0,0,21,nowin,loss,bust,plbust,0,10,13,237,0.41350211,0.054852321,0.628691983,2,0.597373826
20797,135,23467,3,6,11,0,0,20,10,11,0,0,0,21,nowin,loss,beat,dlwin,0,10,9,179,0.391061453,0.067039106,0.586592179,0,0.024924662
20798,40,23467,10,10,0,0,0,20,10,11,0,0,0,21,nowin,loss,beat,dlwin,0,10,20,196,0.367346939,0.030612245,0.617346939,0,0.025358183
20799,150,23467,10,5,0,1,9,25,10,11,0,0,0,21,nowin,loss,bust,plbust,0,10,15,192,0.401041667,0.036458333,0.567708333,0,0.023287458
20800,56,23467,3,4,11,0,0,18,10,11,0,0,0,21,nowin,loss,beat,dlwin,0,10,7,175,0.4,0.057142857,0.582857143,0,0.026685297
20801,14,23467,2,10,0,10,0,22,10,11,0,0,0,21,nowin,loss,bust,plbust,0,10,12,202,0.391089109,0.01980198,0.628712871,2,0.577264877
20802,143,23468,7,5,0,10,0,22,11,6,0,0,0,17,nowin,loss,bust,plbust,0,10,12,203,0.463054187,0.044334975,0.57635468,3,0.883143365
20803,25,23468,9,10,0,0,0,19,11,6,0,0,0,17,nowin,win,plwin,beat,20,0,19,190,0.463157895,0.063157895,0.536842105,1,0.304401563
20804,141,23468,10,10,0,0,0,20,11,6,0,0,0,17,nowin,win,plwin,beat,20,0,20,202,0.420792079,0.074257426,0.564356436,0,0.028377851
20805,97,23468,6,10,0,6,0,22,11,6,0,0,0,17,nowin,loss,bust,plbust,0,10,16,182,0.450549451,0.06043956,0.692307692,2,0.677372279
20806,120,23468,5,10,0,1,3,19,11,6,0,0,0,17,nowin,win,plwin,beat,20,0,15,202,0.440594059,0.034653465,0.618811881,2,0.614441029
20807,88,23468,10,10,0,0,0,20,11,6,0,0,0,17,nowin,win,plwin,beat,20,0,20,206,0.466019417,0.033980583,0.54368932,1,0.309467903
20808,58,23469,3,4,6,6,0,19,11,8,0,0,0,19,nowin,push,push,push,10,0,7,195,0.430769231,0.041025641,0.584615385,2,0.580497586
20809,121,23469,2,9,10,0,0,21,11,8,0,0,0,19,nowin,win,plwin,beat,20,0,11,195,0.456410256,0.025641026,0.512820513,1,0.288597791
20810,72,23469,9,7,0,4,0,20,11,8,0,0,0,19,nowin,win,plwin,beat,20,0,16,185,0.394594595,0.032432432,0.508108108,0,0.006763115
20811,110,23469,11,10,0,0,0,21,11,8,0,0,0,19,win,win,plwin,beat,25,0,21,192,0.416666667,0.046875,0.557291667,0,0.025413132
20812,8,23469,11,8,0,0,0,19,11,8,0,0,0,19,nowin,push,push,push,10,0,19,181,0.44198895,0.071823204,0.596685083,2,0.599438402
20813,3,23469,4,9,0,6,0,19,11,8,0,0,0,19,nowin,push,push,push,10,0,13,190,0.431578947,0.026315789,0.542105263,1,0.288076384
20814,73,23470,3,10,0,10,0,23,10,11,0,0,0,21,nowin,loss,bust,plbust,0,10,13,181,0.375690608,0.011049724,0.596685083,0,0.022795773
20815,144,23470,3,11,5,0,0,19,10,11,0,0,0,21,nowin,loss,beat,dlwin,0,10,14,202,0.386138614,0.054455446,0.564356436,0,0.018006244
20816,130,23470,6,9,0,8,0,23,10,11,0,0,0,21,nowin,loss,bust,plbust,0,10,15,219,0.410958904,0.03652968,0.566210046,0,0.025888739
20817,117,23470,4,2,4,10,0,20,10,11,0,0,0,21,nowin,loss,beat,dlwin,0,10,6,173,0.410404624,0.069364162,0.606936416,2,0.578610282
20818,44,23470,2,11,1,2,9,25,10,11,0,0,0,21,nowin,loss,bust,plbust,0,10,13,219,0.433789954,0.050228311,0.534246575,1,0.285551035
20819,111,23470,10,11,0,0,0,21,10,11,0,0,0,21,win,push,push,push,10,0,21,180,0.433333333,0.055555556,0.611111111,2,0.602264492
20820,36,23471,5,11,3,0,0,19,10,7,0,0,0,17,nowin,win,plwin,beat,20,0,16,229,0.445414847,0.056768559,0.655021834,2,0.645370571
20821,104,23471,9,3,0,6,0,18,10,7,0,0,0,17,nowin,win,plwin,beat,20,0,12,209,0.363636364,0.052631579,0.593301435,0,0.018359419
20822,58,23471,10,3,0,10,0,23,10,7,0,0,0,17,nowin,loss,bust,plbust,0,10,13,195,0.430769231,0.041025641,0.584615385,2,0.580497586
20823,87,23471,11,10,0,0,0,21,10,7,0,0,0,17,win,win,plwin,beat,25,0,21,202,0.405940594,0.054455446,0.628712871,2,0.590599801
20824,31,23471,8,7,0,10,0,25,10,7,0,0,0,17,nowin,loss,bust,plbust,0,10,15,188,0.473404255,0.058510638,0.515957447,1,0.300306557
20825,69,23471,10,6,0,8,0,24,10,7,0,0,0,17,nowin,loss,bust,plbust,0,10,16,194,0.365979381,0.030927835,0.515463918,0,0
20826,149,23472,10,9,0,0,0,19,10,10,0,0,0,20,nowin,loss,beat,dlwin,0,10,19,225,0.457777778,0.057777778,0.648888889,2,0.651965595
20827,15,23472,5,7,0,7,0,19,10,10,0,0,0,20,nowin,loss,beat,dlwin,0,10,12,212,0.410377358,0.051886792,0.561320755,0,0.024517408
20828,38,23472,5,6,4,1,8,24,10,10,0,0,0,20,nowin,loss,bust,plbust,0,10,11,202,0.361386139,0.03960396,0.564356436,0,0.010597953
20829,23,23472,2,9,10,0,0,21,10,10,0,0,0,20,nowin,win,plwin,beat,20,0,11,208,0.427884615,0.0625,0.552884615,1,0.29114424
20830,84,23472,3,10,0,4,0,17,10,10,0,0,0,20,nowin,loss,beat,dlwin,0,10,13,195,0.379487179,0.056410256,0.569230769,0,0.017209119
20831,105,23472,6,9,0,9,0,24,10,10,0,0,0,20,nowin,loss,bust,plbust,0,10,15,198,0.414141414,0.070707071,0.590909091,0,0.032889494
20832,79,23473,10,10,0,0,0,20,10,9,0,0,0,19,nowin,win,plwin,beat,20,0,20,211,0.436018957,0.028436019,0.672985782,2,0.650131054
20833,51,23473,10,7,0,0,0,17,10,9,0,0,0,19,nowin,loss,beat,dlwin,0,10,17,189,0.529100529,0.068783069,0.608465608,3,0.993665715
20834,105,23473,10,8,0,0,0,18,10,9,0,0,0,19,nowin,loss,beat,dlwin,0,10,18,198,0.414141414,0.070707071,0.590909091,0,0.032889494
20835,90,23473,3,4,7,4,0,18,10,9,0,0,0,19,nowin,loss,beat,dlwin,0,10,7,201,0.447761194,0.049751244,0.60199005,3,0.889945023
20836,58,23473,10,4,0,4,0,18,10,9,0,0,0,19,nowin,loss,beat,dlwin,0,10,14,195,0.430769231,0.041025641,0.584615385,2,0.580497586
20837,24,23473,5,10,0,6,0,21,10,9,0,0,0,19,nowin,win,plwin,beat,20,0,15,207,0.458937198,0.048309179,0.570048309,1,0.318138014
20838,33,23474,2,1,10,2,2,17,8,8,9,0,0,25,nowin,win,dlbust,bust,20,0,3,192,0.4375,0.057291667,0.625,2,0.616208916
20839,86,23474,6,10,0,10,0,26,8,8,9,0,0,25,nowin,loss,bust,plbust,0,10,16,196,0.454081633,0.040816327,0.591836735,3,0.887566443
20840,37,23474,10,10,0,0,0,20,8,8,9,0,0,25,nowin,win,dlbust,bust,20,0,20,208,0.394230769,0.038461538,0.581730769,0,0.024682772
20841,115,23474,10,10,0,0,0,20,8,8,9,0,0,25,nowin,win,dlbust,bust,20,0,20,194,0.427835052,0.041237113,0.592783505,2,0.583863602
20842,5,23474,4,7,6,0,0,17,8,8,9,0,0,25,nowin,win,dlbust,bust,20,0,11,203,0.42364532,0.02955665,0.596059113,2,0.582508076
20843,124,23474,5,10,0,2,0,17,8,8,9,0,0,25,nowin,win,dlbust,bust,20,0,15,202,0.47029703,0.064356436,0.584158416,3,0.899458193
20844,97,23475,7,10,0,0,0,17,9,6,7,0,0,22,nowin,win,dlbust,bust,20,0,17,182,0.450549451,0.06043956,0.692307692,2,0.677372279
20845,120,23475,7,10,0,0,0,17,9,6,7,0,0,22,nowin,win,dlbust,bust,20,0,17,202,0.440594059,0.034653465,0.618811881,2,0.614441029
20846,4,23475,5,10,0,10,0,25,9,6,7,0,0,22,nowin,loss,bust,plbust,0,10,15,217,0.460829493,0.036866359,0.562211982,1,0.315432839
20847,124,23475,8,10,0,0,0,18,9,6,7,0,0,22,nowin,win,dlbust,bust,20,0,18,202,0.47029703,0.064356436,0.584158416,3,0.899458193
20848,29,23475,5,10,0,10,0,25,9,6,7,0,0,22,nowin,loss,bust,plbust,0,10,15,189,0.44973545,0.058201058,0.544973545,1,0.300349439
20849,47,23475,8,3,10,0,0,21,9,6,7,0,0,22,nowin,win,dlbust,bust,20,0,11,210,0.438095238,0.057142857,0.623809524,2,0.615868808
20850,128,23476,6,5,7,0,0,18,5,5,3,9,0,22,nowin,win,dlbust,bust,20,0,11,227,0.356828194,0.052863436,0.577092511,0,0.012352564
20851,141,23476,2,10,0,0,0,12,5,5,3,9,0,22,nowin,win,dlbust,bust,20,0,12,202,0.420792079,0.074257426,0.564356436,0,0.028377851
20852,109,23476,5,10,0,0,0,15,5,5,3,9,0,22,nowin,win,dlbust,bust,20,0,15,221,0.461538462,0.058823529,0.597285068,3,0.901830309
20853,106,23476,7,2,10,0,0,19,5,5,3,9,0,22,nowin,win,dlbust,bust,20,0,9,192,0.411458333,0.026041667,0.557291667,0,0.023854304
20854,92,23476,7,4,2,0,0,13,5,5,3,9,0,22,nowin,win,dlbust,bust,20,0,11,186,0.446236559,0.059139785,0.564516129,1,0.307826125
20855,140,23476,11,1,9,0,0,21,5,5,3,9,0,22,nowin,win,dlbust,bust,20,0,12,210,0.466666667,0.023809524,0.604761905,3,0.915293335
20856,82,23477,11,10,0,0,0,21,10,2,6,0,0,18,win,win,plwin,beat,25,0,21,225,0.408888889,0.075555556,0.577777778,0,0.028101874
20857,69,23477,9,7,0,9,0,25,10,2,6,0,0,18,nowin,loss,bust,plbust,0,10,16,194,0.365979381,0.030927835,0.515463918,0,0
20858,87,23477,2,7,3,6,0,18,10,2,6,0,0,18,nowin,push,push,push,10,0,9,202,0.405940594,0.054455446,0.628712871,2,0.590599801
20859,115,23477,10,4,0,3,0,17,10,2,6,0,0,18,nowin,loss,beat,dlwin,0,10,14,194,0.427835052,0.041237113,0.592783505,2,0.583863602
20860,131,23477,10,10,0,0,0,20,10,2,6,0,0,18,nowin,win,plwin,beat,20,0,20,217,0.410138249,0.069124424,0.543778802,0,0.02015021
20861,14,23477,9,2,9,0,0,20,10,2,6,0,0,18,nowin,win,plwin,beat,20,0,11,202,0.391089109,0.01980198,0.628712871,2,0.577264877
20862,13,23478,10,3,0,10,0,23,10,8,0,0,0,18,nowin,loss,bust,plbust,0,10,13,206,0.417475728,0.063106796,0.621359223,2,0.59555479
20863,67,23478,5,4,5,10,0,24,10,8,0,0,0,18,nowin,loss,bust,plbust,0,10,9,195,0.369230769,0.041025641,0.569230769,0,0.014139427
20864,131,23478,9,5,0,4,0,18,10,8,0,0,0,18,nowin,push,push,push,10,0,14,217,0.410138249,0.069124424,0.543778802,0,0.02015021
20865,6,23478,10,10,0,0,0,20,10,8,0,0,0,18,nowin,win,plwin,beat,20,0,20,191,0.439790576,0.047120419,0.581151832,1,0.31211505
20866,71,23478,6,3,10,0,0,19,10,8,0,0,0,18,nowin,win,plwin,beat,20,0,9,193,0.352331606,0.046632124,0.585492228,0,0.013063661
20867,143,23478,10,10,0,0,0,20,10,8,0,0,0,18,nowin,win,plwin,beat,20,0,20,203,0.463054187,0.044334975,0.57635468,3,0.883143365
20868,18,23479,5,4,5,10,0,24,9,6,2,0,0,17,nowin,loss,bust,plbust,0,10,9,182,0.461538462,0.043956044,0.587912088,3,0.892649374
20869,89,23479,8,6,0,6,0,20,9,6,2,0,0,17,nowin,win,plwin,beat,20,0,14,212,0.537735849,0.047169811,0.594339623,3,0.990167191
20870,130,23479,5,6,10,0,0,21,9,6,2,0,0,17,nowin,win,plwin,beat,20,0,11,219,0.410958904,0.03652968,0.566210046,0,0.025888739
20871,117,23479,3,10,0,7,0,20,9,6,2,0,0,17,nowin,win,plwin,beat,20,0,13,173,0.410404624,0.069364162,0.606936416,2,0.578610282
20872,111,23479,5,3,9,0,0,17,9,6,2,0,0,17,nowin,push,push,push,10,0,8,180,0.433333333,0.055555556,0.611111111,2,0.602264492
20873,79,23479,10,7,0,0,0,17,9,6,2,0,0,17,nowin,push,push,push,10,0,17,211,0.436018957,0.028436019,0.672985782,2,0.650131054
20874,40,23480,2,5,11,0,0,18,10,7,0,0,0,17,nowin,win,plwin,beat,20,0,7,196,0.367346939,0.030612245,0.617346939,0,0.025358183
20875,26,23480,10,6,0,10,0,26,10,7,0,0,0,17,nowin,loss,bust,plbust,0,10,16,203,0.463054187,0.0591133,0.541871921,1,0.306802864
20876,110,23480,10,11,0,0,0,21,10,7,0,0,0,17,win,win,plwin,beat,25,0,21,192,0.416666667,0.046875,0.557291667,0,0.025413132
20877,135,23480,5,10,0,10,0,25,10,7,0,0,0,17,nowin,loss,bust,plbust,0,10,15,179,0.391061453,0.067039106,0.586592179,0,0.024924662
20878,49,23480,10,6,0,10,0,26,10,7,0,0,0,17,nowin,loss,bust,plbust,0,10,16,207,0.396135266,0.053140097,0.594202899,0,0.028306925
20879,30,23480,10,10,0,0,0,20,10,7,0,0,0,17,nowin,win,plwin,beat,20,0,20,206,0.393203883,0.033980583,0.601941748,0,0.029324648
20880,113,23481,10,7,0,0,0,17,5,4,10,0,0,19,nowin,loss,beat,dlwin,0,10,17,199,0.407035176,0.055276382,0.668341709,2,0.620695264
20881,61,23481,10,9,0,0,0,19,5,4,10,0,0,19,nowin,push,push,push,10,0,19,194,0.427835052,0.077319588,0.603092784,2,0.591437139
20882,95,23481,7,10,0,0,0,17,5,4,10,0,0,19,nowin,loss,beat,dlwin,0,10,17,218,0.412844037,0.04587156,0.559633028,0,0.024842385
20883,39,23481,6,10,0,0,0,16,5,4,10,0,0,19,nowin,loss,beat,dlwin,0,10,16,191,0.429319372,0.062827225,0.57591623,0,0.033760763
20884,40,23481,5,10,0,0,0,15,5,4,10,0,0,19,nowin,loss,beat,dlwin,0,10,15,196,0.367346939,0.030612245,0.617346939,0,0.025358183
20885,20,23481,3,10,0,0,0,13,5,4,10,0,0,19,nowin,loss,beat,dlwin,0,10,13,186,0.456989247,0.037634409,0.537634409,1,0.301097108
20886,15,23482,9,3,0,1,8,21,7,5,4,8,0,24,nowin,win,dlbust,bust,20,0,12,212,0.410377358,0.051886792,0.561320755,0,0.024517408
20887,74,23482,10,11,0,0,0,21,7,5,4,8,0,24,win,win,dlbust,bust,25,0,21,209,0.411483254,0.04784689,0.531100478,0,0.017448125
20888,110,23482,10,4,0,10,0,24,7,5,4,8,0,24,nowin,loss,bust,plbust,0,10,14,192,0.416666667,0.046875,0.557291667,0,0.025413132
20889,47,23482,6,1,10,0,0,17,7,5,4,8,0,24,nowin,win,dlbust,bust,20,0,7,210,0.438095238,0.057142857,0.623809524,2,0.615868808
20890,122,23482,10,2,0,5,0,17,7,5,4,8,0,24,nowin,win,dlbust,bust,20,0,12,210,0.347619048,0.052380952,0.59047619,0,0.012873677
20891,117,23482,10,10,0,0,0,20,7,5,4,8,0,24,nowin,win,dlbust,bust,20,0,20,173,0.410404624,0.069364162,0.606936416,2,0.578610282
20892,14,23483,9,2,10,0,0,21,2,9,9,0,0,20,nowin,win,plwin,beat,20,0,11,202,0.391089109,0.01980198,0.628712871,2,0.577264877
20893,147,23483,5,6,7,0,0,18,2,9,9,0,0,20,nowin,loss,beat,dlwin,0,10,11,205,0.380487805,0.014634146,0.536585366,0,0.00951447
20894,74,23483,2,7,10,0,0,19,2,9,9,0,0,20,nowin,loss,beat,dlwin,0,10,9,209,0.411483254,0.04784689,0.531100478,0,0.017448125
20895,50,23483,5,10,0,0,0,15,2,9,9,0,0,20,nowin,loss,beat,dlwin,0,10,15,202,0.405940594,0.04950495,0.54950495,0,0.020296079
20896,11,23483,10,9,0,0,0,19,2,9,9,0,0,20,nowin,loss,beat,dlwin,0,10,19,236,0.457627119,0.016949153,0.588983051,3,0.889015813
20897,47,23483,3,8,6,0,0,17,2,9,9,0,0,20,nowin,loss,beat,dlwin,0,10,11,210,0.438095238,0.057142857,0.623809524,2,0.615868808
20898,91,23484,9,9,0,0,0,18,10,4,4,0,0,18,nowin,push,push,push,10,0,18,194,0.417525773,0.046391753,0.515463918,1,0.266616552
20899,107,23484,9,8,0,0,0,17,10,4,4,0,0,18,nowin,loss,beat,dlwin,0,10,17,218,0.444954128,0.073394495,0.600917431,2,0.605210014
20900,38,23484,10,8,0,0,0,18,10,4,4,0,0,18,nowin,push,push,push,10,0,18,202,0.361386139,0.03960396,0.564356436,0,0.010597953
20901,59,23484,10,10,0,0,0,20,10,4,4,0,0,18,nowin,win,plwin,beat,20,0,20,228,0.429824561,0.048245614,0.543859649,1,0.287885446
20902,77,23484,8,11,0,0,0,19,10,4,4,0,0,18,nowin,win,plwin,beat,20,0,19,200,0.455,0.04,0.62,3,0.916252116
20903,15,23484,4,3,7,4,0,18,10,4,4,0,0,18,nowin,push,push,push,10,0,7,212,0.410377358,0.051886792,0.561320755,0,0.024517408
20904,115,23485,10,9,0,0,0,19,10,10,0,0,0,20,nowin,loss,beat,dlwin,0,10,19,194,0.427835052,0.041237113,0.592783505,2,0.583863602
20905,141,23485,8,10,0,0,0,18,10,10,0,0,0,20,nowin,loss,beat,dlwin,0,10,18,202,0.420792079,0.074257426,0.564356436,0,0.028377851
20906,149,23485,6,7,0,10,0,23,10,10,0,0,0,20,nowin,loss,bust,plbust,0,10,13,225,0.457777778,0.057777778,0.648888889,2,0.651965595
20907,25,23485,10,8,0,0,0,18,10,10,0,0,0,20,nowin,loss,beat,dlwin,0,10,18,190,0.463157895,0.063157895,0.536842105,1,0.304401563
20908,120,23485,7,2,10,0,0,19,10,10,0,0,0,20,nowin,loss,beat,dlwin,0,10,9,202,0.440594059,0.034653465,0.618811881,2,0.614441029
20909,126,23485,7,5,0,7,0,19,10,10,0,0,0,20,nowin,loss,beat,dlwin,0,10,12,188,0.457446809,0.074468085,0.60106383,3,0.900633203
20910,130,23486,10,9,0,0,0,19,10,6,1,0,0,17,nowin,win,plwin,beat,20,0,19,219,0.410958904,0.03652968,0.566210046,0,0.025888739
20911,3,23486,4,9,0,7,0,20,10,6,1,0,0,17,nowin,win,plwin,beat,20,0,13,190,0.431578947,0.026315789,0.542105263,1,0.288076384
20912,98,23486,6,10,0,4,0,20,10,6,1,0,0,17,nowin,win,plwin,beat,20,0,16,220,0.422727273,0.054545455,0.55,1,0.28664435
20913,146,23486,3,10,0,10,0,23,10,6,1,0,0,17,nowin,loss,bust,plbust,0,10,13,221,0.43438914,0.040723982,0.542986425,1,0.290190091
20914,8,23486,11,10,0,0,0,21,10,6,1,0,0,17,win,win,plwin,beat,25,0,21,181,0.44198895,0.071823204,0.596685083,2,0.599438402
20915,42,23486,7,5,0,3,10,25,10,6,1,0,0,17,nowin,loss,bust,plbust,0,10,12,212,0.443396226,0.051886792,0.570754717,1,0.309181312
20916,135,23487,10,7,0,0,0,17,11,10,0,0,0,21,nowin,loss,beat,dlwin,0,10,17,179,0.391061453,0.067039106,0.586592179,0,0.024924662
20917,42,23487,5,7,0,3,4,19,11,10,0,0,0,21,nowin,loss,beat,dlwin,0,10,12,212,0.443396226,0.051886792,0.570754717,1,0.309181312
20918,51,23487,5,9,0,4,0,18,11,10,0,0,0,21,nowin,loss,beat,dlwin,0,10,14,189,0.529100529,0.068783069,0.608465608,3,0.993665715
20919,84,23487,9,8,0,0,0,17,11,10,0,0,0,21,nowin,loss,beat,dlwin,0,10,17,195,0.379487179,0.056410256,0.569230769,0,0.017209119
20920,41,23487,4,7,5,1,0,17,11,10,0,0,0,21,nowin,loss,beat,dlwin,0,10,11,192,0.364583333,0.036458333,0.520833333,0,0.00089702
20921,26,23487,2,10,0,3,5,20,11,10,0,0,0,21,nowin,loss,beat,dlwin,0,10,12,203,0.463054187,0.0591133,0.541871921,1,0.306802864
20922,20,23488,5,7,0,9,0,21,8,10,0,0,0,18,nowin,win,plwin,beat,20,0,12,186,0.456989247,0.037634409,0.537634409,1,0.301097108
20923,143,23488,6,4,3,6,0,19,8,10,0,0,0,18,nowin,win,plwin,beat,20,0,10,203,0.463054187,0.044334975,0.57635468,3,0.883143365
20924,129,23488,10,10,0,0,0,20,8,10,0,0,0,18,nowin,win,plwin,beat,20,0,20,201,0.422885572,0.064676617,0.55721393,0,0.027255383
20925,16,23488,6,10,0,10,0,26,8,10,0,0,0,18,nowin,loss,bust,plbust,0,10,16,220,0.427272727,0.081818182,0.6,2,0.588660176
20926,31,23488,10,11,0,0,0,21,8,10,0,0,0,18,win,win,plwin,beat,25,0,21,188,0.473404255,0.058510638,0.515957447,1,0.300306557
20927,76,23488,2,8,10,0,0,20,8,10,0,0,0,18,nowin,win,plwin,beat,20,0,10,189,0.534391534,0.079365079,0.608465608,3,1
20928,24,23489,4,1,10,5,0,20,11,7,0,0,0,18,nowin,win,plwin,beat,20,0,5,207,0.458937198,0.048309179,0.570048309,1,0.318138014
20929,120,23489,6,10,0,1,0,17,11,7,0,0,0,18,nowin,loss,beat,dlwin,0,10,16,202,0.440594059,0.034653465,0.618811881,2,0.614441029
20930,95,23489,10,5,0,1,8,24,11,7,0,0,0,18,nowin,loss,bust,plbust,0,10,15,218,0.412844037,0.04587156,0.559633028,0,0.024842385
20931,43,23489,4,8,0,4,10,26,11,7,0,0,0,18,nowin,loss,bust,plbust,0,10,12,192,0.40625,0.041666667,0.609375,2,0.576671372
20932,75,23489,11,10,0,0,0,21,11,7,0,0,0,18,win,win,plwin,beat,25,0,21,191,0.418848168,0.052356021,0.570680628,0,0.029344702
20933,149,23489,2,10,0,6,0,18,11,7,0,0,0,18,nowin,push,push,push,10,0,12,225,0.457777778,0.057777778,0.648888889,2,0.651965595
20934,87,23490,10,3,0,0,0,13,3,3,5,10,0,21,nowin,loss,beat,dlwin,0,10,13,202,0.405940594,0.054455446,0.628712871,2,0.590599801
20935,46,23490,6,8,0,0,0,14,3,3,5,10,0,21,nowin,loss,beat,dlwin,0,10,14,186,0.403225806,0.048387097,0.591397849,0,0.029742194
20936,67,23490,10,10,0,0,0,20,3,3,5,10,0,21,nowin,loss,beat,dlwin,0,10,20,195,0.369230769,0.041025641,0.569230769,0,0.014139427
20937,144,23490,6,10,0,0,0,16,3,3,5,10,0,21,nowin,loss,beat,dlwin,0,10,16,202,0.386138614,0.054455446,0.564356436,0,0.018006244
20938,19,23490,6,10,0,0,0,16,3,3,5,10,0,21,nowin,loss,beat,dlwin,0,10,16,237,0.41350211,0.054852321,0.628691983,2,0.597373826
20939,17,23490,5,10,0,0,0,15,3,3,5,10,0,21,nowin,loss,beat,dlwin,0,10,15,171,0.444444444,0.070175439,0.555555556,1,0.302364894
20940,116,23491,10,2,0,8,0,20,10,9,0,0,0,19,nowin,win,plwin,beat,20,0,12,195,0.425641026,0.056410256,0.538461538,1,0.28273747
20941,122,23491,11,1,3,10,0,25,10,9,0,0,0,19,nowin,loss,bust,plbust,0,10,12,210,0.347619048,0.052380952,0.59047619,0,0.012873677
20942,110,23491,7,5,0,7,0,19,10,9,0,0,0,19,nowin,push,push,push,10,0,12,192,0.416666667,0.046875,0.557291667,0,0.025413132
20943,2,23491,8,10,0,0,0,18,10,9,0,0,0,19,nowin,loss,beat,dlwin,0,10,18,200,0.445,0.035,0.64,2,0.633962549
20944,134,23491,4,10,0,3,0,17,10,9,0,0,0,19,nowin,loss,beat,dlwin,0,10,14,185,0.443243243,0.021621622,0.545945946,1,0.296939509
20945,10,23491,6,1,10,0,0,17,10,9,0,0,0,19,nowin,loss,beat,dlwin,0,10,7,191,0.413612565,0.057591623,0.596858639,2,0.574087175
20946,10,23492,10,6,0,0,0,16,2,10,10,0,0,22,nowin,win,dlbust,bust,20,0,16,191,0.413612565,0.057591623,0.596858639,2,0.574087175
20947,26,23492,10,10,0,0,0,20,2,10,10,0,0,22,nowin,win,dlbust,bust,20,0,20,203,0.463054187,0.0591133,0.541871921,1,0.306802864
20948,60,23492,10,5,0,0,0,15,2,10,10,0,0,22,nowin,win,dlbust,bust,20,0,15,227,0.418502203,0.022026432,0.559471366,0,0.026496258
20949,83,23492,4,6,9,0,0,19,2,10,10,0,0,22,nowin,win,dlbust,bust,20,0,10,193,0.424870466,0.051813472,0.678756477,2,0.644360335
20950,139,23492,3,10,0,0,0,13,2,10,10,0,0,22,nowin,win,dlbust,bust,20,0,13,192,0.380208333,0.036458333,0.59375,0,0.023429169
20951,44,23492,6,8,0,0,0,14,2,10,10,0,0,22,nowin,win,dlbust,bust,20,0,14,219,0.433789954,0.050228311,0.534246575,1,0.285551035
20952,76,23493,11,10,0,0,0,21,5,10,4,0,0,19,win,win,plwin,beat,25,0,21,189,0.534391534,0.079365079,0.608465608,3,1
20953,78,23493,10,3,0,0,0,13,5,10,4,0,0,19,nowin,loss,beat,dlwin,0,10,13,201,0.517412935,0.034825871,0.587064677,3,0.95871112
20954,19,23493,3,4,4,4,0,15,5,10,4,0,0,19,nowin,loss,beat,dlwin,0,10,7,237,0.41350211,0.054852321,0.628691983,2,0.597373826
20955,47,23493,10,2,0,0,0,12,5,10,4,0,0,19,nowin,loss,beat,dlwin,0,10,12,210,0.438095238,0.057142857,0.623809524,2,0.615868808
20956,29,23493,10,10,0,0,0,20,5,10,4,0,0,19,nowin,win,plwin,beat,20,0,20,189,0.44973545,0.058201058,0.544973545,1,0.300349439
20957,93,23493,2,4,10,0,0,16,5,10,4,0,0,19,nowin,loss,beat,dlwin,0,10,6,175,0.485714286,0.051428571,0.548571429,1,0.323648091
20958,148,23494,10,2,0,2,4,18,8,5,10,0,0,23,nowin,win,dlbust,bust,20,0,12,204,0.401960784,0.078431373,0.593137255,0,0.029789521
20959,10,23494,10,11,0,0,0,21,8,5,10,0,0,23,win,win,dlbust,bust,25,0,21,191,0.413612565,0.057591623,0.596858639,2,0.574087175
20960,50,23494,9,10,0,0,0,19,8,5,10,0,0,23,nowin,win,dlbust,bust,20,0,19,202,0.405940594,0.04950495,0.54950495,0,0.020296079
20961,136,23494,10,4,0,6,0,20,8,5,10,0,0,23,nowin,win,dlbust,bust,20,0,14,194,0.396907216,0.025773196,0.597938144,0,0.029452644
20962,66,23494,10,3,0,10,0,23,8,5,10,0,0,23,nowin,loss,bust,plbust,0,10,13,217,0.456221198,0.064516129,0.626728111,3,0.924304367
20963,20,23494,7,5,0,10,0,22,8,5,10,0,0,23,nowin,loss,bust,plbust,0,10,12,186,0.456989247,0.037634409,0.537634409,1,0.301097108
20964,97,23495,5,6,6,0,0,17,6,6,10,0,0,22,nowin,win,dlbust,bust,20,0,11,182,0.450549451,0.06043956,0.692307692,2,0.677372279
20965,123,23495,6,7,0,0,0,13,6,6,10,0,0,22,nowin,win,dlbust,bust,20,0,13,205,0.43902439,0.034146341,0.614634146,2,0.609962544
20966,30,23495,7,10,0,0,0,17,6,6,10,0,0,22,nowin,win,dlbust,bust,20,0,17,206,0.393203883,0.033980583,0.601941748,0,0.029324648
20967,72,23495,10,10,0,0,0,20,6,6,10,0,0,22,nowin,win,dlbust,bust,20,0,20,185,0.394594595,0.032432432,0.508108108,0,0.006763115
20968,74,23495,5,9,0,0,0,14,6,6,10,0,0,22,nowin,win,dlbust,bust,20,0,14,209,0.411483254,0.04784689,0.531100478,0,0.017448125
20969,76,23495,10,3,0,0,0,13,6,6,10,0,0,22,nowin,win,dlbust,bust,20,0,13,189,0.534391534,0.079365079,0.608465608,3,1
20970,113,23496,10,3,0,1,10,24,9,10,0,0,0,19,nowin,loss,bust,plbust,0,10,13,199,0.407035176,0.055276382,0.668341709,2,0.620695264
20971,49,23496,5,7,0,10,0,22,9,10,0,0,0,19,nowin,loss,bust,plbust,0,10,12,207,0.396135266,0.053140097,0.594202899,0,0.028306925
20972,14,23496,10,5,0,10,0,25,9,10,0,0,0,19,nowin,loss,bust,plbust,0,10,15,202,0.391089109,0.01980198,0.628712871,2,0.577264877
20973,51,23496,2,4,10,10,0,26,9,10,0,0,0,19,nowin,loss,bust,plbust,0,10,6,189,0.529100529,0.068783069,0.608465608,3,0.993665715
20974,48,23496,6,10,0,3,0,19,9,10,0,0,0,19,nowin,push,push,push,10,0,16,203,0.413793103,0.019704433,0.600985222,2,0.577280801
20975,72,23496,10,7,0,0,0,17,9,10,0,0,0,19,nowin,loss,beat,dlwin,0,10,17,185,0.394594595,0.032432432,0.508108108,0,0.006763115
20976,104,23497,10,10,0,0,0,20,2,9,4,8,0,23,nowin,win,dlbust,bust,20,0,20,209,0.363636364,0.052631579,0.593301435,0,0.018359419
20977,59,23497,2,11,8,0,0,21,2,9,4,8,0,23,nowin,win,dlbust,bust,20,0,13,228,0.429824561,0.048245614,0.543859649,1,0.287885446
20978,99,23497,8,10,0,0,0,18,2,9,4,8,0,23,nowin,win,dlbust,bust,20,0,18,207,0.47826087,0.062801932,0.637681159,3,0.961418446
20979,113,23497,10,10,0,0,0,20,2,9,4,8,0,23,nowin,win,dlbust,bust,20,0,20,199,0.407035176,0.055276382,0.668341709,2,0.620695264
20980,31,23497,8,3,7,0,0,18,2,9,4,8,0,23,nowin,win,dlbust,bust,20,0,11,188,0.473404255,0.058510638,0.515957447,1,0.300306557
20981,42,23497,2,10,0,6,0,18,2,9,4,8,0,23,nowin,win,dlbust,bust,20,0,12,212,0.443396226,0.051886792,0.570754717,1,0.309181312
20982,49,23498,4,10,0,8,0,22,7,10,0,0,0,17,nowin,loss,bust,plbust,0,10,14,207,0.396135266,0.053140097,0.594202899,0,0.028306925
20983,23,23498,7,9,0,4,0,20,7,10,0,0,0,17,nowin,win,plwin,beat,20,0,16,208,0.427884615,0.0625,0.552884615,1,0.29114424
20984,88,23498,3,10,0,5,0,18,7,10,0,0,0,17,nowin,win,plwin,beat,20,0,13,206,0.466019417,0.033980583,0.54368932,1,0.309467903
20985,116,23498,4,5,8,0,0,17,7,10,0,0,0,17,nowin,push,push,push,10,0,9,195,0.425641026,0.056410256,0.538461538,1,0.28273747
20986,47,23498,6,10,0,10,0,26,7,10,0,0,0,17,nowin,loss,bust,plbust,0,10,16,210,0.438095238,0.057142857,0.623809524,2,0.615868808
20987,141,23498,11,10,0,0,0,21,7,10,0,0,0,17,win,win,plwin,beat,25,0,21,202,0.420792079,0.074257426,0.564356436,0,0.028377851
20988,113,23499,10,9,0,0,0,19,7,4,10,0,0,21,nowin,loss,beat,dlwin,0,10,19,199,0.407035176,0.055276382,0.668341709,2,0.620695264
20989,104,23499,10,11,0,0,0,21,7,4,10,0,0,21,win,push,push,push,10,0,21,209,0.363636364,0.052631579,0.593301435,0,0.018359419
20990,41,23499,7,5,0,1,10,23,7,4,10,0,0,21,nowin,loss,bust,plbust,0,10,12,192,0.364583333,0.036458333,0.520833333,0,0.00089702
20991,87,23499,10,10,0,0,0,20,7,4,10,0,0,21,nowin,loss,beat,dlwin,0,10,20,202,0.405940594,0.054455446,0.628712871,2,0.590599801
20992,40,23499,5,5,5,8,0,23,7,4,10,0,0,21,nowin,loss,bust,plbust,0,10,10,196,0.367346939,0.030612245,0.617346939,0,0.025358183
20993,62,23499,10,11,0,0,0,21,7,4,10,0,0,21,win,push,push,push,10,0,21,178,0.370786517,0.028089888,0.54494382,0,0.008657722
20994,118,23500,11,7,0,0,0,18,10,4,2,9,0,25,nowin,win,dlbust,bust,20,0,18,216,0.393518519,0.037037037,0.555555556,0,0.018059873
20995,3,23500,10,5,0,10,0,25,10,4,2,9,0,25,nowin,loss,bust,plbust,0,10,15,190,0.431578947,0.026315789,0.542105263,1,0.288076384
20996,78,23500,6,5,10,0,0,21,10,4,2,9,0,25,nowin,win,dlbust,bust,20,0,11,201,0.517412935,0.034825871,0.587064677,3,0.95871112
20997,131,23500,5,2,10,0,0,17,10,4,2,9,0,25,nowin,win,dlbust,bust,20,0,7,217,0.410138249,0.069124424,0.543778802,0,0.02015021
20998,88,23500,8,11,0,0,0,19,10,4,2,9,0,25,nowin,win,dlbust,bust,20,0,19,206,0.466019417,0.033980583,0.54368932,1,0.309467903
20999,34,23500,5,10,0,7,0,22,10,4,2,9,0,25,nowin,loss,bust,plbust,0,10,15,202,0.5,0.079207921,0.618811881,3,0.968961434
21000,101,23501,2,2,4,3,6,17,8,8,1,0,0,17,nowin,push,push,push,10,0,4,205,0.424390244,0.068292683,0.63902439,2,0.614740646
21001,20,23501,10,10,0,0,0,20,8,8,1,0,0,17,nowin,win,plwin,beat,20,0,20,186,0.456989247,0.037634409,0.537634409,1,0.301097108
21002,116,23501,10,10,0,0,0,20,8,8,1,0,0,17,nowin,win,plwin,beat,20,0,20,195,0.425641026,0.056410256,0.538461538,1,0.28273747
21003,48,23501,10,10,0,0,0,20,8,8,1,0,0,17,nowin,win,plwin,beat,20,0,20,203,0.413793103,0.019704433,0.600985222,2,0.577280801
21004,19,23501,10,2,0,2,5,19,8,8,1,0,0,17,nowin,win,plwin,beat,20,0,12,237,0.41350211,0.054852321,0.628691983,2,0.597373826
21005,33,23501,11,5,1,0,0,17,8,8,1,0,0,17,nowin,push,push,push,10,0,16,192,0.4375,0.057291667,0.625,2,0.616208916
21006,12,23502,10,7,0,0,0,17,1,3,10,2,10,26,nowin,win,dlbust,bust,20,0,17,189,0.470899471,0.015873016,0.613756614,3,0.929171178
21007,121,23502,2,6,10,0,0,18,1,3,10,2,10,26,nowin,win,dlbust,bust,20,0,8,195,0.456410256,0.025641026,0.512820513,1,0.288597791
21008,46,23502,9,6,0,6,0,21,1,3,10,2,10,26,nowin,win,dlbust,bust,20,0,15,186,0.403225806,0.048387097,0.591397849,0,0.029742194
21009,7,23502,2,10,0,5,0,17,1,3,10,2,10,26,nowin,win,dlbust,bust,20,0,12,183,0.442622951,0.06010929,0.62295082,2,0.619303341
21010,9,23502,6,9,0,3,0,18,1,3,10,2,10,26,nowin,win,dlbust,bust,20,0,15,194,0.37628866,0.015463918,0.541237113,0,0.009396796
21011,129,23502,4,3,6,10,0,23,1,3,10,2,10,26,nowin,loss,bust,plbust,0,10,7,201,0.422885572,0.064676617,0.55721393,0,0.027255383
21012,142,23503,2,2,10,9,0,23,9,11,0,0,0,20,nowin,loss,bust,plbust,0,10,4,211,0.417061611,0.047393365,0.526066351,1,0.271531309
21013,135,23503,11,1,7,0,0,19,9,11,0,0,0,20,nowin,loss,beat,dlwin,0,10,12,179,0.391061453,0.067039106,0.586592179,0,0.024924662
21014,42,23503,3,9,0,8,0,20,9,11,0,0,0,20,nowin,push,push,push,10,0,12,212,0.443396226,0.051886792,0.570754717,1,0.309181312
21015,8,23503,7,3,10,0,0,20,9,11,0,0,0,20,nowin,push,push,push,10,0,10,181,0.44198895,0.071823204,0.596685083,2,0.599438402
21016,123,23503,10,10,0,0,0,20,9,11,0,0,0,20,nowin,push,push,push,10,0,20,205,0.43902439,0.034146341,0.614634146,2,0.609962544
21017,41,23503,10,7,0,0,0,17,9,11,0,0,0,20,nowin,loss,beat,dlwin,0,10,17,192,0.364583333,0.036458333,0.520833333,0,0.00089702
21018,109,23504,10,8,0,0,0,18,9,6,5,0,0,20,nowin,loss,beat,dlwin,0,10,18,221,0.461538462,0.058823529,0.597285068,3,0.901830309
21019,144,23504,9,3,0,3,9,24,9,6,5,0,0,20,nowin,loss,bust,plbust,0,10,12,202,0.386138614,0.054455446,0.564356436,0,0.018006244
21020,32,23504,9,4,0,1,10,24,9,6,5,0,0,20,nowin,loss,bust,plbust,0,10,13,189,0.391534392,0.037037037,0.53968254,0,0.013579086
21021,110,23504,4,7,10,0,0,21,9,6,5,0,0,20,nowin,win,plwin,beat,20,0,11,192,0.416666667,0.046875,0.557291667,0,0.025413132
21022,63,23504,10,4,0,6,0,20,9,6,5,0,0,20,nowin,push,push,push,10,0,14,216,0.467592593,0.037037037,0.62037037,3,0.931690496
21023,26,23504,10,2,0,10,0,22,9,6,5,0,0,20,nowin,loss,bust,plbust,0,10,12,203,0.463054187,0.0591133,0.541871921,1,0.306802864
21024,82,23505,11,5,4,0,0,20,4,10,7,0,0,21,nowin,loss,beat,dlwin,0,10,16,225,0.408888889,0.075555556,0.577777778,0,0.028101874
21025,10,23505,10,10,0,0,0,20,4,10,7,0,0,21,nowin,loss,beat,dlwin,0,10,20,191,0.413612565,0.057591623,0.596858639,2,0.574087175
21026,21,23505,5,5,10,0,0,20,4,10,7,0,0,21,nowin,loss,beat,dlwin,0,10,10,214,0.359813084,0.042056075,0.626168224,0,0.025263474
21027,44,23505,8,4,0,0,0,12,4,10,7,0,0,21,nowin,loss,beat,dlwin,0,10,12,219,0.433789954,0.050228311,0.534246575,1,0.285551035
21028,51,23505,9,10,0,0,0,19,4,10,7,0,0,21,nowin,loss,beat,dlwin,0,10,19,189,0.529100529,0.068783069,0.608465608,3,0.993665715
21029,88,23505,5,9,0,0,0,14,4,10,7,0,0,21,nowin,loss,beat,dlwin,0,10,14,206,0.466019417,0.033980583,0.54368932,1,0.309467903
21030,135,23506,10,5,0,0,0,15,6,6,7,0,0,19,nowin,loss,beat,dlwin,0,10,15,179,0.391061453,0.067039106,0.586592179,0,0.024924662
21031,88,23506,3,5,10,0,0,18,6,6,7,0,0,19,nowin,loss,beat,dlwin,0,10,8,206,0.466019417,0.033980583,0.54368932,1,0.309467903
21032,150,23506,8,10,0,0,0,18,6,6,7,0,0,19,nowin,loss,beat,dlwin,0,10,18,192,0.401041667,0.036458333,0.567708333,0,0.023287458
21033,75,23506,6,5,3,0,0,14,6,6,7,0,0,19,nowin,loss,beat,dlwin,0,10,11,191,0.418848168,0.052356021,0.570680628,0,0.029344702
21034,139,23506,2,8,10,0,0,20,6,6,7,0,0,19,nowin,win,plwin,beat,20,0,10,192,0.380208333,0.036458333,0.59375,0,0.023429169
21035,16,23506,9,10,0,0,0,19,6,6,7,0,0,19,nowin,push,push,push,10,0,19,220,0.427272727,0.081818182,0.6,2,0.588660176
21036,144,23507,10,8,0,0,0,18,10,10,0,0,0,20,nowin,loss,beat,dlwin,0,10,18,202,0.386138614,0.054455446,0.564356436,0,0.018006244
21037,94,23507,10,11,0,0,0,21,10,10,0,0,0,20,win,win,plwin,beat,25,0,21,183,0.43715847,0.043715847,0.540983607,1,0.290866892
21038,139,23507,4,5,5,8,0,22,10,10,0,0,0,20,nowin,loss,bust,plbust,0,10,9,192,0.380208333,0.036458333,0.59375,0,0.023429169
21039,88,23507,10,8,0,0,0,18,10,10,0,0,0,20,nowin,loss,beat,dlwin,0,10,18,206,0.466019417,0.033980583,0.54368932,1,0.309467903
21040,60,23507,6,3,4,10,0,23,10,10,0,0,0,20,nowin,loss,bust,plbust,0,10,9,227,0.418502203,0.022026432,0.559471366,0,0.026496258
21041,79,23507,8,11,0,0,0,19,10,10,0,0,0,20,nowin,loss,beat,dlwin,0,10,19,211,0.436018957,0.028436019,0.672985782,2,0.650131054
21042,8,23508,5,11,5,0,0,21,4,8,10,0,0,22,nowin,win,dlbust,bust,20,0,16,181,0.44198895,0.071823204,0.596685083,2,0.599438402
21043,39,23508,10,3,0,0,0,13,4,8,10,0,0,22,nowin,win,dlbust,bust,20,0,13,191,0.429319372,0.062827225,0.57591623,0,0.033760763
21044,97,23508,1,6,8,0,0,15,4,8,10,0,0,22,nowin,win,dlbust,bust,20,0,7,182,0.450549451,0.06043956,0.692307692,2,0.677372279
21045,94,23508,3,1,10,0,0,14,4,8,10,0,0,22,nowin,win,dlbust,bust,20,0,4,183,0.43715847,0.043715847,0.540983607,1,0.290866892
21046,67,23508,10,6,0,0,0,16,4,8,10,0,0,22,nowin,win,dlbust,bust,20,0,16,195,0.369230769,0.041025641,0.569230769,0,0.014139427
21047,97,23508,10,7,0,0,0,17,4,8,10,0,0,22,nowin,win,dlbust,bust,20,0,17,182,0.450549451,0.06043956,0.692307692,2,0.677372279
21048,74,23509,6,1,7,10,0,24,10,10,0,0,0,20,nowin,loss,bust,plbust,0,10,7,209,0.411483254,0.04784689,0.531100478,0,0.017448125
21049,65,23509,2,11,3,7,0,23,10,10,0,0,0,20,nowin,loss,bust,plbust,0,10,13,203,0.492610837,0.054187192,0.571428571,3,0.913702814
21050,125,23509,8,10,0,0,0,18,10,10,0,0,0,20,nowin,loss,beat,dlwin,0,10,18,219,0.438356164,0.050228311,0.575342466,1,0.308411257
21051,13,23509,4,8,0,10,0,22,10,10,0,0,0,20,nowin,loss,bust,plbust,0,10,12,206,0.417475728,0.063106796,0.621359223,2,0.59555479
21052,66,23509,6,4,2,8,0,20,10,10,0,0,0,20,nowin,push,push,push,10,0,10,217,0.456221198,0.064516129,0.626728111,3,0.924304367
21053,13,23509,5,10,0,8,0,23,10,10,0,0,0,20,nowin,loss,bust,plbust,0,10,15,206,0.417475728,0.063106796,0.621359223,2,0.59555479
21054,24,23510,2,2,10,2,5,21,10,10,0,0,0,20,nowin,win,plwin,beat,20,0,4,207,0.458937198,0.048309179,0.570048309,1,0.318138014
21055,45,23510,11,8,0,0,0,19,10,10,0,0,0,20,nowin,loss,beat,dlwin,0,10,19,196,0.428571429,0.051020408,0.612244898,2,0.598821767
21056,24,23510,10,4,0,10,0,24,10,10,0,0,0,20,nowin,loss,bust,plbust,0,10,14,207,0.458937198,0.048309179,0.570048309,1,0.318138014
21057,45,23510,10,10,0,0,0,20,10,10,0,0,0,20,nowin,push,push,push,10,0,20,196,0.428571429,0.051020408,0.612244898,2,0.598821767
21058,100,23510,1,4,10,5,0,20,10,10,0,0,0,20,nowin,push,push,push,10,0,5,190,0.452631579,0.036842105,0.594736842,3,0.888671154
21059,108,23510,2,10,0,9,0,21,10,10,0,0,0,20,nowin,win,plwin,beat,20,0,12,193,0.435233161,0.056994819,0.559585492,1,0.298824795
21060,49,23511,5,10,0,4,0,19,10,10,0,0,0,20,nowin,loss,beat,dlwin,0,10,15,207,0.396135266,0.053140097,0.594202899,0,0.028306925
21061,120,23511,10,10,0,0,0,20,10,10,0,0,0,20,nowin,push,push,push,10,0,20,202,0.440594059,0.034653465,0.618811881,2,0.614441029
21062,113,23511,6,6,0,2,8,22,10,10,0,0,0,20,nowin,loss,bust,plbust,0,10,12,199,0.407035176,0.055276382,0.668341709,2,0.620695264
21063,97,23511,6,10,0,10,0,26,10,10,0,0,0,20,nowin,loss,bust,plbust,0,10,16,182,0.450549451,0.06043956,0.692307692,2,0.677372279
21064,118,23511,10,11,0,0,0,21,10,10,0,0,0,20,win,win,plwin,beat,25,0,21,216,0.393518519,0.037037037,0.555555556,0,0.018059873
21065,49,23511,10,6,0,7,0,23,10,10,0,0,0,20,nowin,loss,bust,plbust,0,10,16,207,0.396135266,0.053140097,0.594202899,0,0.028306925
21066,140,23512,9,5,0,5,0,19,9,6,6,0,0,21,nowin,loss,beat,dlwin,0,10,14,210,0.466666667,0.023809524,0.604761905,3,0.915293335
21067,103,23512,7,11,0,0,0,18,9,6,6,0,0,21,nowin,loss,beat,dlwin,0,10,18,203,0.379310345,0.064039409,0.551724138,0,0.012869209
21068,64,23512,8,8,0,7,0,23,9,6,6,0,0,21,nowin,loss,bust,plbust,0,10,16,187,0.363636364,0.048128342,0.631016043,0,0.027594885
21069,109,23512,10,7,0,0,0,17,9,6,6,0,0,21,nowin,loss,beat,dlwin,0,10,17,221,0.461538462,0.058823529,0.597285068,3,0.901830309
21070,63,23512,3,4,4,10,0,21,9,6,6,0,0,21,nowin,push,push,push,10,0,7,216,0.467592593,0.037037037,0.62037037,3,0.931690496
21071,107,23512,10,11,0,0,0,21,9,6,6,0,0,21,win,push,push,push,10,0,21,218,0.444954128,0.073394495,0.600917431,2,0.605210014
21072,64,23513,3,10,0,0,0,13,6,8,6,0,0,20,nowin,loss,beat,dlwin,0,10,13,187,0.363636364,0.048128342,0.631016043,0,0.027594885
21073,68,23513,6,8,0,0,0,14,6,8,6,0,0,20,nowin,loss,beat,dlwin,0,10,14,205,0.434146341,0.029268293,0.6,2,0.59483189
21074,92,23513,10,2,0,0,0,12,6,8,6,0,0,20,nowin,loss,beat,dlwin,0,10,12,186,0.446236559,0.059139785,0.564516129,1,0.307826125
21075,113,23513,10,10,0,0,0,20,6,8,6,0,0,20,nowin,push,push,push,10,0,20,199,0.407035176,0.055276382,0.668341709,2,0.620695264
21076,31,23513,10,10,0,0,0,20,6,8,6,0,0,20,nowin,push,push,push,10,0,20,188,0.473404255,0.058510638,0.515957447,1,0.300306557
21077,5,23513,8,10,0,0,0,18,6,8,6,0,0,20,nowin,loss,beat,dlwin,0,10,18,203,0.42364532,0.02955665,0.596059113,2,0.582508076
21078,101,23514,3,10,0,9,0,22,10,9,0,0,0,19,nowin,loss,bust,plbust,0,10,13,205,0.424390244,0.068292683,0.63902439,2,0.614740646
21079,139,23514,11,10,0,0,0,21,10,9,0,0,0,19,win,win,plwin,beat,25,0,21,192,0.380208333,0.036458333,0.59375,0,0.023429169
21080,37,23514,5,1,10,10,0,26,10,9,0,0,0,19,nowin,loss,bust,plbust,0,10,6,208,0.394230769,0.038461538,0.581730769,0,0.024682772
21081,142,23514,5,10,0,1,6,22,10,9,0,0,0,19,nowin,loss,bust,plbust,0,10,15,211,0.417061611,0.047393365,0.526066351,1,0.271531309
21082,77,23514,6,3,2,10,0,21,10,9,0,0,0,19,nowin,win,plwin,beat,20,0,9,200,0.455,0.04,0.62,3,0.916252116
21083,98,23514,6,9,0,9,0,24,10,9,0,0,0,19,nowin,loss,bust,plbust,0,10,15,220,0.422727273,0.054545455,0.55,1,0.28664435
21084,65,23515,10,3,0,0,0,13,2,5,10,0,0,17,nowin,loss,beat,dlwin,0,10,13,203,0.492610837,0.054187192,0.571428571,3,0.913702814
21085,48,23515,10,9,0,0,0,19,2,5,10,0,0,17,nowin,win,plwin,beat,20,0,19,203,0.413793103,0.019704433,0.600985222,2,0.577280801
21086,140,23515,3,8,8,0,0,19,2,5,10,0,0,17,nowin,win,plwin,beat,20,0,11,210,0.466666667,0.023809524,0.604761905,3,0.915293335
21087,42,23515,9,9,0,0,0,18,2,5,10,0,0,17,nowin,win,plwin,beat,20,0,18,212,0.443396226,0.051886792,0.570754717,1,0.309181312
21088,149,23515,6,10,0,0,0,16,2,5,10,0,0,17,nowin,loss,beat,dlwin,0,10,16,225,0.457777778,0.057777778,0.648888889,2,0.651965595
21089,30,23515,5,10,0,0,0,15,2,5,10,0,0,17,nowin,loss,beat,dlwin,0,10,15,206,0.393203883,0.033980583,0.601941748,0,0.029324648
21090,141,23516,10,5,0,6,0,21,10,10,0,0,0,20,nowin,win,plwin,beat,20,0,15,202,0.420792079,0.074257426,0.564356436,0,0.028377851
21091,46,23516,10,3,0,9,0,22,10,10,0,0,0,20,nowin,loss,bust,plbust,0,10,13,186,0.403225806,0.048387097,0.591397849,0,0.029742194
21092,25,23516,10,7,0,0,0,17,10,10,0,0,0,20,nowin,loss,beat,dlwin,0,10,17,190,0.463157895,0.063157895,0.536842105,1,0.304401563
21093,105,23516,8,11,0,0,0,19,10,10,0,0,0,20,nowin,loss,beat,dlwin,0,10,19,198,0.414141414,0.070707071,0.590909091,0,0.032889494
21094,19,23516,2,5,8,10,0,25,10,10,0,0,0,20,nowin,loss,bust,plbust,0,10,7,237,0.41350211,0.054852321,0.628691983,2,0.597373826
21095,91,23516,3,5,6,10,0,24,10,10,0,0,0,20,nowin,loss,bust,plbust,0,10,8,194,0.417525773,0.046391753,0.515463918,1,0.266616552
21096,143,23517,2,6,3,6,0,17,9,5,10,0,0,24,nowin,win,dlbust,bust,20,0,8,203,0.463054187,0.044334975,0.57635468,3,0.883143365
21097,25,23517,11,8,0,0,0,19,9,5,10,0,0,24,nowin,win,dlbust,bust,20,0,19,190,0.463157895,0.063157895,0.536842105,1,0.304401563
21098,123,23517,7,10,0,0,0,17,9,5,10,0,0,24,nowin,win,dlbust,bust,20,0,17,205,0.43902439,0.034146341,0.614634146,2,0.609962544
21099,105,23517,9,8,0,0,0,17,9,5,10,0,0,24,nowin,win,dlbust,bust,20,0,17,198,0.414141414,0.070707071,0.590909091,0,0.032889494
21100,71,23517,3,3,4,4,4,18,9,5,10,0,0,24,nowin,win,dlbust,bust,20,0,6,193,0.352331606,0.046632124,0.585492228,0,0.013063661
21101,127,23517,2,10,0,4,7,23,9,5,10,0,0,24,nowin,loss,bust,plbust,0,10,12,201,0.402985075,0.029850746,0.60199005,0,0.032263937
21102,19,23518,7,2,10,0,0,19,9,6,1,6,0,22,nowin,win,dlbust,bust,20,0,9,237,0.41350211,0.054852321,0.628691983,2,0.597373826
21103,27,23518,11,5,5,0,0,21,9,6,1,6,0,22,nowin,win,dlbust,bust,20,0,16,178,0.370786517,0.016853933,0.573033708,0,0.015536309
21104,111,23518,10,11,0,0,0,21,9,6,1,6,0,22,win,win,dlbust,bust,25,0,21,180,0.433333333,0.055555556,0.611111111,2,0.602264492
21105,99,23518,11,10,0,0,0,21,9,6,1,6,0,22,win,win,dlbust,bust,25,0,21,207,0.47826087,0.062801932,0.637681159,3,0.961418446
21106,132,23518,4,10,0,7,0,21,9,6,1,6,0,22,nowin,win,dlbust,bust,20,0,14,194,0.412371134,0.036082474,0.649484536,2,0.611633238
21107,145,23518,3,6,10,0,0,19,9,6,1,6,0,22,nowin,win,dlbust,bust,20,0,9,188,0.441489362,0.031914894,0.622340426,2,0.617837093
21108,16,23519,10,11,0,0,0,21,8,6,5,0,0,19,win,win,plwin,beat,25,0,21,220,0.427272727,0.081818182,0.6,2,0.588660176
21109,7,23519,11,9,0,0,0,20,8,6,5,0,0,19,nowin,win,plwin,beat,20,0,20,183,0.442622951,0.06010929,0.62295082,2,0.619303341
21110,137,23519,9,9,0,0,0,18,8,6,5,0,0,19,nowin,loss,beat,dlwin,0,10,18,194,0.417525773,0.046391753,0.536082474,1,0.276714602
21111,125,23519,10,3,0,4,0,17,8,6,5,0,0,19,nowin,loss,beat,dlwin,0,10,13,219,0.438356164,0.050228311,0.575342466,1,0.308411257
21112,97,23519,5,7,0,10,0,22,8,6,5,0,0,19,nowin,loss,bust,plbust,0,10,12,182,0.450549451,0.06043956,0.692307692,2,0.677372279
21113,123,23519,3,10,0,4,0,17,8,6,5,0,0,19,nowin,loss,beat,dlwin,0,10,13,205,0.43902439,0.034146341,0.614634146,2,0.609962544
21114,1,23520,6,10,0,8,0,24,10,11,0,0,0,21,nowin,loss,bust,plbust,0,10,16,197,0.406091371,0.025380711,0.649746193,2,0.606186955
21115,46,23520,5,6,1,8,0,20,10,11,0,0,0,21,nowin,loss,beat,dlwin,0,10,11,186,0.403225806,0.048387097,0.591397849,0,0.029742194
21116,111,23520,10,9,0,0,0,19,10,11,0,0,0,21,nowin,loss,beat,dlwin,0,10,19,180,0.433333333,0.055555556,0.611111111,2,0.602264492
21117,84,23520,11,8,0,0,0,19,10,11,0,0,0,21,nowin,loss,beat,dlwin,0,10,19,195,0.379487179,0.056410256,0.569230769,0,0.017209119
21118,36,23520,2,10,0,8,0,20,10,11,0,0,0,21,nowin,loss,beat,dlwin,0,10,12,229,0.445414847,0.056768559,0.655021834,2,0.645370571
21119,11,23520,1,3,10,9,0,23,10,11,0,0,0,21,nowin,loss,bust,plbust,0,10,4,236,0.457627119,0.016949153,0.588983051,3,0.889015813
21120,46,23521,6,10,0,7,0,23,10,7,0,0,0,17,nowin,loss,bust,plbust,0,10,16,186,0.403225806,0.048387097,0.591397849,0,0.029742194
21121,24,23521,10,10,0,0,0,20,10,7,0,0,0,17,nowin,win,plwin,beat,20,0,20,207,0.458937198,0.048309179,0.570048309,1,0.318138014
21122,26,23521,4,11,2,0,0,17,10,7,0,0,0,17,nowin,push,push,push,10,0,15,203,0.463054187,0.0591133,0.541871921,1,0.306802864
21123,136,23521,2,2,10,3,0,17,10,7,0,0,0,17,nowin,push,push,push,10,0,4,194,0.396907216,0.025773196,0.597938144,0,0.029452644
21124,44,23521,10,6,0,10,0,26,10,7,0,0,0,17,nowin,loss,bust,plbust,0,10,16,219,0.433789954,0.050228311,0.534246575,1,0.285551035
21125,45,23521,10,10,0,0,0,20,10,7,0,0,0,17,nowin,win,plwin,beat,20,0,20,196,0.428571429,0.051020408,0.612244898,2,0.598821767
21126,135,23522,4,2,10,0,0,16,4,5,3,8,0,20,nowin,loss,beat,dlwin,0,10,6,179,0.391061453,0.067039106,0.586592179,0,0.024924662
21127,99,23522,7,4,10,0,0,21,4,5,3,8,0,20,nowin,win,plwin,beat,20,0,11,207,0.47826087,0.062801932,0.637681159,3,0.961418446
21128,138,23522,10,9,0,0,0,19,4,5,3,8,0,20,nowin,loss,beat,dlwin,0,10,19,190,0.442105263,0.047368421,0.610526316,2,0.609711065
21129,104,23522,10,5,0,0,0,15,4,5,3,8,0,20,nowin,loss,beat,dlwin,0,10,15,209,0.363636364,0.052631579,0.593301435,0,0.018359419
21130,19,23522,2,9,5,0,0,16,4,5,3,8,0,20,nowin,loss,beat,dlwin,0,10,11,237,0.41350211,0.054852321,0.628691983,2,0.597373826
21131,91,23522,9,5,0,0,0,14,4,5,3,8,0,20,nowin,loss,beat,dlwin,0,10,14,194,0.417525773,0.046391753,0.515463918,1,0.266616552
21132,49,23523,10,9,0,0,0,19,11,10,0,0,0,21,nowin,loss,beat,dlwin,0,10,19,207,0.396135266,0.053140097,0.594202899,0,0.028306925
21133,90,23523,5,7,0,4,10,26,11,10,0,0,0,21,nowin,loss,bust,plbust,0,10,12,201,0.447761194,0.049751244,0.60199005,3,0.889945023
21134,87,23523,10,10,0,0,0,20,11,10,0,0,0,21,nowin,loss,beat,dlwin,0,10,20,202,0.405940594,0.054455446,0.628712871,2,0.590599801
21135,63,23523,4,8,0,9,0,21,11,10,0,0,0,21,nowin,push,push,push,10,0,12,216,0.467592593,0.037037037,0.62037037,3,0.931690496
21136,33,23523,10,10,0,0,0,20,11,10,0,0,0,21,nowin,loss,beat,dlwin,0,10,20,192,0.4375,0.057291667,0.625,2,0.616208916
21137,84,23523,11,10,0,0,0,21,11,10,0,0,0,21,win,push,push,push,10,0,21,195,0.379487179,0.056410256,0.569230769,0,0.017209119
21138,42,23524,6,8,0,0,0,14,5,2,4,3,1,15,nowin,loss,beat,dlwin,0,10,14,212,0.443396226,0.051886792,0.570754717,1,0.309181312
21139,48,23524,2,8,8,0,0,18,5,2,4,3,1,15,nowin,win,plwin,beat,20,0,10,203,0.413793103,0.019704433,0.600985222,2,0.577280801
21140,108,23524,10,10,0,0,0,20,5,2,4,3,1,15,nowin,win,plwin,beat,20,0,20,193,0.435233161,0.056994819,0.559585492,1,0.298824795
21141,111,23524,3,3,10,0,0,16,5,2,4,3,1,15,nowin,win,plwin,beat,20,0,6,180,0.433333333,0.055555556,0.611111111,2,0.602264492
21142,99,23524,10,8,0,0,0,18,5,2,4,3,1,15,nowin,win,plwin,beat,20,0,18,207,0.47826087,0.062801932,0.637681159,3,0.961418446
21143,121,23524,10,11,0,0,0,21,5,2,4,3,1,15,win,win,plwin,beat,25,0,21,195,0.456410256,0.025641026,0.512820513,1,0.288597791
21144,141,23525,6,7,0,0,0,13,2,10,7,0,0,19,nowin,loss,beat,dlwin,0,10,13,202,0.420792079,0.074257426,0.564356436,0,0.028377851
21145,3,23525,9,10,0,0,0,19,2,10,7,0,0,19,nowin,push,push,push,10,0,19,190,0.431578947,0.026315789,0.542105263,1,0.288076384
21146,6,23525,11,4,1,0,0,16,2,10,7,0,0,19,nowin,loss,beat,dlwin,0,10,15,191,0.439790576,0.047120419,0.581151832,1,0.31211505
21147,116,23525,10,5,0,0,0,15,2,10,7,0,0,19,nowin,loss,beat,dlwin,0,10,15,195,0.425641026,0.056410256,0.538461538,1,0.28273747
21148,148,23525,4,10,0,0,0,14,2,10,7,0,0,19,nowin,loss,beat,dlwin,0,10,14,204,0.401960784,0.078431373,0.593137255,0,0.029789521
21149,71,23525,9,3,0,1,0,13,2,10,7,0,0,19,nowin,loss,beat,dlwin,0,10,12,193,0.352331606,0.046632124,0.585492228,0,0.013063661
21150,108,23526,10,2,0,4,3,19,11,1,7,0,0,19,nowin,push,push,push,10,0,12,193,0.435233161,0.056994819,0.559585492,1,0.298824795
21151,34,23526,8,5,0,1,5,19,11,1,7,0,0,19,nowin,push,push,push,10,0,13,202,0.5,0.079207921,0.618811881,3,0.968961434
21152,70,23526,1,4,10,9,0,24,11,1,7,0,0,19,nowin,loss,bust,plbust,0,10,5,228,0.385964912,0.039473684,0.557017544,0,0.016157125
21153,67,23526,7,9,0,7,0,23,11,1,7,0,0,19,nowin,loss,bust,plbust,0,10,16,195,0.369230769,0.041025641,0.569230769,0,0.014139427
21154,4,23526,4,3,10,0,0,17,11,1,7,0,0,19,nowin,loss,beat,dlwin,0,10,7,217,0.460829493,0.036866359,0.562211982,1,0.315432839
21155,32,23526,5,11,1,0,0,17,11,1,7,0,0,19,nowin,loss,beat,dlwin,0,10,16,189,0.391534392,0.037037037,0.53968254,0,0.013579086
21156,80,23527,10,8,0,0,0,18,4,10,5,0,0,19,nowin,loss,beat,dlwin,0,10,18,186,0.419354839,0.059139785,0.623655914,2,0.59892924
21157,53,23527,4,10,0,0,0,14,4,10,5,0,0,19,nowin,loss,beat,dlwin,0,10,14,250,0.372,0.064,0.564,0,0.013687345
21158,49,23527,3,7,10,0,0,20,4,10,5,0,0,19,nowin,win,plwin,beat,20,0,10,207,0.396135266,0.053140097,0.594202899,0,0.028306925
21159,43,23527,2,1,10,0,0,13,4,10,5,0,0,19,nowin,loss,beat,dlwin,0,10,3,192,0.40625,0.041666667,0.609375,2,0.576671372
21160,137,23527,10,7,0,0,0,17,4,10,5,0,0,19,nowin,loss,beat,dlwin,0,10,17,194,0.417525773,0.046391753,0.536082474,1,0.276714602
21161,16,23527,10,10,0,0,0,20,4,10,5,0,0,19,nowin,win,plwin,beat,20,0,20,220,0.427272727,0.081818182,0.6,2,0.588660176
21162,25,23528,2,9,1,3,10,25,10,10,0,0,0,20,nowin,loss,bust,plbust,0,10,11,190,0.463157895,0.063157895,0.536842105,1,0.304401563
21163,97,23528,4,10,0,5,0,19,10,10,0,0,0,20,nowin,loss,beat,dlwin,0,10,14,182,0.450549451,0.06043956,0.692307692,2,0.677372279
21164,91,23528,9,10,0,0,0,19,10,10,0,0,0,20,nowin,loss,beat,dlwin,0,10,19,194,0.417525773,0.046391753,0.515463918,1,0.266616552
21165,25,23528,10,10,0,0,0,20,10,10,0,0,0,20,nowin,push,push,push,10,0,20,190,0.463157895,0.063157895,0.536842105,1,0.304401563
21166,140,23528,8,6,0,7,0,21,10,10,0,0,0,20,nowin,win,plwin,beat,20,0,14,210,0.466666667,0.023809524,0.604761905,3,0.915293335
21167,92,23528,4,5,7,2,0,18,10,10,0,0,0,20,nowin,loss,beat,dlwin,0,10,9,186,0.446236559,0.059139785,0.564516129,1,0.307826125
21168,107,23529,10,5,0,0,0,15,5,6,4,7,0,22,nowin,win,dlbust,bust,20,0,15,218,0.444954128,0.073394495,0.600917431,2,0.605210014
21169,98,23529,7,6,0,0,0,13,5,6,4,7,0,22,nowin,win,dlbust,bust,20,0,13,220,0.422727273,0.054545455,0.55,1,0.28664435
21170,147,23529,10,3,0,0,0,13,5,6,4,7,0,22,nowin,win,dlbust,bust,20,0,13,205,0.380487805,0.014634146,0.536585366,0,0.00951447
21171,129,23529,5,3,10,0,0,18,5,6,4,7,0,22,nowin,win,dlbust,bust,20,0,8,201,0.422885572,0.064676617,0.55721393,0,0.027255383
21172,32,23529,9,11,0,0,0,20,5,6,4,7,0,22,nowin,win,dlbust,bust,20,0,20,189,0.391534392,0.037037037,0.53968254,0,0.013579086
21173,55,23529,8,7,0,0,0,15,5,6,4,7,0,22,nowin,win,dlbust,bust,20,0,15,191,0.371727749,0.057591623,0.54973822,0,0.01011347
21174,14,23530,7,8,0,9,0,24,10,3,10,0,0,23,nowin,loss,bust,plbust,0,10,15,202,0.391089109,0.01980198,0.628712871,2,0.577264877
21175,70,23530,11,7,0,0,0,18,10,3,10,0,0,23,nowin,win,dlbust,bust,20,0,18,228,0.385964912,0.039473684,0.557017544,0,0.016157125
21176,67,23530,10,7,0,0,0,17,10,3,10,0,0,23,nowin,win,dlbust,bust,20,0,17,195,0.369230769,0.041025641,0.569230769,0,0.014139427
21177,145,23530,10,5,0,2,0,17,10,3,10,0,0,23,nowin,win,dlbust,bust,20,0,15,188,0.441489362,0.031914894,0.622340426,2,0.617837093
21178,53,23530,10,10,0,0,0,20,10,3,10,0,0,23,nowin,win,dlbust,bust,20,0,20,250,0.372,0.064,0.564,0,0.013687345
21179,123,23530,4,10,0,2,5,21,10,3,10,0,0,23,nowin,win,dlbust,bust,20,0,14,205,0.43902439,0.034146341,0.614634146,2,0.609962544
21180,147,23531,5,11,1,0,0,17,4,8,10,0,0,22,nowin,win,dlbust,bust,20,0,16,205,0.380487805,0.014634146,0.536585366,0,0.00951447
21181,136,23531,3,9,0,0,0,12,4,8,10,0,0,22,nowin,win,dlbust,bust,20,0,12,194,0.396907216,0.025773196,0.597938144,0,0.029452644
21182,112,23531,6,3,5,0,0,14,4,8,10,0,0,22,nowin,win,dlbust,bust,20,0,9,203,0.448275862,0.054187192,0.600985222,3,0.889576933
21183,9,23531,5,7,0,0,0,12,4,8,10,0,0,22,nowin,win,dlbust,bust,20,0,12,194,0.37628866,0.015463918,0.541237113,0,0.009396796
21184,85,23531,8,10,0,0,0,18,4,8,10,0,0,22,nowin,win,dlbust,bust,20,0,18,195,0.41025641,0.066666667,0.594871795,0,0.03269711
21185,63,23531,4,5,8,0,0,17,4,8,10,0,0,22,nowin,win,dlbust,bust,20,0,9,216,0.467592593,0.037037037,0.62037037,3,0.931690496
21186,62,23532,8,10,0,0,0,18,3,1,10,1,9,24,nowin,win,dlbust,bust,20,0,18,178,0.370786517,0.028089888,0.54494382,0,0.008657722
21187,44,23532,10,8,0,0,0,18,3,1,10,1,9,24,nowin,win,dlbust,bust,20,0,18,219,0.433789954,0.050228311,0.534246575,1,0.285551035
21188,36,23532,9,8,0,0,0,17,3,1,10,1,9,24,nowin,win,dlbust,bust,20,0,17,229,0.445414847,0.056768559,0.655021834,2,0.645370571
21189,132,23532,6,10,0,0,0,16,3,1,10,1,9,24,nowin,win,dlbust,bust,20,0,16,194,0.412371134,0.036082474,0.649484536,2,0.611633238
21190,44,23532,2,10,0,4,0,16,3,1,10,1,9,24,nowin,win,dlbust,bust,20,0,12,219,0.433789954,0.050228311,0.534246575,1,0.285551035
21191,69,23532,8,8,0,0,0,16,3,1,10,1,9,24,nowin,win,dlbust,bust,20,0,16,194,0.365979381,0.030927835,0.515463918,0,0
21192,119,23533,6,7,0,2,10,25,7,5,4,5,0,21,nowin,loss,bust,plbust,0,10,13,190,0.405263158,0.068421053,0.515789474,0,0.011837158
21193,125,23533,1,1,10,9,0,21,7,5,4,5,0,21,nowin,push,push,push,10,0,2,219,0.438356164,0.050228311,0.575342466,1,0.308411257
21194,10,23533,7,5,0,9,0,21,7,5,4,5,0,21,nowin,push,push,push,10,0,12,191,0.413612565,0.057591623,0.596858639,2,0.574087175
21195,127,23533,3,10,0,3,4,20,7,5,4,5,0,21,nowin,loss,beat,dlwin,0,10,13,201,0.402985075,0.029850746,0.60199005,0,0.032263937
21196,25,23533,10,8,0,0,0,18,7,5,4,5,0,21,nowin,loss,beat,dlwin,0,10,18,190,0.463157895,0.063157895,0.536842105,1,0.304401563
21197,47,23533,6,3,10,0,0,19,7,5,4,5,0,21,nowin,loss,beat,dlwin,0,10,9,210,0.438095238,0.057142857,0.623809524,2,0.615868808
21198,99,23534,7,6,0,2,10,25,9,10,0,0,0,19,nowin,loss,bust,plbust,0,10,13,207,0.47826087,0.062801932,0.637681159,3,0.961418446
21199,36,23534,10,5,0,1,10,26,9,10,0,0,0,19,nowin,loss,bust,plbust,0,10,15,229,0.445414847,0.056768559,0.655021834,2,0.645370571
21200,35,23534,8,8,0,9,0,25,9,10,0,0,0,19,nowin,loss,bust,plbust,0,10,16,202,0.410891089,0.044554455,0.633663366,2,0.598681573
21201,31,23534,2,8,10,0,0,20,9,10,0,0,0,19,nowin,win,plwin,beat,20,0,10,188,0.473404255,0.058510638,0.515957447,1,0.300306557
21202,128,23534,10,8,0,0,0,18,9,10,0,0,0,19,nowin,loss,beat,dlwin,0,10,18,227,0.356828194,0.052863436,0.577092511,0,0.012352564
21203,39,23534,6,5,8,0,0,19,9,10,0,0,0,19,nowin,push,push,push,10,0,11,191,0.429319372,0.062827225,0.57591623,0,0.033760763
21204,38,23535,8,2,5,5,0,20,11,8,0,0,0,19,nowin,win,plwin,beat,20,0,10,202,0.361386139,0.03960396,0.564356436,0,0.010597953
21205,50,23535,7,4,1,9,0,21,11,8,0,0,0,19,nowin,win,plwin,beat,20,0,11,202,0.405940594,0.04950495,0.54950495,0,0.020296079
21206,100,23535,9,8,0,0,0,17,11,8,0,0,0,19,nowin,loss,beat,dlwin,0,10,17,190,0.452631579,0.036842105,0.594736842,3,0.888671154
21207,135,23535,7,11,0,0,0,18,11,8,0,0,0,19,nowin,loss,beat,dlwin,0,10,18,179,0.391061453,0.067039106,0.586592179,0,0.024924662
21208,99,23535,7,10,0,0,0,17,11,8,0,0,0,19,nowin,loss,beat,dlwin,0,10,17,207,0.47826087,0.062801932,0.637681159,3,0.961418446
21209,120,23535,3,10,0,6,0,19,11,8,0,0,0,19,nowin,push,push,push,10,0,13,202,0.440594059,0.034653465,0.618811881,2,0.614441029
21210,93,23536,10,10,0,0,0,20,10,10,0,0,0,20,nowin,push,push,push,10,0,20,175,0.485714286,0.051428571,0.548571429,1,0.323648091
21211,13,23536,7,10,0,0,0,17,10,10,0,0,0,20,nowin,loss,beat,dlwin,0,10,17,206,0.417475728,0.063106796,0.621359223,2,0.59555479
21212,38,23536,8,10,0,0,0,18,10,10,0,0,0,20,nowin,loss,beat,dlwin,0,10,18,202,0.361386139,0.03960396,0.564356436,0,0.010597953
21213,54,23536,8,2,7,0,0,17,10,10,0,0,0,20,nowin,loss,beat,dlwin,0,10,10,185,0.437837838,0.032432432,0.556756757,1,0.29899854
21214,80,23536,2,8,9,0,0,19,10,10,0,0,0,20,nowin,loss,beat,dlwin,0,10,10,186,0.419354839,0.059139785,0.623655914,2,0.59892924
21215,13,23536,10,3,0,3,3,19,10,10,0,0,0,20,nowin,loss,beat,dlwin,0,10,13,206,0.417475728,0.063106796,0.621359223,2,0.59555479
21216,47,23537,7,11,0,0,0,18,10,10,0,0,0,20,nowin,loss,beat,dlwin,0,10,18,210,0.438095238,0.057142857,0.623809524,2,0.615868808
21217,34,23537,5,9,0,3,0,17,10,10,0,0,0,20,nowin,loss,beat,dlwin,0,10,14,202,0.5,0.079207921,0.618811881,3,0.968961434
21218,21,23537,11,7,0,0,0,18,10,10,0,0,0,20,nowin,loss,beat,dlwin,0,10,18,214,0.359813084,0.042056075,0.626168224,0,0.025263474
21219,99,23537,4,10,0,2,4,20,10,10,0,0,0,20,nowin,push,push,push,10,0,14,207,0.47826087,0.062801932,0.637681159,3,0.961418446
21220,139,23537,5,6,9,0,0,20,10,10,0,0,0,20,nowin,push,push,push,10,0,11,192,0.380208333,0.036458333,0.59375,0,0.023429169
21221,123,23537,5,6,10,0,0,21,10,10,0,0,0,20,nowin,win,plwin,beat,20,0,11,205,0.43902439,0.034146341,0.614634146,2,0.609962544
21222,29,23538,2,8,10,0,0,20,10,11,0,0,0,21,nowin,loss,beat,dlwin,0,10,10,189,0.44973545,0.058201058,0.544973545,1,0.300349439
21223,82,23538,7,7,0,10,0,24,10,11,0,0,0,21,nowin,loss,bust,plbust,0,10,14,225,0.408888889,0.075555556,0.577777778,0,0.028101874
21224,119,23538,10,9,0,0,0,19,10,11,0,0,0,21,nowin,loss,beat,dlwin,0,10,19,190,0.405263158,0.068421053,0.515789474,0,0.011837158
21225,32,23538,7,11,0,0,0,18,10,11,0,0,0,21,nowin,loss,beat,dlwin,0,10,18,189,0.391534392,0.037037037,0.53968254,0,0.013579086
21226,27,23538,11,7,0,0,0,18,10,11,0,0,0,21,nowin,loss,beat,dlwin,0,10,18,178,0.370786517,0.016853933,0.573033708,0,0.015536309
21227,60,23538,8,3,10,0,0,21,10,11,0,0,0,21,nowin,push,push,push,10,0,11,227,0.418502203,0.022026432,0.559471366,0,0.026496258
21228,6,23539,9,10,0,0,0,19,3,5,10,0,0,18,nowin,win,plwin,beat,20,0,19,191,0.439790576,0.047120419,0.581151832,1,0.31211505
21229,74,23539,10,9,0,0,0,19,3,5,10,0,0,18,nowin,win,plwin,beat,20,0,19,209,0.411483254,0.04784689,0.531100478,0,0.017448125
21230,77,23539,7,4,3,0,0,14,3,5,10,0,0,18,nowin,loss,beat,dlwin,0,10,11,200,0.455,0.04,0.62,3,0.916252116
21231,51,23539,5,5,6,0,0,16,3,5,10,0,0,18,nowin,loss,beat,dlwin,0,10,10,189,0.529100529,0.068783069,0.608465608,3,0.993665715
21232,72,23539,9,7,0,0,0,16,3,5,10,0,0,18,nowin,loss,beat,dlwin,0,10,16,185,0.394594595,0.032432432,0.508108108,0,0.006763115
21233,44,23539,10,10,0,0,0,20,3,5,10,0,0,18,nowin,win,plwin,beat,20,0,20,219,0.433789954,0.050228311,0.534246575,1,0.285551035
21234,140,23540,9,10,0,0,0,19,9,9,0,0,0,18,nowin,win,plwin,beat,20,0,19,210,0.466666667,0.023809524,0.604761905,3,0.915293335
21235,86,23540,2,6,11,0,0,19,9,9,0,0,0,18,nowin,win,plwin,beat,20,0,8,196,0.454081633,0.040816327,0.591836735,3,0.887566443
21236,63,23540,8,8,0,5,0,21,9,9,0,0,0,18,nowin,win,plwin,beat,20,0,16,216,0.467592593,0.037037037,0.62037037,3,0.931690496
21237,69,23540,10,2,0,10,0,22,9,9,0,0,0,18,nowin,loss,bust,plbust,0,10,12,194,0.365979381,0.030927835,0.515463918,0,0
21238,134,23540,3,10,0,5,0,18,9,9,0,0,0,18,nowin,push,push,push,10,0,13,185,0.443243243,0.021621622,0.545945946,1,0.296939509
21239,129,23540,10,10,0,0,0,20,9,9,0,0,0,18,nowin,win,plwin,beat,20,0,20,201,0.422885572,0.064676617,0.55721393,0,0.027255383
21240,136,23541,8,5,0,10,0,23,10,6,10,0,0,26,nowin,loss,bust,plbust,0,10,13,194,0.396907216,0.025773196,0.597938144,0,0.029452644
21241,72,23541,1,2,10,10,0,23,10,6,10,0,0,26,nowin,loss,bust,plbust,0,10,3,185,0.394594595,0.032432432,0.508108108,0,0.006763115
21242,27,23541,7,8,0,10,0,25,10,6,10,0,0,26,nowin,loss,bust,plbust,0,10,15,178,0.370786517,0.016853933,0.573033708,0,0.015536309
21243,104,23541,7,5,0,8,0,20,10,6,10,0,0,26,nowin,win,dlbust,bust,20,0,12,209,0.363636364,0.052631579,0.593301435,0,0.018359419
21244,9,23541,4,9,0,10,0,23,10,6,10,0,0,26,nowin,loss,bust,plbust,0,10,13,194,0.37628866,0.015463918,0.541237113,0,0.009396796
21245,122,23541,9,10,0,0,0,19,10,6,10,0,0,26,nowin,win,dlbust,bust,20,0,19,210,0.347619048,0.052380952,0.59047619,0,0.012873677
21246,92,23542,7,5,0,10,0,22,10,3,3,1,0,17,nowin,loss,bust,plbust,0,10,12,186,0.446236559,0.059139785,0.564516129,1,0.307826125
21247,67,23542,9,7,0,10,0,26,10,3,3,1,0,17,nowin,loss,bust,plbust,0,10,16,195,0.369230769,0.041025641,0.569230769,0,0.014139427
21248,149,23542,8,3,10,0,0,21,10,3,3,1,0,17,nowin,win,plwin,beat,20,0,11,225,0.457777778,0.057777778,0.648888889,2,0.651965595
21249,44,23542,7,10,0,0,0,17,10,3,3,1,0,17,nowin,push,push,push,10,0,17,219,0.433789954,0.050228311,0.534246575,1,0.285551035
21250,80,23542,10,8,0,0,0,18,10,3,3,1,0,17,nowin,win,plwin,beat,20,0,18,186,0.419354839,0.059139785,0.623655914,2,0.59892924
21251,143,23542,3,7,10,0,0,20,10,3,3,1,0,17,nowin,win,plwin,beat,20,0,10,203,0.463054187,0.044334975,0.57635468,3,0.883143365
21252,14,23543,8,8,0,0,0,16,3,10,8,0,0,21,nowin,loss,beat,dlwin,0,10,16,202,0.391089109,0.01980198,0.628712871,2,0.577264877
21253,2,23543,6,4,10,0,0,20,3,10,8,0,0,21,nowin,loss,beat,dlwin,0,10,10,200,0.445,0.035,0.64,2,0.633962549
21254,31,23543,10,2,0,10,0,22,3,10,8,0,0,21,nowin,loss,bust,plbust,0,10,12,188,0.473404255,0.058510638,0.515957447,1,0.300306557
21255,40,23543,10,10,0,0,0,20,3,10,8,0,0,21,nowin,loss,beat,dlwin,0,10,20,196,0.367346939,0.030612245,0.617346939,0,0.025358183
21256,46,23543,9,2,8,0,0,19,3,10,8,0,0,21,nowin,loss,beat,dlwin,0,10,11,186,0.403225806,0.048387097,0.591397849,0,0.029742194
21257,138,23543,10,10,0,0,0,20,3,10,8,0,0,21,nowin,loss,beat,dlwin,0,10,20,190,0.442105263,0.047368421,0.610526316,2,0.609711065
21258,149,23544,4,7,5,0,0,16,4,9,8,0,0,21,nowin,loss,beat,dlwin,0,10,11,225,0.457777778,0.057777778,0.648888889,2,0.651965595
21259,28,23544,10,7,0,0,0,17,4,9,8,0,0,21,nowin,loss,beat,dlwin,0,10,17,199,0.422110553,0.045226131,0.542713568,1,0.282706618
21260,42,23544,2,10,0,0,0,12,4,9,8,0,0,21,nowin,loss,beat,dlwin,0,10,12,212,0.443396226,0.051886792,0.570754717,1,0.309181312
21261,26,23544,6,10,0,0,0,16,4,9,8,0,0,21,nowin,loss,beat,dlwin,0,10,16,203,0.463054187,0.0591133,0.541871921,1,0.306802864
21262,110,23544,10,10,0,0,0,20,4,9,8,0,0,21,nowin,loss,beat,dlwin,0,10,20,192,0.416666667,0.046875,0.557291667,0,0.025413132
21263,4,23544,2,10,0,0,0,12,4,9,8,0,0,21,nowin,loss,beat,dlwin,0,10,12,217,0.460829493,0.036866359,0.562211982,1,0.315432839
21264,108,23545,1,1,10,7,0,19,10,11,0,0,0,21,nowin,loss,beat,dlwin,0,10,2,193,0.435233161,0.056994819,0.559585492,1,0.298824795
21265,2,23545,10,10,0,0,0,20,10,11,0,0,0,21,nowin,loss,beat,dlwin,0,10,20,200,0.445,0.035,0.64,2,0.633962549
21266,102,23545,7,10,0,0,0,17,10,11,0,0,0,21,nowin,loss,beat,dlwin,0,10,17,192,0.338541667,0.046875,0.5625,0,0.003306118
21267,107,23545,6,10,0,2,0,18,10,11,0,0,0,21,nowin,loss,beat,dlwin,0,10,16,218,0.444954128,0.073394495,0.600917431,2,0.605210014
21268,10,23545,10,6,0,7,0,23,10,11,0,0,0,21,nowin,loss,bust,plbust,0,10,16,191,0.413612565,0.057591623,0.596858639,2,0.574087175
21269,20,23545,6,10,0,5,0,21,10,11,0,0,0,21,nowin,push,push,push,10,0,16,186,0.456989247,0.037634409,0.537634409,1,0.301097108
21270,50,23546,4,11,3,0,0,18,6,3,10,0,0,19,nowin,loss,beat,dlwin,0,10,15,202,0.405940594,0.04950495,0.54950495,0,0.020296079
21271,89,23546,10,9,0,0,0,19,6,3,10,0,0,19,nowin,push,push,push,10,0,19,212,0.537735849,0.047169811,0.594339623,3,0.990167191
21272,133,23546,5,2,7,0,0,14,6,3,10,0,0,19,nowin,loss,beat,dlwin,0,10,7,201,0.47761194,0.064676617,0.611940299,3,0.935428111
21273,47,23546,7,5,0,0,0,12,6,3,10,0,0,19,nowin,loss,beat,dlwin,0,10,12,210,0.438095238,0.057142857,0.623809524,2,0.615868808
21274,16,23546,6,11,3,0,0,20,6,3,10,0,0,19,nowin,win,plwin,beat,20,0,17,220,0.427272727,0.081818182,0.6,2,0.588660176
21275,149,23546,10,10,0,0,0,20,6,3,10,0,0,19,nowin,win,plwin,beat,20,0,20,225,0.457777778,0.057777778,0.648888889,2,0.651965595
21276,145,23547,2,2,5,10,0,19,10,9,0,0,0,19,nowin,push,push,push,10,0,4,188,0.441489362,0.031914894,0.622340426,2,0.617837093
21277,11,23547,2,10,0,2,4,18,10,9,0,0,0,19,nowin,loss,beat,dlwin,0,10,12,236,0.457627119,0.016949153,0.588983051,3,0.889015813
21278,80,23547,5,10,0,7,0,22,10,9,0,0,0,19,nowin,loss,bust,plbust,0,10,15,186,0.419354839,0.059139785,0.623655914,2,0.59892924
21279,84,23547,10,10,0,0,0,20,10,9,0,0,0,19,nowin,win,plwin,beat,20,0,20,195,0.379487179,0.056410256,0.569230769,0,0.017209119
21280,40,23547,10,8,0,0,0,18,10,9,0,0,0,19,nowin,loss,beat,dlwin,0,10,18,196,0.367346939,0.030612245,0.617346939,0,0.025358183
21281,83,23547,7,10,0,0,0,17,10,9,0,0,0,19,nowin,loss,beat,dlwin,0,10,17,193,0.424870466,0.051813472,0.678756477,2,0.644360335
21282,7,23548,10,8,0,0,0,18,10,3,2,1,10,26,nowin,win,dlbust,bust,20,0,18,183,0.442622951,0.06010929,0.62295082,2,0.619303341
21283,129,23548,4,2,10,1,0,17,10,3,2,1,10,26,nowin,win,dlbust,bust,20,0,6,201,0.422885572,0.064676617,0.55721393,0,0.027255383
21284,111,23548,9,4,0,6,0,19,10,3,2,1,10,26,nowin,win,dlbust,bust,20,0,13,180,0.433333333,0.055555556,0.611111111,2,0.602264492
21285,120,23548,2,10,0,6,0,18,10,3,2,1,10,26,nowin,win,dlbust,bust,20,0,12,202,0.440594059,0.034653465,0.618811881,2,0.614441029
21286,60,23548,10,10,0,0,0,20,10,3,2,1,10,26,nowin,win,dlbust,bust,20,0,20,227,0.418502203,0.022026432,0.559471366,0,0.026496258
21287,49,23548,4,3,7,10,0,24,10,3,2,1,10,26,nowin,loss,bust,plbust,0,10,7,207,0.396135266,0.053140097,0.594202899,0,0.028306925
21288,84,23549,10,8,0,0,0,18,6,5,4,8,0,23,nowin,win,dlbust,bust,20,0,18,195,0.379487179,0.056410256,0.569230769,0,0.017209119
21289,107,23549,2,3,2,10,0,17,6,5,4,8,0,23,nowin,win,dlbust,bust,20,0,5,218,0.444954128,0.073394495,0.600917431,2,0.605210014
21290,42,23549,10,5,0,0,0,15,6,5,4,8,0,23,nowin,win,dlbust,bust,20,0,15,212,0.443396226,0.051886792,0.570754717,1,0.309181312
21291,39,23549,6,4,10,0,0,20,6,5,4,8,0,23,nowin,win,dlbust,bust,20,0,10,191,0.429319372,0.062827225,0.57591623,0,0.033760763
21292,80,23549,10,9,0,0,0,19,6,5,4,8,0,23,nowin,win,dlbust,bust,20,0,19,186,0.419354839,0.059139785,0.623655914,2,0.59892924
21293,121,23549,2,11,7,0,0,20,6,5,4,8,0,23,nowin,win,dlbust,bust,20,0,13,195,0.456410256,0.025641026,0.512820513,1,0.288597791
21294,74,23550,10,3,0,0,0,13,4,6,11,0,0,21,nowin,loss,beat,dlwin,0,10,13,209,0.411483254,0.04784689,0.531100478,0,0.017448125
21295,113,23550,5,8,0,0,0,13,4,6,11,0,0,21,nowin,loss,beat,dlwin,0,10,13,199,0.407035176,0.055276382,0.668341709,2,0.620695264
21296,147,23550,10,9,0,0,0,19,4,6,11,0,0,21,nowin,loss,beat,dlwin,0,10,19,205,0.380487805,0.014634146,0.536585366,0,0.00951447
21297,10,23550,10,10,0,0,0,20,4,6,11,0,0,21,nowin,loss,beat,dlwin,0,10,20,191,0.413612565,0.057591623,0.596858639,2,0.574087175
21298,24,23550,9,3,0,0,0,12,4,6,11,0,0,21,nowin,loss,beat,dlwin,0,10,12,207,0.458937198,0.048309179,0.570048309,1,0.318138014
21299,35,23550,6,4,2,0,0,12,4,6,11,0,0,21,nowin,loss,beat,dlwin,0,10,10,202,0.410891089,0.044554455,0.633663366,2,0.598681573
21300,61,23551,3,8,4,7,0,22,10,3,6,0,0,19,nowin,loss,bust,plbust,0,10,11,194,0.427835052,0.077319588,0.603092784,2,0.591437139
21301,114,23551,9,10,0,0,0,19,10,3,6,0,0,19,nowin,push,push,push,10,0,19,198,0.47979798,0.025252525,0.611111111,3,0.937232995
21302,65,23551,11,3,6,0,0,20,10,3,6,0,0,19,nowin,win,plwin,beat,20,0,14,203,0.492610837,0.054187192,0.571428571,3,0.913702814
21303,27,23551,8,10,0,0,0,18,10,3,6,0,0,19,nowin,loss,beat,dlwin,0,10,18,178,0.370786517,0.016853933,0.573033708,0,0.015536309
21304,95,23551,7,10,0,0,0,17,10,3,6,0,0,19,nowin,loss,beat,dlwin,0,10,17,218,0.412844037,0.04587156,0.559633028,0,0.024842385
21305,119,23551,10,10,0,0,0,20,10,3,6,0,0,19,nowin,win,plwin,beat,20,0,20,190,0.405263158,0.068421053,0.515789474,0,0.011837158
21306,47,23552,10,3,0,0,0,13,2,6,10,0,0,18,nowin,loss,beat,dlwin,0,10,13,210,0.438095238,0.057142857,0.623809524,2,0.615868808
21307,36,23552,5,10,0,0,0,15,2,6,10,0,0,18,nowin,loss,beat,dlwin,0,10,15,229,0.445414847,0.056768559,0.655021834,2,0.645370571
21308,94,23552,10,3,0,0,0,13,2,6,10,0,0,18,nowin,loss,beat,dlwin,0,10,13,183,0.43715847,0.043715847,0.540983607,1,0.290866892
21309,113,23552,10,4,0,0,0,14,2,6,10,0,0,18,nowin,loss,beat,dlwin,0,10,14,199,0.407035176,0.055276382,0.668341709,2,0.620695264
21310,131,23552,4,10,0,0,0,14,2,6,10,0,0,18,nowin,loss,beat,dlwin,0,10,14,217,0.410138249,0.069124424,0.543778802,0,0.02015021
21311,128,23552,2,11,1,0,0,14,2,6,10,0,0,18,nowin,loss,beat,dlwin,0,10,13,227,0.356828194,0.052863436,0.577092511,0,0.012352564
21312,44,23553,7,9,0,4,0,20,10,2,7,0,0,19,nowin,win,plwin,beat,20,0,16,219,0.433789954,0.050228311,0.534246575,1,0.285551035
21313,22,23553,7,7,0,3,0,17,10,2,7,0,0,19,nowin,loss,beat,dlwin,0,10,14,187,0.481283422,0.042780749,0.577540107,3,0.906128176
21314,100,23553,9,6,0,10,0,25,10,2,7,0,0,19,nowin,loss,bust,plbust,0,10,15,190,0.452631579,0.036842105,0.594736842,3,0.888671154
21315,32,23553,11,10,0,0,0,21,10,2,7,0,0,19,win,win,plwin,beat,25,0,21,189,0.391534392,0.037037037,0.53968254,0,0.013579086
21316,21,23553,5,10,0,3,0,18,10,2,7,0,0,19,nowin,loss,beat,dlwin,0,10,15,214,0.359813084,0.042056075,0.626168224,0,0.025263474
21317,58,23553,10,7,0,0,0,17,10,2,7,0,0,19,nowin,loss,beat,dlwin,0,10,17,195,0.430769231,0.041025641,0.584615385,2,0.580497586
21318,7,23554,3,7,7,0,0,17,10,3,10,0,0,23,nowin,win,dlbust,bust,20,0,10,183,0.442622951,0.06010929,0.62295082,2,0.619303341
21319,49,23554,11,9,0,0,0,20,10,3,10,0,0,23,nowin,win,dlbust,bust,20,0,20,207,0.396135266,0.053140097,0.594202899,0,0.028306925
21320,16,23554,2,2,4,8,10,26,10,3,10,0,0,23,nowin,loss,bust,plbust,0,10,4,220,0.427272727,0.081818182,0.6,2,0.588660176
21321,24,23554,10,10,0,0,0,20,10,3,10,0,0,23,nowin,win,dlbust,bust,20,0,20,207,0.458937198,0.048309179,0.570048309,1,0.318138014
21322,27,23554,7,8,0,3,0,18,10,3,10,0,0,23,nowin,win,dlbust,bust,20,0,15,178,0.370786517,0.016853933,0.573033708,0,0.015536309
21323,2,23554,2,10,0,10,0,22,10,3,10,0,0,23,nowin,loss,bust,plbust,0,10,12,200,0.445,0.035,0.64,2,0.633962549
21324,85,23555,6,1,9,0,0,16,3,2,7,1,9,22,nowin,win,dlbust,bust,20,0,7,195,0.41025641,0.066666667,0.594871795,0,0.03269711
21325,48,23555,5,7,0,10,0,22,3,2,7,1,9,22,nowin,loss,bust,plbust,0,10,12,203,0.413793103,0.019704433,0.600985222,2,0.577280801
21326,33,23555,7,10,0,0,0,17,3,2,7,1,9,22,nowin,win,dlbust,bust,20,0,17,192,0.4375,0.057291667,0.625,2,0.616208916
21327,2,23555,8,10,0,0,0,18,3,2,7,1,9,22,nowin,win,dlbust,bust,20,0,18,200,0.445,0.035,0.64,2,0.633962549
21328,3,23555,7,3,10,0,0,20,3,2,7,1,9,22,nowin,win,dlbust,bust,20,0,10,190,0.431578947,0.026315789,0.542105263,1,0.288076384
21329,36,23555,10,3,0,0,0,13,3,2,7,1,9,22,nowin,win,dlbust,bust,20,0,13,229,0.445414847,0.056768559,0.655021834,2,0.645370571
21330,14,23556,8,10,0,0,0,18,10,8,0,0,0,18,nowin,push,push,push,10,0,18,202,0.391089109,0.01980198,0.628712871,2,0.577264877
21331,29,23556,10,4,0,10,0,24,10,8,0,0,0,18,nowin,loss,bust,plbust,0,10,14,189,0.44973545,0.058201058,0.544973545,1,0.300349439
21332,146,23556,7,10,0,0,0,17,10,8,0,0,0,18,nowin,loss,beat,dlwin,0,10,17,221,0.43438914,0.040723982,0.542986425,1,0.290190091
21333,58,23556,4,10,0,6,0,20,10,8,0,0,0,18,nowin,win,plwin,beat,20,0,14,195,0.430769231,0.041025641,0.584615385,2,0.580497586
21334,51,23556,4,9,0,2,10,25,10,8,0,0,0,18,nowin,loss,bust,plbust,0,10,13,189,0.529100529,0.068783069,0.608465608,3,0.993665715
21335,65,23556,4,10,0,8,0,22,10,8,0,0,0,18,nowin,loss,bust,plbust,0,10,14,203,0.492610837,0.054187192,0.571428571,3,0.913702814
21336,56,23557,10,8,0,0,0,18,8,5,9,0,0,22,nowin,win,dlbust,bust,20,0,18,175,0.4,0.057142857,0.582857143,0,0.026685297
21337,26,23557,8,10,0,0,0,18,8,5,9,0,0,22,nowin,win,dlbust,bust,20,0,18,203,0.463054187,0.0591133,0.541871921,1,0.306802864
21338,133,23557,8,9,0,0,0,17,8,5,9,0,0,22,nowin,win,dlbust,bust,20,0,17,201,0.47761194,0.064676617,0.611940299,3,0.935428111
21339,82,23557,10,10,0,0,0,20,8,5,9,0,0,22,nowin,win,dlbust,bust,20,0,20,225,0.408888889,0.075555556,0.577777778,0,0.028101874
21340,75,23557,10,6,0,10,0,26,8,5,9,0,0,22,nowin,loss,bust,plbust,0,10,16,191,0.418848168,0.052356021,0.570680628,0,0.029344702
21341,131,23557,4,10,0,7,0,21,8,5,9,0,0,22,nowin,win,dlbust,bust,20,0,14,217,0.410138249,0.069124424,0.543778802,0,0.02015021
21342,30,23558,11,10,0,0,0,21,2,10,2,7,0,21,win,push,push,push,10,0,21,206,0.393203883,0.033980583,0.601941748,0,0.029324648
21343,49,23558,7,11,0,0,0,18,2,10,2,7,0,21,nowin,loss,beat,dlwin,0,10,18,207,0.396135266,0.053140097,0.594202899,0,0.028306925
21344,16,23558,10,2,0,2,0,14,2,10,2,7,0,21,nowin,loss,beat,dlwin,0,10,12,220,0.427272727,0.081818182,0.6,2,0.588660176
21345,23,23558,9,10,0,0,0,19,2,10,2,7,0,21,nowin,loss,beat,dlwin,0,10,19,208,0.427884615,0.0625,0.552884615,1,0.29114424
21346,127,23558,7,6,0,0,0,13,2,10,2,7,0,21,nowin,loss,beat,dlwin,0,10,13,201,0.402985075,0.029850746,0.60199005,0,0.032263937
21347,26,23558,7,6,0,0,0,13,2,10,2,7,0,21,nowin,loss,beat,dlwin,0,10,13,203,0.463054187,0.0591133,0.541871921,1,0.306802864
21348,96,23559,5,8,0,8,0,21,10,5,5,0,0,20,nowin,win,plwin,beat,20,0,13,190,0.468421053,0.057894737,0.584210526,3,0.897263354
21349,136,23559,2,5,10,0,0,17,10,5,5,0,0,20,nowin,loss,beat,dlwin,0,10,7,194,0.396907216,0.025773196,0.597938144,0,0.029452644
21350,66,23559,2,7,3,1,10,23,10,5,5,0,0,20,nowin,loss,bust,plbust,0,10,9,217,0.456221198,0.064516129,0.626728111,3,0.924304367
21351,80,23559,2,10,0,3,10,25,10,5,5,0,0,20,nowin,loss,bust,plbust,0,10,12,186,0.419354839,0.059139785,0.623655914,2,0.59892924
21352,121,23559,10,6,0,10,0,26,10,5,5,0,0,20,nowin,loss,bust,plbust,0,10,16,195,0.456410256,0.025641026,0.512820513,1,0.288597791
21353,126,23559,9,7,0,10,0,26,10,5,5,0,0,20,nowin,loss,bust,plbust,0,10,16,188,0.457446809,0.074468085,0.60106383,3,0.900633203
21354,53,23560,1,5,7,1,4,18,8,10,0,0,0,18,nowin,push,push,push,10,0,6,250,0.372,0.064,0.564,0,0.013687345
21355,68,23560,9,7,0,8,0,24,8,10,0,0,0,18,nowin,loss,bust,plbust,0,10,16,205,0.434146341,0.029268293,0.6,2,0.59483189
21356,24,23560,10,5,0,7,0,22,8,10,0,0,0,18,nowin,loss,bust,plbust,0,10,15,207,0.458937198,0.048309179,0.570048309,1,0.318138014
21357,79,23560,7,10,0,0,0,17,8,10,0,0,0,18,nowin,loss,beat,dlwin,0,10,17,211,0.436018957,0.028436019,0.672985782,2,0.650131054
21358,102,23560,9,6,0,10,0,25,8,10,0,0,0,18,nowin,loss,bust,plbust,0,10,15,192,0.338541667,0.046875,0.5625,0,0.003306118
21359,88,23560,1,2,10,9,0,22,8,10,0,0,0,18,nowin,loss,bust,plbust,0,10,3,206,0.466019417,0.033980583,0.54368932,1,0.309467903
21360,93,23561,7,7,0,10,0,24,7,3,10,0,0,20,nowin,loss,bust,plbust,0,10,14,175,0.485714286,0.051428571,0.548571429,1,0.323648091
21361,139,23561,10,10,0,0,0,20,7,3,10,0,0,20,nowin,push,push,push,10,0,20,192,0.380208333,0.036458333,0.59375,0,0.023429169
21362,42,23561,9,10,0,0,0,19,7,3,10,0,0,20,nowin,loss,beat,dlwin,0,10,19,212,0.443396226,0.051886792,0.570754717,1,0.309181312
21363,113,23561,6,9,0,10,0,25,7,3,10,0,0,20,nowin,loss,bust,plbust,0,10,15,199,0.407035176,0.055276382,0.668341709,2,0.620695264
21364,46,23561,10,3,0,10,0,23,7,3,10,0,0,20,nowin,loss,bust,plbust,0,10,13,186,0.403225806,0.048387097,0.591397849,0,0.029742194
21365,40,23561,5,10,0,8,0,23,7,3,10,0,0,20,nowin,loss,bust,plbust,0,10,15,196,0.367346939,0.030612245,0.617346939,0,0.025358183
21366,47,23562,3,9,0,10,0,22,2,3,10,9,0,24,nowin,loss,bust,plbust,0,10,12,210,0.438095238,0.057142857,0.623809524,2,0.615868808
21367,89,23562,10,2,0,3,0,15,2,3,10,9,0,24,nowin,win,dlbust,bust,20,0,12,212,0.537735849,0.047169811,0.594339623,3,0.990167191
21368,144,23562,10,10,0,0,0,20,2,3,10,9,0,24,nowin,win,dlbust,bust,20,0,20,202,0.386138614,0.054455446,0.564356436,0,0.018006244
21369,131,23562,7,2,3,9,0,21,2,3,10,9,0,24,nowin,win,dlbust,bust,20,0,9,217,0.410138249,0.069124424,0.543778802,0,0.02015021
21370,104,23562,10,10,0,0,0,20,2,3,10,9,0,24,nowin,win,dlbust,bust,20,0,20,209,0.363636364,0.052631579,0.593301435,0,0.018359419
21371,142,23562,11,3,1,0,0,15,2,3,10,9,0,24,nowin,win,dlbust,bust,20,0,14,211,0.417061611,0.047393365,0.526066351,1,0.271531309
21372,62,23563,9,8,0,0,0,17,10,8,0,0,0,18,nowin,loss,beat,dlwin,0,10,17,178,0.370786517,0.028089888,0.54494382,0,0.008657722
21373,88,23563,10,2,0,6,0,18,10,8,0,0,0,18,nowin,push,push,push,10,0,12,206,0.466019417,0.033980583,0.54368932,1,0.309467903
21374,26,23563,10,4,0,1,5,20,10,8,0,0,0,18,nowin,win,plwin,beat,20,0,14,203,0.463054187,0.0591133,0.541871921,1,0.306802864
21375,63,23563,3,6,10,0,0,19,10,8,0,0,0,18,nowin,win,plwin,beat,20,0,9,216,0.467592593,0.037037037,0.62037037,3,0.931690496
21376,89,23563,10,5,0,5,0,20,10,8,0,0,0,18,nowin,win,plwin,beat,20,0,15,212,0.537735849,0.047169811,0.594339623,3,0.990167191
21377,59,23563,2,5,6,10,0,23,10,8,0,0,0,18,nowin,loss,bust,plbust,0,10,7,228,0.429824561,0.048245614,0.543859649,1,0.287885446
21378,133,23564,2,6,7,0,0,15,2,10,4,10,0,26,nowin,win,dlbust,bust,20,0,8,201,0.47761194,0.064676617,0.611940299,3,0.935428111
21379,46,23564,4,10,0,0,0,14,2,10,4,10,0,26,nowin,win,dlbust,bust,20,0,14,186,0.403225806,0.048387097,0.591397849,0,0.029742194
21380,118,23564,2,10,0,8,0,20,2,10,4,10,0,26,nowin,win,dlbust,bust,20,0,12,216,0.393518519,0.037037037,0.555555556,0,0.018059873
21381,142,23564,10,4,0,0,0,14,2,10,4,10,0,26,nowin,win,dlbust,bust,20,0,14,211,0.417061611,0.047393365,0.526066351,1,0.271531309
21382,149,23564,8,5,0,0,0,13,2,10,4,10,0,26,nowin,win,dlbust,bust,20,0,13,225,0.457777778,0.057777778,0.648888889,2,0.651965595
21383,107,23564,7,5,0,9,0,21,2,10,4,10,0,26,nowin,win,dlbust,bust,20,0,12,218,0.444954128,0.073394495,0.600917431,2,0.605210014
21384,108,23565,10,5,0,4,0,19,7,5,10,0,0,22,nowin,win,dlbust,bust,20,0,15,193,0.435233161,0.056994819,0.559585492,1,0.298824795
21385,60,23565,10,10,0,0,0,20,7,5,10,0,0,22,nowin,win,dlbust,bust,20,0,20,227,0.418502203,0.022026432,0.559471366,0,0.026496258
21386,14,23565,6,11,1,0,0,18,7,5,10,0,0,22,nowin,win,dlbust,bust,20,0,17,202,0.391089109,0.01980198,0.628712871,2,0.577264877
21387,136,23565,6,4,6,8,0,24,7,5,10,0,0,22,nowin,loss,bust,plbust,0,10,10,194,0.396907216,0.025773196,0.597938144,0,0.029452644
21388,15,23565,11,10,0,0,0,21,7,5,10,0,0,22,win,win,dlbust,bust,25,0,21,212,0.410377358,0.051886792,0.561320755,0,0.024517408
21389,30,23565,10,10,0,0,0,20,7,5,10,0,0,22,nowin,win,dlbust,bust,20,0,20,206,0.393203883,0.033980583,0.601941748,0,0.029324648
21390,96,23566,7,4,2,1,10,24,10,10,0,0,0,20,nowin,loss,bust,plbust,0,10,11,190,0.468421053,0.057894737,0.584210526,3,0.897263354
21391,118,23566,8,9,0,0,0,17,10,10,0,0,0,20,nowin,loss,beat,dlwin,0,10,17,216,0.393518519,0.037037037,0.555555556,0,0.018059873
21392,64,23566,10,10,0,0,0,20,10,10,0,0,0,20,nowin,push,push,push,10,0,20,187,0.363636364,0.048128342,0.631016043,0,0.027594885
21393,130,23566,4,2,3,3,10,22,10,10,0,0,0,20,nowin,loss,bust,plbust,0,10,6,219,0.410958904,0.03652968,0.566210046,0,0.025888739
21394,103,23566,1,5,7,10,0,23,10,10,0,0,0,20,nowin,loss,bust,plbust,0,10,6,203,0.379310345,0.064039409,0.551724138,0,0.012869209
21395,78,23566,10,10,0,0,0,20,10,10,0,0,0,20,nowin,push,push,push,10,0,20,201,0.517412935,0.034825871,0.587064677,3,0.95871112
21396,26,23567,8,11,0,0,0,19,2,8,8,0,0,18,nowin,win,plwin,beat,20,0,19,203,0.463054187,0.0591133,0.541871921,1,0.306802864
21397,15,23567,6,10,0,0,0,16,2,8,8,0,0,18,nowin,loss,beat,dlwin,0,10,16,212,0.410377358,0.051886792,0.561320755,0,0.024517408
21398,146,23567,8,10,0,0,0,18,2,8,8,0,0,18,nowin,push,push,push,10,0,18,221,0.43438914,0.040723982,0.542986425,1,0.290190091
21399,25,23567,10,10,0,0,0,20,2,8,8,0,0,18,nowin,win,plwin,beat,20,0,20,190,0.463157895,0.063157895,0.536842105,1,0.304401563
21400,27,23567,2,3,2,10,0,17,2,8,8,0,0,18,nowin,loss,beat,dlwin,0,10,5,178,0.370786517,0.016853933,0.573033708,0,0.015536309
21401,45,23567,8,6,0,0,0,14,2,8,8,0,0,18,nowin,loss,beat,dlwin,0,10,14,196,0.428571429,0.051020408,0.612244898,2,0.598821767
21402,112,23568,10,8,0,0,0,18,2,5,7,5,0,19,nowin,loss,beat,dlwin,0,10,18,203,0.448275862,0.054187192,0.600985222,3,0.889576933
21403,70,23568,7,7,0,0,0,14,2,5,7,5,0,19,nowin,loss,beat,dlwin,0,10,14,228,0.385964912,0.039473684,0.557017544,0,0.016157125
21404,47,23568,9,2,8,0,0,19,2,5,7,5,0,19,nowin,push,push,push,10,0,11,210,0.438095238,0.057142857,0.623809524,2,0.615868808
21405,73,23568,10,10,0,0,0,20,2,5,7,5,0,19,nowin,win,plwin,beat,20,0,20,181,0.375690608,0.011049724,0.596685083,0,0.022795773
21406,145,23568,11,2,5,0,0,18,2,5,7,5,0,19,nowin,loss,beat,dlwin,0,10,13,188,0.441489362,0.031914894,0.622340426,2,0.617837093
21407,76,23568,10,10,0,0,0,20,2,5,7,5,0,19,nowin,win,plwin,beat,20,0,20,189,0.534391534,0.079365079,0.608465608,3,1
21408,96,23569,4,8,0,0,0,12,6,11,0,0,0,17,nowin,loss,beat,dlwin,0,10,12,190,0.468421053,0.057894737,0.584210526,3,0.897263354
21409,82,23569,10,3,0,0,0,13,6,11,0,0,0,17,nowin,loss,beat,dlwin,0,10,13,225,0.408888889,0.075555556,0.577777778,0,0.028101874
21410,67,23569,9,5,0,0,0,14,6,11,0,0,0,17,nowin,loss,beat,dlwin,0,10,14,195,0.369230769,0.041025641,0.569230769,0,0.014139427
21411,82,23569,3,3,10,0,0,16,6,11,0,0,0,17,nowin,loss,beat,dlwin,0,10,6,225,0.408888889,0.075555556,0.577777778,0,0.028101874
21412,126,23569,10,10,0,0,0,20,6,11,0,0,0,17,nowin,win,plwin,beat,20,0,20,188,0.457446809,0.074468085,0.60106383,3,0.900633203
21413,98,23569,3,2,10,0,0,15,6,11,0,0,0,17,nowin,loss,beat,dlwin,0,10,5,220,0.422727273,0.054545455,0.55,1,0.28664435
21414,114,23570,10,6,0,4,0,20,10,4,9,0,0,23,nowin,win,dlbust,bust,20,0,16,198,0.47979798,0.025252525,0.611111111,3,0.937232995
21415,93,23570,10,10,0,0,0,20,10,4,9,0,0,23,nowin,win,dlbust,bust,20,0,20,175,0.485714286,0.051428571,0.548571429,1,0.323648091
21416,6,23570,11,10,0,0,0,21,10,4,9,0,0,23,win,win,dlbust,bust,25,0,21,191,0.439790576,0.047120419,0.581151832,1,0.31211505
21417,127,23570,10,6,0,10,0,26,10,4,9,0,0,23,nowin,loss,bust,plbust,0,10,16,201,0.402985075,0.029850746,0.60199005,0,0.032263937
21418,11,23570,10,2,0,10,0,22,10,4,9,0,0,23,nowin,loss,bust,plbust,0,10,12,236,0.457627119,0.016949153,0.588983051,3,0.889015813
21419,7,23570,10,7,0,0,0,17,10,4,9,0,0,23,nowin,win,dlbust,bust,20,0,17,183,0.442622951,0.06010929,0.62295082,2,0.619303341
21420,31,23571,10,10,0,0,0,20,10,5,8,0,0,23,nowin,win,dlbust,bust,20,0,20,188,0.473404255,0.058510638,0.515957447,1,0.300306557
21421,72,23571,10,5,0,10,0,25,10,5,8,0,0,23,nowin,loss,bust,plbust,0,10,15,185,0.394594595,0.032432432,0.508108108,0,0.006763115
21422,24,23571,10,10,0,0,0,20,10,5,8,0,0,23,nowin,win,dlbust,bust,20,0,20,207,0.458937198,0.048309179,0.570048309,1,0.318138014
21423,118,23571,10,7,0,0,0,17,10,5,8,0,0,23,nowin,win,dlbust,bust,20,0,17,216,0.393518519,0.037037037,0.555555556,0,0.018059873
21424,70,23571,9,10,0,0,0,19,10,5,8,0,0,23,nowin,win,dlbust,bust,20,0,19,228,0.385964912,0.039473684,0.557017544,0,0.016157125
21425,107,23571,2,1,10,9,0,22,10,5,8,0,0,23,nowin,loss,bust,plbust,0,10,3,218,0.444954128,0.073394495,0.600917431,2,0.605210014
21426,20,23572,10,10,0,0,0,20,5,5,8,0,0,18,nowin,win,plwin,beat,20,0,20,186,0.456989247,0.037634409,0.537634409,1,0.301097108
21427,39,23572,8,10,0,0,0,18,5,5,8,0,0,18,nowin,push,push,push,10,0,18,191,0.429319372,0.062827225,0.57591623,0,0.033760763
21428,3,23572,10,6,0,0,0,16,5,5,8,0,0,18,nowin,loss,beat,dlwin,0,10,16,190,0.431578947,0.026315789,0.542105263,1,0.288076384
21429,45,23572,9,9,0,0,0,18,5,5,8,0,0,18,nowin,push,push,push,10,0,18,196,0.428571429,0.051020408,0.612244898,2,0.598821767
21430,72,23572,3,6,4,0,0,13,5,5,8,0,0,18,nowin,loss,beat,dlwin,0,10,9,185,0.394594595,0.032432432,0.508108108,0,0.006763115
21431,10,23572,5,8,0,0,0,13,5,5,8,0,0,18,nowin,loss,beat,dlwin,0,10,13,191,0.413612565,0.057591623,0.596858639,2,0.574087175
21432,3,23573,4,7,10,0,0,21,2,6,2,4,10,24,nowin,win,dlbust,bust,20,0,11,190,0.431578947,0.026315789,0.542105263,1,0.288076384
21433,8,23573,11,2,4,0,0,17,2,6,2,4,10,24,nowin,win,dlbust,bust,20,0,13,181,0.44198895,0.071823204,0.596685083,2,0.599438402
21434,53,23573,5,7,0,10,0,22,2,6,2,4,10,24,nowin,loss,bust,plbust,0,10,12,250,0.372,0.064,0.564,0,0.013687345
21435,115,23573,8,6,0,0,0,14,2,6,2,4,10,24,nowin,win,dlbust,bust,20,0,14,194,0.427835052,0.041237113,0.592783505,2,0.583863602
21436,117,23573,6,10,0,0,0,16,2,6,2,4,10,24,nowin,win,dlbust,bust,20,0,16,173,0.410404624,0.069364162,0.606936416,2,0.578610282
21437,141,23573,10,6,0,0,0,16,2,6,2,4,10,24,nowin,win,dlbust,bust,20,0,16,202,0.420792079,0.074257426,0.564356436,0,0.028377851
21438,75,23574,5,3,10,0,0,18,6,2,10,0,0,18,nowin,push,push,push,10,0,8,191,0.418848168,0.052356021,0.570680628,0,0.029344702
21439,113,23574,7,10,0,0,0,17,6,2,10,0,0,18,nowin,loss,beat,dlwin,0,10,17,199,0.407035176,0.055276382,0.668341709,2,0.620695264
21440,43,23574,7,6,0,0,0,13,6,2,10,0,0,18,nowin,loss,beat,dlwin,0,10,13,192,0.40625,0.041666667,0.609375,2,0.576671372
21441,52,23574,6,7,0,0,0,13,6,2,10,0,0,18,nowin,loss,beat,dlwin,0,10,13,217,0.414746544,0.02764977,0.599078341,2,0.576736024
21442,66,23574,7,9,0,0,0,16,6,2,10,0,0,18,nowin,loss,beat,dlwin,0,10,16,217,0.456221198,0.064516129,0.626728111,3,0.924304367
21443,72,23574,8,3,2,0,0,13,6,2,10,0,0,18,nowin,loss,beat,dlwin,0,10,11,185,0.394594595,0.032432432,0.508108108,0,0.006763115
21444,119,23575,10,2,0,0,0,12,5,5,7,0,0,17,nowin,loss,beat,dlwin,0,10,12,190,0.405263158,0.068421053,0.515789474,0,0.011837158
21445,145,23575,10,10,0,0,0,20,5,5,7,0,0,17,nowin,win,plwin,beat,20,0,20,188,0.441489362,0.031914894,0.622340426,2,0.617837093
21446,120,23575,11,6,1,0,0,18,5,5,7,0,0,17,nowin,win,plwin,beat,20,0,17,202,0.440594059,0.034653465,0.618811881,2,0.614441029
21447,6,23575,7,11,0,0,0,18,5,5,7,0,0,17,nowin,win,plwin,beat,20,0,18,191,0.439790576,0.047120419,0.581151832,1,0.31211505
21448,74,23575,3,6,10,0,0,19,5,5,7,0,0,17,nowin,win,plwin,beat,20,0,9,209,0.411483254,0.04784689,0.531100478,0,0.017448125
21449,31,23575,7,2,6,0,0,15,5,5,7,0,0,17,nowin,loss,beat,dlwin,0,10,9,188,0.473404255,0.058510638,0.515957447,1,0.300306557
21450,40,23576,10,10,0,0,0,20,10,4,10,0,0,24,nowin,win,dlbust,bust,20,0,20,196,0.367346939,0.030612245,0.617346939,0,0.025358183
21451,95,23576,10,11,0,0,0,21,10,4,10,0,0,24,win,win,dlbust,bust,25,0,21,218,0.412844037,0.04587156,0.559633028,0,0.024842385
21452,107,23576,3,10,0,10,0,23,10,4,10,0,0,24,nowin,loss,bust,plbust,0,10,13,218,0.444954128,0.073394495,0.600917431,2,0.605210014
21453,98,23576,6,7,0,9,0,22,10,4,10,0,0,24,nowin,loss,bust,plbust,0,10,13,220,0.422727273,0.054545455,0.55,1,0.28664435
21454,68,23576,10,4,0,3,0,17,10,4,10,0,0,24,nowin,win,dlbust,bust,20,0,14,205,0.434146341,0.029268293,0.6,2,0.59483189
21455,42,23576,10,5,0,1,9,25,10,4,10,0,0,24,nowin,loss,bust,plbust,0,10,15,212,0.443396226,0.051886792,0.570754717,1,0.309181312
21456,125,23577,11,8,0,0,0,19,4,10,10,0,0,24,nowin,win,dlbust,bust,20,0,19,219,0.438356164,0.050228311,0.575342466,1,0.308411257
21457,44,23577,6,10,0,0,0,16,4,10,10,0,0,24,nowin,win,dlbust,bust,20,0,16,219,0.433789954,0.050228311,0.534246575,1,0.285551035
21458,147,23577,4,11,2,0,0,17,4,10,10,0,0,24,nowin,win,dlbust,bust,20,0,15,205,0.380487805,0.014634146,0.536585366,0,0.00951447
21459,28,23577,9,10,0,0,0,19,4,10,10,0,0,24,nowin,win,dlbust,bust,20,0,19,199,0.422110553,0.045226131,0.542713568,1,0.282706618
21460,98,23577,6,10,0,0,0,16,4,10,10,0,0,24,nowin,win,dlbust,bust,20,0,16,220,0.422727273,0.054545455,0.55,1,0.28664435
21461,149,23577,10,10,0,0,0,20,4,10,10,0,0,24,nowin,win,dlbust,bust,20,0,20,225,0.457777778,0.057777778,0.648888889,2,0.651965595
21462,149,23578,8,2,10,0,0,20,5,4,10,0,0,19,nowin,win,plwin,beat,20,0,10,225,0.457777778,0.057777778,0.648888889,2,0.651965595
21463,146,23578,9,3,0,0,0,12,5,4,10,0,0,19,nowin,loss,beat,dlwin,0,10,12,221,0.43438914,0.040723982,0.542986425,1,0.290190091
21464,131,23578,7,6,0,0,0,13,5,4,10,0,0,19,nowin,loss,beat,dlwin,0,10,13,217,0.410138249,0.069124424,0.543778802,0,0.02015021
21465,124,23578,7,2,4,0,0,13,5,4,10,0,0,19,nowin,loss,beat,dlwin,0,10,9,202,0.47029703,0.064356436,0.584158416,3,0.899458193
21466,114,23578,7,5,0,0,0,12,5,4,10,0,0,19,nowin,loss,beat,dlwin,0,10,12,198,0.47979798,0.025252525,0.611111111,3,0.937232995
21467,21,23578,11,5,3,0,0,19,5,4,10,0,0,19,nowin,push,push,push,10,0,16,214,0.359813084,0.042056075,0.626168224,0,0.025263474
21468,79,23579,7,2,10,0,0,19,10,3,5,0,0,18,nowin,win,plwin,beat,20,0,9,211,0.436018957,0.028436019,0.672985782,2,0.650131054
21469,33,23579,10,10,0,0,0,20,10,3,5,0,0,18,nowin,win,plwin,beat,20,0,20,192,0.4375,0.057291667,0.625,2,0.616208916
21470,11,23579,4,10,0,1,5,20,10,3,5,0,0,18,nowin,win,plwin,beat,20,0,14,236,0.457627119,0.016949153,0.588983051,3,0.889015813
21471,15,23579,7,2,4,7,0,20,10,3,5,0,0,18,nowin,win,plwin,beat,20,0,9,212,0.410377358,0.051886792,0.561320755,0,0.024517408
21472,144,23579,10,2,0,2,3,17,10,3,5,0,0,18,nowin,loss,beat,dlwin,0,10,12,202,0.386138614,0.054455446,0.564356436,0,0.018006244
21473,144,23579,7,2,10,0,0,19,10,3,5,0,0,18,nowin,win,plwin,beat,20,0,9,202,0.386138614,0.054455446,0.564356436,0,0.018006244
21474,52,23580,5,5,10,0,0,20,10,10,0,0,0,20,nowin,push,push,push,10,0,10,217,0.414746544,0.02764977,0.599078341,2,0.576736024
21475,39,23580,4,9,0,9,0,22,10,10,0,0,0,20,nowin,loss,bust,plbust,0,10,13,191,0.429319372,0.062827225,0.57591623,0,0.033760763
21476,53,23580,5,7,0,3,3,18,10,10,0,0,0,20,nowin,loss,beat,dlwin,0,10,12,250,0.372,0.064,0.564,0,0.013687345
21477,145,23580,2,3,8,10,0,23,10,10,0,0,0,20,nowin,loss,bust,plbust,0,10,5,188,0.441489362,0.031914894,0.622340426,2,0.617837093
21478,31,23580,5,11,3,0,0,19,10,10,0,0,0,20,nowin,loss,beat,dlwin,0,10,16,188,0.473404255,0.058510638,0.515957447,1,0.300306557
21479,90,23580,6,10,0,1,0,17,10,10,0,0,0,20,nowin,loss,beat,dlwin,0,10,16,201,0.447761194,0.049751244,0.60199005,3,0.889945023
21480,36,23581,5,10,0,10,0,25,10,7,0,0,0,17,nowin,loss,bust,plbust,0,10,15,229,0.445414847,0.056768559,0.655021834,2,0.645370571
21481,59,23581,4,1,10,10,0,25,10,7,0,0,0,17,nowin,loss,bust,plbust,0,10,5,228,0.429824561,0.048245614,0.543859649,1,0.287885446
21482,15,23581,9,11,0,0,0,20,10,7,0,0,0,17,nowin,win,plwin,beat,20,0,20,212,0.410377358,0.051886792,0.561320755,0,0.024517408
21483,18,23581,8,10,0,0,0,18,10,7,0,0,0,17,nowin,win,plwin,beat,20,0,18,182,0.461538462,0.043956044,0.587912088,3,0.892649374
21484,45,23581,2,7,10,0,0,19,10,7,0,0,0,17,nowin,win,plwin,beat,20,0,9,196,0.428571429,0.051020408,0.612244898,2,0.598821767
21485,19,23581,9,11,0,0,0,20,10,7,0,0,0,17,nowin,win,plwin,beat,20,0,20,237,0.41350211,0.054852321,0.628691983,2,0.597373826
21486,148,23582,10,4,0,0,0,14,4,2,3,6,6,21,nowin,loss,beat,dlwin,0,10,14,204,0.401960784,0.078431373,0.593137255,0,0.029789521
21487,21,23582,8,10,0,0,0,18,4,2,3,6,6,21,nowin,loss,beat,dlwin,0,10,18,214,0.359813084,0.042056075,0.626168224,0,0.025263474
21488,16,23582,10,4,0,0,0,14,4,2,3,6,6,21,nowin,loss,beat,dlwin,0,10,14,220,0.427272727,0.081818182,0.6,2,0.588660176
21489,121,23582,10,3,0,0,0,13,4,2,3,6,6,21,nowin,loss,beat,dlwin,0,10,13,195,0.456410256,0.025641026,0.512820513,1,0.288597791
21490,100,23582,10,2,0,0,0,12,4,2,3,6,6,21,nowin,loss,beat,dlwin,0,10,12,190,0.452631579,0.036842105,0.594736842,3,0.888671154
21491,112,23582,8,7,0,0,0,15,4,2,3,6,6,21,nowin,loss,beat,dlwin,0,10,15,203,0.448275862,0.054187192,0.600985222,3,0.889576933
21492,40,23583,3,4,9,9,0,25,10,2,3,6,0,21,nowin,loss,bust,plbust,0,10,7,196,0.367346939,0.030612245,0.617346939,0,0.025358183
21493,25,23583,3,9,0,7,0,19,10,2,3,6,0,21,nowin,loss,beat,dlwin,0,10,12,190,0.463157895,0.063157895,0.536842105,1,0.304401563
21494,53,23583,9,9,0,0,0,18,10,2,3,6,0,21,nowin,loss,beat,dlwin,0,10,18,250,0.372,0.064,0.564,0,0.013687345
21495,139,23583,10,10,0,0,0,20,10,2,3,6,0,21,nowin,loss,beat,dlwin,0,10,20,192,0.380208333,0.036458333,0.59375,0,0.023429169
21496,28,23583,8,10,0,0,0,18,10,2,3,6,0,21,nowin,loss,beat,dlwin,0,10,18,199,0.422110553,0.045226131,0.542713568,1,0.282706618
21497,123,23583,7,10,0,0,0,17,10,2,3,6,0,21,nowin,loss,beat,dlwin,0,10,17,205,0.43902439,0.034146341,0.614634146,2,0.609962544
21498,12,23584,5,2,2,3,6,18,2,10,9,0,0,21,nowin,loss,beat,dlwin,0,10,7,189,0.470899471,0.015873016,0.613756614,3,0.929171178
21499,110,23584,10,3,0,0,0,13,2,10,9,0,0,21,nowin,loss,beat,dlwin,0,10,13,192,0.416666667,0.046875,0.557291667,0,0.025413132
21500,56,23584,2,10,0,10,0,22,2,10,9,0,0,21,nowin,loss,bust,plbust,0,10,12,175,0.4,0.057142857,0.582857143,0,0.026685297
21501,91,23584,5,10,0,0,0,15,2,10,9,0,0,21,nowin,loss,beat,dlwin,0,10,15,194,0.417525773,0.046391753,0.515463918,1,0.266616552
21502,103,23584,10,4,0,0,0,14,2,10,9,0,0,21,nowin,loss,beat,dlwin,0,10,14,203,0.379310345,0.064039409,0.551724138,0,0.012869209
21503,95,23584,6,1,8,0,0,15,2,10,9,0,0,21,nowin,loss,beat,dlwin,0,10,7,218,0.412844037,0.04587156,0.559633028,0,0.024842385
21504,4,23585,11,8,0,0,0,19,11,7,0,0,0,18,nowin,win,plwin,beat,20,0,19,217,0.460829493,0.036866359,0.562211982,1,0.315432839
21505,107,23585,10,7,0,0,0,17,11,7,0,0,0,18,nowin,loss,beat,dlwin,0,10,17,218,0.444954128,0.073394495,0.600917431,2,0.605210014
21506,134,23585,9,3,0,2,10,24,11,7,0,0,0,18,nowin,loss,bust,plbust,0,10,12,185,0.443243243,0.021621622,0.545945946,1,0.296939509
21507,3,23585,5,10,0,4,0,19,11,7,0,0,0,18,nowin,win,plwin,beat,20,0,15,190,0.431578947,0.026315789,0.542105263,1,0.288076384
21508,107,23585,3,2,9,1,2,17,11,7,0,0,0,18,nowin,loss,beat,dlwin,0,10,5,218,0.444954128,0.073394495,0.600917431,2,0.605210014
21509,11,23585,10,10,0,0,0,20,11,7,0,0,0,18,nowin,win,plwin,beat,20,0,20,236,0.457627119,0.016949153,0.588983051,3,0.889015813
21510,89,23586,2,10,0,10,0,22,11,10,0,0,0,21,nowin,loss,bust,plbust,0,10,12,212,0.537735849,0.047169811,0.594339623,3,0.990167191
21511,75,23586,10,4,0,4,0,18,11,10,0,0,0,21,nowin,loss,beat,dlwin,0,10,14,191,0.418848168,0.052356021,0.570680628,0,0.029344702
21512,122,23586,10,6,0,1,0,17,11,10,0,0,0,21,nowin,loss,beat,dlwin,0,10,16,210,0.347619048,0.052380952,0.59047619,0,0.012873677
21513,57,23586,8,2,10,0,0,20,11,10,0,0,0,21,nowin,loss,beat,dlwin,0,10,10,192,0.46875,0.052083333,0.59375,3,0.907001181
21514,93,23586,2,8,8,0,0,18,11,10,0,0,0,21,nowin,loss,beat,dlwin,0,10,10,175,0.485714286,0.051428571,0.548571429,1,0.323648091
21515,17,23586,10,10,0,0,0,20,11,10,0,0,0,21,nowin,loss,beat,dlwin,0,10,20,171,0.444444444,0.070175439,0.555555556,1,0.302364894
21516,56,23587,8,7,0,8,0,23,10,2,10,0,0,22,nowin,loss,bust,plbust,0,10,15,175,0.4,0.057142857,0.582857143,0,0.026685297
21517,33,23587,3,5,10,0,0,18,10,2,10,0,0,22,nowin,win,dlbust,bust,20,0,8,192,0.4375,0.057291667,0.625,2,0.616208916
21518,45,23587,1,5,10,5,0,21,10,2,10,0,0,22,nowin,win,dlbust,bust,20,0,6,196,0.428571429,0.051020408,0.612244898,2,0.598821767
21519,8,23587,7,10,0,0,0,17,10,2,10,0,0,22,nowin,win,dlbust,bust,20,0,17,181,0.44198895,0.071823204,0.596685083,2,0.599438402
21520,99,23587,10,5,0,10,0,25,10,2,10,0,0,22,nowin,loss,bust,plbust,0,10,15,207,0.47826087,0.062801932,0.637681159,3,0.961418446
21521,136,23587,6,1,9,4,0,20,10,2,10,0,0,22,nowin,win,dlbust,bust,20,0,7,194,0.396907216,0.025773196,0.597938144,0,0.029452644
21522,99,23588,10,2,0,10,0,22,7,11,0,0,0,18,nowin,loss,bust,plbust,0,10,12,207,0.47826087,0.062801932,0.637681159,3,0.961418446
21523,141,23588,1,3,10,8,0,22,7,11,0,0,0,18,nowin,loss,bust,plbust,0,10,4,202,0.420792079,0.074257426,0.564356436,0,0.028377851
21524,128,23588,10,9,0,0,0,19,7,11,0,0,0,18,nowin,win,plwin,beat,20,0,19,227,0.356828194,0.052863436,0.577092511,0,0.012352564
21525,90,23588,10,6,0,1,0,17,7,11,0,0,0,18,nowin,loss,beat,dlwin,0,10,16,201,0.447761194,0.049751244,0.60199005,3,0.889945023
21526,135,23588,7,9,0,4,0,20,7,11,0,0,0,18,nowin,win,plwin,beat,20,0,16,179,0.391061453,0.067039106,0.586592179,0,0.024924662
21527,33,23588,1,5,8,10,0,24,7,11,0,0,0,18,nowin,loss,bust,plbust,0,10,6,192,0.4375,0.057291667,0.625,2,0.616208916
21528,11,23589,3,9,0,6,0,18,3,8,1,2,6,20,nowin,loss,beat,dlwin,0,10,12,236,0.457627119,0.016949153,0.588983051,3,0.889015813
21529,100,23589,2,10,0,2,0,14,3,8,1,2,6,20,nowin,loss,beat,dlwin,0,10,12,190,0.452631579,0.036842105,0.594736842,3,0.888671154
21530,60,23589,7,5,0,3,0,15,3,8,1,2,6,20,nowin,loss,beat,dlwin,0,10,12,227,0.418502203,0.022026432,0.559471366,0,0.026496258
21531,53,23589,10,2,0,1,0,13,3,8,1,2,6,20,nowin,loss,beat,dlwin,0,10,12,250,0.372,0.064,0.564,0,0.013687345
21532,22,23589,2,10,0,8,0,20,3,8,1,2,6,20,nowin,push,push,push,10,0,12,187,0.481283422,0.042780749,0.577540107,3,0.906128176
21533,52,23589,5,3,6,0,0,14,3,8,1,2,6,20,nowin,loss,beat,dlwin,0,10,8,217,0.414746544,0.02764977,0.599078341,2,0.576736024
21534,138,23590,3,8,3,7,0,21,7,7,10,0,0,24,nowin,win,dlbust,bust,20,0,11,190,0.442105263,0.047368421,0.610526316,2,0.609711065
21535,37,23590,6,1,9,2,0,18,7,7,10,0,0,24,nowin,win,dlbust,bust,20,0,7,208,0.394230769,0.038461538,0.581730769,0,0.024682772
21536,112,23590,1,3,10,9,0,23,7,7,10,0,0,24,nowin,loss,bust,plbust,0,10,4,203,0.448275862,0.054187192,0.600985222,3,0.889576933
21537,56,23590,3,10,0,5,0,18,7,7,10,0,0,24,nowin,win,dlbust,bust,20,0,13,175,0.4,0.057142857,0.582857143,0,0.026685297
21538,125,23590,3,10,0,8,0,21,7,7,10,0,0,24,nowin,win,dlbust,bust,20,0,13,219,0.438356164,0.050228311,0.575342466,1,0.308411257
21539,51,23590,4,4,10,0,0,18,7,7,10,0,0,24,nowin,win,dlbust,bust,20,0,8,189,0.529100529,0.068783069,0.608465608,3,0.993665715
21540,79,23591,2,6,8,0,0,16,5,11,5,0,0,21,nowin,loss,beat,dlwin,0,10,8,211,0.436018957,0.028436019,0.672985782,2,0.650131054
21541,21,23591,8,11,0,0,0,19,5,11,5,0,0,21,nowin,loss,beat,dlwin,0,10,19,214,0.359813084,0.042056075,0.626168224,0,0.025263474
21542,50,23591,10,10,0,0,0,20,5,11,5,0,0,21,nowin,loss,beat,dlwin,0,10,20,202,0.405940594,0.04950495,0.54950495,0,0.020296079
21543,32,23591,3,7,8,0,0,18,5,11,5,0,0,21,nowin,loss,beat,dlwin,0,10,10,189,0.391534392,0.037037037,0.53968254,0,0.013579086
21544,80,23591,10,11,0,0,0,21,5,11,5,0,0,21,win,push,push,push,10,0,21,186,0.419354839,0.059139785,0.623655914,2,0.59892924
21545,134,23591,10,2,0,0,0,12,5,11,5,0,0,21,nowin,loss,beat,dlwin,0,10,12,185,0.443243243,0.021621622,0.545945946,1,0.296939509
21546,20,23592,10,10,0,0,0,20,7,10,0,0,0,17,nowin,win,plwin,beat,20,0,20,186,0.456989247,0.037634409,0.537634409,1,0.301097108
21547,33,23592,3,7,2,3,1,16,7,10,0,0,0,17,nowin,loss,beat,dlwin,0,10,10,192,0.4375,0.057291667,0.625,2,0.616208916
21548,6,23592,10,10,0,0,0,20,7,10,0,0,0,17,nowin,win,plwin,beat,20,0,20,191,0.439790576,0.047120419,0.581151832,1,0.31211505
21549,1,23592,4,4,6,10,0,24,7,10,0,0,0,17,nowin,loss,bust,plbust,0,10,8,197,0.406091371,0.025380711,0.649746193,2,0.606186955
21550,64,23592,2,1,10,3,4,20,7,10,0,0,0,17,nowin,win,plwin,beat,20,0,3,187,0.363636364,0.048128342,0.631016043,0,0.027594885
21551,99,23592,7,4,10,0,0,21,7,10,0,0,0,17,nowin,win,plwin,beat,20,0,11,207,0.47826087,0.062801932,0.637681159,3,0.961418446
21552,36,23593,5,11,5,0,0,21,6,10,10,0,0,26,nowin,win,dlbust,bust,20,0,16,229,0.445414847,0.056768559,0.655021834,2,0.645370571
21553,98,23593,9,2,8,0,0,19,6,10,10,0,0,26,nowin,win,dlbust,bust,20,0,11,220,0.422727273,0.054545455,0.55,1,0.28664435
21554,29,23593,10,4,0,0,0,14,6,10,10,0,0,26,nowin,win,dlbust,bust,20,0,14,189,0.44973545,0.058201058,0.544973545,1,0.300349439
21555,138,23593,9,5,0,0,0,14,6,10,10,0,0,26,nowin,win,dlbust,bust,20,0,14,190,0.442105263,0.047368421,0.610526316,2,0.609711065
21556,96,23593,11,3,5,0,0,19,6,10,10,0,0,26,nowin,win,dlbust,bust,20,0,14,190,0.468421053,0.057894737,0.584210526,3,0.897263354
21557,132,23593,10,10,0,0,0,20,6,10,10,0,0,26,nowin,win,dlbust,bust,20,0,20,194,0.412371134,0.036082474,0.649484536,2,0.611633238
21558,59,23594,4,6,10,0,0,20,10,2,10,0,0,22,nowin,win,dlbust,bust,20,0,10,228,0.429824561,0.048245614,0.543859649,1,0.287885446
21559,113,23594,2,10,0,2,10,24,10,2,10,0,0,22,nowin,loss,bust,plbust,0,10,12,199,0.407035176,0.055276382,0.668341709,2,0.620695264
21560,40,23594,3,10,0,9,0,22,10,2,10,0,0,22,nowin,loss,bust,plbust,0,10,13,196,0.367346939,0.030612245,0.617346939,0,0.025358183
21561,149,23594,6,2,10,0,0,18,10,2,10,0,0,22,nowin,win,dlbust,bust,20,0,8,225,0.457777778,0.057777778,0.648888889,2,0.651965595
21562,32,23594,9,10,0,0,0,19,10,2,10,0,0,22,nowin,win,dlbust,bust,20,0,19,189,0.391534392,0.037037037,0.53968254,0,0.013579086
21563,56,23594,8,7,0,10,0,25,10,2,10,0,0,22,nowin,loss,bust,plbust,0,10,15,175,0.4,0.057142857,0.582857143,0,0.026685297
21564,27,23595,4,8,0,8,0,20,11,10,0,0,0,21,nowin,loss,beat,dlwin,0,10,12,178,0.370786517,0.016853933,0.573033708,0,0.015536309
21565,72,23595,6,10,0,10,0,26,11,10,0,0,0,21,nowin,loss,bust,plbust,0,10,16,185,0.394594595,0.032432432,0.508108108,0,0.006763115
21566,106,23595,5,11,3,0,0,19,11,10,0,0,0,21,nowin,loss,beat,dlwin,0,10,16,192,0.411458333,0.026041667,0.557291667,0,0.023854304
21567,87,23595,3,10,0,10,0,23,11,10,0,0,0,21,nowin,loss,bust,plbust,0,10,13,202,0.405940594,0.054455446,0.628712871,2,0.590599801
21568,64,23595,10,10,0,0,0,20,11,10,0,0,0,21,nowin,loss,beat,dlwin,0,10,20,187,0.363636364,0.048128342,0.631016043,0,0.027594885
21569,103,23595,6,10,0,1,0,17,11,10,0,0,0,21,nowin,loss,beat,dlwin,0,10,16,203,0.379310345,0.064039409,0.551724138,0,0.012869209
21570,38,23596,7,5,0,2,1,15,9,10,0,0,0,19,nowin,loss,beat,dlwin,0,10,12,202,0.361386139,0.03960396,0.564356436,0,0.010597953
21571,69,23596,11,7,0,0,0,18,9,10,0,0,0,19,nowin,loss,beat,dlwin,0,10,18,194,0.365979381,0.030927835,0.515463918,0,0
21572,51,23596,10,5,0,1,2,18,9,10,0,0,0,19,nowin,loss,beat,dlwin,0,10,15,189,0.529100529,0.068783069,0.608465608,3,0.993665715
21573,68,23596,5,10,0,4,0,19,9,10,0,0,0,19,nowin,push,push,push,10,0,15,205,0.434146341,0.029268293,0.6,2,0.59483189
21574,15,23596,3,10,0,10,0,23,9,10,0,0,0,19,nowin,loss,bust,plbust,0,10,13,212,0.410377358,0.051886792,0.561320755,0,0.024517408
21575,63,23596,6,10,0,10,0,26,9,10,0,0,0,19,nowin,loss,bust,plbust,0,10,16,216,0.467592593,0.037037037,0.62037037,3,0.931690496
21576,61,23597,10,6,0,4,0,20,10,2,5,0,0,17,nowin,win,plwin,beat,20,0,16,194,0.427835052,0.077319588,0.603092784,2,0.591437139
21577,88,23597,9,6,0,4,0,19,10,2,5,0,0,17,nowin,win,plwin,beat,20,0,15,206,0.466019417,0.033980583,0.54368932,1,0.309467903
21578,51,23597,6,1,6,10,0,23,10,2,5,0,0,17,nowin,loss,bust,plbust,0,10,7,189,0.529100529,0.068783069,0.608465608,3,0.993665715
21579,127,23597,7,8,0,7,0,22,10,2,5,0,0,17,nowin,loss,bust,plbust,0,10,15,201,0.402985075,0.029850746,0.60199005,0,0.032263937
21580,143,23597,2,8,10,0,0,20,10,2,5,0,0,17,nowin,win,plwin,beat,20,0,10,203,0.463054187,0.044334975,0.57635468,3,0.883143365
21581,55,23597,6,10,0,6,0,22,10,2,5,0,0,17,nowin,loss,bust,plbust,0,10,16,191,0.371727749,0.057591623,0.54973822,0,0.01011347
21582,115,23598,7,7,0,4,0,18,7,8,5,0,0,20,nowin,loss,beat,dlwin,0,10,14,194,0.427835052,0.041237113,0.592783505,2,0.583863602
21583,50,23598,4,6,8,0,0,18,7,8,5,0,0,20,nowin,loss,beat,dlwin,0,10,10,202,0.405940594,0.04950495,0.54950495,0,0.020296079
21584,138,23598,7,7,0,10,0,24,7,8,5,0,0,20,nowin,loss,bust,plbust,0,10,14,190,0.442105263,0.047368421,0.610526316,2,0.609711065
21585,1,23598,6,3,9,0,0,18,7,8,5,0,0,20,nowin,loss,beat,dlwin,0,10,9,197,0.406091371,0.025380711,0.649746193,2,0.606186955
21586,9,23598,9,4,0,6,0,19,7,8,5,0,0,20,nowin,loss,beat,dlwin,0,10,13,194,0.37628866,0.015463918,0.541237113,0,0.009396796
21587,61,23598,8,5,0,10,0,23,7,8,5,0,0,20,nowin,loss,bust,plbust,0,10,13,194,0.427835052,0.077319588,0.603092784,2,0.591437139
21588,149,23599,1,2,10,6,0,19,10,7,0,0,0,17,nowin,win,plwin,beat,20,0,3,225,0.457777778,0.057777778,0.648888889,2,0.651965595
21589,127,23599,7,11,0,0,0,18,10,7,0,0,0,17,nowin,win,plwin,beat,20,0,18,201,0.402985075,0.029850746,0.60199005,0,0.032263937
21590,11,23599,1,5,7,2,8,23,10,7,0,0,0,17,nowin,loss,bust,plbust,0,10,6,236,0.457627119,0.016949153,0.588983051,3,0.889015813
21591,88,23599,4,10,0,6,0,20,10,7,0,0,0,17,nowin,win,plwin,beat,20,0,14,206,0.466019417,0.033980583,0.54368932,1,0.309467903
21592,102,23599,10,11,0,0,0,21,10,7,0,0,0,17,win,win,plwin,beat,25,0,21,192,0.338541667,0.046875,0.5625,0,0.003306118
21593,137,23599,9,5,0,10,0,24,10,7,0,0,0,17,nowin,loss,bust,plbust,0,10,14,194,0.417525773,0.046391753,0.536082474,1,0.276714602
21594,80,23600,3,5,7,10,0,25,10,8,0,0,0,18,nowin,loss,bust,plbust,0,10,8,186,0.419354839,0.059139785,0.623655914,2,0.59892924
21595,72,23600,8,11,0,0,0,19,10,8,0,0,0,18,nowin,win,plwin,beat,20,0,19,185,0.394594595,0.032432432,0.508108108,0,0.006763115
21596,34,23600,10,2,0,9,0,21,10,8,0,0,0,18,nowin,win,plwin,beat,20,0,12,202,0.5,0.079207921,0.618811881,3,0.968961434
21597,16,23600,10,6,0,10,0,26,10,8,0,0,0,18,nowin,loss,bust,plbust,0,10,16,220,0.427272727,0.081818182,0.6,2,0.588660176
21598,33,23600,10,10,0,0,0,20,10,8,0,0,0,18,nowin,win,plwin,beat,20,0,20,192,0.4375,0.057291667,0.625,2,0.616208916
21599,53,23600,10,9,0,0,0,19,10,8,0,0,0,18,nowin,win,plwin,beat,20,0,19,250,0.372,0.064,0.564,0,0.013687345
21600,136,23601,6,10,0,8,0,24,11,7,0,0,0,18,nowin,loss,bust,plbust,0,10,16,194,0.396907216,0.025773196,0.597938144,0,0.029452644
21601,34,23601,9,10,0,0,0,19,11,7,0,0,0,18,nowin,win,plwin,beat,20,0,19,202,0.5,0.079207921,0.618811881,3,0.968961434
21602,112,23601,4,10,0,2,2,18,11,7,0,0,0,18,nowin,push,push,push,10,0,14,203,0.448275862,0.054187192,0.600985222,3,0.889576933
21603,84,23601,11,10,0,0,0,21,11,7,0,0,0,18,win,win,plwin,beat,25,0,21,195,0.379487179,0.056410256,0.569230769,0,0.017209119
21604,26,23601,8,5,0,8,0,21,11,7,0,0,0,18,nowin,win,plwin,beat,20,0,13,203,0.463054187,0.0591133,0.541871921,1,0.306802864
21605,11,23601,5,2,7,9,0,23,11,7,0,0,0,18,nowin,loss,bust,plbust,0,10,7,236,0.457627119,0.016949153,0.588983051,3,0.889015813
21606,5,23602,10,4,0,2,1,17,10,10,0,0,0,20,nowin,loss,beat,dlwin,0,10,14,203,0.42364532,0.02955665,0.596059113,2,0.582508076
21607,77,23602,8,9,0,0,0,17,10,10,0,0,0,20,nowin,loss,beat,dlwin,0,10,17,200,0.455,0.04,0.62,3,0.916252116
21608,128,23602,3,1,8,2,5,19,10,10,0,0,0,20,nowin,loss,beat,dlwin,0,10,4,227,0.356828194,0.052863436,0.577092511,0,0.012352564
21609,122,23602,4,4,3,10,0,21,10,10,0,0,0,20,nowin,win,plwin,beat,20,0,8,210,0.347619048,0.052380952,0.59047619,0,0.012873677
21610,26,23602,7,8,0,5,0,20,10,10,0,0,0,20,nowin,push,push,push,10,0,15,203,0.463054187,0.0591133,0.541871921,1,0.306802864
21611,72,23602,1,4,7,8,0,20,10,10,0,0,0,20,nowin,push,push,push,10,0,5,185,0.394594595,0.032432432,0.508108108,0,0.006763115
21612,62,23603,9,4,0,9,0,22,10,10,0,0,0,20,nowin,loss,bust,plbust,0,10,13,178,0.370786517,0.028089888,0.54494382,0,0.008657722
21613,135,23603,10,9,0,0,0,19,10,10,0,0,0,20,nowin,loss,beat,dlwin,0,10,19,179,0.391061453,0.067039106,0.586592179,0,0.024924662
21614,89,23603,10,4,0,7,0,21,10,10,0,0,0,20,nowin,win,plwin,beat,20,0,14,212,0.537735849,0.047169811,0.594339623,3,0.990167191
21615,93,23603,7,9,0,8,0,24,10,10,0,0,0,20,nowin,loss,bust,plbust,0,10,16,175,0.485714286,0.051428571,0.548571429,1,0.323648091
21616,15,23603,10,9,0,0,0,19,10,10,0,0,0,20,nowin,loss,beat,dlwin,0,10,19,212,0.410377358,0.051886792,0.561320755,0,0.024517408
21617,71,23603,10,9,0,0,0,19,10,10,0,0,0,20,nowin,loss,beat,dlwin,0,10,19,193,0.352331606,0.046632124,0.585492228,0,0.013063661
21618,54,23604,10,6,0,10,0,26,7,2,3,10,0,22,nowin,loss,bust,plbust,0,10,16,185,0.437837838,0.032432432,0.556756757,1,0.29899854
21619,25,23604,2,2,7,10,0,21,7,2,3,10,0,22,nowin,win,dlbust,bust,20,0,4,190,0.463157895,0.063157895,0.536842105,1,0.304401563
21620,72,23604,6,6,0,2,6,20,7,2,3,10,0,22,nowin,win,dlbust,bust,20,0,12,185,0.394594595,0.032432432,0.508108108,0,0.006763115
21621,149,23604,2,1,10,4,0,17,7,2,3,10,0,22,nowin,win,dlbust,bust,20,0,3,225,0.457777778,0.057777778,0.648888889,2,0.651965595
21622,143,23604,9,10,0,0,0,19,7,2,3,10,0,22,nowin,win,dlbust,bust,20,0,19,203,0.463054187,0.044334975,0.57635468,3,0.883143365
21623,116,23604,10,10,0,0,0,20,7,2,3,10,0,22,nowin,win,dlbust,bust,20,0,20,195,0.425641026,0.056410256,0.538461538,1,0.28273747
21624,109,23605,3,11,1,10,0,25,9,8,0,0,0,17,nowin,loss,bust,plbust,0,10,14,221,0.461538462,0.058823529,0.597285068,3,0.901830309
21625,114,23605,8,5,0,10,0,23,9,8,0,0,0,17,nowin,loss,bust,plbust,0,10,13,198,0.47979798,0.025252525,0.611111111,3,0.937232995
21626,65,23605,11,10,0,0,0,21,9,8,0,0,0,17,win,win,plwin,beat,25,0,21,203,0.492610837,0.054187192,0.571428571,3,0.913702814
21627,150,23605,5,5,10,0,0,20,9,8,0,0,0,17,nowin,win,plwin,beat,20,0,10,192,0.401041667,0.036458333,0.567708333,0,0.023287458
21628,143,23605,2,3,4,1,3,13,9,8,0,0,0,17,nowin,loss,beat,dlwin,0,10,5,203,0.463054187,0.044334975,0.57635468,3,0.883143365
21629,79,23605,10,10,0,0,0,20,9,8,0,0,0,17,nowin,win,plwin,beat,20,0,20,211,0.436018957,0.028436019,0.672985782,2,0.650131054
21630,124,23606,10,4,0,0,0,14,2,7,10,0,0,19,nowin,loss,beat,dlwin,0,10,14,202,0.47029703,0.064356436,0.584158416,3,0.899458193
21631,10,23606,10,8,0,0,0,18,2,7,10,0,0,19,nowin,loss,beat,dlwin,0,10,18,191,0.413612565,0.057591623,0.596858639,2,0.574087175
21632,150,23606,6,3,10,0,0,19,2,7,10,0,0,19,nowin,push,push,push,10,0,9,192,0.401041667,0.036458333,0.567708333,0,0.023287458
21633,16,23606,5,8,0,0,0,13,2,7,10,0,0,19,nowin,loss,beat,dlwin,0,10,13,220,0.427272727,0.081818182,0.6,2,0.588660176
21634,145,23606,6,7,0,0,0,13,2,7,10,0,0,19,nowin,loss,beat,dlwin,0,10,13,188,0.441489362,0.031914894,0.622340426,2,0.617837093
21635,89,23606,7,2,4,0,0,13,2,7,10,0,0,19,nowin,loss,beat,dlwin,0,10,9,212,0.537735849,0.047169811,0.594339623,3,0.990167191
21636,30,23607,5,2,8,0,0,15,5,1,9,10,0,25,nowin,win,dlbust,bust,20,0,7,206,0.393203883,0.033980583,0.601941748,0,0.029324648
21637,94,23607,9,10,0,0,0,19,5,1,9,10,0,25,nowin,win,dlbust,bust,20,0,19,183,0.43715847,0.043715847,0.540983607,1,0.290866892
21638,87,23607,11,8,0,0,0,19,5,1,9,10,0,25,nowin,win,dlbust,bust,20,0,19,202,0.405940594,0.054455446,0.628712871,2,0.590599801
21639,59,23607,3,6,5,0,0,14,5,1,9,10,0,25,nowin,win,dlbust,bust,20,0,9,228,0.429824561,0.048245614,0.543859649,1,0.287885446
21640,40,23607,5,10,0,0,0,15,5,1,9,10,0,25,nowin,win,dlbust,bust,20,0,15,196,0.367346939,0.030612245,0.617346939,0,0.025358183
21641,88,23607,9,7,0,0,0,16,5,1,9,10,0,25,nowin,win,dlbust,bust,20,0,16,206,0.466019417,0.033980583,0.54368932,1,0.309467903
21642,44,23608,11,9,0,0,0,20,10,9,0,0,0,19,nowin,win,plwin,beat,20,0,20,219,0.433789954,0.050228311,0.534246575,1,0.285551035
21643,123,23608,4,4,9,0,0,17,10,9,0,0,0,19,nowin,loss,beat,dlwin,0,10,8,205,0.43902439,0.034146341,0.614634146,2,0.609962544
21644,7,23608,7,10,0,0,0,17,10,9,0,0,0,19,nowin,loss,beat,dlwin,0,10,17,183,0.442622951,0.06010929,0.62295082,2,0.619303341
21645,149,23608,4,10,0,10,0,24,10,9,0,0,0,19,nowin,loss,bust,plbust,0,10,14,225,0.457777778,0.057777778,0.648888889,2,0.651965595
21646,47,23608,7,10,0,0,0,17,10,9,0,0,0,19,nowin,loss,beat,dlwin,0,10,17,210,0.438095238,0.057142857,0.623809524,2,0.615868808
21647,5,23608,10,11,0,0,0,21,10,9,0,0,0,19,win,win,plwin,beat,25,0,21,203,0.42364532,0.02955665,0.596059113,2,0.582508076
21648,36,23609,10,10,0,0,0,20,10,10,0,0,0,20,nowin,push,push,push,10,0,20,229,0.445414847,0.056768559,0.655021834,2,0.645370571
21649,150,23609,4,5,3,10,0,22,10,10,0,0,0,20,nowin,loss,bust,plbust,0,10,9,192,0.401041667,0.036458333,0.567708333,0,0.023287458
21650,64,23609,10,11,0,0,0,21,10,10,0,0,0,20,win,win,plwin,beat,25,0,21,187,0.363636364,0.048128342,0.631016043,0,0.027594885
21651,19,23609,4,10,0,6,0,20,10,10,0,0,0,20,nowin,push,push,push,10,0,14,237,0.41350211,0.054852321,0.628691983,2,0.597373826
21652,106,23609,10,11,0,0,0,21,10,10,0,0,0,20,win,win,plwin,beat,25,0,21,192,0.411458333,0.026041667,0.557291667,0,0.023854304
21653,73,23609,11,7,0,0,0,18,10,10,0,0,0,20,nowin,loss,beat,dlwin,0,10,18,181,0.375690608,0.011049724,0.596685083,0,0.022795773
21654,140,23610,1,2,10,0,0,13,3,4,3,4,2,16,nowin,loss,beat,dlwin,0,10,3,210,0.466666667,0.023809524,0.604761905,3,0.915293335
21655,2,23610,3,10,0,0,0,13,3,4,3,4,2,16,nowin,loss,beat,dlwin,0,10,13,200,0.445,0.035,0.64,2,0.633962549
21656,18,23610,7,10,0,0,0,17,3,4,3,4,2,16,nowin,win,plwin,beat,20,0,17,182,0.461538462,0.043956044,0.587912088,3,0.892649374
21657,149,23610,10,7,0,0,0,17,3,4,3,4,2,16,nowin,win,plwin,beat,20,0,17,225,0.457777778,0.057777778,0.648888889,2,0.651965595
21658,32,23610,10,2,0,8,0,20,3,4,3,4,2,16,nowin,win,plwin,beat,20,0,12,189,0.391534392,0.037037037,0.53968254,0,0.013579086
21659,81,23610,10,10,0,0,0,20,3,4,3,4,2,16,nowin,win,plwin,beat,20,0,20,182,0.395604396,0.043956044,0.60989011,2,0.567491261
21660,82,23611,10,10,0,0,0,20,3,1,10,10,0,24,nowin,win,dlbust,bust,20,0,20,225,0.408888889,0.075555556,0.577777778,0,0.028101874
21661,49,23611,9,9,0,0,0,18,3,1,10,10,0,24,nowin,win,dlbust,bust,20,0,18,207,0.396135266,0.053140097,0.594202899,0,0.028306925
21662,93,23611,2,11,8,0,0,21,3,1,10,10,0,24,nowin,win,dlbust,bust,20,0,13,175,0.485714286,0.051428571,0.548571429,1,0.323648091
21663,53,23611,9,10,0,0,0,19,3,1,10,10,0,24,nowin,win,dlbust,bust,20,0,19,250,0.372,0.064,0.564,0,0.013687345
21664,94,23611,10,11,0,0,0,21,3,1,10,10,0,24,win,win,dlbust,bust,25,0,21,183,0.43715847,0.043715847,0.540983607,1,0.290866892
21665,59,23611,10,6,0,0,0,16,3,1,10,10,0,24,nowin,win,dlbust,bust,20,0,16,228,0.429824561,0.048245614,0.543859649,1,0.287885446
21666,88,23612,8,7,0,10,0,25,10,6,8,0,0,24,nowin,loss,bust,plbust,0,10,15,206,0.466019417,0.033980583,0.54368932,1,0.309467903
21667,117,23612,11,10,0,0,0,21,10,6,8,0,0,24,win,win,dlbust,bust,25,0,21,173,0.410404624,0.069364162,0.606936416,2,0.578610282
21668,150,23612,7,7,0,7,0,21,10,6,8,0,0,24,nowin,win,dlbust,bust,20,0,14,192,0.401041667,0.036458333,0.567708333,0,0.023287458
21669,118,23612,9,10,0,0,0,19,10,6,8,0,0,24,nowin,win,dlbust,bust,20,0,19,216,0.393518519,0.037037037,0.555555556,0,0.018059873
21670,132,23612,3,10,0,10,0,23,10,6,8,0,0,24,nowin,loss,bust,plbust,0,10,13,194,0.412371134,0.036082474,0.649484536,2,0.611633238
21671,136,23612,10,3,0,6,0,19,10,6,8,0,0,24,nowin,win,dlbust,bust,20,0,13,194,0.396907216,0.025773196,0.597938144,0,0.029452644
21672,50,23613,2,5,7,10,0,24,11,9,0,0,0,20,nowin,loss,bust,plbust,0,10,7,202,0.405940594,0.04950495,0.54950495,0,0.020296079
21673,16,23613,7,10,0,0,0,17,11,9,0,0,0,20,nowin,loss,beat,dlwin,0,10,17,220,0.427272727,0.081818182,0.6,2,0.588660176
21674,51,23613,6,10,0,5,0,21,11,9,0,0,0,20,nowin,win,plwin,beat,20,0,16,189,0.529100529,0.068783069,0.608465608,3,0.993665715
21675,33,23613,4,4,7,10,0,25,11,9,0,0,0,20,nowin,loss,bust,plbust,0,10,8,192,0.4375,0.057291667,0.625,2,0.616208916
21676,144,23613,2,1,10,3,4,20,11,9,0,0,0,20,nowin,push,push,push,10,0,3,202,0.386138614,0.054455446,0.564356436,0,0.018006244
21677,4,23613,3,2,11,7,0,23,11,9,0,0,0,20,nowin,loss,bust,plbust,0,10,5,217,0.460829493,0.036866359,0.562211982,1,0.315432839
21678,55,23614,3,10,0,0,0,13,5,5,7,0,0,17,nowin,loss,beat,dlwin,0,10,13,191,0.371727749,0.057591623,0.54973822,0,0.01011347
21679,150,23614,7,10,0,0,0,17,5,5,7,0,0,17,nowin,push,push,push,10,0,17,192,0.401041667,0.036458333,0.567708333,0,0.023287458
21680,79,23614,3,11,4,0,0,18,5,5,7,0,0,17,nowin,win,plwin,beat,20,0,14,211,0.436018957,0.028436019,0.672985782,2,0.650131054
21681,137,23614,7,10,0,0,0,17,5,5,7,0,0,17,nowin,push,push,push,10,0,17,194,0.417525773,0.046391753,0.536082474,1,0.276714602
21682,29,23614,2,11,7,0,0,20,5,5,7,0,0,17,nowin,win,plwin,beat,20,0,13,189,0.44973545,0.058201058,0.544973545,1,0.300349439
21683,78,23614,2,3,8,0,0,13,5,5,7,0,0,17,nowin,loss,beat,dlwin,0,10,5,201,0.517412935,0.034825871,0.587064677,3,0.95871112
21684,56,23615,9,8,0,0,0,17,11,7,0,0,0,18,nowin,loss,beat,dlwin,0,10,17,175,0.4,0.057142857,0.582857143,0,0.026685297
21685,21,23615,10,6,0,2,0,18,11,7,0,0,0,18,nowin,push,push,push,10,0,16,214,0.359813084,0.042056075,0.626168224,0,0.025263474
21686,131,23615,10,5,0,10,0,25,11,7,0,0,0,18,nowin,loss,bust,plbust,0,10,15,217,0.410138249,0.069124424,0.543778802,0,0.02015021
21687,46,23615,10,8,0,0,0,18,11,7,0,0,0,18,nowin,push,push,push,10,0,18,186,0.403225806,0.048387097,0.591397849,0,0.029742194
21688,2,23615,7,8,0,10,0,25,11,7,0,0,0,18,nowin,loss,bust,plbust,0,10,15,200,0.445,0.035,0.64,2,0.633962549
21689,45,23615,5,9,0,7,0,21,11,7,0,0,0,18,nowin,win,plwin,beat,20,0,14,196,0.428571429,0.051020408,0.612244898,2,0.598821767
21690,30,23616,10,3,0,7,0,20,9,10,0,0,0,19,nowin,win,plwin,beat,20,0,13,206,0.393203883,0.033980583,0.601941748,0,0.029324648
21691,29,23616,4,9,0,1,9,23,9,10,0,0,0,19,nowin,loss,bust,plbust,0,10,13,189,0.44973545,0.058201058,0.544973545,1,0.300349439
21692,53,23616,10,10,0,0,0,20,9,10,0,0,0,19,nowin,win,plwin,beat,20,0,20,250,0.372,0.064,0.564,0,0.013687345
21693,100,23616,10,10,0,0,0,20,9,10,0,0,0,19,nowin,win,plwin,beat,20,0,20,190,0.452631579,0.036842105,0.594736842,3,0.888671154
21694,3,23616,11,9,0,0,0,20,9,10,0,0,0,19,nowin,win,plwin,beat,20,0,20,190,0.431578947,0.026315789,0.542105263,1,0.288076384
21695,17,23616,8,6,0,4,0,18,9,10,0,0,0,19,nowin,loss,beat,dlwin,0,10,14,171,0.444444444,0.070175439,0.555555556,1,0.302364894
21696,11,23617,2,3,7,6,0,18,7,4,4,10,0,25,nowin,win,dlbust,bust,20,0,5,236,0.457627119,0.016949153,0.588983051,3,0.889015813
21697,99,23617,6,3,4,8,0,21,7,4,4,10,0,25,nowin,win,dlbust,bust,20,0,9,207,0.47826087,0.062801932,0.637681159,3,0.961418446
21698,29,23617,7,10,0,0,0,17,7,4,4,10,0,25,nowin,win,dlbust,bust,20,0,17,189,0.44973545,0.058201058,0.544973545,1,0.300349439
21699,26,23617,10,2,0,8,0,20,7,4,4,10,0,25,nowin,win,dlbust,bust,20,0,12,203,0.463054187,0.0591133,0.541871921,1,0.306802864
21700,15,23617,7,10,0,0,0,17,7,4,4,10,0,25,nowin,win,dlbust,bust,20,0,17,212,0.410377358,0.051886792,0.561320755,0,0.024517408
21701,45,23617,10,7,0,0,0,17,7,4,4,10,0,25,nowin,win,dlbust,bust,20,0,17,196,0.428571429,0.051020408,0.612244898,2,0.598821767
21702,104,23618,10,2,0,3,10,25,10,5,5,0,0,20,nowin,loss,bust,plbust,0,10,12,209,0.363636364,0.052631579,0.593301435,0,0.018359419
21703,144,23618,5,10,0,7,0,22,10,5,5,0,0,20,nowin,loss,bust,plbust,0,10,15,202,0.386138614,0.054455446,0.564356436,0,0.018006244
21704,93,23618,2,1,9,7,0,19,10,5,5,0,0,20,nowin,loss,beat,dlwin,0,10,3,175,0.485714286,0.051428571,0.548571429,1,0.323648091
21705,18,23618,10,10,0,0,0,20,10,5,5,0,0,20,nowin,push,push,push,10,0,20,182,0.461538462,0.043956044,0.587912088,3,0.892649374
21706,62,23618,5,10,0,2,0,17,10,5,5,0,0,20,nowin,loss,beat,dlwin,0,10,15,178,0.370786517,0.028089888,0.54494382,0,0.008657722
21707,51,23618,4,7,10,0,0,21,10,5,5,0,0,20,nowin,win,plwin,beat,20,0,11,189,0.529100529,0.068783069,0.608465608,3,0.993665715
21708,137,23619,10,6,0,0,0,16,2,2,10,10,0,24,nowin,win,dlbust,bust,20,0,16,194,0.417525773,0.046391753,0.536082474,1,0.276714602
21709,97,23619,6,2,4,9,0,21,2,2,10,10,0,24,nowin,win,dlbust,bust,20,0,8,182,0.450549451,0.06043956,0.692307692,2,0.677372279
21710,89,23619,3,10,0,0,0,13,2,2,10,10,0,24,nowin,win,dlbust,bust,20,0,13,212,0.537735849,0.047169811,0.594339623,3,0.990167191
21711,1,23619,10,6,0,0,0,16,2,2,10,10,0,24,nowin,win,dlbust,bust,20,0,16,197,0.406091371,0.025380711,0.649746193,2,0.606186955
21712,88,23619,10,6,0,0,0,16,2,2,10,10,0,24,nowin,win,dlbust,bust,20,0,16,206,0.466019417,0.033980583,0.54368932,1,0.309467903
21713,72,23619,1,4,10,0,0,15,2,2,10,10,0,24,nowin,win,dlbust,bust,20,0,5,185,0.394594595,0.032432432,0.508108108,0,0.006763115
21714,80,23620,5,10,0,7,0,22,8,10,0,0,0,18,nowin,loss,bust,plbust,0,10,15,186,0.419354839,0.059139785,0.623655914,2,0.59892924
21715,99,23620,8,6,0,9,0,23,8,10,0,0,0,18,nowin,loss,bust,plbust,0,10,14,207,0.47826087,0.062801932,0.637681159,3,0.961418446
21716,40,23620,1,6,10,0,0,17,8,10,0,0,0,18,nowin,loss,beat,dlwin,0,10,7,196,0.367346939,0.030612245,0.617346939,0,0.025358183
21717,14,23620,6,3,5,8,0,22,8,10,0,0,0,18,nowin,loss,bust,plbust,0,10,9,202,0.391089109,0.01980198,0.628712871,2,0.577264877
21718,143,23620,5,10,0,7,0,22,8,10,0,0,0,18,nowin,loss,bust,plbust,0,10,15,203,0.463054187,0.044334975,0.57635468,3,0.883143365
21719,22,23620,6,9,0,6,0,21,8,10,0,0,0,18,nowin,win,plwin,beat,20,0,15,187,0.481283422,0.042780749,0.577540107,3,0.906128176
21720,12,23621,3,10,0,0,0,13,3,8,10,0,0,21,nowin,loss,beat,dlwin,0,10,13,189,0.470899471,0.015873016,0.613756614,3,0.929171178
21721,124,23621,5,5,8,0,0,18,3,8,10,0,0,21,nowin,loss,beat,dlwin,0,10,10,202,0.47029703,0.064356436,0.584158416,3,0.899458193
21722,2,23621,10,10,0,0,0,20,3,8,10,0,0,21,nowin,loss,beat,dlwin,0,10,20,200,0.445,0.035,0.64,2,0.633962549
21723,7,23621,2,8,5,0,0,15,3,8,10,0,0,21,nowin,loss,beat,dlwin,0,10,10,183,0.442622951,0.06010929,0.62295082,2,0.619303341
21724,30,23621,6,10,0,0,0,16,3,8,10,0,0,21,nowin,loss,beat,dlwin,0,10,16,206,0.393203883,0.033980583,0.601941748,0,0.029324648
21725,98,23621,3,3,9,0,0,15,3,8,10,0,0,21,nowin,loss,beat,dlwin,0,10,6,220,0.422727273,0.054545455,0.55,1,0.28664435
21726,47,23622,6,3,6,0,0,15,4,2,11,0,0,17,nowin,loss,beat,dlwin,0,10,9,210,0.438095238,0.057142857,0.623809524,2,0.615868808
21727,6,23622,7,10,0,0,0,17,4,2,11,0,0,17,nowin,push,push,push,10,0,17,191,0.439790576,0.047120419,0.581151832,1,0.31211505
21728,55,23622,2,6,4,0,0,12,4,2,11,0,0,17,nowin,loss,beat,dlwin,0,10,8,191,0.371727749,0.057591623,0.54973822,0,0.01011347
21729,45,23622,11,7,0,0,0,18,4,2,11,0,0,17,nowin,win,plwin,beat,20,0,18,196,0.428571429,0.051020408,0.612244898,2,0.598821767
21730,119,23622,4,10,0,0,0,14,4,2,11,0,0,17,nowin,loss,beat,dlwin,0,10,14,190,0.405263158,0.068421053,0.515789474,0,0.011837158
21731,84,23622,8,8,0,0,0,16,4,2,11,0,0,17,nowin,loss,beat,dlwin,0,10,16,195,0.379487179,0.056410256,0.569230769,0,0.017209119
21732,95,23623,8,10,0,0,0,18,6,11,0,0,0,17,nowin,win,plwin,beat,20,0,18,218,0.412844037,0.04587156,0.559633028,0,0.024842385
21733,88,23623,3,5,4,0,0,12,6,11,0,0,0,17,nowin,loss,beat,dlwin,0,10,8,206,0.466019417,0.033980583,0.54368932,1,0.309467903
21734,31,23623,10,10,0,0,0,20,6,11,0,0,0,17,nowin,win,plwin,beat,20,0,20,188,0.473404255,0.058510638,0.515957447,1,0.300306557
21735,31,23623,10,2,0,0,0,12,6,11,0,0,0,17,nowin,loss,beat,dlwin,0,10,12,188,0.473404255,0.058510638,0.515957447,1,0.300306557
21736,3,23623,7,7,0,0,0,14,6,11,0,0,0,17,nowin,loss,beat,dlwin,0,10,14,190,0.431578947,0.026315789,0.542105263,1,0.288076384
21737,16,23623,7,6,0,0,0,13,6,11,0,0,0,17,nowin,loss,beat,dlwin,0,10,13,220,0.427272727,0.081818182,0.6,2,0.588660176
21738,89,23624,5,5,10,0,0,20,7,6,2,1,2,18,nowin,win,plwin,beat,20,0,10,212,0.537735849,0.047169811,0.594339623,3,0.990167191
21739,53,23624,10,10,0,0,0,20,7,6,2,1,2,18,nowin,win,plwin,beat,20,0,20,250,0.372,0.064,0.564,0,0.013687345
21740,50,23624,4,10,0,3,0,17,7,6,2,1,2,18,nowin,loss,beat,dlwin,0,10,14,202,0.405940594,0.04950495,0.54950495,0,0.020296079
21741,36,23624,1,6,8,9,0,24,7,6,2,1,2,18,nowin,loss,bust,plbust,0,10,7,229,0.445414847,0.056768559,0.655021834,2,0.645370571
21742,24,23624,2,10,0,10,0,22,7,6,2,1,2,18,nowin,loss,bust,plbust,0,10,12,207,0.458937198,0.048309179,0.570048309,1,0.318138014
21743,75,23624,3,10,0,1,6,20,7,6,2,1,2,18,nowin,win,plwin,beat,20,0,13,191,0.418848168,0.052356021,0.570680628,0,0.029344702
21744,99,23625,4,4,6,0,0,14,6,6,10,0,0,22,nowin,win,dlbust,bust,20,0,8,207,0.47826087,0.062801932,0.637681159,3,0.961418446
21745,134,23625,7,10,0,0,0,17,6,6,10,0,0,22,nowin,win,dlbust,bust,20,0,17,185,0.443243243,0.021621622,0.545945946,1,0.296939509
21746,3,23625,7,10,0,0,0,17,6,6,10,0,0,22,nowin,win,dlbust,bust,20,0,17,190,0.431578947,0.026315789,0.542105263,1,0.288076384
21747,69,23625,5,9,0,0,0,14,6,6,10,0,0,22,nowin,win,dlbust,bust,20,0,14,194,0.365979381,0.030927835,0.515463918,0,0
21748,25,23625,10,6,0,0,0,16,6,6,10,0,0,22,nowin,win,dlbust,bust,20,0,16,190,0.463157895,0.063157895,0.536842105,1,0.304401563
21749,53,23625,3,10,0,0,0,13,6,6,10,0,0,22,nowin,win,dlbust,bust,20,0,13,250,0.372,0.064,0.564,0,0.013687345
21750,74,23626,7,10,0,0,0,17,8,2,4,10,0,24,nowin,win,dlbust,bust,20,0,17,209,0.411483254,0.04784689,0.531100478,0,0.017448125
21751,42,23626,11,8,0,0,0,19,8,2,4,10,0,24,nowin,win,dlbust,bust,20,0,19,212,0.443396226,0.051886792,0.570754717,1,0.309181312
21752,3,23626,2,10,0,10,0,22,8,2,4,10,0,24,nowin,loss,bust,plbust,0,10,12,190,0.431578947,0.026315789,0.542105263,1,0.288076384
21753,35,23626,7,3,10,0,0,20,8,2,4,10,0,24,nowin,win,dlbust,bust,20,0,10,202,0.410891089,0.044554455,0.633663366,2,0.598681573
21754,66,23626,7,3,10,0,0,20,8,2,4,10,0,24,nowin,win,dlbust,bust,20,0,10,217,0.456221198,0.064516129,0.626728111,3,0.924304367
21755,85,23626,10,10,0,0,0,20,8,2,4,10,0,24,nowin,win,dlbust,bust,20,0,20,195,0.41025641,0.066666667,0.594871795,0,0.03269711
21756,24,23627,3,1,10,10,0,24,10,8,0,0,0,18,nowin,loss,bust,plbust,0,10,4,207,0.458937198,0.048309179,0.570048309,1,0.318138014
21757,30,23627,5,4,10,0,0,19,10,8,0,0,0,18,nowin,win,plwin,beat,20,0,9,206,0.393203883,0.033980583,0.601941748,0,0.029324648
21758,70,23627,6,7,0,10,0,23,10,8,0,0,0,18,nowin,loss,bust,plbust,0,10,13,228,0.385964912,0.039473684,0.557017544,0,0.016157125
21759,123,23627,5,2,8,2,0,17,10,8,0,0,0,18,nowin,loss,beat,dlwin,0,10,7,205,0.43902439,0.034146341,0.614634146,2,0.609962544
21760,59,23627,4,10,0,4,0,18,10,8,0,0,0,18,nowin,push,push,push,10,0,14,228,0.429824561,0.048245614,0.543859649,1,0.287885446
21761,108,23627,7,6,0,5,0,18,10,8,0,0,0,18,nowin,push,push,push,10,0,13,193,0.435233161,0.056994819,0.559585492,1,0.298824795
21762,114,23628,3,2,5,2,7,19,7,10,0,0,0,17,nowin,win,plwin,beat,20,0,5,198,0.47979798,0.025252525,0.611111111,3,0.937232995
21763,16,23628,10,7,0,0,0,17,7,10,0,0,0,17,nowin,push,push,push,10,0,17,220,0.427272727,0.081818182,0.6,2,0.588660176
21764,68,23628,10,11,0,0,0,21,7,10,0,0,0,17,win,win,plwin,beat,25,0,21,205,0.434146341,0.029268293,0.6,2,0.59483189
21765,144,23628,11,6,3,0,0,20,7,10,0,0,0,17,nowin,win,plwin,beat,20,0,17,202,0.386138614,0.054455446,0.564356436,0,0.018006244
21766,68,23628,4,10,0,3,0,17,7,10,0,0,0,17,nowin,push,push,push,10,0,14,205,0.434146341,0.029268293,0.6,2,0.59483189
21767,72,23628,1,2,10,7,0,20,7,10,0,0,0,17,nowin,win,plwin,beat,20,0,3,185,0.394594595,0.032432432,0.508108108,0,0.006763115
21768,6,23629,10,8,0,0,0,18,11,8,0,0,0,19,nowin,loss,beat,dlwin,0,10,18,191,0.439790576,0.047120419,0.581151832,1,0.31211505
21769,90,23629,6,10,0,9,0,25,11,8,0,0,0,19,nowin,loss,bust,plbust,0,10,16,201,0.447761194,0.049751244,0.60199005,3,0.889945023
21770,22,23629,10,9,0,0,0,19,11,8,0,0,0,19,nowin,push,push,push,10,0,19,187,0.481283422,0.042780749,0.577540107,3,0.906128176
21771,103,23629,3,7,9,0,0,19,11,8,0,0,0,19,nowin,push,push,push,10,0,10,203,0.379310345,0.064039409,0.551724138,0,0.012869209
21772,103,23629,10,10,0,0,0,20,11,8,0,0,0,19,nowin,win,plwin,beat,20,0,20,203,0.379310345,0.064039409,0.551724138,0,0.012869209
21773,121,23629,10,10,0,0,0,20,11,8,0,0,0,19,nowin,win,plwin,beat,20,0,20,195,0.456410256,0.025641026,0.512820513,1,0.288597791
21774,60,23630,6,10,0,10,0,26,7,9,5,0,0,21,nowin,loss,bust,plbust,0,10,16,227,0.418502203,0.022026432,0.559471366,0,0.026496258
21775,19,23630,7,10,0,0,0,17,7,9,5,0,0,21,nowin,loss,beat,dlwin,0,10,17,237,0.41350211,0.054852321,0.628691983,2,0.597373826
21776,56,23630,2,10,0,10,0,22,7,9,5,0,0,21,nowin,loss,bust,plbust,0,10,12,175,0.4,0.057142857,0.582857143,0,0.026685297
21777,129,23630,4,10,0,2,2,18,7,9,5,0,0,21,nowin,loss,beat,dlwin,0,10,14,201,0.422885572,0.064676617,0.55721393,0,0.027255383
21778,118,23630,10,4,0,1,8,23,7,9,5,0,0,21,nowin,loss,bust,plbust,0,10,14,216,0.393518519,0.037037037,0.555555556,0,0.018059873
21779,127,23630,3,5,10,0,0,18,7,9,5,0,0,21,nowin,loss,beat,dlwin,0,10,8,201,0.402985075,0.029850746,0.60199005,0,0.032263937
21780,94,23631,10,6,0,10,0,26,10,10,0,0,0,20,nowin,loss,bust,plbust,0,10,16,183,0.43715847,0.043715847,0.540983607,1,0.290866892
21781,47,23631,8,4,0,4,8,24,10,10,0,0,0,20,nowin,loss,bust,plbust,0,10,12,210,0.438095238,0.057142857,0.623809524,2,0.615868808
21782,1,23631,8,8,0,2,0,18,10,10,0,0,0,20,nowin,loss,beat,dlwin,0,10,16,197,0.406091371,0.025380711,0.649746193,2,0.606186955
21783,116,23631,10,3,0,8,0,21,10,10,0,0,0,20,nowin,win,plwin,beat,20,0,13,195,0.425641026,0.056410256,0.538461538,1,0.28273747
21784,14,23631,8,10,0,0,0,18,10,10,0,0,0,20,nowin,loss,beat,dlwin,0,10,18,202,0.391089109,0.01980198,0.628712871,2,0.577264877
21785,92,23631,10,9,0,0,0,19,10,10,0,0,0,20,nowin,loss,beat,dlwin,0,10,19,186,0.446236559,0.059139785,0.564516129,1,0.307826125
21786,72,23632,10,8,0,0,0,18,3,10,2,8,0,23,nowin,win,dlbust,bust,20,0,18,185,0.394594595,0.032432432,0.508108108,0,0.006763115
21787,59,23632,10,6,0,0,0,16,3,10,2,8,0,23,nowin,win,dlbust,bust,20,0,16,228,0.429824561,0.048245614,0.543859649,1,0.287885446
21788,149,23632,7,5,0,5,0,17,3,10,2,8,0,23,nowin,win,dlbust,bust,20,0,12,225,0.457777778,0.057777778,0.648888889,2,0.651965595
21789,45,23632,10,10,0,0,0,20,3,10,2,8,0,23,nowin,win,dlbust,bust,20,0,20,196,0.428571429,0.051020408,0.612244898,2,0.598821767
21790,86,23632,10,10,0,0,0,20,3,10,2,8,0,23,nowin,win,dlbust,bust,20,0,20,196,0.454081633,0.040816327,0.591836735,3,0.887566443
21791,107,23632,4,10,0,0,0,14,3,10,2,8,0,23,nowin,win,dlbust,bust,20,0,14,218,0.444954128,0.073394495,0.600917431,2,0.605210014
21792,142,23633,10,6,0,4,0,20,8,7,3,0,0,18,nowin,win,plwin,beat,20,0,16,211,0.417061611,0.047393365,0.526066351,1,0.271531309
21793,112,23633,6,9,0,9,0,24,8,7,3,0,0,18,nowin,loss,bust,plbust,0,10,15,203,0.448275862,0.054187192,0.600985222,3,0.889576933
21794,46,23633,9,5,0,4,0,18,8,7,3,0,0,18,nowin,push,push,push,10,0,14,186,0.403225806,0.048387097,0.591397849,0,0.029742194
21795,57,23633,4,7,4,2,0,17,8,7,3,0,0,18,nowin,loss,beat,dlwin,0,10,11,192,0.46875,0.052083333,0.59375,3,0.907001181
21796,3,23633,10,10,0,0,0,20,8,7,3,0,0,18,nowin,win,plwin,beat,20,0,20,190,0.431578947,0.026315789,0.542105263,1,0.288076384
21797,52,23633,8,10,0,0,0,18,8,7,3,0,0,18,nowin,push,push,push,10,0,18,217,0.414746544,0.02764977,0.599078341,2,0.576736024
21798,97,23634,10,10,0,0,0,20,3,5,2,3,2,15,nowin,win,plwin,beat,20,0,20,182,0.450549451,0.06043956,0.692307692,2,0.677372279
21799,48,23634,11,7,0,0,0,18,3,5,2,3,2,15,nowin,win,plwin,beat,20,0,18,203,0.413793103,0.019704433,0.600985222,2,0.577280801
21800,147,23634,6,5,1,10,0,22,3,5,2,3,2,15,nowin,loss,bust,plbust,0,10,11,205,0.380487805,0.014634146,0.536585366,0,0.00951447
21801,35,23634,11,2,8,0,0,21,3,5,2,3,2,15,nowin,win,plwin,beat,20,0,13,202,0.410891089,0.044554455,0.633663366,2,0.598681573
21802,22,23634,10,11,0,0,0,21,3,5,2,3,2,15,win,win,plwin,beat,25,0,21,187,0.481283422,0.042780749,0.577540107,3,0.906128176
21803,138,23634,10,5,0,0,0,15,3,5,2,3,2,15,nowin,push,push,push,10,0,15,190,0.442105263,0.047368421,0.610526316,2,0.609711065
21804,128,23635,2,6,5,0,0,13,6,7,2,2,0,17,nowin,loss,beat,dlwin,0,10,8,227,0.356828194,0.052863436,0.577092511,0,0.012352564
21805,129,23635,7,8,0,0,0,15,6,7,2,2,0,17,nowin,loss,beat,dlwin,0,10,15,201,0.422885572,0.064676617,0.55721393,0,0.027255383
21806,145,23635,10,8,0,0,0,18,6,7,2,2,0,17,nowin,win,plwin,beat,20,0,18,188,0.441489362,0.031914894,0.622340426,2,0.617837093
21807,51,23635,11,10,0,0,0,21,6,7,2,2,0,17,win,win,plwin,beat,25,0,21,189,0.529100529,0.068783069,0.608465608,3,0.993665715
21808,148,23635,8,10,0,0,0,18,6,7,2,2,0,17,nowin,win,plwin,beat,20,0,18,204,0.401960784,0.078431373,0.593137255,0,0.029789521
21809,112,23635,10,8,0,0,0,18,6,7,2,2,0,17,nowin,win,plwin,beat,20,0,18,203,0.448275862,0.054187192,0.600985222,3,0.889576933
21810,51,23636,10,8,0,0,0,18,11,10,0,0,0,21,nowin,loss,beat,dlwin,0,10,18,189,0.529100529,0.068783069,0.608465608,3,0.993665715
21811,110,23636,6,5,8,0,0,19,11,10,0,0,0,21,nowin,loss,beat,dlwin,0,10,11,192,0.416666667,0.046875,0.557291667,0,0.025413132
21812,145,23636,4,10,0,7,0,21,11,10,0,0,0,21,nowin,push,push,push,10,0,14,188,0.441489362,0.031914894,0.622340426,2,0.617837093
21813,91,23636,9,5,0,9,0,23,11,10,0,0,0,21,nowin,loss,bust,plbust,0,10,14,194,0.417525773,0.046391753,0.515463918,1,0.266616552
21814,26,23636,11,2,7,0,0,20,11,10,0,0,0,21,nowin,loss,beat,dlwin,0,10,13,203,0.463054187,0.0591133,0.541871921,1,0.306802864
21815,49,23636,5,4,11,0,0,20,11,10,0,0,0,21,nowin,loss,beat,dlwin,0,10,9,207,0.396135266,0.053140097,0.594202899,0,0.028306925
21816,60,23637,1,4,10,0,0,15,2,11,4,0,0,17,nowin,loss,beat,dlwin,0,10,5,227,0.418502203,0.022026432,0.559471366,0,0.026496258
21817,43,23637,10,11,0,0,0,21,2,11,4,0,0,17,win,win,plwin,beat,25,0,21,192,0.40625,0.041666667,0.609375,2,0.576671372
21818,49,23637,3,10,0,0,0,13,2,11,4,0,0,17,nowin,loss,beat,dlwin,0,10,13,207,0.396135266,0.053140097,0.594202899,0,0.028306925
21819,75,23637,4,10,0,0,0,14,2,11,4,0,0,17,nowin,loss,beat,dlwin,0,10,14,191,0.418848168,0.052356021,0.570680628,0,0.029344702
21820,106,23637,8,10,0,0,0,18,2,11,4,0,0,17,nowin,win,plwin,beat,20,0,18,192,0.411458333,0.026041667,0.557291667,0,0.023854304
21821,76,23637,5,10,0,0,0,15,2,11,4,0,0,17,nowin,loss,beat,dlwin,0,10,15,189,0.534391534,0.079365079,0.608465608,3,1
21822,23,23638,11,4,6,0,0,21,7,6,7,0,0,20,nowin,win,plwin,beat,20,0,15,208,0.427884615,0.0625,0.552884615,1,0.29114424
21823,53,23638,9,10,0,0,0,19,7,6,7,0,0,20,nowin,loss,beat,dlwin,0,10,19,250,0.372,0.064,0.564,0,0.013687345
21824,95,23638,10,3,0,4,0,17,7,6,7,0,0,20,nowin,loss,beat,dlwin,0,10,13,218,0.412844037,0.04587156,0.559633028,0,0.024842385
21825,14,23638,8,2,9,0,0,19,7,6,7,0,0,20,nowin,loss,beat,dlwin,0,10,10,202,0.391089109,0.01980198,0.628712871,2,0.577264877
21826,138,23638,6,7,0,7,0,20,7,6,7,0,0,20,nowin,push,push,push,10,0,13,190,0.442105263,0.047368421,0.610526316,2,0.609711065
21827,120,23638,10,10,0,0,0,20,7,6,7,0,0,20,nowin,push,push,push,10,0,20,202,0.440594059,0.034653465,0.618811881,2,0.614441029
21828,95,23639,10,10,0,0,0,20,8,4,7,0,0,19,nowin,win,plwin,beat,20,0,20,218,0.412844037,0.04587156,0.559633028,0,0.024842385
21829,136,23639,6,9,0,10,0,25,8,4,7,0,0,19,nowin,loss,bust,plbust,0,10,15,194,0.396907216,0.025773196,0.597938144,0,0.029452644
21830,126,23639,2,11,6,0,0,19,8,4,7,0,0,19,nowin,push,push,push,10,0,13,188,0.457446809,0.074468085,0.60106383,3,0.900633203
21831,42,23639,5,10,0,6,0,21,8,4,7,0,0,19,nowin,win,plwin,beat,20,0,15,212,0.443396226,0.051886792,0.570754717,1,0.309181312
21832,142,23639,9,10,0,0,0,19,8,4,7,0,0,19,nowin,push,push,push,10,0,19,211,0.417061611,0.047393365,0.526066351,1,0.271531309
21833,81,23639,10,2,0,3,10,25,8,4,7,0,0,19,nowin,loss,bust,plbust,0,10,12,182,0.395604396,0.043956044,0.60989011,2,0.567491261
21834,43,23640,8,10,0,0,0,18,10,6,6,0,0,22,nowin,win,dlbust,bust,20,0,18,192,0.40625,0.041666667,0.609375,2,0.576671372
21835,138,23640,5,6,7,0,0,18,10,6,6,0,0,22,nowin,win,dlbust,bust,20,0,11,190,0.442105263,0.047368421,0.610526316,2,0.609711065
21836,10,23640,10,3,0,5,0,18,10,6,6,0,0,22,nowin,win,dlbust,bust,20,0,13,191,0.413612565,0.057591623,0.596858639,2,0.574087175
21837,66,23640,11,10,0,0,0,21,10,6,6,0,0,22,win,win,dlbust,bust,25,0,21,217,0.456221198,0.064516129,0.626728111,3,0.924304367
21838,115,23640,6,4,5,3,0,18,10,6,6,0,0,22,nowin,win,dlbust,bust,20,0,10,194,0.427835052,0.041237113,0.592783505,2,0.583863602
21839,149,23640,10,8,0,0,0,18,10,6,6,0,0,22,nowin,win,dlbust,bust,20,0,18,225,0.457777778,0.057777778,0.648888889,2,0.651965595
21840,112,23641,10,8,0,0,0,18,10,7,0,0,0,17,nowin,win,plwin,beat,20,0,18,203,0.448275862,0.054187192,0.600985222,3,0.889576933
21841,10,23641,8,5,0,5,0,18,10,7,0,0,0,17,nowin,win,plwin,beat,20,0,13,191,0.413612565,0.057591623,0.596858639,2,0.574087175
21842,30,23641,10,9,0,0,0,19,10,7,0,0,0,17,nowin,win,plwin,beat,20,0,19,206,0.393203883,0.033980583,0.601941748,0,0.029324648
21843,114,23641,10,10,0,0,0,20,10,7,0,0,0,17,nowin,win,plwin,beat,20,0,20,198,0.47979798,0.025252525,0.611111111,3,0.937232995
21844,25,23641,3,8,10,0,0,21,10,7,0,0,0,17,nowin,win,plwin,beat,20,0,11,190,0.463157895,0.063157895,0.536842105,1,0.304401563
21845,138,23641,7,11,0,0,0,18,10,7,0,0,0,17,nowin,win,plwin,beat,20,0,18,190,0.442105263,0.047368421,0.610526316,2,0.609711065
21846,64,23642,2,9,1,6,0,18,10,6,7,0,0,23,nowin,win,dlbust,bust,20,0,11,187,0.363636364,0.048128342,0.631016043,0,0.027594885
21847,2,23642,10,7,0,0,0,17,10,6,7,0,0,23,nowin,win,dlbust,bust,20,0,17,200,0.445,0.035,0.64,2,0.633962549
21848,52,23642,3,8,1,4,3,19,10,6,7,0,0,23,nowin,win,dlbust,bust,20,0,11,217,0.414746544,0.02764977,0.599078341,2,0.576736024
21849,139,23642,2,7,10,0,0,19,10,6,7,0,0,23,nowin,win,dlbust,bust,20,0,9,192,0.380208333,0.036458333,0.59375,0,0.023429169
21850,111,23642,8,9,0,0,0,17,10,6,7,0,0,23,nowin,win,dlbust,bust,20,0,17,180,0.433333333,0.055555556,0.611111111,2,0.602264492
21851,114,23642,2,10,0,10,0,22,10,6,7,0,0,23,nowin,loss,bust,plbust,0,10,12,198,0.47979798,0.025252525,0.611111111,3,0.937232995
21852,70,23643,10,10,0,0,0,20,9,5,1,3,0,18,nowin,win,plwin,beat,20,0,20,228,0.385964912,0.039473684,0.557017544,0,0.016157125
21853,79,23643,5,10,0,3,0,18,9,5,1,3,0,18,nowin,push,push,push,10,0,15,211,0.436018957,0.028436019,0.672985782,2,0.650131054
21854,131,23643,10,7,0,0,0,17,9,5,1,3,0,18,nowin,loss,beat,dlwin,0,10,17,217,0.410138249,0.069124424,0.543778802,0,0.02015021
21855,106,23643,10,3,0,8,0,21,9,5,1,3,0,18,nowin,win,plwin,beat,20,0,13,192,0.411458333,0.026041667,0.557291667,0,0.023854304
21856,126,23643,10,11,0,0,0,21,9,5,1,3,0,18,win,win,plwin,beat,25,0,21,188,0.457446809,0.074468085,0.60106383,3,0.900633203
21857,76,23643,9,8,0,0,0,17,9,5,1,3,0,18,nowin,loss,beat,dlwin,0,10,17,189,0.534391534,0.079365079,0.608465608,3,1
21858,4,23644,8,4,0,0,0,12,6,5,10,0,0,21,nowin,loss,beat,dlwin,0,10,12,217,0.460829493,0.036866359,0.562211982,1,0.315432839
21859,19,23644,4,2,10,0,0,16,6,5,10,0,0,21,nowin,loss,beat,dlwin,0,10,6,237,0.41350211,0.054852321,0.628691983,2,0.597373826
21860,119,23644,8,3,9,0,0,20,6,5,10,0,0,21,nowin,loss,beat,dlwin,0,10,11,190,0.405263158,0.068421053,0.515789474,0,0.011837158
21861,119,23644,6,10,0,0,0,16,6,5,10,0,0,21,nowin,loss,beat,dlwin,0,10,16,190,0.405263158,0.068421053,0.515789474,0,0.011837158
21862,96,23644,10,8,0,0,0,18,6,5,10,0,0,21,nowin,loss,beat,dlwin,0,10,18,190,0.468421053,0.057894737,0.584210526,3,0.897263354
21863,92,23644,1,3,8,0,0,12,6,5,10,0,0,21,nowin,loss,beat,dlwin,0,10,4,186,0.446236559,0.059139785,0.564516129,1,0.307826125
21864,62,23645,10,8,0,0,0,18,11,10,0,0,0,21,nowin,loss,beat,dlwin,0,10,18,178,0.370786517,0.028089888,0.54494382,0,0.008657722
21865,112,23645,2,5,7,3,0,17,11,10,0,0,0,21,nowin,loss,beat,dlwin,0,10,7,203,0.448275862,0.054187192,0.600985222,3,0.889576933
21866,46,23645,4,6,2,4,10,26,11,10,0,0,0,21,nowin,loss,bust,plbust,0,10,10,186,0.403225806,0.048387097,0.591397849,0,0.029742194
21867,131,23645,4,10,0,4,0,18,11,10,0,0,0,21,nowin,loss,beat,dlwin,0,10,14,217,0.410138249,0.069124424,0.543778802,0,0.02015021
21868,62,23645,6,4,2,5,0,17,11,10,0,0,0,21,nowin,loss,beat,dlwin,0,10,10,178,0.370786517,0.028089888,0.54494382,0,0.008657722
21869,124,23645,8,8,0,7,0,23,11,10,0,0,0,21,nowin,loss,bust,plbust,0,10,16,202,0.47029703,0.064356436,0.584158416,3,0.899458193
21870,133,23646,3,7,8,0,0,18,11,3,6,0,0,20,nowin,loss,beat,dlwin,0,10,10,201,0.47761194,0.064676617,0.611940299,3,0.935428111
21871,83,23646,10,10,0,0,0,20,11,3,6,0,0,20,nowin,push,push,push,10,0,20,193,0.424870466,0.051813472,0.678756477,2,0.644360335
21872,38,23646,9,5,0,1,8,23,11,3,6,0,0,20,nowin,loss,bust,plbust,0,10,14,202,0.361386139,0.03960396,0.564356436,0,0.010597953
21873,136,23646,5,10,0,9,0,24,11,3,6,0,0,20,nowin,loss,bust,plbust,0,10,15,194,0.396907216,0.025773196,0.597938144,0,0.029452644
21874,138,23646,1,6,8,10,0,25,11,3,6,0,0,20,nowin,loss,bust,plbust,0,10,7,190,0.442105263,0.047368421,0.610526316,2,0.609711065
21875,144,23646,5,10,0,2,0,17,11,3,6,0,0,20,nowin,loss,beat,dlwin,0,10,15,202,0.386138614,0.054455446,0.564356436,0,0.018006244
21876,24,23647,5,4,6,1,5,21,10,2,3,10,0,25,nowin,win,dlbust,bust,20,0,9,207,0.458937198,0.048309179,0.570048309,1,0.318138014
21877,7,23647,7,10,0,0,0,17,10,2,3,10,0,25,nowin,win,dlbust,bust,20,0,17,183,0.442622951,0.06010929,0.62295082,2,0.619303341
21878,144,23647,10,10,0,0,0,20,10,2,3,10,0,25,nowin,win,dlbust,bust,20,0,20,202,0.386138614,0.054455446,0.564356436,0,0.018006244
21879,64,23647,1,4,10,10,0,25,10,2,3,10,0,25,nowin,loss,bust,plbust,0,10,5,187,0.363636364,0.048128342,0.631016043,0,0.027594885
21880,54,23647,10,6,0,9,0,25,10,2,3,10,0,25,nowin,loss,bust,plbust,0,10,16,185,0.437837838,0.032432432,0.556756757,1,0.29899854
21881,105,23647,10,7,0,0,0,17,10,2,3,10,0,25,nowin,win,dlbust,bust,20,0,17,198,0.414141414,0.070707071,0.590909091,0,0.032889494
21882,74,23648,3,4,10,0,0,17,3,4,7,10,0,24,nowin,win,dlbust,bust,20,0,7,209,0.411483254,0.04784689,0.531100478,0,0.017448125
21883,92,23648,5,10,0,0,0,15,3,4,7,10,0,24,nowin,win,dlbust,bust,20,0,15,186,0.446236559,0.059139785,0.564516129,1,0.307826125
21884,144,23648,7,10,0,0,0,17,3,4,7,10,0,24,nowin,win,dlbust,bust,20,0,17,202,0.386138614,0.054455446,0.564356436,0,0.018006244
21885,148,23648,5,10,0,0,0,15,3,4,7,10,0,24,nowin,win,dlbust,bust,20,0,15,204,0.401960784,0.078431373,0.593137255,0,0.029789521
21886,81,23648,6,10,0,0,0,16,3,4,7,10,0,24,nowin,win,dlbust,bust,20,0,16,182,0.395604396,0.043956044,0.60989011,2,0.567491261
21887,15,23648,10,2,0,1,0,13,3,4,7,10,0,24,nowin,win,dlbust,bust,20,0,12,212,0.410377358,0.051886792,0.561320755,0,0.024517408
21888,47,23649,10,5,0,10,0,25,10,10,0,0,0,20,nowin,loss,bust,plbust,0,10,15,210,0.438095238,0.057142857,0.623809524,2,0.615868808
21889,117,23649,2,5,10,0,0,17,10,10,0,0,0,20,nowin,loss,beat,dlwin,0,10,7,173,0.410404624,0.069364162,0.606936416,2,0.578610282
21890,20,23649,10,7,0,0,0,17,10,10,0,0,0,20,nowin,loss,beat,dlwin,0,10,17,186,0.456989247,0.037634409,0.537634409,1,0.301097108
21891,21,23649,10,10,0,0,0,20,10,10,0,0,0,20,nowin,push,push,push,10,0,20,214,0.359813084,0.042056075,0.626168224,0,0.025263474
21892,65,23649,9,4,0,10,0,23,10,10,0,0,0,20,nowin,loss,bust,plbust,0,10,13,203,0.492610837,0.054187192,0.571428571,3,0.913702814
21893,42,23649,6,9,0,3,0,18,10,10,0,0,0,20,nowin,loss,beat,dlwin,0,10,15,212,0.443396226,0.051886792,0.570754717,1,0.309181312
21894,7,23650,7,5,0,10,0,22,10,5,10,0,0,25,nowin,loss,bust,plbust,0,10,12,183,0.442622951,0.06010929,0.62295082,2,0.619303341
21895,32,23650,5,6,3,1,7,22,10,5,10,0,0,25,nowin,loss,bust,plbust,0,10,11,189,0.391534392,0.037037037,0.53968254,0,0.013579086
21896,130,23650,10,3,0,10,0,23,10,5,10,0,0,25,nowin,loss,bust,plbust,0,10,13,219,0.410958904,0.03652968,0.566210046,0,0.025888739
21897,128,23650,5,10,0,10,0,25,10,5,10,0,0,25,nowin,loss,bust,plbust,0,10,15,227,0.356828194,0.052863436,0.577092511,0,0.012352564
21898,135,23650,10,7,0,0,0,17,10,5,10,0,0,25,nowin,win,dlbust,bust,20,0,17,179,0.391061453,0.067039106,0.586592179,0,0.024924662
21899,101,23650,10,7,0,0,0,17,10,5,10,0,0,25,nowin,win,dlbust,bust,20,0,17,205,0.424390244,0.068292683,0.63902439,2,0.614740646
21900,132,23651,10,7,0,0,0,17,6,6,8,0,0,20,nowin,loss,beat,dlwin,0,10,17,194,0.412371134,0.036082474,0.649484536,2,0.611633238
21901,129,23651,3,9,0,0,0,12,6,6,8,0,0,20,nowin,loss,beat,dlwin,0,10,12,201,0.422885572,0.064676617,0.55721393,0,0.027255383
21902,15,23651,6,9,0,0,0,15,6,6,8,0,0,20,nowin,loss,beat,dlwin,0,10,15,212,0.410377358,0.051886792,0.561320755,0,0.024517408
21903,69,23651,10,7,0,0,0,17,6,6,8,0,0,20,nowin,loss,beat,dlwin,0,10,17,194,0.365979381,0.030927835,0.515463918,0,0
21904,80,23651,1,4,10,0,0,15,6,6,8,0,0,20,nowin,loss,beat,dlwin,0,10,5,186,0.419354839,0.059139785,0.623655914,2,0.59892924
21905,68,23651,5,10,0,0,0,15,6,6,8,0,0,20,nowin,loss,beat,dlwin,0,10,15,205,0.434146341,0.029268293,0.6,2,0.59483189
21906,98,23652,11,8,0,0,0,19,7,6,10,0,0,23,nowin,win,dlbust,bust,20,0,19,220,0.422727273,0.054545455,0.55,1,0.28664435
21907,78,23652,10,3,0,2,10,25,7,6,10,0,0,23,nowin,loss,bust,plbust,0,10,13,201,0.517412935,0.034825871,0.587064677,3,0.95871112
21908,29,23652,4,4,10,0,0,18,7,6,10,0,0,23,nowin,win,dlbust,bust,20,0,8,189,0.44973545,0.058201058,0.544973545,1,0.300349439
21909,148,23652,4,2,10,4,0,20,7,6,10,0,0,23,nowin,win,dlbust,bust,20,0,6,204,0.401960784,0.078431373,0.593137255,0,0.029789521
21910,16,23652,10,8,0,0,0,18,7,6,10,0,0,23,nowin,win,dlbust,bust,20,0,18,220,0.427272727,0.081818182,0.6,2,0.588660176
21911,112,23652,10,11,0,0,0,21,7,6,10,0,0,23,win,win,dlbust,bust,25,0,21,203,0.448275862,0.054187192,0.600985222,3,0.889576933
21912,2,23653,2,8,10,0,0,20,7,10,0,0,0,17,nowin,win,plwin,beat,20,0,10,200,0.445,0.035,0.64,2,0.633962549
21913,36,23653,6,10,0,8,0,24,7,10,0,0,0,17,nowin,loss,bust,plbust,0,10,16,229,0.445414847,0.056768559,0.655021834,2,0.645370571
21914,141,23653,10,5,0,2,0,17,7,10,0,0,0,17,nowin,push,push,push,10,0,15,202,0.420792079,0.074257426,0.564356436,0,0.028377851
21915,134,23653,4,11,6,0,0,21,7,10,0,0,0,17,nowin,win,plwin,beat,20,0,15,185,0.443243243,0.021621622,0.545945946,1,0.296939509
21916,86,23653,4,10,0,9,0,23,7,10,0,0,0,17,nowin,loss,bust,plbust,0,10,14,196,0.454081633,0.040816327,0.591836735,3,0.887566443
21917,66,23653,4,10,0,4,0,18,7,10,0,0,0,17,nowin,win,plwin,beat,20,0,14,217,0.456221198,0.064516129,0.626728111,3,0.924304367
21918,46,23654,10,4,0,2,10,26,9,10,0,0,0,19,nowin,loss,bust,plbust,0,10,14,186,0.403225806,0.048387097,0.591397849,0,0.029742194
21919,130,23654,10,4,0,4,0,18,9,10,0,0,0,19,nowin,loss,beat,dlwin,0,10,14,219,0.410958904,0.03652968,0.566210046,0,0.025888739
21920,57,23654,4,3,11,0,0,18,9,10,0,0,0,19,nowin,loss,beat,dlwin,0,10,7,192,0.46875,0.052083333,0.59375,3,0.907001181
21921,84,23654,8,4,0,10,0,22,9,10,0,0,0,19,nowin,loss,bust,plbust,0,10,12,195,0.379487179,0.056410256,0.569230769,0,0.017209119
21922,59,23654,6,9,0,10,0,25,9,10,0,0,0,19,nowin,loss,bust,plbust,0,10,15,228,0.429824561,0.048245614,0.543859649,1,0.287885446
21923,79,23654,3,8,1,10,0,22,9,10,0,0,0,19,nowin,loss,bust,plbust,0,10,11,211,0.436018957,0.028436019,0.672985782,2,0.650131054
21924,142,23655,3,10,0,10,0,23,11,10,0,0,0,21,nowin,loss,bust,plbust,0,10,13,211,0.417061611,0.047393365,0.526066351,1,0.271531309
21925,36,23655,11,5,5,0,0,21,11,10,0,0,0,21,nowin,push,push,push,10,0,16,229,0.445414847,0.056768559,0.655021834,2,0.645370571
21926,60,23655,3,8,1,5,0,17,11,10,0,0,0,21,nowin,loss,beat,dlwin,0,10,11,227,0.418502203,0.022026432,0.559471366,0,0.026496258
21927,51,23655,4,4,10,0,0,18,11,10,0,0,0,21,nowin,loss,beat,dlwin,0,10,8,189,0.529100529,0.068783069,0.608465608,3,0.993665715
21928,84,23655,10,10,0,0,0,20,11,10,0,0,0,21,nowin,loss,beat,dlwin,0,10,20,195,0.379487179,0.056410256,0.569230769,0,0.017209119
21929,106,23655,6,10,0,6,0,22,11,10,0,0,0,21,nowin,loss,bust,plbust,0,10,16,192,0.411458333,0.026041667,0.557291667,0,0.023854304
21930,76,23656,10,4,0,2,10,26,10,5,10,0,0,25,nowin,loss,bust,plbust,0,10,14,189,0.534391534,0.079365079,0.608465608,3,1
21931,148,23656,5,3,4,10,0,22,10,5,10,0,0,25,nowin,loss,bust,plbust,0,10,8,204,0.401960784,0.078431373,0.593137255,0,0.029789521
21932,128,23656,4,10,0,4,0,18,10,5,10,0,0,25,nowin,win,dlbust,bust,20,0,14,227,0.356828194,0.052863436,0.577092511,0,0.012352564
21933,95,23656,9,8,0,0,0,17,10,5,10,0,0,25,nowin,win,dlbust,bust,20,0,17,218,0.412844037,0.04587156,0.559633028,0,0.024842385
21934,100,23656,10,8,0,0,0,18,10,5,10,0,0,25,nowin,win,dlbust,bust,20,0,18,190,0.452631579,0.036842105,0.594736842,3,0.888671154
21935,125,23656,11,10,0,0,0,21,10,5,10,0,0,25,win,win,dlbust,bust,25,0,21,219,0.438356164,0.050228311,0.575342466,1,0.308411257
21936,131,23657,10,5,0,8,0,23,10,10,0,0,0,20,nowin,loss,bust,plbust,0,10,15,217,0.410138249,0.069124424,0.543778802,0,0.02015021
21937,94,23657,5,10,0,4,0,19,10,10,0,0,0,20,nowin,loss,beat,dlwin,0,10,15,183,0.43715847,0.043715847,0.540983607,1,0.290866892
21938,102,23657,9,4,0,9,0,22,10,10,0,0,0,20,nowin,loss,bust,plbust,0,10,13,192,0.338541667,0.046875,0.5625,0,0.003306118
21939,66,23657,10,10,0,0,0,20,10,10,0,0,0,20,nowin,push,push,push,10,0,20,217,0.456221198,0.064516129,0.626728111,3,0.924304367
21940,84,23657,11,10,0,0,0,21,10,10,0,0,0,20,win,win,plwin,beat,25,0,21,195,0.379487179,0.056410256,0.569230769,0,0.017209119
21941,96,23657,7,5,0,1,9,22,10,10,0,0,0,20,nowin,loss,bust,plbust,0,10,12,190,0.468421053,0.057894737,0.584210526,3,0.897263354
21942,97,23658,10,10,0,0,0,20,6,10,5,0,0,21,nowin,loss,beat,dlwin,0,10,20,182,0.450549451,0.06043956,0.692307692,2,0.677372279
21943,23,23658,10,3,0,0,0,13,6,10,5,0,0,21,nowin,loss,beat,dlwin,0,10,13,208,0.427884615,0.0625,0.552884615,1,0.29114424
21944,86,23658,11,6,3,0,0,20,6,10,5,0,0,21,nowin,loss,beat,dlwin,0,10,17,196,0.454081633,0.040816327,0.591836735,3,0.887566443
21945,146,23658,6,3,10,0,0,19,6,10,5,0,0,21,nowin,loss,beat,dlwin,0,10,9,221,0.43438914,0.040723982,0.542986425,1,0.290190091
21946,14,23658,9,2,9,0,0,20,6,10,5,0,0,21,nowin,loss,beat,dlwin,0,10,11,202,0.391089109,0.01980198,0.628712871,2,0.577264877
21947,107,23658,2,5,10,0,0,17,6,10,5,0,0,21,nowin,loss,beat,dlwin,0,10,7,218,0.444954128,0.073394495,0.600917431,2,0.605210014
21948,120,23659,10,10,0,0,0,20,3,2,10,4,0,19,nowin,win,plwin,beat,20,0,20,202,0.440594059,0.034653465,0.618811881,2,0.614441029
21949,7,23659,4,8,0,10,0,22,3,2,10,4,0,19,nowin,loss,bust,plbust,0,10,12,183,0.442622951,0.06010929,0.62295082,2,0.619303341
21950,17,23659,10,11,0,0,0,21,3,2,10,4,0,19,win,win,plwin,beat,25,0,21,171,0.444444444,0.070175439,0.555555556,1,0.302364894
21951,46,23659,9,8,0,0,0,17,3,2,10,4,0,19,nowin,loss,beat,dlwin,0,10,17,186,0.403225806,0.048387097,0.591397849,0,0.029742194
21952,41,23659,3,6,3,3,0,15,3,2,10,4,0,19,nowin,loss,beat,dlwin,0,10,9,192,0.364583333,0.036458333,0.520833333,0,0.00089702
21953,25,23659,10,5,0,0,0,15,3,2,10,4,0,19,nowin,loss,beat,dlwin,0,10,15,190,0.463157895,0.063157895,0.536842105,1,0.304401563
21954,91,23660,11,10,0,0,0,21,8,10,0,0,0,18,win,win,plwin,beat,25,0,21,194,0.417525773,0.046391753,0.515463918,1,0.266616552
21955,124,23660,6,1,10,0,0,17,8,10,0,0,0,18,nowin,loss,beat,dlwin,0,10,7,202,0.47029703,0.064356436,0.584158416,3,0.899458193
21956,114,23660,9,7,0,9,0,25,8,10,0,0,0,18,nowin,loss,bust,plbust,0,10,16,198,0.47979798,0.025252525,0.611111111,3,0.937232995
21957,67,23660,4,10,0,7,0,21,8,10,0,0,0,18,nowin,win,plwin,beat,20,0,14,195,0.369230769,0.041025641,0.569230769,0,0.014139427
21958,65,23660,10,11,0,0,0,21,8,10,0,0,0,18,win,win,plwin,beat,25,0,21,203,0.492610837,0.054187192,0.571428571,3,0.913702814
21959,64,23660,10,5,0,10,0,25,8,10,0,0,0,18,nowin,loss,bust,plbust,0,10,15,187,0.363636364,0.048128342,0.631016043,0,0.027594885
21960,94,23661,8,10,0,0,0,18,10,5,10,0,0,25,nowin,win,dlbust,bust,20,0,18,183,0.43715847,0.043715847,0.540983607,1,0.290866892
21961,17,23661,4,9,0,7,0,20,10,5,10,0,0,25,nowin,win,dlbust,bust,20,0,13,171,0.444444444,0.070175439,0.555555556,1,0.302364894
21962,44,23661,4,3,10,0,0,17,10,5,10,0,0,25,nowin,win,dlbust,bust,20,0,7,219,0.433789954,0.050228311,0.534246575,1,0.285551035
21963,67,23661,10,9,0,0,0,19,10,5,10,0,0,25,nowin,win,dlbust,bust,20,0,19,195,0.369230769,0.041025641,0.569230769,0,0.014139427
21964,1,23661,8,7,0,8,0,23,10,5,10,0,0,25,nowin,loss,bust,plbust,0,10,15,197,0.406091371,0.025380711,0.649746193,2,0.606186955
21965,61,23661,8,10,0,0,0,18,10,5,10,0,0,25,nowin,win,dlbust,bust,20,0,18,194,0.427835052,0.077319588,0.603092784,2,0.591437139
21966,22,23662,6,7,0,0,0,13,6,10,3,0,0,19,nowin,loss,beat,dlwin,0,10,13,187,0.481283422,0.042780749,0.577540107,3,0.906128176
21967,10,23662,8,9,0,0,0,17,6,10,3,0,0,19,nowin,loss,beat,dlwin,0,10,17,191,0.413612565,0.057591623,0.596858639,2,0.574087175
21968,26,23662,8,2,2,0,0,12,6,10,3,0,0,19,nowin,loss,beat,dlwin,0,10,10,203,0.463054187,0.0591133,0.541871921,1,0.306802864
21969,108,23662,10,9,0,0,0,19,6,10,3,0,0,19,nowin,push,push,push,10,0,19,193,0.435233161,0.056994819,0.559585492,1,0.298824795
21970,90,23662,7,7,0,0,0,14,6,10,3,0,0,19,nowin,loss,beat,dlwin,0,10,14,201,0.447761194,0.049751244,0.60199005,3,0.889945023
21971,127,23662,8,11,0,0,0,19,6,10,3,0,0,19,nowin,push,push,push,10,0,19,201,0.402985075,0.029850746,0.60199005,0,0.032263937
21972,147,23663,4,3,10,0,0,17,6,9,6,0,0,21,nowin,loss,beat,dlwin,0,10,7,205,0.380487805,0.014634146,0.536585366,0,0.00951447
21973,4,23663,10,10,0,0,0,20,6,9,6,0,0,21,nowin,loss,beat,dlwin,0,10,20,217,0.460829493,0.036866359,0.562211982,1,0.315432839
21974,113,23663,2,7,4,0,0,13,6,9,6,0,0,21,nowin,loss,beat,dlwin,0,10,9,199,0.407035176,0.055276382,0.668341709,2,0.620695264
21975,129,23663,8,5,0,0,0,13,6,9,6,0,0,21,nowin,loss,beat,dlwin,0,10,13,201,0.422885572,0.064676617,0.55721393,0,0.027255383
21976,125,23663,8,10,0,0,0,18,6,9,6,0,0,21,nowin,loss,beat,dlwin,0,10,18,219,0.438356164,0.050228311,0.575342466,1,0.308411257
21977,88,23663,11,9,0,0,0,20,6,9,6,0,0,21,nowin,loss,beat,dlwin,0,10,20,206,0.466019417,0.033980583,0.54368932,1,0.309467903
21978,36,23664,4,3,10,0,0,17,11,10,0,0,0,21,nowin,loss,beat,dlwin,0,10,7,229,0.445414847,0.056768559,0.655021834,2,0.645370571
21979,146,23664,9,7,0,6,0,22,11,10,0,0,0,21,nowin,loss,bust,plbust,0,10,16,221,0.43438914,0.040723982,0.542986425,1,0.290190091
21980,100,23664,10,3,0,10,0,23,11,10,0,0,0,21,nowin,loss,bust,plbust,0,10,13,190,0.452631579,0.036842105,0.594736842,3,0.888671154
21981,66,23664,7,10,0,0,0,17,11,10,0,0,0,21,nowin,loss,beat,dlwin,0,10,17,217,0.456221198,0.064516129,0.626728111,3,0.924304367
21982,14,23664,10,8,0,0,0,18,11,10,0,0,0,21,nowin,loss,beat,dlwin,0,10,18,202,0.391089109,0.01980198,0.628712871,2,0.577264877
21983,53,23664,10,2,0,6,0,18,11,10,0,0,0,21,nowin,loss,beat,dlwin,0,10,12,250,0.372,0.064,0.564,0,0.013687345
21984,65,23665,9,2,8,0,0,19,11,1,1,10,0,23,nowin,win,dlbust,bust,20,0,11,203,0.492610837,0.054187192,0.571428571,3,0.913702814
21985,62,23665,9,7,0,10,0,26,11,1,1,10,0,23,nowin,loss,bust,plbust,0,10,16,178,0.370786517,0.028089888,0.54494382,0,0.008657722
21986,78,23665,10,10,0,0,0,20,11,1,1,10,0,23,nowin,win,dlbust,bust,20,0,20,201,0.517412935,0.034825871,0.587064677,3,0.95871112
21987,31,23665,5,10,0,6,0,21,11,1,1,10,0,23,nowin,win,dlbust,bust,20,0,15,188,0.473404255,0.058510638,0.515957447,1,0.300306557
21988,35,23665,4,10,0,7,0,21,11,1,1,10,0,23,nowin,win,dlbust,bust,20,0,14,202,0.410891089,0.044554455,0.633663366,2,0.598681573
21989,56,23665,10,10,0,0,0,20,11,1,1,10,0,23,nowin,win,dlbust,bust,20,0,20,175,0.4,0.057142857,0.582857143,0,0.026685297
21990,105,23666,2,2,9,1,5,19,10,10,0,0,0,20,nowin,loss,beat,dlwin,0,10,4,198,0.414141414,0.070707071,0.590909091,0,0.032889494
21991,104,23666,5,10,0,8,0,23,10,10,0,0,0,20,nowin,loss,bust,plbust,0,10,15,209,0.363636364,0.052631579,0.593301435,0,0.018359419
21992,4,23666,10,10,0,0,0,20,10,10,0,0,0,20,nowin,push,push,push,10,0,20,217,0.460829493,0.036866359,0.562211982,1,0.315432839
21993,10,23666,5,10,0,6,0,21,10,10,0,0,0,20,nowin,win,plwin,beat,20,0,15,191,0.413612565,0.057591623,0.596858639,2,0.574087175
21994,62,23666,8,7,0,10,0,25,10,10,0,0,0,20,nowin,loss,bust,plbust,0,10,15,178,0.370786517,0.028089888,0.54494382,0,0.008657722
21995,72,23666,3,6,9,0,0,18,10,10,0,0,0,20,nowin,loss,beat,dlwin,0,10,9,185,0.394594595,0.032432432,0.508108108,0,0.006763115
21996,4,23667,5,10,0,0,0,15,3,3,9,7,0,22,nowin,win,dlbust,bust,20,0,15,217,0.460829493,0.036866359,0.562211982,1,0.315432839
21997,47,23667,10,10,0,0,0,20,3,3,9,7,0,22,nowin,win,dlbust,bust,20,0,20,210,0.438095238,0.057142857,0.623809524,2,0.615868808
21998,141,23667,10,8,0,0,0,18,3,3,9,7,0,22,nowin,win,dlbust,bust,20,0,18,202,0.420792079,0.074257426,0.564356436,0,0.028377851
21999,88,23667,5,10,0,0,0,15,3,3,9,7,0,22,nowin,win,dlbust,bust,20,0,15,206,0.466019417,0.033980583,0.54368932,1,0.309467903
22000,76,23667,5,7,0,10,0,22,3,3,9,7,0,22,nowin,loss,bust,plbust,0,10,12,189,0.534391534,0.079365079,0.608465608,3,1
22001,36,23667,7,5,0,10,0,22,3,3,9,7,0,22,nowin,loss,bust,plbust,0,10,12,229,0.445414847,0.056768559,0.655021834,2,0.645370571
22002,79,23668,11,10,0,0,0,21,4,3,10,0,0,17,win,win,plwin,beat,25,0,21,211,0.436018957,0.028436019,0.672985782,2,0.650131054
22003,11,23668,10,11,0,0,0,21,4,3,10,0,0,17,win,win,plwin,beat,25,0,21,236,0.457627119,0.016949153,0.588983051,3,0.889015813
22004,52,23668,10,10,0,0,0,20,4,3,10,0,0,17,nowin,win,plwin,beat,20,0,20,217,0.414746544,0.02764977,0.599078341,2,0.576736024
22005,108,23668,5,7,0,0,0,12,4,3,10,0,0,17,nowin,loss,beat,dlwin,0,10,12,193,0.435233161,0.056994819,0.559585492,1,0.298824795
22006,128,23668,7,10,0,0,0,17,4,3,10,0,0,17,nowin,push,push,push,10,0,17,227,0.356828194,0.052863436,0.577092511,0,0.012352564
22007,15,23668,2,10,0,0,0,12,4,3,10,0,0,17,nowin,loss,beat,dlwin,0,10,12,212,0.410377358,0.051886792,0.561320755,0,0.024517408
22008,74,23669,9,3,0,0,0,12,5,7,3,5,0,20,nowin,loss,beat,dlwin,0,10,12,209,0.411483254,0.04784689,0.531100478,0,0.017448125
22009,34,23669,10,5,0,0,0,15,5,7,3,5,0,20,nowin,loss,beat,dlwin,0,10,15,202,0.5,0.079207921,0.618811881,3,0.968961434
22010,13,23669,10,9,0,0,0,19,5,7,3,5,0,20,nowin,loss,beat,dlwin,0,10,19,206,0.417475728,0.063106796,0.621359223,2,0.59555479
22011,99,23669,9,11,0,0,0,20,5,7,3,5,0,20,nowin,push,push,push,10,0,20,207,0.47826087,0.062801932,0.637681159,3,0.961418446
22012,101,23669,10,8,0,0,0,18,5,7,3,5,0,20,nowin,loss,beat,dlwin,0,10,18,205,0.424390244,0.068292683,0.63902439,2,0.614740646
22013,84,23669,4,6,10,0,0,20,5,7,3,5,0,20,nowin,push,push,push,10,0,10,195,0.379487179,0.056410256,0.569230769,0,0.017209119
22014,112,23670,2,10,0,0,0,12,5,5,5,1,3,19,nowin,loss,beat,dlwin,0,10,12,203,0.448275862,0.054187192,0.600985222,3,0.889576933
22015,117,23670,5,5,4,0,0,14,5,5,5,1,3,19,nowin,loss,beat,dlwin,0,10,10,173,0.410404624,0.069364162,0.606936416,2,0.578610282
22016,127,23670,9,10,0,0,0,19,5,5,5,1,3,19,nowin,push,push,push,10,0,19,201,0.402985075,0.029850746,0.60199005,0,0.032263937
22017,106,23670,6,4,11,0,0,21,5,5,5,1,3,19,nowin,win,plwin,beat,20,0,10,192,0.411458333,0.026041667,0.557291667,0,0.023854304
22018,49,23670,4,10,0,0,0,14,5,5,5,1,3,19,nowin,loss,beat,dlwin,0,10,14,207,0.396135266,0.053140097,0.594202899,0,0.028306925
22019,37,23670,7,10,0,0,0,17,5,5,5,1,3,19,nowin,loss,beat,dlwin,0,10,17,208,0.394230769,0.038461538,0.581730769,0,0.024682772
22020,14,23671,3,10,0,10,0,23,10,8,0,0,0,18,nowin,loss,bust,plbust,0,10,13,202,0.391089109,0.01980198,0.628712871,2,0.577264877
22021,104,23671,2,10,0,2,9,23,10,8,0,0,0,18,nowin,loss,bust,plbust,0,10,12,209,0.363636364,0.052631579,0.593301435,0,0.018359419
22022,72,23671,10,6,0,9,0,25,10,8,0,0,0,18,nowin,loss,bust,plbust,0,10,16,185,0.394594595,0.032432432,0.508108108,0,0.006763115
22023,67,23671,8,6,0,10,0,24,10,8,0,0,0,18,nowin,loss,bust,plbust,0,10,14,195,0.369230769,0.041025641,0.569230769,0,0.014139427
22024,70,23671,11,10,0,0,0,21,10,8,0,0,0,18,win,win,plwin,beat,25,0,21,228,0.385964912,0.039473684,0.557017544,0,0.016157125
22025,111,23671,9,10,0,0,0,19,10,8,0,0,0,18,nowin,win,plwin,beat,20,0,19,180,0.433333333,0.055555556,0.611111111,2,0.602264492
22026,51,23672,10,10,0,0,0,20,10,7,0,0,0,17,nowin,win,plwin,beat,20,0,20,189,0.529100529,0.068783069,0.608465608,3,0.993665715
22027,66,23672,10,7,0,0,0,17,10,7,0,0,0,17,nowin,push,push,push,10,0,17,217,0.456221198,0.064516129,0.626728111,3,0.924304367
22028,114,23672,4,4,3,4,2,17,10,7,0,0,0,17,nowin,push,push,push,10,0,8,198,0.47979798,0.025252525,0.611111111,3,0.937232995
22029,16,23672,3,7,10,0,0,20,10,7,0,0,0,17,nowin,win,plwin,beat,20,0,10,220,0.427272727,0.081818182,0.6,2,0.588660176
22030,86,23672,10,6,0,10,0,26,10,7,0,0,0,17,nowin,loss,bust,plbust,0,10,16,196,0.454081633,0.040816327,0.591836735,3,0.887566443
22031,129,23672,10,10,0,0,0,20,10,7,0,0,0,17,nowin,win,plwin,beat,20,0,20,201,0.422885572,0.064676617,0.55721393,0,0.027255383
22032,117,23673,10,3,0,10,0,23,10,10,0,0,0,20,nowin,loss,bust,plbust,0,10,13,173,0.410404624,0.069364162,0.606936416,2,0.578610282
22033,115,23673,4,9,0,2,10,25,10,10,0,0,0,20,nowin,loss,bust,plbust,0,10,13,194,0.427835052,0.041237113,0.592783505,2,0.583863602
22034,75,23673,10,8,0,0,0,18,10,10,0,0,0,20,nowin,loss,beat,dlwin,0,10,18,191,0.418848168,0.052356021,0.570680628,0,0.029344702
22035,121,23673,3,4,4,3,3,17,10,10,0,0,0,20,nowin,loss,beat,dlwin,0,10,7,195,0.456410256,0.025641026,0.512820513,1,0.288597791
22036,148,23673,10,10,0,0,0,20,10,10,0,0,0,20,nowin,push,push,push,10,0,20,204,0.401960784,0.078431373,0.593137255,0,0.029789521
22037,132,23673,5,2,6,3,10,26,10,10,0,0,0,20,nowin,loss,bust,plbust,0,10,7,194,0.412371134,0.036082474,0.649484536,2,0.611633238
22038,30,23674,6,10,0,2,0,18,9,9,0,0,0,18,nowin,push,push,push,10,0,16,206,0.393203883,0.033980583,0.601941748,0,0.029324648
22039,105,23674,11,7,0,0,0,18,9,9,0,0,0,18,nowin,push,push,push,10,0,18,198,0.414141414,0.070707071,0.590909091,0,0.032889494
22040,102,23674,5,4,6,6,0,21,9,9,0,0,0,18,nowin,win,plwin,beat,20,0,9,192,0.338541667,0.046875,0.5625,0,0.003306118
22041,35,23674,9,9,0,0,0,18,9,9,0,0,0,18,nowin,push,push,push,10,0,18,202,0.410891089,0.044554455,0.633663366,2,0.598681573
22042,141,23674,8,10,0,0,0,18,9,9,0,0,0,18,nowin,push,push,push,10,0,18,202,0.420792079,0.074257426,0.564356436,0,0.028377851
22043,22,23674,8,11,0,0,0,19,9,9,0,0,0,18,nowin,win,plwin,beat,20,0,19,187,0.481283422,0.042780749,0.577540107,3,0.906128176
22044,13,23675,6,3,6,10,0,25,10,10,0,0,0,20,nowin,loss,bust,plbust,0,10,9,206,0.417475728,0.063106796,0.621359223,2,0.59555479
22045,114,23675,11,10,0,0,0,21,10,10,0,0,0,20,win,win,plwin,beat,25,0,21,198,0.47979798,0.025252525,0.611111111,3,0.937232995
22046,123,23675,7,6,0,9,0,22,10,10,0,0,0,20,nowin,loss,bust,plbust,0,10,13,205,0.43902439,0.034146341,0.614634146,2,0.609962544
22047,150,23675,11,4,2,0,0,17,10,10,0,0,0,20,nowin,loss,beat,dlwin,0,10,15,192,0.401041667,0.036458333,0.567708333,0,0.023287458
22048,37,23675,2,7,7,10,0,26,10,10,0,0,0,20,nowin,loss,bust,plbust,0,10,9,208,0.394230769,0.038461538,0.581730769,0,0.024682772
22049,58,23675,10,8,0,0,0,18,10,10,0,0,0,20,nowin,loss,beat,dlwin,0,10,18,195,0.430769231,0.041025641,0.584615385,2,0.580497586
22050,125,23676,5,10,0,0,0,15,5,6,2,8,0,21,nowin,loss,beat,dlwin,0,10,15,219,0.438356164,0.050228311,0.575342466,1,0.308411257
22051,50,23676,7,10,0,0,0,17,5,6,2,8,0,21,nowin,loss,beat,dlwin,0,10,17,202,0.405940594,0.04950495,0.54950495,0,0.020296079
22052,21,23676,4,4,10,0,0,18,5,6,2,8,0,21,nowin,loss,beat,dlwin,0,10,8,214,0.359813084,0.042056075,0.626168224,0,0.025263474
22053,60,23676,8,10,0,0,0,18,5,6,2,8,0,21,nowin,loss,beat,dlwin,0,10,18,227,0.418502203,0.022026432,0.559471366,0,0.026496258
22054,12,23676,8,7,0,0,0,15,5,6,2,8,0,21,nowin,loss,beat,dlwin,0,10,15,189,0.470899471,0.015873016,0.613756614,3,0.929171178
22055,50,23676,5,11,4,0,0,20,5,6,2,8,0,21,nowin,loss,beat,dlwin,0,10,16,202,0.405940594,0.04950495,0.54950495,0,0.020296079
22056,41,23677,3,6,3,0,0,12,4,9,9,0,0,22,nowin,win,dlbust,bust,20,0,9,192,0.364583333,0.036458333,0.520833333,0,0.00089702
22057,70,23677,10,11,0,0,0,21,4,9,9,0,0,22,win,win,dlbust,bust,25,0,21,228,0.385964912,0.039473684,0.557017544,0,0.016157125
22058,10,23677,10,10,0,0,0,20,4,9,9,0,0,22,nowin,win,dlbust,bust,20,0,20,191,0.413612565,0.057591623,0.596858639,2,0.574087175
22059,8,23677,5,10,0,0,0,15,4,9,9,0,0,22,nowin,win,dlbust,bust,20,0,15,181,0.44198895,0.071823204,0.596685083,2,0.599438402
22060,50,23677,1,1,10,0,0,12,4,9,9,0,0,22,nowin,win,dlbust,bust,20,0,2,202,0.405940594,0.04950495,0.54950495,0,0.020296079
22061,98,23677,10,4,0,0,0,14,4,9,9,0,0,22,nowin,win,dlbust,bust,20,0,14,220,0.422727273,0.054545455,0.55,1,0.28664435
22062,44,23678,10,2,0,0,0,12,6,8,2,10,0,26,nowin,win,dlbust,bust,20,0,12,219,0.433789954,0.050228311,0.534246575,1,0.285551035
22063,52,23678,9,9,0,0,0,18,6,8,2,10,0,26,nowin,win,dlbust,bust,20,0,18,217,0.414746544,0.02764977,0.599078341,2,0.576736024
22064,14,23678,4,8,0,0,0,12,6,8,2,10,0,26,nowin,win,dlbust,bust,20,0,12,202,0.391089109,0.01980198,0.628712871,2,0.577264877
22065,2,23678,10,5,0,0,0,15,6,8,2,10,0,26,nowin,win,dlbust,bust,20,0,15,200,0.445,0.035,0.64,2,0.633962549
22066,46,23678,10,2,0,0,0,12,6,8,2,10,0,26,nowin,win,dlbust,bust,20,0,12,186,0.403225806,0.048387097,0.591397849,0,0.029742194
22067,124,23678,2,5,10,0,0,17,6,8,2,10,0,26,nowin,win,dlbust,bust,20,0,7,202,0.47029703,0.064356436,0.584158416,3,0.899458193
22068,70,23679,4,10,0,10,0,24,10,5,5,0,0,20,nowin,loss,bust,plbust,0,10,14,228,0.385964912,0.039473684,0.557017544,0,0.016157125
22069,2,23679,10,10,0,0,0,20,10,5,5,0,0,20,nowin,push,push,push,10,0,20,200,0.445,0.035,0.64,2,0.633962549
22070,117,23679,8,11,0,0,0,19,10,5,5,0,0,20,nowin,loss,beat,dlwin,0,10,19,173,0.410404624,0.069364162,0.606936416,2,0.578610282
22071,114,23679,2,1,10,4,0,17,10,5,5,0,0,20,nowin,loss,beat,dlwin,0,10,3,198,0.47979798,0.025252525,0.611111111,3,0.937232995
22072,66,23679,10,10,0,0,0,20,10,5,5,0,0,20,nowin,push,push,push,10,0,20,217,0.456221198,0.064516129,0.626728111,3,0.924304367
22073,1,23679,8,10,0,0,0,18,10,5,5,0,0,20,nowin,loss,beat,dlwin,0,10,18,197,0.406091371,0.025380711,0.649746193,2,0.606186955
22074,99,23680,10,10,0,0,0,20,10,7,0,0,0,17,nowin,win,plwin,beat,20,0,20,207,0.47826087,0.062801932,0.637681159,3,0.961418446
22075,32,23680,10,6,0,2,0,18,10,7,0,0,0,17,nowin,win,plwin,beat,20,0,16,189,0.391534392,0.037037037,0.53968254,0,0.013579086
22076,14,23680,1,3,10,10,0,24,10,7,0,0,0,17,nowin,loss,bust,plbust,0,10,4,202,0.391089109,0.01980198,0.628712871,2,0.577264877
22077,23,23680,2,3,11,10,0,26,10,7,0,0,0,17,nowin,loss,bust,plbust,0,10,5,208,0.427884615,0.0625,0.552884615,1,0.29114424
22078,35,23680,2,6,7,3,0,18,10,7,0,0,0,17,nowin,win,plwin,beat,20,0,8,202,0.410891089,0.044554455,0.633663366,2,0.598681573
22079,112,23680,10,3,0,2,2,17,10,7,0,0,0,17,nowin,push,push,push,10,0,13,203,0.448275862,0.054187192,0.600985222,3,0.889576933
22080,50,23681,8,5,0,10,0,23,8,3,5,10,0,26,nowin,loss,bust,plbust,0,10,13,202,0.405940594,0.04950495,0.54950495,0,0.020296079
22081,95,23681,5,9,0,1,8,23,8,3,5,10,0,26,nowin,loss,bust,plbust,0,10,14,218,0.412844037,0.04587156,0.559633028,0,0.024842385
22082,19,23681,11,10,0,0,0,21,8,3,5,10,0,26,win,win,dlbust,bust,25,0,21,237,0.41350211,0.054852321,0.628691983,2,0.597373826
22083,123,23681,7,10,0,0,0,17,8,3,5,10,0,26,nowin,win,dlbust,bust,20,0,17,205,0.43902439,0.034146341,0.614634146,2,0.609962544
22084,9,23681,9,10,0,0,0,19,8,3,5,10,0,26,nowin,win,dlbust,bust,20,0,19,194,0.37628866,0.015463918,0.541237113,0,0.009396796
22085,130,23681,5,2,10,0,0,17,8,3,5,10,0,26,nowin,win,dlbust,bust,20,0,7,219,0.410958904,0.03652968,0.566210046,0,0.025888739
22086,15,23682,5,1,9,10,0,25,9,7,8,0,0,24,nowin,loss,bust,plbust,0,10,6,212,0.410377358,0.051886792,0.561320755,0,0.024517408
22087,54,23682,2,2,9,2,7,22,9,7,8,0,0,24,nowin,loss,bust,plbust,0,10,4,185,0.437837838,0.032432432,0.556756757,1,0.29899854
22088,36,23682,10,10,0,0,0,20,9,7,8,0,0,24,nowin,win,dlbust,bust,20,0,20,229,0.445414847,0.056768559,0.655021834,2,0.645370571
22089,59,23682,4,3,8,6,0,21,9,7,8,0,0,24,nowin,win,dlbust,bust,20,0,7,228,0.429824561,0.048245614,0.543859649,1,0.287885446
22090,116,23682,10,6,0,1,0,17,9,7,8,0,0,24,nowin,win,dlbust,bust,20,0,16,195,0.425641026,0.056410256,0.538461538,1,0.28273747
22091,9,23682,10,10,0,0,0,20,9,7,8,0,0,24,nowin,win,dlbust,bust,20,0,20,194,0.37628866,0.015463918,0.541237113,0,0.009396796
22092,128,23683,7,10,0,0,0,17,2,9,9,0,0,20,nowin,loss,beat,dlwin,0,10,17,227,0.356828194,0.052863436,0.577092511,0,0.012352564
22093,11,23683,10,3,0,0,0,13,2,9,9,0,0,20,nowin,loss,beat,dlwin,0,10,13,236,0.457627119,0.016949153,0.588983051,3,0.889015813
22094,119,23683,10,10,0,0,0,20,2,9,9,0,0,20,nowin,push,push,push,10,0,20,190,0.405263158,0.068421053,0.515789474,0,0.011837158
22095,129,23683,5,8,0,0,0,13,2,9,9,0,0,20,nowin,loss,beat,dlwin,0,10,13,201,0.422885572,0.064676617,0.55721393,0,0.027255383
22096,21,23683,6,10,0,0,0,16,2,9,9,0,0,20,nowin,loss,beat,dlwin,0,10,16,214,0.359813084,0.042056075,0.626168224,0,0.025263474
22097,81,23683,9,3,0,3,0,15,2,9,9,0,0,20,nowin,loss,beat,dlwin,0,10,12,182,0.395604396,0.043956044,0.60989011,2,0.567491261
22098,47,23684,9,11,0,0,0,20,4,5,5,7,0,21,nowin,loss,beat,dlwin,0,10,20,210,0.438095238,0.057142857,0.623809524,2,0.615868808
22099,58,23684,8,5,0,0,0,13,4,5,5,7,0,21,nowin,loss,beat,dlwin,0,10,13,195,0.430769231,0.041025641,0.584615385,2,0.580497586
22100,65,23684,9,7,0,0,0,16,4,5,5,7,0,21,nowin,loss,beat,dlwin,0,10,16,203,0.492610837,0.054187192,0.571428571,3,0.913702814
22101,123,23684,10,10,0,0,0,20,4,5,5,7,0,21,nowin,loss,beat,dlwin,0,10,20,205,0.43902439,0.034146341,0.614634146,2,0.609962544
22102,146,23684,8,7,0,0,0,15,4,5,5,7,0,21,nowin,loss,beat,dlwin,0,10,15,221,0.43438914,0.040723982,0.542986425,1,0.290190091
22103,112,23684,7,7,0,0,0,14,4,5,5,7,0,21,nowin,loss,beat,dlwin,0,10,14,203,0.448275862,0.054187192,0.600985222,3,0.889576933
22104,53,23685,10,11,0,0,0,21,2,8,2,1,2,15,win,win,plwin,beat,25,0,21,250,0.372,0.064,0.564,0,0.013687345
22105,99,23685,5,3,10,0,0,18,2,8,2,1,2,15,nowin,win,plwin,beat,20,0,8,207,0.47826087,0.062801932,0.637681159,3,0.961418446
22106,7,23685,6,2,5,0,0,13,2,8,2,1,2,15,nowin,loss,beat,dlwin,0,10,8,183,0.442622951,0.06010929,0.62295082,2,0.619303341
22107,15,23685,10,5,0,0,0,15,2,8,2,1,2,15,nowin,push,push,push,10,0,15,212,0.410377358,0.051886792,0.561320755,0,0.024517408
22108,71,23685,6,7,0,0,0,13,2,8,2,1,2,15,nowin,loss,beat,dlwin,0,10,13,193,0.352331606,0.046632124,0.585492228,0,0.013063661
22109,66,23685,5,8,0,0,0,13,2,8,2,1,2,15,nowin,loss,beat,dlwin,0,10,13,217,0.456221198,0.064516129,0.626728111,3,0.924304367
22110,130,23686,3,2,10,10,0,25,10,3,7,0,0,20,nowin,loss,bust,plbust,0,10,5,219,0.410958904,0.03652968,0.566210046,0,0.025888739
22111,113,23686,10,10,0,0,0,20,10,3,7,0,0,20,nowin,push,push,push,10,0,20,199,0.407035176,0.055276382,0.668341709,2,0.620695264
22112,93,23686,10,8,0,0,0,18,10,3,7,0,0,20,nowin,loss,beat,dlwin,0,10,18,175,0.485714286,0.051428571,0.548571429,1,0.323648091
22113,141,23686,10,10,0,0,0,20,10,3,7,0,0,20,nowin,push,push,push,10,0,20,202,0.420792079,0.074257426,0.564356436,0,0.028377851
22114,89,23686,5,4,2,10,0,21,10,3,7,0,0,20,nowin,win,plwin,beat,20,0,9,212,0.537735849,0.047169811,0.594339623,3,0.990167191
22115,90,23686,6,10,0,4,0,20,10,3,7,0,0,20,nowin,push,push,push,10,0,16,201,0.447761194,0.049751244,0.60199005,3,0.889945023
22116,4,23687,6,7,0,0,0,13,4,10,10,0,0,24,nowin,win,dlbust,bust,20,0,13,217,0.460829493,0.036866359,0.562211982,1,0.315432839
22117,123,23687,9,10,0,0,0,19,4,10,10,0,0,24,nowin,win,dlbust,bust,20,0,19,205,0.43902439,0.034146341,0.614634146,2,0.609962544
22118,76,23687,10,11,0,0,0,21,4,10,10,0,0,24,win,win,dlbust,bust,25,0,21,189,0.534391534,0.079365079,0.608465608,3,1
22119,17,23687,6,7,0,0,0,13,4,10,10,0,0,24,nowin,win,dlbust,bust,20,0,13,171,0.444444444,0.070175439,0.555555556,1,0.302364894
22120,130,23687,7,3,8,0,0,18,4,10,10,0,0,24,nowin,win,dlbust,bust,20,0,10,219,0.410958904,0.03652968,0.566210046,0,0.025888739
22121,38,23687,8,11,0,0,0,19,4,10,10,0,0,24,nowin,win,dlbust,bust,20,0,19,202,0.361386139,0.03960396,0.564356436,0,0.010597953
22122,42,23688,4,3,10,0,0,17,5,3,10,0,0,18,nowin,loss,beat,dlwin,0,10,7,212,0.443396226,0.051886792,0.570754717,1,0.309181312
22123,6,23688,6,1,8,0,0,15,5,3,10,0,0,18,nowin,loss,beat,dlwin,0,10,7,191,0.439790576,0.047120419,0.581151832,1,0.31211505
22124,5,23688,2,6,2,1,8,19,5,3,10,0,0,18,nowin,win,plwin,beat,20,0,8,203,0.42364532,0.02955665,0.596059113,2,0.582508076
22125,48,23688,6,5,4,0,0,15,5,3,10,0,0,18,nowin,loss,beat,dlwin,0,10,11,203,0.413793103,0.019704433,0.600985222,2,0.577280801
22126,84,23688,5,7,0,0,0,12,5,3,10,0,0,18,nowin,loss,beat,dlwin,0,10,12,195,0.379487179,0.056410256,0.569230769,0,0.017209119
22127,146,23688,9,11,0,0,0,20,5,3,10,0,0,18,nowin,win,plwin,beat,20,0,20,221,0.43438914,0.040723982,0.542986425,1,0.290190091
22128,98,23689,6,2,7,3,0,18,8,10,0,0,0,18,nowin,push,push,push,10,0,8,220,0.422727273,0.054545455,0.55,1,0.28664435
22129,133,23689,11,10,0,0,0,21,8,10,0,0,0,18,win,win,plwin,beat,25,0,21,201,0.47761194,0.064676617,0.611940299,3,0.935428111
22130,81,23689,8,10,0,0,0,18,8,10,0,0,0,18,nowin,push,push,push,10,0,18,182,0.395604396,0.043956044,0.60989011,2,0.567491261
22131,43,23689,11,1,8,0,0,20,8,10,0,0,0,18,nowin,win,plwin,beat,20,0,12,192,0.40625,0.041666667,0.609375,2,0.576671372
22132,102,23689,4,3,10,0,0,17,8,10,0,0,0,18,nowin,loss,beat,dlwin,0,10,7,192,0.338541667,0.046875,0.5625,0,0.003306118
22133,66,23689,6,2,10,0,0,18,8,10,0,0,0,18,nowin,push,push,push,10,0,8,217,0.456221198,0.064516129,0.626728111,3,0.924304367
22134,19,23690,10,6,0,0,0,16,6,8,10,0,0,24,nowin,win,dlbust,bust,20,0,16,237,0.41350211,0.054852321,0.628691983,2,0.597373826
22135,13,23690,6,3,10,0,0,19,6,8,10,0,0,24,nowin,win,dlbust,bust,20,0,9,206,0.417475728,0.063106796,0.621359223,2,0.59555479
22136,116,23690,2,2,10,0,0,14,6,8,10,0,0,24,nowin,win,dlbust,bust,20,0,4,195,0.425641026,0.056410256,0.538461538,1,0.28273747
22137,9,23690,5,5,2,0,0,12,6,8,10,0,0,24,nowin,win,dlbust,bust,20,0,10,194,0.37628866,0.015463918,0.541237113,0,0.009396796
22138,38,23690,6,10,0,0,0,16,6,8,10,0,0,24,nowin,win,dlbust,bust,20,0,16,202,0.361386139,0.03960396,0.564356436,0,0.010597953
22139,141,23690,10,10,0,0,0,20,6,8,10,0,0,24,nowin,win,dlbust,bust,20,0,20,202,0.420792079,0.074257426,0.564356436,0,0.028377851
22140,15,23691,10,10,0,0,0,20,1,5,10,9,0,25,nowin,win,dlbust,bust,20,0,20,212,0.410377358,0.051886792,0.561320755,0,0.024517408
22141,31,23691,10,2,0,6,0,18,1,5,10,9,0,25,nowin,win,dlbust,bust,20,0,12,188,0.473404255,0.058510638,0.515957447,1,0.300306557
22142,3,23691,10,10,0,0,0,20,1,5,10,9,0,25,nowin,win,dlbust,bust,20,0,20,190,0.431578947,0.026315789,0.542105263,1,0.288076384
22143,133,23691,10,10,0,0,0,20,1,5,10,9,0,25,nowin,win,dlbust,bust,20,0,20,201,0.47761194,0.064676617,0.611940299,3,0.935428111
22144,83,23691,8,10,0,0,0,18,1,5,10,9,0,25,nowin,win,dlbust,bust,20,0,18,193,0.424870466,0.051813472,0.678756477,2,0.644360335
22145,9,23691,3,8,5,8,0,24,1,5,10,9,0,25,nowin,loss,bust,plbust,0,10,11,194,0.37628866,0.015463918,0.541237113,0,0.009396796
22146,123,23692,3,10,0,9,0,22,7,11,0,0,0,18,nowin,loss,bust,plbust,0,10,13,205,0.43902439,0.034146341,0.614634146,2,0.609962544
22147,51,23692,7,6,0,5,0,18,7,11,0,0,0,18,nowin,push,push,push,10,0,13,189,0.529100529,0.068783069,0.608465608,3,0.993665715
22148,5,23692,10,10,0,0,0,20,7,11,0,0,0,18,nowin,win,plwin,beat,20,0,20,203,0.42364532,0.02955665,0.596059113,2,0.582508076
22149,67,23692,10,7,0,0,0,17,7,11,0,0,0,18,nowin,loss,beat,dlwin,0,10,17,195,0.369230769,0.041025641,0.569230769,0,0.014139427
22150,24,23692,9,7,0,3,0,19,7,11,0,0,0,18,nowin,win,plwin,beat,20,0,16,207,0.458937198,0.048309179,0.570048309,1,0.318138014
22151,55,23692,10,5,0,10,0,25,7,11,0,0,0,18,nowin,loss,bust,plbust,0,10,15,191,0.371727749,0.057591623,0.54973822,0,0.01011347
22152,43,23693,2,6,4,6,0,18,2,10,1,4,0,17,nowin,win,plwin,beat,20,0,8,192,0.40625,0.041666667,0.609375,2,0.576671372
22153,139,23693,5,4,2,10,0,21,2,10,1,4,0,17,nowin,win,plwin,beat,20,0,9,192,0.380208333,0.036458333,0.59375,0,0.023429169
22154,45,23693,2,2,10,0,0,14,2,10,1,4,0,17,nowin,loss,beat,dlwin,0,10,4,196,0.428571429,0.051020408,0.612244898,2,0.598821767
22155,95,23693,10,10,0,0,0,20,2,10,1,4,0,17,nowin,win,plwin,beat,20,0,20,218,0.412844037,0.04587156,0.559633028,0,0.024842385
22156,88,23693,10,4,0,0,0,14,2,10,1,4,0,17,nowin,loss,beat,dlwin,0,10,14,206,0.466019417,0.033980583,0.54368932,1,0.309467903
22157,47,23693,11,5,1,0,0,17,2,10,1,4,0,17,nowin,push,push,push,10,0,16,210,0.438095238,0.057142857,0.623809524,2,0.615868808
22158,53,23694,10,5,0,2,0,17,10,3,10,0,0,23,nowin,win,dlbust,bust,20,0,15,250,0.372,0.064,0.564,0,0.013687345
22159,115,23694,10,3,0,8,0,21,10,3,10,0,0,23,nowin,win,dlbust,bust,20,0,13,194,0.427835052,0.041237113,0.592783505,2,0.583863602
22160,141,23694,6,10,0,4,0,20,10,3,10,0,0,23,nowin,win,dlbust,bust,20,0,16,202,0.420792079,0.074257426,0.564356436,0,0.028377851
22161,96,23694,9,10,0,0,0,19,10,3,10,0,0,23,nowin,win,dlbust,bust,20,0,19,190,0.468421053,0.057894737,0.584210526,3,0.897263354
22162,56,23694,2,6,9,0,0,17,10,3,10,0,0,23,nowin,win,dlbust,bust,20,0,8,175,0.4,0.057142857,0.582857143,0,0.026685297
22163,125,23694,8,11,0,0,0,19,10,3,10,0,0,23,nowin,win,dlbust,bust,20,0,19,219,0.438356164,0.050228311,0.575342466,1,0.308411257
22164,89,23695,9,8,0,0,0,17,7,10,0,0,0,17,nowin,push,push,push,10,0,17,212,0.537735849,0.047169811,0.594339623,3,0.990167191
22165,12,23695,11,7,0,0,0,18,7,10,0,0,0,17,nowin,win,plwin,beat,20,0,18,189,0.470899471,0.015873016,0.613756614,3,0.929171178
22166,42,23695,10,10,0,0,0,20,7,10,0,0,0,17,nowin,win,plwin,beat,20,0,20,212,0.443396226,0.051886792,0.570754717,1,0.309181312
22167,82,23695,11,6,1,0,0,18,7,10,0,0,0,17,nowin,win,plwin,beat,20,0,17,225,0.408888889,0.075555556,0.577777778,0,0.028101874
22168,67,23695,3,5,11,0,0,19,7,10,0,0,0,17,nowin,win,plwin,beat,20,0,8,195,0.369230769,0.041025641,0.569230769,0,0.014139427
22169,113,23695,11,10,0,0,0,21,7,10,0,0,0,17,win,win,plwin,beat,25,0,21,199,0.407035176,0.055276382,0.668341709,2,0.620695264
22170,147,23696,2,10,0,8,0,20,9,5,1,1,10,26,nowin,win,dlbust,bust,20,0,12,205,0.380487805,0.014634146,0.536585366,0,0.00951447
22171,143,23696,8,10,0,0,0,18,9,5,1,1,10,26,nowin,win,dlbust,bust,20,0,18,203,0.463054187,0.044334975,0.57635468,3,0.883143365
22172,23,23696,10,7,0,0,0,17,9,5,1,1,10,26,nowin,win,dlbust,bust,20,0,17,208,0.427884615,0.0625,0.552884615,1,0.29114424
22173,85,23696,6,10,0,6,0,22,9,5,1,1,10,26,nowin,loss,bust,plbust,0,10,16,195,0.41025641,0.066666667,0.594871795,0,0.03269711
22174,63,23696,10,4,0,3,0,17,9,5,1,1,10,26,nowin,win,dlbust,bust,20,0,14,216,0.467592593,0.037037037,0.62037037,3,0.931690496
22175,33,23696,10,6,0,2,0,18,9,5,1,1,10,26,nowin,win,dlbust,bust,20,0,16,192,0.4375,0.057291667,0.625,2,0.616208916
22176,56,23697,2,10,0,10,0,22,3,10,4,0,0,17,nowin,loss,bust,plbust,0,10,12,175,0.4,0.057142857,0.582857143,0,0.026685297
22177,136,23697,4,4,9,0,0,17,3,10,4,0,0,17,nowin,push,push,push,10,0,8,194,0.396907216,0.025773196,0.597938144,0,0.029452644
22178,51,23697,3,11,5,0,0,19,3,10,4,0,0,17,nowin,win,plwin,beat,20,0,14,189,0.529100529,0.068783069,0.608465608,3,0.993665715
22179,118,23697,1,6,5,10,0,22,3,10,4,0,0,17,nowin,loss,bust,plbust,0,10,7,216,0.393518519,0.037037037,0.555555556,0,0.018059873
22180,2,23697,5,3,6,0,0,14,3,10,4,0,0,17,nowin,loss,beat,dlwin,0,10,8,200,0.445,0.035,0.64,2,0.633962549
22181,26,23697,9,10,0,0,0,19,3,10,4,0,0,17,nowin,win,plwin,beat,20,0,19,203,0.463054187,0.0591133,0.541871921,1,0.306802864
22182,120,23698,11,10,0,0,0,21,7,10,0,0,0,17,win,win,plwin,beat,25,0,21,202,0.440594059,0.034653465,0.618811881,2,0.614441029
22183,36,23698,7,10,0,0,0,17,7,10,0,0,0,17,nowin,push,push,push,10,0,17,229,0.445414847,0.056768559,0.655021834,2,0.645370571
22184,149,23698,10,4,0,9,0,23,7,10,0,0,0,17,nowin,loss,bust,plbust,0,10,14,225,0.457777778,0.057777778,0.648888889,2,0.651965595
22185,52,23698,5,9,0,5,0,19,7,10,0,0,0,17,nowin,win,plwin,beat,20,0,14,217,0.414746544,0.02764977,0.599078341,2,0.576736024
22186,90,23698,9,3,0,10,0,22,7,10,0,0,0,17,nowin,loss,bust,plbust,0,10,12,201,0.447761194,0.049751244,0.60199005,3,0.889945023
22187,35,23698,10,10,0,0,0,20,7,10,0,0,0,17,nowin,win,plwin,beat,20,0,20,202,0.410891089,0.044554455,0.633663366,2,0.598681573
22188,19,23699,10,11,0,0,0,21,7,8,10,0,0,25,win,win,dlbust,bust,25,0,21,237,0.41350211,0.054852321,0.628691983,2,0.597373826
22189,14,23699,3,3,6,1,8,21,7,8,10,0,0,25,nowin,win,dlbust,bust,20,0,6,202,0.391089109,0.01980198,0.628712871,2,0.577264877
22190,72,23699,10,8,0,0,0,18,7,8,10,0,0,25,nowin,win,dlbust,bust,20,0,18,185,0.394594595,0.032432432,0.508108108,0,0.006763115
22191,26,23699,7,10,0,0,0,17,7,8,10,0,0,25,nowin,win,dlbust,bust,20,0,17,203,0.463054187,0.0591133,0.541871921,1,0.306802864
22192,16,23699,2,10,0,10,0,22,7,8,10,0,0,25,nowin,loss,bust,plbust,0,10,12,220,0.427272727,0.081818182,0.6,2,0.588660176
22193,92,23699,10,8,0,0,0,18,7,8,10,0,0,25,nowin,win,dlbust,bust,20,0,18,186,0.446236559,0.059139785,0.564516129,1,0.307826125
22194,84,23700,10,6,0,10,0,26,10,11,0,0,0,21,nowin,loss,bust,plbust,0,10,16,195,0.379487179,0.056410256,0.569230769,0,0.017209119
22195,80,23700,9,10,0,0,0,19,10,11,0,0,0,21,nowin,loss,beat,dlwin,0,10,19,186,0.419354839,0.059139785,0.623655914,2,0.59892924
22196,86,23700,5,3,11,0,0,19,10,11,0,0,0,21,nowin,loss,beat,dlwin,0,10,8,196,0.454081633,0.040816327,0.591836735,3,0.887566443
22197,13,23700,8,4,0,1,2,15,10,11,0,0,0,21,nowin,loss,beat,dlwin,0,10,12,206,0.417475728,0.063106796,0.621359223,2,0.59555479
22198,70,23700,10,2,0,5,0,17,10,11,0,0,0,21,nowin,loss,beat,dlwin,0,10,12,228,0.385964912,0.039473684,0.557017544,0,0.016157125
22199,115,23700,3,6,10,0,0,19,10,11,0,0,0,21,nowin,loss,beat,dlwin,0,10,9,194,0.427835052,0.041237113,0.592783505,2,0.583863602
22200,30,23701,5,4,7,9,0,25,9,10,0,0,0,19,nowin,loss,bust,plbust,0,10,9,206,0.393203883,0.033980583,0.601941748,0,0.029324648
22201,7,23701,10,3,0,8,0,21,9,10,0,0,0,19,nowin,win,plwin,beat,20,0,13,183,0.442622951,0.06010929,0.62295082,2,0.619303341
22202,39,23701,8,7,0,10,0,25,9,10,0,0,0,19,nowin,loss,bust,plbust,0,10,15,191,0.429319372,0.062827225,0.57591623,0,0.033760763
22203,53,23701,3,2,2,7,9,23,9,10,0,0,0,19,nowin,loss,bust,plbust,0,10,5,250,0.372,0.064,0.564,0,0.013687345
22204,10,23701,7,6,0,1,5,19,9,10,0,0,0,19,nowin,push,push,push,10,0,13,191,0.413612565,0.057591623,0.596858639,2,0.574087175
22205,57,23701,3,11,4,0,0,18,9,10,0,0,0,19,nowin,loss,beat,dlwin,0,10,14,192,0.46875,0.052083333,0.59375,3,0.907001181
22206,14,23702,7,5,0,4,1,17,8,2,5,10,0,25,nowin,win,dlbust,bust,20,0,12,202,0.391089109,0.01980198,0.628712871,2,0.577264877
22207,78,23702,3,10,0,3,8,24,8,2,5,10,0,25,nowin,loss,bust,plbust,0,10,13,201,0.517412935,0.034825871,0.587064677,3,0.95871112
22208,125,23702,6,6,0,10,0,22,8,2,5,10,0,25,nowin,loss,bust,plbust,0,10,12,219,0.438356164,0.050228311,0.575342466,1,0.308411257
22209,62,23702,8,8,0,7,0,23,8,2,5,10,0,25,nowin,loss,bust,plbust,0,10,16,178,0.370786517,0.028089888,0.54494382,0,0.008657722
22210,32,23702,3,10,0,1,1,15,8,2,5,10,0,25,nowin,win,dlbust,bust,20,0,13,189,0.391534392,0.037037037,0.53968254,0,0.013579086
22211,25,23702,10,10,0,0,0,20,8,2,5,10,0,25,nowin,win,dlbust,bust,20,0,20,190,0.463157895,0.063157895,0.536842105,1,0.304401563
22212,113,23703,8,11,0,0,0,19,10,10,0,0,0,20,nowin,loss,beat,dlwin,0,10,19,199,0.407035176,0.055276382,0.668341709,2,0.620695264
22213,140,23703,7,10,0,0,0,17,10,10,0,0,0,20,nowin,loss,beat,dlwin,0,10,17,210,0.466666667,0.023809524,0.604761905,3,0.915293335
22214,128,23703,2,11,3,8,0,24,10,10,0,0,0,20,nowin,loss,bust,plbust,0,10,13,227,0.356828194,0.052863436,0.577092511,0,0.012352564
22215,99,23703,10,10,0,0,0,20,10,10,0,0,0,20,nowin,push,push,push,10,0,20,207,0.47826087,0.062801932,0.637681159,3,0.961418446
22216,44,23703,6,10,0,9,0,25,10,10,0,0,0,20,nowin,loss,bust,plbust,0,10,16,219,0.433789954,0.050228311,0.534246575,1,0.285551035
22217,38,23703,3,10,0,3,5,21,10,10,0,0,0,20,nowin,win,plwin,beat,20,0,13,202,0.361386139,0.03960396,0.564356436,0,0.010597953
22218,48,23704,10,5,0,0,0,15,3,6,7,6,0,22,nowin,win,dlbust,bust,20,0,15,203,0.413793103,0.019704433,0.600985222,2,0.577280801
22219,6,23704,6,7,0,0,0,13,3,6,7,6,0,22,nowin,win,dlbust,bust,20,0,13,191,0.439790576,0.047120419,0.581151832,1,0.31211505
22220,149,23704,10,7,0,0,0,17,3,6,7,6,0,22,nowin,win,dlbust,bust,20,0,17,225,0.457777778,0.057777778,0.648888889,2,0.651965595
22221,2,23704,10,7,0,0,0,17,3,6,7,6,0,22,nowin,win,dlbust,bust,20,0,17,200,0.445,0.035,0.64,2,0.633962549
22222,126,23704,2,3,6,8,0,19,3,6,7,6,0,22,nowin,win,dlbust,bust,20,0,5,188,0.457446809,0.074468085,0.60106383,3,0.900633203
22223,16,23704,10,10,0,0,0,20,3,6,7,6,0,22,nowin,win,dlbust,bust,20,0,20,220,0.427272727,0.081818182,0.6,2,0.588660176
22224,89,23705,6,11,1,0,0,18,5,1,8,3,0,17,nowin,win,plwin,beat,20,0,17,212,0.537735849,0.047169811,0.594339623,3,0.990167191
22225,53,23705,4,9,0,0,0,13,5,1,8,3,0,17,nowin,loss,beat,dlwin,0,10,13,250,0.372,0.064,0.564,0,0.013687345
22226,121,23705,10,9,0,0,0,19,5,1,8,3,0,17,nowin,win,plwin,beat,20,0,19,195,0.456410256,0.025641026,0.512820513,1,0.288597791
22227,113,23705,10,8,0,0,0,18,5,1,8,3,0,17,nowin,win,plwin,beat,20,0,18,199,0.407035176,0.055276382,0.668341709,2,0.620695264
22228,57,23705,10,8,0,0,0,18,5,1,8,3,0,17,nowin,win,plwin,beat,20,0,18,192,0.46875,0.052083333,0.59375,3,0.907001181
22229,120,23705,8,5,0,0,0,13,5,1,8,3,0,17,nowin,loss,beat,dlwin,0,10,13,202,0.440594059,0.034653465,0.618811881,2,0.614441029
22230,87,23706,9,10,0,0,0,19,5,7,1,7,0,20,nowin,loss,beat,dlwin,0,10,19,202,0.405940594,0.054455446,0.628712871,2,0.590599801
22231,16,23706,10,10,0,0,0,20,5,7,1,7,0,20,nowin,push,push,push,10,0,20,220,0.427272727,0.081818182,0.6,2,0.588660176
22232,131,23706,5,7,0,0,0,12,5,7,1,7,0,20,nowin,loss,beat,dlwin,0,10,12,217,0.410138249,0.069124424,0.543778802,0,0.02015021
22233,18,23706,5,10,0,0,0,15,5,7,1,7,0,20,nowin,loss,beat,dlwin,0,10,15,182,0.461538462,0.043956044,0.587912088,3,0.892649374
22234,47,23706,4,1,10,0,0,15,5,7,1,7,0,20,nowin,loss,beat,dlwin,0,10,5,210,0.438095238,0.057142857,0.623809524,2,0.615868808
22235,139,23706,9,4,0,0,0,13,5,7,1,7,0,20,nowin,loss,beat,dlwin,0,10,13,192,0.380208333,0.036458333,0.59375,0,0.023429169
22236,84,23707,4,6,10,0,0,20,8,10,0,0,0,18,nowin,win,plwin,beat,20,0,10,195,0.379487179,0.056410256,0.569230769,0,0.017209119
22237,70,23707,6,6,0,4,4,20,8,10,0,0,0,18,nowin,win,plwin,beat,20,0,12,228,0.385964912,0.039473684,0.557017544,0,0.016157125
22238,98,23707,2,8,6,10,0,26,8,10,0,0,0,18,nowin,loss,bust,plbust,0,10,10,220,0.422727273,0.054545455,0.55,1,0.28664435
22239,149,23707,1,5,8,6,0,20,8,10,0,0,0,18,nowin,win,plwin,beat,20,0,6,225,0.457777778,0.057777778,0.648888889,2,0.651965595
22240,10,23707,1,1,10,6,0,18,8,10,0,0,0,18,nowin,push,push,push,10,0,2,191,0.413612565,0.057591623,0.596858639,2,0.574087175
22241,97,23707,3,5,10,0,0,18,8,10,0,0,0,18,nowin,push,push,push,10,0,8,182,0.450549451,0.06043956,0.692307692,2,0.677372279
22242,97,23708,11,10,0,0,0,21,11,8,0,0,0,19,win,win,plwin,beat,25,0,21,182,0.450549451,0.06043956,0.692307692,2,0.677372279
22243,140,23708,5,4,7,10,0,26,11,8,0,0,0,19,nowin,loss,bust,plbust,0,10,9,210,0.466666667,0.023809524,0.604761905,3,0.915293335
22244,116,23708,10,4,0,1,2,17,11,8,0,0,0,19,nowin,loss,beat,dlwin,0,10,14,195,0.425641026,0.056410256,0.538461538,1,0.28273747
22245,145,23708,10,9,0,0,0,19,11,8,0,0,0,19,nowin,push,push,push,10,0,19,188,0.441489362,0.031914894,0.622340426,2,0.617837093
22246,124,23708,4,10,0,5,0,19,11,8,0,0,0,19,nowin,push,push,push,10,0,14,202,0.47029703,0.064356436,0.584158416,3,0.899458193
22247,113,23708,10,7,0,0,0,17,11,8,0,0,0,19,nowin,loss,beat,dlwin,0,10,17,199,0.407035176,0.055276382,0.668341709,2,0.620695264
22248,30,23709,10,9,0,0,0,19,5,4,8,0,0,17,nowin,win,plwin,beat,20,0,19,206,0.393203883,0.033980583,0.601941748,0,0.029324648
22249,53,23709,10,3,0,0,0,13,5,4,8,0,0,17,nowin,loss,beat,dlwin,0,10,13,250,0.372,0.064,0.564,0,0.013687345
22250,31,23709,5,5,10,0,0,20,5,4,8,0,0,17,nowin,win,plwin,beat,20,0,10,188,0.473404255,0.058510638,0.515957447,1,0.300306557
22251,63,23709,9,10,0,0,0,19,5,4,8,0,0,17,nowin,win,plwin,beat,20,0,19,216,0.467592593,0.037037037,0.62037037,3,0.931690496
22252,37,23709,10,4,0,0,0,14,5,4,8,0,0,17,nowin,loss,beat,dlwin,0,10,14,208,0.394230769,0.038461538,0.581730769,0,0.024682772
22253,107,23709,10,10,0,0,0,20,5,4,8,0,0,17,nowin,win,plwin,beat,20,0,20,218,0.444954128,0.073394495,0.600917431,2,0.605210014
22254,144,23710,7,10,0,0,0,17,10,11,0,0,0,21,nowin,loss,beat,dlwin,0,10,17,202,0.386138614,0.054455446,0.564356436,0,0.018006244
22255,3,23710,6,10,0,2,0,18,10,11,0,0,0,21,nowin,loss,beat,dlwin,0,10,16,190,0.431578947,0.026315789,0.542105263,1,0.288076384
22256,105,23710,4,9,0,3,9,25,10,11,0,0,0,21,nowin,loss,bust,plbust,0,10,13,198,0.414141414,0.070707071,0.590909091,0,0.032889494
22257,52,23710,8,5,0,8,0,21,10,11,0,0,0,21,nowin,push,push,push,10,0,13,217,0.414746544,0.02764977,0.599078341,2,0.576736024
22258,41,23710,10,9,0,0,0,19,10,11,0,0,0,21,nowin,loss,beat,dlwin,0,10,19,192,0.364583333,0.036458333,0.520833333,0,0.00089702
22259,147,23710,10,11,0,0,0,21,10,11,0,0,0,21,win,push,push,push,10,0,21,205,0.380487805,0.014634146,0.536585366,0,0.00951447
22260,108,23711,5,2,3,2,5,17,10,2,7,0,0,19,nowin,loss,beat,dlwin,0,10,7,193,0.435233161,0.056994819,0.559585492,1,0.298824795
22261,126,23711,8,2,10,0,0,20,10,2,7,0,0,19,nowin,win,plwin,beat,20,0,10,188,0.457446809,0.074468085,0.60106383,3,0.900633203
22262,37,23711,7,4,10,0,0,21,10,2,7,0,0,19,nowin,win,plwin,beat,20,0,11,208,0.394230769,0.038461538,0.581730769,0,0.024682772
22263,20,23711,10,10,0,0,0,20,10,2,7,0,0,19,nowin,win,plwin,beat,20,0,20,186,0.456989247,0.037634409,0.537634409,1,0.301097108
22264,32,23711,10,3,0,8,0,21,10,2,7,0,0,19,nowin,win,plwin,beat,20,0,13,189,0.391534392,0.037037037,0.53968254,0,0.013579086
22265,56,23711,9,5,0,10,0,24,10,2,7,0,0,19,nowin,loss,bust,plbust,0,10,14,175,0.4,0.057142857,0.582857143,0,0.026685297
22266,30,23712,9,6,0,10,0,25,7,5,2,3,0,17,nowin,loss,bust,plbust,0,10,15,206,0.393203883,0.033980583,0.601941748,0,0.029324648
22267,7,23712,11,1,9,0,0,21,7,5,2,3,0,17,nowin,win,plwin,beat,20,0,12,183,0.442622951,0.06010929,0.62295082,2,0.619303341
22268,46,23712,10,4,0,6,0,20,7,5,2,3,0,17,nowin,win,plwin,beat,20,0,14,186,0.403225806,0.048387097,0.591397849,0,0.029742194
22269,52,23712,3,11,6,0,0,20,7,5,2,3,0,17,nowin,win,plwin,beat,20,0,14,217,0.414746544,0.02764977,0.599078341,2,0.576736024
22270,96,23712,9,4,0,10,0,23,7,5,2,3,0,17,nowin,loss,bust,plbust,0,10,13,190,0.468421053,0.057894737,0.584210526,3,0.897263354
22271,143,23712,6,5,8,0,0,19,7,5,2,3,0,17,nowin,win,plwin,beat,20,0,11,203,0.463054187,0.044334975,0.57635468,3,0.883143365
22272,107,23713,3,10,0,10,0,23,10,10,0,0,0,20,nowin,loss,bust,plbust,0,10,13,218,0.444954128,0.073394495,0.600917431,2,0.605210014
22273,135,23713,5,7,0,10,0,22,10,10,0,0,0,20,nowin,loss,bust,plbust,0,10,12,179,0.391061453,0.067039106,0.586592179,0,0.024924662
22274,14,23713,7,10,0,0,0,17,10,10,0,0,0,20,nowin,loss,beat,dlwin,0,10,17,202,0.391089109,0.01980198,0.628712871,2,0.577264877
22275,9,23713,4,2,10,2,0,18,10,10,0,0,0,20,nowin,loss,beat,dlwin,0,10,6,194,0.37628866,0.015463918,0.541237113,0,0.009396796
22276,110,23713,7,11,0,0,0,18,10,10,0,0,0,20,nowin,loss,beat,dlwin,0,10,18,192,0.416666667,0.046875,0.557291667,0,0.025413132
22277,143,23713,4,6,3,10,0,23,10,10,0,0,0,20,nowin,loss,bust,plbust,0,10,10,203,0.463054187,0.044334975,0.57635468,3,0.883143365
22278,18,23714,3,9,0,10,0,22,10,10,0,0,0,20,nowin,loss,bust,plbust,0,10,12,182,0.461538462,0.043956044,0.587912088,3,0.892649374
22279,87,23714,11,10,0,0,0,21,10,10,0,0,0,20,win,win,plwin,beat,25,0,21,202,0.405940594,0.054455446,0.628712871,2,0.590599801
22280,17,23714,6,9,0,1,5,21,10,10,0,0,0,20,nowin,win,plwin,beat,20,0,15,171,0.444444444,0.070175439,0.555555556,1,0.302364894
22281,45,23714,11,10,0,0,0,21,10,10,0,0,0,20,win,win,plwin,beat,25,0,21,196,0.428571429,0.051020408,0.612244898,2,0.598821767
22282,10,23714,9,10,0,0,0,19,10,10,0,0,0,20,nowin,loss,beat,dlwin,0,10,19,191,0.413612565,0.057591623,0.596858639,2,0.574087175
22283,41,23714,6,10,0,10,0,26,10,10,0,0,0,20,nowin,loss,bust,plbust,0,10,16,192,0.364583333,0.036458333,0.520833333,0,0.00089702
22284,1,23715,10,11,0,0,0,21,11,10,0,0,0,21,win,push,push,push,10,0,21,197,0.406091371,0.025380711,0.649746193,2,0.606186955
22285,140,23715,7,8,0,10,0,25,11,10,0,0,0,21,nowin,loss,bust,plbust,0,10,15,210,0.466666667,0.023809524,0.604761905,3,0.915293335
22286,29,23715,3,10,0,10,0,23,11,10,0,0,0,21,nowin,loss,bust,plbust,0,10,13,189,0.44973545,0.058201058,0.544973545,1,0.300349439
22287,141,23715,9,6,0,10,0,25,11,10,0,0,0,21,nowin,loss,bust,plbust,0,10,15,202,0.420792079,0.074257426,0.564356436,0,0.028377851
22288,33,23715,8,11,0,0,0,19,11,10,0,0,0,21,nowin,loss,beat,dlwin,0,10,19,192,0.4375,0.057291667,0.625,2,0.616208916
22289,59,23715,6,10,0,9,0,25,11,10,0,0,0,21,nowin,loss,bust,plbust,0,10,16,228,0.429824561,0.048245614,0.543859649,1,0.287885446
22290,79,23716,4,10,0,1,3,18,10,6,4,0,0,20,nowin,loss,beat,dlwin,0,10,14,211,0.436018957,0.028436019,0.672985782,2,0.650131054
22291,102,23716,4,5,4,8,0,21,10,6,4,0,0,20,nowin,win,plwin,beat,20,0,9,192,0.338541667,0.046875,0.5625,0,0.003306118
22292,125,23716,2,5,10,0,0,17,10,6,4,0,0,20,nowin,loss,beat,dlwin,0,10,7,219,0.438356164,0.050228311,0.575342466,1,0.308411257
22293,135,23716,10,2,0,5,0,17,10,6,4,0,0,20,nowin,loss,beat,dlwin,0,10,12,179,0.391061453,0.067039106,0.586592179,0,0.024924662
22294,38,23716,10,2,0,8,0,20,10,6,4,0,0,20,nowin,push,push,push,10,0,12,202,0.361386139,0.03960396,0.564356436,0,0.010597953
22295,61,23716,5,8,0,10,0,23,10,6,4,0,0,20,nowin,loss,bust,plbust,0,10,13,194,0.427835052,0.077319588,0.603092784,2,0.591437139
22296,149,23717,10,8,0,0,0,18,7,6,3,10,0,26,nowin,win,dlbust,bust,20,0,18,225,0.457777778,0.057777778,0.648888889,2,0.651965595
22297,66,23717,10,8,0,0,0,18,7,6,3,10,0,26,nowin,win,dlbust,bust,20,0,18,217,0.456221198,0.064516129,0.626728111,3,0.924304367
22298,59,23717,7,5,0,6,0,18,7,6,3,10,0,26,nowin,win,dlbust,bust,20,0,12,228,0.429824561,0.048245614,0.543859649,1,0.287885446
22299,133,23717,1,1,10,6,0,18,7,6,3,10,0,26,nowin,win,dlbust,bust,20,0,2,201,0.47761194,0.064676617,0.611940299,3,0.935428111
22300,125,23717,2,10,0,6,0,18,7,6,3,10,0,26,nowin,win,dlbust,bust,20,0,12,219,0.438356164,0.050228311,0.575342466,1,0.308411257
22301,149,23717,10,2,0,5,0,17,7,6,3,10,0,26,nowin,win,dlbust,bust,20,0,12,225,0.457777778,0.057777778,0.648888889,2,0.651965595
22302,70,23718,9,4,0,10,0,23,10,11,0,0,0,21,nowin,loss,bust,plbust,0,10,13,228,0.385964912,0.039473684,0.557017544,0,0.016157125
22303,100,23718,10,3,0,10,0,23,10,11,0,0,0,21,nowin,loss,bust,plbust,0,10,13,190,0.452631579,0.036842105,0.594736842,3,0.888671154
22304,24,23718,11,10,0,0,0,21,10,11,0,0,0,21,win,push,push,push,10,0,21,207,0.458937198,0.048309179,0.570048309,1,0.318138014
22305,104,23718,8,9,0,0,0,17,10,11,0,0,0,21,nowin,loss,beat,dlwin,0,10,17,209,0.363636364,0.052631579,0.593301435,0,0.018359419
22306,101,23718,10,7,0,0,0,17,10,11,0,0,0,21,nowin,loss,beat,dlwin,0,10,17,205,0.424390244,0.068292683,0.63902439,2,0.614740646
22307,94,23718,5,4,10,0,0,19,10,11,0,0,0,21,nowin,loss,beat,dlwin,0,10,9,183,0.43715847,0.043715847,0.540983607,1,0.290866892
22308,73,23719,10,10,0,0,0,20,10,10,0,0,0,20,nowin,push,push,push,10,0,20,181,0.375690608,0.011049724,0.596685083,0,0.022795773
22309,81,23719,2,5,6,6,0,19,10,10,0,0,0,20,nowin,loss,beat,dlwin,0,10,7,182,0.395604396,0.043956044,0.60989011,2,0.567491261
22310,118,23719,10,10,0,0,0,20,10,10,0,0,0,20,nowin,push,push,push,10,0,20,216,0.393518519,0.037037037,0.555555556,0,0.018059873
22311,38,23719,11,10,0,0,0,21,10,10,0,0,0,20,win,win,plwin,beat,25,0,21,202,0.361386139,0.03960396,0.564356436,0,0.010597953
22312,109,23719,10,9,0,0,0,19,10,10,0,0,0,20,nowin,loss,beat,dlwin,0,10,19,221,0.461538462,0.058823529,0.597285068,3,0.901830309
22313,91,23719,5,8,0,9,0,22,10,10,0,0,0,20,nowin,loss,bust,plbust,0,10,13,194,0.417525773,0.046391753,0.515463918,1,0.266616552
22314,113,23720,8,6,0,2,5,21,10,11,0,0,0,21,nowin,push,push,push,10,0,14,199,0.407035176,0.055276382,0.668341709,2,0.620695264
22315,65,23720,10,2,0,2,4,18,10,11,0,0,0,21,nowin,loss,beat,dlwin,0,10,12,203,0.492610837,0.054187192,0.571428571,3,0.913702814
22316,96,23720,5,10,0,3,0,18,10,11,0,0,0,21,nowin,loss,beat,dlwin,0,10,15,190,0.468421053,0.057894737,0.584210526,3,0.897263354
22317,133,23720,10,10,0,0,0,20,10,11,0,0,0,21,nowin,loss,beat,dlwin,0,10,20,201,0.47761194,0.064676617,0.611940299,3,0.935428111
22318,129,23720,6,10,0,10,0,26,10,11,0,0,0,21,nowin,loss,bust,plbust,0,10,16,201,0.422885572,0.064676617,0.55721393,0,0.027255383
22319,103,23720,10,10,0,0,0,20,10,11,0,0,0,21,nowin,loss,beat,dlwin,0,10,20,203,0.379310345,0.064039409,0.551724138,0,0.012869209
22320,146,23721,10,6,0,2,0,18,10,9,0,0,0,19,nowin,loss,beat,dlwin,0,10,16,221,0.43438914,0.040723982,0.542986425,1,0.290190091
22321,104,23721,10,10,0,0,0,20,10,9,0,0,0,19,nowin,win,plwin,beat,20,0,20,209,0.363636364,0.052631579,0.593301435,0,0.018359419
22322,20,23721,10,6,0,10,0,26,10,9,0,0,0,19,nowin,loss,bust,plbust,0,10,16,186,0.456989247,0.037634409,0.537634409,1,0.301097108
22323,41,23721,4,7,2,1,8,22,10,9,0,0,0,19,nowin,loss,bust,plbust,0,10,11,192,0.364583333,0.036458333,0.520833333,0,0.00089702
22324,129,23721,2,10,0,2,9,23,10,9,0,0,0,19,nowin,loss,bust,plbust,0,10,12,201,0.422885572,0.064676617,0.55721393,0,0.027255383
22325,134,23721,6,8,0,4,0,18,10,9,0,0,0,19,nowin,loss,beat,dlwin,0,10,14,185,0.443243243,0.021621622,0.545945946,1,0.296939509
22326,19,23722,10,10,0,0,0,20,8,6,10,0,0,24,nowin,win,dlbust,bust,20,0,20,237,0.41350211,0.054852321,0.628691983,2,0.597373826
22327,98,23722,10,10,0,0,0,20,8,6,10,0,0,24,nowin,win,dlbust,bust,20,0,20,220,0.422727273,0.054545455,0.55,1,0.28664435
22328,147,23722,10,9,0,0,0,19,8,6,10,0,0,24,nowin,win,dlbust,bust,20,0,19,205,0.380487805,0.014634146,0.536585366,0,0.00951447
22329,105,23722,10,10,0,0,0,20,8,6,10,0,0,24,nowin,win,dlbust,bust,20,0,20,198,0.414141414,0.070707071,0.590909091,0,0.032889494
22330,148,23722,4,7,2,10,0,23,8,6,10,0,0,24,nowin,loss,bust,plbust,0,10,11,204,0.401960784,0.078431373,0.593137255,0,0.029789521
22331,118,23722,10,2,0,10,0,22,8,6,10,0,0,24,nowin,loss,bust,plbust,0,10,12,216,0.393518519,0.037037037,0.555555556,0,0.018059873
22332,74,23723,10,9,0,0,0,19,10,8,0,0,0,18,nowin,win,plwin,beat,20,0,19,209,0.411483254,0.04784689,0.531100478,0,0.017448125
22333,77,23723,1,5,7,1,10,24,10,8,0,0,0,18,nowin,loss,bust,plbust,0,10,6,200,0.455,0.04,0.62,3,0.916252116
22334,20,23723,7,9,0,10,0,26,10,8,0,0,0,18,nowin,loss,bust,plbust,0,10,16,186,0.456989247,0.037634409,0.537634409,1,0.301097108
22335,78,23723,10,7,0,0,0,17,10,8,0,0,0,18,nowin,loss,beat,dlwin,0,10,17,201,0.517412935,0.034825871,0.587064677,3,0.95871112
22336,112,23723,6,1,5,10,0,22,10,8,0,0,0,18,nowin,loss,bust,plbust,0,10,7,203,0.448275862,0.054187192,0.600985222,3,0.889576933
22337,17,23723,10,2,0,3,2,17,10,8,0,0,0,18,nowin,loss,beat,dlwin,0,10,12,171,0.444444444,0.070175439,0.555555556,1,0.302364894
22338,149,23724,7,3,10,0,0,20,3,6,2,5,4,20,nowin,push,push,push,10,0,10,225,0.457777778,0.057777778,0.648888889,2,0.651965595
22339,65,23724,9,10,0,0,0,19,3,6,2,5,4,20,nowin,loss,beat,dlwin,0,10,19,203,0.492610837,0.054187192,0.571428571,3,0.913702814
22340,145,23724,8,4,0,2,0,14,3,6,2,5,4,20,nowin,loss,beat,dlwin,0,10,12,188,0.441489362,0.031914894,0.622340426,2,0.617837093
22341,60,23724,10,11,0,0,0,21,3,6,2,5,4,20,win,win,plwin,beat,25,0,21,227,0.418502203,0.022026432,0.559471366,0,0.026496258
22342,141,23724,10,8,0,0,0,18,3,6,2,5,4,20,nowin,loss,beat,dlwin,0,10,18,202,0.420792079,0.074257426,0.564356436,0,0.028377851
22343,86,23724,6,10,0,0,0,16,3,6,2,5,4,20,nowin,loss,beat,dlwin,0,10,16,196,0.454081633,0.040816327,0.591836735,3,0.887566443
22344,99,23725,4,5,7,1,0,17,7,10,0,0,0,17,nowin,push,push,push,10,0,9,207,0.47826087,0.062801932,0.637681159,3,0.961418446
22345,89,23725,10,7,0,0,0,17,7,10,0,0,0,17,nowin,push,push,push,10,0,17,212,0.537735849,0.047169811,0.594339623,3,0.990167191
22346,58,23725,3,3,3,10,0,19,7,10,0,0,0,17,nowin,win,plwin,beat,20,0,6,195,0.430769231,0.041025641,0.584615385,2,0.580497586
22347,117,23725,2,2,2,6,10,22,7,10,0,0,0,17,nowin,loss,bust,plbust,0,10,4,173,0.410404624,0.069364162,0.606936416,2,0.578610282
22348,101,23725,3,6,3,10,0,22,7,10,0,0,0,17,nowin,loss,bust,plbust,0,10,9,205,0.424390244,0.068292683,0.63902439,2,0.614740646
22349,26,23725,10,3,0,10,0,23,7,10,0,0,0,17,nowin,loss,bust,plbust,0,10,13,203,0.463054187,0.0591133,0.541871921,1,0.306802864
22350,122,23726,8,10,0,0,0,18,8,5,8,0,0,21,nowin,loss,beat,dlwin,0,10,18,210,0.347619048,0.052380952,0.59047619,0,0.012873677
22351,147,23726,7,4,7,0,0,18,8,5,8,0,0,21,nowin,loss,beat,dlwin,0,10,11,205,0.380487805,0.014634146,0.536585366,0,0.00951447
22352,8,23726,8,9,0,0,0,17,8,5,8,0,0,21,nowin,loss,beat,dlwin,0,10,17,181,0.44198895,0.071823204,0.596685083,2,0.599438402
22353,134,23726,3,10,0,10,0,23,8,5,8,0,0,21,nowin,loss,bust,plbust,0,10,13,185,0.443243243,0.021621622,0.545945946,1,0.296939509
22354,138,23726,10,10,0,0,0,20,8,5,8,0,0,21,nowin,loss,beat,dlwin,0,10,20,190,0.442105263,0.047368421,0.610526316,2,0.609711065
22355,72,23726,5,11,4,0,0,20,8,5,8,0,0,21,nowin,loss,beat,dlwin,0,10,16,185,0.394594595,0.032432432,0.508108108,0,0.006763115
22356,43,23727,10,9,0,0,0,19,9,10,0,0,0,19,nowin,push,push,push,10,0,19,192,0.40625,0.041666667,0.609375,2,0.576671372
22357,65,23727,3,3,8,1,5,20,9,10,0,0,0,19,nowin,win,plwin,beat,20,0,6,203,0.492610837,0.054187192,0.571428571,3,0.913702814
22358,131,23727,6,1,10,0,0,17,9,10,0,0,0,19,nowin,loss,beat,dlwin,0,10,7,217,0.410138249,0.069124424,0.543778802,0,0.02015021
22359,26,23727,3,10,0,1,10,24,9,10,0,0,0,19,nowin,loss,bust,plbust,0,10,13,203,0.463054187,0.0591133,0.541871921,1,0.306802864
22360,106,23727,8,7,0,1,9,25,9,10,0,0,0,19,nowin,loss,bust,plbust,0,10,15,192,0.411458333,0.026041667,0.557291667,0,0.023854304
22361,111,23727,6,7,0,10,0,23,9,10,0,0,0,19,nowin,loss,bust,plbust,0,10,13,180,0.433333333,0.055555556,0.611111111,2,0.602264492
22362,90,23728,10,3,0,0,0,13,5,8,10,0,0,23,nowin,win,dlbust,bust,20,0,13,201,0.447761194,0.049751244,0.60199005,3,0.889945023
22363,37,23728,2,10,0,0,0,12,5,8,10,0,0,23,nowin,win,dlbust,bust,20,0,12,208,0.394230769,0.038461538,0.581730769,0,0.024682772
22364,27,23728,10,10,0,0,0,20,5,8,10,0,0,23,nowin,win,dlbust,bust,20,0,20,178,0.370786517,0.016853933,0.573033708,0,0.015536309
22365,33,23728,9,6,0,0,0,15,5,8,10,0,0,23,nowin,win,dlbust,bust,20,0,15,192,0.4375,0.057291667,0.625,2,0.616208916
22366,124,23728,6,10,0,0,0,16,5,8,10,0,0,23,nowin,win,dlbust,bust,20,0,16,202,0.47029703,0.064356436,0.584158416,3,0.899458193
22367,113,23728,10,2,0,0,0,12,5,8,10,0,0,23,nowin,win,dlbust,bust,20,0,12,199,0.407035176,0.055276382,0.668341709,2,0.620695264
22368,145,23729,2,7,9,0,0,18,2,10,6,0,0,18,nowin,push,push,push,10,0,9,188,0.441489362,0.031914894,0.622340426,2,0.617837093
22369,57,23729,10,10,0,0,0,20,2,10,6,0,0,18,nowin,win,plwin,beat,20,0,20,192,0.46875,0.052083333,0.59375,3,0.907001181
22370,141,23729,10,3,0,0,0,13,2,10,6,0,0,18,nowin,loss,beat,dlwin,0,10,13,202,0.420792079,0.074257426,0.564356436,0,0.028377851
22371,53,23729,10,2,0,10,0,22,2,10,6,0,0,18,nowin,loss,bust,plbust,0,10,12,250,0.372,0.064,0.564,0,0.013687345
22372,118,23729,6,9,0,0,0,15,2,10,6,0,0,18,nowin,loss,beat,dlwin,0,10,15,216,0.393518519,0.037037037,0.555555556,0,0.018059873
22373,90,23729,11,9,0,0,0,20,2,10,6,0,0,18,nowin,win,plwin,beat,20,0,20,201,0.447761194,0.049751244,0.60199005,3,0.889945023
22374,147,23730,11,7,0,0,0,18,4,6,5,9,0,24,nowin,win,dlbust,bust,20,0,18,205,0.380487805,0.014634146,0.536585366,0,0.00951447
22375,103,23730,10,4,0,0,0,14,4,6,5,9,0,24,nowin,win,dlbust,bust,20,0,14,203,0.379310345,0.064039409,0.551724138,0,0.012869209
22376,92,23730,6,11,4,0,0,21,4,6,5,9,0,24,nowin,win,dlbust,bust,20,0,17,186,0.446236559,0.059139785,0.564516129,1,0.307826125
22377,9,23730,6,8,0,0,0,14,4,6,5,9,0,24,nowin,win,dlbust,bust,20,0,14,194,0.37628866,0.015463918,0.541237113,0,0.009396796
22378,139,23730,10,7,0,0,0,17,4,6,5,9,0,24,nowin,win,dlbust,bust,20,0,17,192,0.380208333,0.036458333,0.59375,0,0.023429169
22379,25,23730,6,3,7,0,0,16,4,6,5,9,0,24,nowin,win,dlbust,bust,20,0,9,190,0.463157895,0.063157895,0.536842105,1,0.304401563
22380,142,23731,10,3,0,10,0,23,10,8,0,0,0,18,nowin,loss,bust,plbust,0,10,13,211,0.417061611,0.047393365,0.526066351,1,0.271531309
22381,127,23731,11,10,0,0,0,21,10,8,0,0,0,18,win,win,plwin,beat,25,0,21,201,0.402985075,0.029850746,0.60199005,0,0.032263937
22382,99,23731,3,9,0,9,0,21,10,8,0,0,0,18,nowin,win,plwin,beat,20,0,12,207,0.47826087,0.062801932,0.637681159,3,0.961418446
22383,16,23731,10,9,0,0,0,19,10,8,0,0,0,18,nowin,win,plwin,beat,20,0,19,220,0.427272727,0.081818182,0.6,2,0.588660176
22384,30,23731,8,11,0,0,0,19,10,8,0,0,0,18,nowin,win,plwin,beat,20,0,19,206,0.393203883,0.033980583,0.601941748,0,0.029324648
22385,135,23731,10,8,0,0,0,18,10,8,0,0,0,18,nowin,push,push,push,10,0,18,179,0.391061453,0.067039106,0.586592179,0,0.024924662
22386,44,23732,8,4,0,9,0,21,7,5,10,0,0,22,nowin,win,dlbust,bust,20,0,12,219,0.433789954,0.050228311,0.534246575,1,0.285551035
22387,49,23732,10,10,0,0,0,20,7,5,10,0,0,22,nowin,win,dlbust,bust,20,0,20,207,0.396135266,0.053140097,0.594202899,0,0.028306925
22388,42,23732,10,10,0,0,0,20,7,5,10,0,0,22,nowin,win,dlbust,bust,20,0,20,212,0.443396226,0.051886792,0.570754717,1,0.309181312
22389,110,23732,4,3,10,0,0,17,7,5,10,0,0,22,nowin,win,dlbust,bust,20,0,7,192,0.416666667,0.046875,0.557291667,0,0.025413132
22390,120,23732,2,10,0,4,1,17,7,5,10,0,0,22,nowin,win,dlbust,bust,20,0,12,202,0.440594059,0.034653465,0.618811881,2,0.614441029
22391,87,23732,10,6,0,1,0,17,7,5,10,0,0,22,nowin,win,dlbust,bust,20,0,16,202,0.405940594,0.054455446,0.628712871,2,0.590599801
22392,120,23733,7,10,0,0,0,17,8,11,0,0,0,19,nowin,loss,beat,dlwin,0,10,17,202,0.440594059,0.034653465,0.618811881,2,0.614441029
22393,59,23733,10,9,0,0,0,19,8,11,0,0,0,19,nowin,push,push,push,10,0,19,228,0.429824561,0.048245614,0.543859649,1,0.287885446
22394,17,23733,6,6,0,8,0,20,8,11,0,0,0,19,nowin,win,plwin,beat,20,0,12,171,0.444444444,0.070175439,0.555555556,1,0.302364894
22395,1,23733,3,10,0,2,2,17,8,11,0,0,0,19,nowin,loss,beat,dlwin,0,10,13,197,0.406091371,0.025380711,0.649746193,2,0.606186955
22396,47,23733,10,10,0,0,0,20,8,11,0,0,0,19,nowin,win,plwin,beat,20,0,20,210,0.438095238,0.057142857,0.623809524,2,0.615868808
22397,65,23733,8,2,2,9,0,21,8,11,0,0,0,19,nowin,win,plwin,beat,20,0,10,203,0.492610837,0.054187192,0.571428571,3,0.913702814
22398,52,23734,9,2,10,0,0,21,5,10,10,0,0,25,nowin,win,dlbust,bust,20,0,11,217,0.414746544,0.02764977,0.599078341,2,0.576736024
22399,69,23734,5,4,4,0,0,13,5,10,10,0,0,25,nowin,win,dlbust,bust,20,0,9,194,0.365979381,0.030927835,0.515463918,0,0
22400,94,23734,3,10,0,0,0,13,5,10,10,0,0,25,nowin,win,dlbust,bust,20,0,13,183,0.43715847,0.043715847,0.540983607,1,0.290866892
22401,149,23734,10,5,0,0,0,15,5,10,10,0,0,25,nowin,win,dlbust,bust,20,0,15,225,0.457777778,0.057777778,0.648888889,2,0.651965595
22402,56,23734,8,8,0,0,0,16,5,10,10,0,0,25,nowin,win,dlbust,bust,20,0,16,175,0.4,0.057142857,0.582857143,0,0.026685297
22403,40,23734,9,10,0,0,0,19,5,10,10,0,0,25,nowin,win,dlbust,bust,20,0,19,196,0.367346939,0.030612245,0.617346939,0,0.025358183
22404,103,23735,4,8,0,0,0,12,4,6,7,0,0,17,nowin,loss,beat,dlwin,0,10,12,203,0.379310345,0.064039409,0.551724138,0,0.012869209
22405,142,23735,10,3,0,0,0,13,4,6,7,0,0,17,nowin,loss,beat,dlwin,0,10,13,211,0.417061611,0.047393365,0.526066351,1,0.271531309
22406,1,23735,10,9,0,0,0,19,4,6,7,0,0,17,nowin,win,plwin,beat,20,0,19,197,0.406091371,0.025380711,0.649746193,2,0.606186955
22407,42,23735,5,10,0,0,0,15,4,6,7,0,0,17,nowin,loss,beat,dlwin,0,10,15,212,0.443396226,0.051886792,0.570754717,1,0.309181312
22408,131,23735,3,9,0,0,0,12,4,6,7,0,0,17,nowin,loss,beat,dlwin,0,10,12,217,0.410138249,0.069124424,0.543778802,0,0.02015021
22409,75,23735,6,8,0,0,0,14,4,6,7,0,0,17,nowin,loss,beat,dlwin,0,10,14,191,0.418848168,0.052356021,0.570680628,0,0.029344702
22410,21,23736,10,10,0,0,0,20,10,10,0,0,0,20,nowin,push,push,push,10,0,20,214,0.359813084,0.042056075,0.626168224,0,0.025263474
22411,39,23736,11,10,0,0,0,21,10,10,0,0,0,20,win,win,plwin,beat,25,0,21,191,0.429319372,0.062827225,0.57591623,0,0.033760763
22412,86,23736,10,10,0,0,0,20,10,10,0,0,0,20,nowin,push,push,push,10,0,20,196,0.454081633,0.040816327,0.591836735,3,0.887566443
22413,142,23736,10,6,0,6,0,22,10,10,0,0,0,20,nowin,loss,bust,plbust,0,10,16,211,0.417061611,0.047393365,0.526066351,1,0.271531309
22414,107,23736,10,4,0,9,0,23,10,10,0,0,0,20,nowin,loss,bust,plbust,0,10,14,218,0.444954128,0.073394495,0.600917431,2,0.605210014
22415,146,23736,10,2,0,7,0,19,10,10,0,0,0,20,nowin,loss,beat,dlwin,0,10,12,221,0.43438914,0.040723982,0.542986425,1,0.290190091
22416,46,23737,6,7,0,8,0,21,10,10,0,0,0,20,nowin,win,plwin,beat,20,0,13,186,0.403225806,0.048387097,0.591397849,0,0.029742194
22417,23,23737,3,4,5,7,0,19,10,10,0,0,0,20,nowin,loss,beat,dlwin,0,10,7,208,0.427884615,0.0625,0.552884615,1,0.29114424
22418,101,23737,10,6,0,10,0,26,10,10,0,0,0,20,nowin,loss,bust,plbust,0,10,16,205,0.424390244,0.068292683,0.63902439,2,0.614740646
22419,1,23737,10,8,0,0,0,18,10,10,0,0,0,20,nowin,loss,beat,dlwin,0,10,18,197,0.406091371,0.025380711,0.649746193,2,0.606186955
22420,113,23737,2,1,10,5,0,18,10,10,0,0,0,20,nowin,loss,beat,dlwin,0,10,3,199,0.407035176,0.055276382,0.668341709,2,0.620695264
22421,95,23737,3,8,8,0,0,19,10,10,0,0,0,20,nowin,loss,beat,dlwin,0,10,11,218,0.412844037,0.04587156,0.559633028,0,0.024842385
22422,118,23738,4,10,0,8,0,22,11,10,0,0,0,21,nowin,loss,bust,plbust,0,10,14,216,0.393518519,0.037037037,0.555555556,0,0.018059873
22423,13,23738,10,8,0,0,0,18,11,10,0,0,0,21,nowin,loss,beat,dlwin,0,10,18,206,0.417475728,0.063106796,0.621359223,2,0.59555479
22424,52,23738,8,10,0,0,0,18,11,10,0,0,0,21,nowin,loss,beat,dlwin,0,10,18,217,0.414746544,0.02764977,0.599078341,2,0.576736024
22425,76,23738,9,10,0,0,0,19,11,10,0,0,0,21,nowin,loss,beat,dlwin,0,10,19,189,0.534391534,0.079365079,0.608465608,3,1
22426,117,23738,7,10,0,0,0,17,11,10,0,0,0,21,nowin,loss,beat,dlwin,0,10,17,173,0.410404624,0.069364162,0.606936416,2,0.578610282
22427,111,23738,9,10,0,0,0,19,11,10,0,0,0,21,nowin,loss,beat,dlwin,0,10,19,180,0.433333333,0.055555556,0.611111111,2,0.602264492
22428,47,23739,6,9,0,3,0,18,7,4,10,0,0,21,nowin,loss,beat,dlwin,0,10,15,210,0.438095238,0.057142857,0.623809524,2,0.615868808
22429,55,23739,8,10,0,0,0,18,7,4,10,0,0,21,nowin,loss,beat,dlwin,0,10,18,191,0.371727749,0.057591623,0.54973822,0,0.01011347
22430,145,23739,2,6,7,10,0,25,7,4,10,0,0,21,nowin,loss,bust,plbust,0,10,8,188,0.441489362,0.031914894,0.622340426,2,0.617837093
22431,119,23739,10,9,0,0,0,19,7,4,10,0,0,21,nowin,loss,beat,dlwin,0,10,19,190,0.405263158,0.068421053,0.515789474,0,0.011837158
22432,138,23739,10,6,0,6,0,22,7,4,10,0,0,21,nowin,loss,bust,plbust,0,10,16,190,0.442105263,0.047368421,0.610526316,2,0.609711065
22433,129,23739,10,9,0,0,0,19,7,4,10,0,0,21,nowin,loss,beat,dlwin,0,10,19,201,0.422885572,0.064676617,0.55721393,0,0.027255383
22434,70,23740,5,7,0,2,9,23,10,6,3,0,0,19,nowin,loss,bust,plbust,0,10,12,228,0.385964912,0.039473684,0.557017544,0,0.016157125
22435,150,23740,10,10,0,0,0,20,10,6,3,0,0,19,nowin,win,plwin,beat,20,0,20,192,0.401041667,0.036458333,0.567708333,0,0.023287458
22436,123,23740,2,8,8,0,0,18,10,6,3,0,0,19,nowin,loss,beat,dlwin,0,10,10,205,0.43902439,0.034146341,0.614634146,2,0.609962544
22437,102,23740,10,3,0,10,0,23,10,6,3,0,0,19,nowin,loss,bust,plbust,0,10,13,192,0.338541667,0.046875,0.5625,0,0.003306118
22438,50,23740,7,10,0,0,0,17,10,6,3,0,0,19,nowin,loss,beat,dlwin,0,10,17,202,0.405940594,0.04950495,0.54950495,0,0.020296079
22439,7,23740,4,10,0,3,0,17,10,6,3,0,0,19,nowin,loss,beat,dlwin,0,10,14,183,0.442622951,0.06010929,0.62295082,2,0.619303341
22440,65,23741,10,8,0,0,0,18,10,9,0,0,0,19,nowin,loss,beat,dlwin,0,10,18,203,0.492610837,0.054187192,0.571428571,3,0.913702814
22441,91,23741,6,9,0,1,7,23,10,9,0,0,0,19,nowin,loss,bust,plbust,0,10,15,194,0.417525773,0.046391753,0.515463918,1,0.266616552
22442,88,23741,7,5,0,8,0,20,10,9,0,0,0,19,nowin,win,plwin,beat,20,0,12,206,0.466019417,0.033980583,0.54368932,1,0.309467903
22443,88,23741,10,9,0,0,0,19,10,9,0,0,0,19,nowin,push,push,push,10,0,19,206,0.466019417,0.033980583,0.54368932,1,0.309467903
22444,67,23741,10,5,0,10,0,25,10,9,0,0,0,19,nowin,loss,bust,plbust,0,10,15,195,0.369230769,0.041025641,0.569230769,0,0.014139427
22445,5,23741,6,6,0,10,0,22,10,9,0,0,0,19,nowin,loss,bust,plbust,0,10,12,203,0.42364532,0.02955665,0.596059113,2,0.582508076
22446,65,23742,7,5,0,1,7,20,10,11,0,0,0,21,nowin,loss,beat,dlwin,0,10,12,203,0.492610837,0.054187192,0.571428571,3,0.913702814
22447,44,23742,10,8,0,0,0,18,10,11,0,0,0,21,nowin,loss,beat,dlwin,0,10,18,219,0.433789954,0.050228311,0.534246575,1,0.285551035
22448,149,23742,11,7,0,0,0,18,10,11,0,0,0,21,nowin,loss,beat,dlwin,0,10,18,225,0.457777778,0.057777778,0.648888889,2,0.651965595
22449,24,23742,10,11,0,0,0,21,10,11,0,0,0,21,win,push,push,push,10,0,21,207,0.458937198,0.048309179,0.570048309,1,0.318138014
22450,19,23742,7,4,6,0,0,17,10,11,0,0,0,21,nowin,loss,beat,dlwin,0,10,11,237,0.41350211,0.054852321,0.628691983,2,0.597373826
22451,55,23742,10,2,0,10,0,22,10,11,0,0,0,21,nowin,loss,bust,plbust,0,10,12,191,0.371727749,0.057591623,0.54973822,0,0.01011347
22452,123,23743,1,3,10,0,0,14,6,10,3,0,0,19,nowin,loss,beat,dlwin,0,10,4,205,0.43902439,0.034146341,0.614634146,2,0.609962544
22453,50,23743,8,10,0,0,0,18,6,10,3,0,0,19,nowin,loss,beat,dlwin,0,10,18,202,0.405940594,0.04950495,0.54950495,0,0.020296079
22454,38,23743,4,2,3,2,7,18,6,10,3,0,0,19,nowin,loss,beat,dlwin,0,10,6,202,0.361386139,0.03960396,0.564356436,0,0.010597953
22455,26,23743,4,11,3,0,0,18,6,10,3,0,0,19,nowin,loss,beat,dlwin,0,10,15,203,0.463054187,0.0591133,0.541871921,1,0.306802864
22456,57,23743,3,4,4,10,0,21,6,10,3,0,0,19,nowin,win,plwin,beat,20,0,7,192,0.46875,0.052083333,0.59375,3,0.907001181
22457,100,23743,3,3,5,3,0,14,6,10,3,0,0,19,nowin,loss,beat,dlwin,0,10,6,190,0.452631579,0.036842105,0.594736842,3,0.888671154
22458,115,23744,9,4,0,5,0,18,7,10,0,0,0,17,nowin,win,plwin,beat,20,0,13,194,0.427835052,0.041237113,0.592783505,2,0.583863602
22459,49,23744,3,7,4,10,0,24,7,10,0,0,0,17,nowin,loss,bust,plbust,0,10,10,207,0.396135266,0.053140097,0.594202899,0,0.028306925
22460,99,23744,2,11,6,0,0,19,7,10,0,0,0,17,nowin,win,plwin,beat,20,0,13,207,0.47826087,0.062801932,0.637681159,3,0.961418446
22461,91,23744,6,6,0,10,0,22,7,10,0,0,0,17,nowin,loss,bust,plbust,0,10,12,194,0.417525773,0.046391753,0.515463918,1,0.266616552
22462,44,23744,7,10,0,0,0,17,7,10,0,0,0,17,nowin,push,push,push,10,0,17,219,0.433789954,0.050228311,0.534246575,1,0.285551035
22463,148,23744,2,8,3,9,0,22,7,10,0,0,0,17,nowin,loss,bust,plbust,0,10,10,204,0.401960784,0.078431373,0.593137255,0,0.029789521
22464,128,23745,3,8,10,0,0,21,2,10,10,0,0,22,nowin,win,dlbust,bust,20,0,11,227,0.356828194,0.052863436,0.577092511,0,0.012352564
22465,11,23745,9,4,0,0,0,13,2,10,10,0,0,22,nowin,win,dlbust,bust,20,0,13,236,0.457627119,0.016949153,0.588983051,3,0.889015813
22466,89,23745,10,10,0,0,0,20,2,10,10,0,0,22,nowin,win,dlbust,bust,20,0,20,212,0.537735849,0.047169811,0.594339623,3,0.990167191
22467,133,23745,5,9,0,0,0,14,2,10,10,0,0,22,nowin,win,dlbust,bust,20,0,14,201,0.47761194,0.064676617,0.611940299,3,0.935428111
22468,19,23745,10,10,0,0,0,20,2,10,10,0,0,22,nowin,win,dlbust,bust,20,0,20,237,0.41350211,0.054852321,0.628691983,2,0.597373826
22469,143,23745,5,10,0,0,0,15,2,10,10,0,0,22,nowin,win,dlbust,bust,20,0,15,203,0.463054187,0.044334975,0.57635468,3,0.883143365
22470,78,23746,10,11,0,0,0,21,10,6,9,0,0,25,win,win,dlbust,bust,25,0,21,201,0.517412935,0.034825871,0.587064677,3,0.95871112
22471,51,23746,7,10,0,0,0,17,10,6,9,0,0,25,nowin,win,dlbust,bust,20,0,17,189,0.529100529,0.068783069,0.608465608,3,0.993665715
22472,15,23746,2,10,0,10,0,22,10,6,9,0,0,25,nowin,loss,bust,plbust,0,10,12,212,0.410377358,0.051886792,0.561320755,0,0.024517408
22473,148,23746,10,5,0,10,0,25,10,6,9,0,0,25,nowin,loss,bust,plbust,0,10,15,204,0.401960784,0.078431373,0.593137255,0,0.029789521
22474,139,23746,7,11,0,0,0,18,10,6,9,0,0,25,nowin,win,dlbust,bust,20,0,18,192,0.380208333,0.036458333,0.59375,0,0.023429169
22475,146,23746,2,11,6,0,0,19,10,6,9,0,0,25,nowin,win,dlbust,bust,20,0,13,221,0.43438914,0.040723982,0.542986425,1,0.290190091
22476,20,23747,11,7,0,0,0,18,5,10,10,0,0,25,nowin,win,dlbust,bust,20,0,18,186,0.456989247,0.037634409,0.537634409,1,0.301097108
22477,75,23747,10,2,0,0,0,12,5,10,10,0,0,25,nowin,win,dlbust,bust,20,0,12,191,0.418848168,0.052356021,0.570680628,0,0.029344702
22478,127,23747,10,7,0,0,0,17,5,10,10,0,0,25,nowin,win,dlbust,bust,20,0,17,201,0.402985075,0.029850746,0.60199005,0,0.032263937
22479,70,23747,8,6,0,0,0,14,5,10,10,0,0,25,nowin,win,dlbust,bust,20,0,14,228,0.385964912,0.039473684,0.557017544,0,0.016157125
22480,8,23747,11,10,0,0,0,21,5,10,10,0,0,25,win,win,dlbust,bust,25,0,21,181,0.44198895,0.071823204,0.596685083,2,0.599438402
22481,107,23747,2,8,11,0,0,21,5,10,10,0,0,25,nowin,win,dlbust,bust,20,0,10,218,0.444954128,0.073394495,0.600917431,2,0.605210014
22482,69,23748,8,3,10,0,0,21,4,10,5,0,0,19,nowin,win,plwin,beat,20,0,11,194,0.365979381,0.030927835,0.515463918,0,0
22483,8,23748,9,11,0,0,0,20,4,10,5,0,0,19,nowin,win,plwin,beat,20,0,20,181,0.44198895,0.071823204,0.596685083,2,0.599438402
22484,147,23748,3,2,10,0,0,15,4,10,5,0,0,19,nowin,loss,beat,dlwin,0,10,5,205,0.380487805,0.014634146,0.536585366,0,0.00951447
22485,18,23748,7,9,0,0,0,16,4,10,5,0,0,19,nowin,loss,beat,dlwin,0,10,16,182,0.461538462,0.043956044,0.587912088,3,0.892649374
22486,104,23748,7,10,0,0,0,17,4,10,5,0,0,19,nowin,loss,beat,dlwin,0,10,17,209,0.363636364,0.052631579,0.593301435,0,0.018359419
22487,103,23748,2,10,0,0,0,12,4,10,5,0,0,19,nowin,loss,beat,dlwin,0,10,12,203,0.379310345,0.064039409,0.551724138,0,0.012869209
22488,132,23749,9,10,0,0,0,19,10,10,0,0,0,20,nowin,loss,beat,dlwin,0,10,19,194,0.412371134,0.036082474,0.649484536,2,0.611633238
22489,144,23749,7,3,8,0,0,18,10,10,0,0,0,20,nowin,loss,beat,dlwin,0,10,10,202,0.386138614,0.054455446,0.564356436,0,0.018006244
22490,51,23749,9,3,0,4,10,26,10,10,0,0,0,20,nowin,loss,bust,plbust,0,10,12,189,0.529100529,0.068783069,0.608465608,3,0.993665715
22491,42,23749,4,8,0,10,0,22,10,10,0,0,0,20,nowin,loss,bust,plbust,0,10,12,212,0.443396226,0.051886792,0.570754717,1,0.309181312
22492,41,23749,2,10,0,6,0,18,10,10,0,0,0,20,nowin,loss,beat,dlwin,0,10,12,192,0.364583333,0.036458333,0.520833333,0,0.00089702
22493,123,23749,3,2,9,10,0,24,10,10,0,0,0,20,nowin,loss,bust,plbust,0,10,5,205,0.43902439,0.034146341,0.614634146,2,0.609962544
22494,51,23750,4,10,0,5,0,19,8,6,1,10,0,25,nowin,win,dlbust,bust,20,0,14,189,0.529100529,0.068783069,0.608465608,3,0.993665715
22495,21,23750,4,2,4,10,0,20,8,6,1,10,0,25,nowin,win,dlbust,bust,20,0,6,214,0.359813084,0.042056075,0.626168224,0,0.025263474
22496,45,23750,10,11,0,0,0,21,8,6,1,10,0,25,win,win,dlbust,bust,25,0,21,196,0.428571429,0.051020408,0.612244898,2,0.598821767
22497,106,23750,4,1,9,1,10,25,8,6,1,10,0,25,nowin,loss,bust,plbust,0,10,5,192,0.411458333,0.026041667,0.557291667,0,0.023854304
22498,56,23750,10,10,0,0,0,20,8,6,1,10,0,25,nowin,win,dlbust,bust,20,0,20,175,0.4,0.057142857,0.582857143,0,0.026685297
22499,44,23750,10,8,0,0,0,18,8,6,1,10,0,25,nowin,win,dlbust,bust,20,0,18,219,0.433789954,0.050228311,0.534246575,1,0.285551035
22500,139,23751,8,9,0,0,0,17,10,9,0,0,0,19,nowin,loss,beat,dlwin,0,10,17,192,0.380208333,0.036458333,0.59375,0,0.023429169
22501,39,23751,11,10,0,0,0,21,10,9,0,0,0,19,win,win,plwin,beat,25,0,21,191,0.429319372,0.062827225,0.57591623,0,0.033760763
22502,19,23751,9,9,0,0,0,18,10,9,0,0,0,19,nowin,loss,beat,dlwin,0,10,18,237,0.41350211,0.054852321,0.628691983,2,0.597373826
22503,55,23751,9,3,0,10,0,22,10,9,0,0,0,19,nowin,loss,bust,plbust,0,10,12,191,0.371727749,0.057591623,0.54973822,0,0.01011347
22504,149,23751,9,5,0,4,0,18,10,9,0,0,0,19,nowin,loss,beat,dlwin,0,10,14,225,0.457777778,0.057777778,0.648888889,2,0.651965595
22505,142,23751,9,10,0,0,0,19,10,9,0,0,0,19,nowin,push,push,push,10,0,19,211,0.417061611,0.047393365,0.526066351,1,0.271531309
22506,102,23752,8,10,0,0,0,18,10,9,0,0,0,19,nowin,loss,beat,dlwin,0,10,18,192,0.338541667,0.046875,0.5625,0,0.003306118
22507,100,23752,1,5,7,9,0,22,10,9,0,0,0,19,nowin,loss,bust,plbust,0,10,6,190,0.452631579,0.036842105,0.594736842,3,0.888671154
22508,23,23752,10,10,0,0,0,20,10,9,0,0,0,19,nowin,win,plwin,beat,20,0,20,208,0.427884615,0.0625,0.552884615,1,0.29114424
22509,11,23752,6,3,4,7,0,20,10,9,0,0,0,19,nowin,win,plwin,beat,20,0,9,236,0.457627119,0.016949153,0.588983051,3,0.889015813
22510,21,23752,3,10,0,10,0,23,10,9,0,0,0,19,nowin,loss,bust,plbust,0,10,13,214,0.359813084,0.042056075,0.626168224,0,0.025263474
22511,102,23752,4,10,0,5,0,19,10,9,0,0,0,19,nowin,push,push,push,10,0,14,192,0.338541667,0.046875,0.5625,0,0.003306118
22512,137,23753,10,10,0,0,0,20,11,9,0,0,0,20,nowin,push,push,push,10,0,20,194,0.417525773,0.046391753,0.536082474,1,0.276714602
22513,89,23753,7,5,0,2,7,21,11,9,0,0,0,20,nowin,win,plwin,beat,20,0,12,212,0.537735849,0.047169811,0.594339623,3,0.990167191
22514,134,23753,5,3,11,0,0,19,11,9,0,0,0,20,nowin,loss,beat,dlwin,0,10,8,185,0.443243243,0.021621622,0.545945946,1,0.296939509
22515,66,23753,7,2,10,0,0,19,11,9,0,0,0,20,nowin,loss,beat,dlwin,0,10,9,217,0.456221198,0.064516129,0.626728111,3,0.924304367
22516,69,23753,4,2,11,0,0,17,11,9,0,0,0,20,nowin,loss,beat,dlwin,0,10,6,194,0.365979381,0.030927835,0.515463918,0,0
22517,77,23753,5,10,0,9,0,24,11,9,0,0,0,20,nowin,loss,bust,plbust,0,10,15,200,0.455,0.04,0.62,3,0.916252116
22518,74,23754,11,10,0,0,0,21,10,9,0,0,0,19,win,win,plwin,beat,25,0,21,209,0.411483254,0.04784689,0.531100478,0,0.017448125
22519,72,23754,4,10,0,6,0,20,10,9,0,0,0,19,nowin,win,plwin,beat,20,0,14,185,0.394594595,0.032432432,0.508108108,0,0.006763115
22520,12,23754,10,10,0,0,0,20,10,9,0,0,0,19,nowin,win,plwin,beat,20,0,20,189,0.470899471,0.015873016,0.613756614,3,0.929171178
22521,22,23754,11,6,4,0,0,21,10,9,0,0,0,19,nowin,win,plwin,beat,20,0,17,187,0.481283422,0.042780749,0.577540107,3,0.906128176
22522,134,23754,6,5,1,10,0,22,10,9,0,0,0,19,nowin,loss,bust,plbust,0,10,11,185,0.443243243,0.021621622,0.545945946,1,0.296939509
22523,129,23754,8,6,0,7,0,21,10,9,0,0,0,19,nowin,win,plwin,beat,20,0,14,201,0.422885572,0.064676617,0.55721393,0,0.027255383
22524,94,23755,8,9,0,0,0,17,6,8,5,0,0,19,nowin,loss,beat,dlwin,0,10,17,183,0.43715847,0.043715847,0.540983607,1,0.290866892
22525,118,23755,5,10,0,0,0,15,6,8,5,0,0,19,nowin,loss,beat,dlwin,0,10,15,216,0.393518519,0.037037037,0.555555556,0,0.018059873
22526,59,23755,10,7,0,0,0,17,6,8,5,0,0,19,nowin,loss,beat,dlwin,0,10,17,228,0.429824561,0.048245614,0.543859649,1,0.287885446
22527,10,23755,4,10,0,0,0,14,6,8,5,0,0,19,nowin,loss,beat,dlwin,0,10,14,191,0.413612565,0.057591623,0.596858639,2,0.574087175
22528,53,23755,8,7,0,0,0,15,6,8,5,0,0,19,nowin,loss,beat,dlwin,0,10,15,250,0.372,0.064,0.564,0,0.013687345
22529,48,23755,9,10,0,0,0,19,6,8,5,0,0,19,nowin,push,push,push,10,0,19,203,0.413793103,0.019704433,0.600985222,2,0.577280801
22530,5,23756,7,10,0,0,0,17,8,10,0,0,0,18,nowin,loss,beat,dlwin,0,10,17,203,0.42364532,0.02955665,0.596059113,2,0.582508076
22531,21,23756,9,2,1,10,0,22,8,10,0,0,0,18,nowin,loss,bust,plbust,0,10,11,214,0.359813084,0.042056075,0.626168224,0,0.025263474
22532,137,23756,10,10,0,0,0,20,8,10,0,0,0,18,nowin,win,plwin,beat,20,0,20,194,0.417525773,0.046391753,0.536082474,1,0.276714602
22533,119,23756,10,2,0,7,0,19,8,10,0,0,0,18,nowin,win,plwin,beat,20,0,12,190,0.405263158,0.068421053,0.515789474,0,0.011837158
22534,74,23756,10,8,0,0,0,18,8,10,0,0,0,18,nowin,push,push,push,10,0,18,209,0.411483254,0.04784689,0.531100478,0,0.017448125
22535,108,23756,4,10,0,9,0,23,8,10,0,0,0,18,nowin,loss,bust,plbust,0,10,14,193,0.435233161,0.056994819,0.559585492,1,0.298824795
22536,142,23757,11,4,4,0,0,19,10,10,0,0,0,20,nowin,loss,beat,dlwin,0,10,15,211,0.417061611,0.047393365,0.526066351,1,0.271531309
22537,2,23757,2,7,10,0,0,19,10,10,0,0,0,20,nowin,loss,beat,dlwin,0,10,9,200,0.445,0.035,0.64,2,0.633962549
22538,103,23757,4,3,10,0,0,17,10,10,0,0,0,20,nowin,loss,beat,dlwin,0,10,7,203,0.379310345,0.064039409,0.551724138,0,0.012869209
22539,149,23757,8,3,2,10,0,23,10,10,0,0,0,20,nowin,loss,bust,plbust,0,10,11,225,0.457777778,0.057777778,0.648888889,2,0.651965595
22540,37,23757,10,6,0,10,0,26,10,10,0,0,0,20,nowin,loss,bust,plbust,0,10,16,208,0.394230769,0.038461538,0.581730769,0,0.024682772
22541,100,23757,10,10,0,0,0,20,10,10,0,0,0,20,nowin,push,push,push,10,0,20,190,0.452631579,0.036842105,0.594736842,3,0.888671154
22542,148,23758,10,3,0,10,0,23,8,11,0,0,0,19,nowin,loss,bust,plbust,0,10,13,204,0.401960784,0.078431373,0.593137255,0,0.029789521
22543,55,23758,7,10,0,0,0,17,8,11,0,0,0,19,nowin,loss,beat,dlwin,0,10,17,191,0.371727749,0.057591623,0.54973822,0,0.01011347
22544,36,23758,9,2,4,9,0,24,8,11,0,0,0,19,nowin,loss,bust,plbust,0,10,11,229,0.445414847,0.056768559,0.655021834,2,0.645370571
22545,131,23758,10,6,0,5,0,21,8,11,0,0,0,19,nowin,win,plwin,beat,20,0,16,217,0.410138249,0.069124424,0.543778802,0,0.02015021
22546,123,23758,3,10,0,9,0,22,8,11,0,0,0,19,nowin,loss,bust,plbust,0,10,13,205,0.43902439,0.034146341,0.614634146,2,0.609962544
22547,123,23758,5,4,3,2,5,19,8,11,0,0,0,19,nowin,push,push,push,10,0,9,205,0.43902439,0.034146341,0.614634146,2,0.609962544
22548,113,23759,6,10,0,1,0,17,10,9,0,0,0,19,nowin,loss,beat,dlwin,0,10,16,199,0.407035176,0.055276382,0.668341709,2,0.620695264
22549,22,23759,8,2,10,0,0,20,10,9,0,0,0,19,nowin,win,plwin,beat,20,0,10,187,0.481283422,0.042780749,0.577540107,3,0.906128176
22550,46,23759,6,5,4,10,0,25,10,9,0,0,0,19,nowin,loss,bust,plbust,0,10,11,186,0.403225806,0.048387097,0.591397849,0,0.029742194
22551,69,23759,3,4,10,0,0,17,10,9,0,0,0,19,nowin,loss,beat,dlwin,0,10,7,194,0.365979381,0.030927835,0.515463918,0,0
22552,32,23759,10,6,0,2,0,18,10,9,0,0,0,19,nowin,loss,beat,dlwin,0,10,16,189,0.391534392,0.037037037,0.53968254,0,0.013579086
22553,85,23759,10,11,0,0,0,21,10,9,0,0,0,19,win,win,plwin,beat,25,0,21,195,0.41025641,0.066666667,0.594871795,0,0.03269711
22554,22,23760,3,7,4,0,0,14,2,4,8,4,0,18,nowin,loss,beat,dlwin,0,10,10,187,0.481283422,0.042780749,0.577540107,3,0.906128176
22555,75,23760,10,11,0,0,0,21,2,4,8,4,0,18,win,win,plwin,beat,25,0,21,191,0.418848168,0.052356021,0.570680628,0,0.029344702
22556,98,23760,2,10,0,6,0,18,2,4,8,4,0,18,nowin,push,push,push,10,0,12,220,0.422727273,0.054545455,0.55,1,0.28664435
22557,60,23760,10,6,0,0,0,16,2,4,8,4,0,18,nowin,loss,beat,dlwin,0,10,16,227,0.418502203,0.022026432,0.559471366,0,0.026496258
22558,51,23760,4,10,0,0,0,14,2,4,8,4,0,18,nowin,loss,beat,dlwin,0,10,14,189,0.529100529,0.068783069,0.608465608,3,0.993665715
22559,104,23760,6,10,0,0,0,16,2,4,8,4,0,18,nowin,loss,beat,dlwin,0,10,16,209,0.363636364,0.052631579,0.593301435,0,0.018359419
22560,146,23761,10,10,0,0,0,20,10,4,3,0,0,17,nowin,win,plwin,beat,20,0,20,221,0.43438914,0.040723982,0.542986425,1,0.290190091
22561,88,23761,6,2,10,0,0,18,10,4,3,0,0,17,nowin,win,plwin,beat,20,0,8,206,0.466019417,0.033980583,0.54368932,1,0.309467903
22562,44,23761,10,3,0,3,6,22,10,4,3,0,0,17,nowin,loss,bust,plbust,0,10,13,219,0.433789954,0.050228311,0.534246575,1,0.285551035
22563,131,23761,9,10,0,0,0,19,10,4,3,0,0,17,nowin,win,plwin,beat,20,0,19,217,0.410138249,0.069124424,0.543778802,0,0.02015021
22564,45,23761,3,9,0,1,10,23,10,4,3,0,0,17,nowin,loss,bust,plbust,0,10,12,196,0.428571429,0.051020408,0.612244898,2,0.598821767
22565,14,23761,6,2,5,10,0,23,10,4,3,0,0,17,nowin,loss,bust,plbust,0,10,8,202,0.391089109,0.01980198,0.628712871,2,0.577264877
22566,74,23762,10,10,0,0,0,20,5,10,10,0,0,25,nowin,win,dlbust,bust,20,0,20,209,0.411483254,0.04784689,0.531100478,0,0.017448125
22567,75,23762,1,4,7,0,0,12,5,10,10,0,0,25,nowin,win,dlbust,bust,20,0,5,191,0.418848168,0.052356021,0.570680628,0,0.029344702
22568,28,23762,11,1,8,0,0,20,5,10,10,0,0,25,nowin,win,dlbust,bust,20,0,12,199,0.422110553,0.045226131,0.542713568,1,0.282706618
22569,11,23762,7,8,0,0,0,15,5,10,10,0,0,25,nowin,win,dlbust,bust,20,0,15,236,0.457627119,0.016949153,0.588983051,3,0.889015813
22570,120,23762,1,6,7,0,0,14,5,10,10,0,0,25,nowin,win,dlbust,bust,20,0,7,202,0.440594059,0.034653465,0.618811881,2,0.614441029
22571,111,23762,8,5,0,0,0,13,5,10,10,0,0,25,nowin,win,dlbust,bust,20,0,13,180,0.433333333,0.055555556,0.611111111,2,0.602264492
22572,141,23763,2,7,7,9,0,25,11,10,0,0,0,21,nowin,loss,bust,plbust,0,10,9,202,0.420792079,0.074257426,0.564356436,0,0.028377851
22573,4,23763,10,8,0,0,0,18,11,10,0,0,0,21,nowin,loss,beat,dlwin,0,10,18,217,0.460829493,0.036866359,0.562211982,1,0.315432839
22574,84,23763,11,10,0,0,0,21,11,10,0,0,0,21,win,push,push,push,10,0,21,195,0.379487179,0.056410256,0.569230769,0,0.017209119
22575,15,23763,10,9,0,0,0,19,11,10,0,0,0,21,nowin,loss,beat,dlwin,0,10,19,212,0.410377358,0.051886792,0.561320755,0,0.024517408
22576,123,23763,6,8,0,7,0,21,11,10,0,0,0,21,nowin,push,push,push,10,0,14,205,0.43902439,0.034146341,0.614634146,2,0.609962544
22577,34,23763,10,2,0,10,0,22,11,10,0,0,0,21,nowin,loss,bust,plbust,0,10,12,202,0.5,0.079207921,0.618811881,3,0.968961434
22578,148,23764,10,11,0,0,0,21,10,6,10,0,0,26,win,win,dlbust,bust,25,0,21,204,0.401960784,0.078431373,0.593137255,0,0.029789521
22579,87,23764,10,11,0,0,0,21,10,6,10,0,0,26,win,win,dlbust,bust,25,0,21,202,0.405940594,0.054455446,0.628712871,2,0.590599801
22580,91,23764,7,8,0,6,0,21,10,6,10,0,0,26,nowin,win,dlbust,bust,20,0,15,194,0.417525773,0.046391753,0.515463918,1,0.266616552
22581,84,23764,10,5,0,2,0,17,10,6,10,0,0,26,nowin,win,dlbust,bust,20,0,15,195,0.379487179,0.056410256,0.569230769,0,0.017209119
22582,135,23764,7,10,0,0,0,17,10,6,10,0,0,26,nowin,win,dlbust,bust,20,0,17,179,0.391061453,0.067039106,0.586592179,0,0.024924662
22583,3,23764,1,5,10,10,0,26,10,6,10,0,0,26,nowin,loss,bust,plbust,0,10,6,190,0.431578947,0.026315789,0.542105263,1,0.288076384
22584,86,23765,10,11,0,0,0,21,6,10,8,0,0,24,win,win,dlbust,bust,25,0,21,196,0.454081633,0.040816327,0.591836735,3,0.887566443
22585,99,23765,9,3,0,0,0,12,6,10,8,0,0,24,nowin,win,dlbust,bust,20,0,12,207,0.47826087,0.062801932,0.637681159,3,0.961418446
22586,123,23765,10,7,0,0,0,17,6,10,8,0,0,24,nowin,win,dlbust,bust,20,0,17,205,0.43902439,0.034146341,0.614634146,2,0.609962544
22587,15,23765,2,10,0,0,0,12,6,10,8,0,0,24,nowin,win,dlbust,bust,20,0,12,212,0.410377358,0.051886792,0.561320755,0,0.024517408
22588,112,23765,8,10,0,0,0,18,6,10,8,0,0,24,nowin,win,dlbust,bust,20,0,18,203,0.448275862,0.054187192,0.600985222,3,0.889576933
22589,10,23765,3,7,10,0,0,20,6,10,8,0,0,24,nowin,win,dlbust,bust,20,0,10,191,0.413612565,0.057591623,0.596858639,2,0.574087175
22590,86,23766,9,11,0,0,0,20,2,10,10,0,0,22,nowin,win,dlbust,bust,20,0,20,196,0.454081633,0.040816327,0.591836735,3,0.887566443
22591,123,23766,9,8,0,0,0,17,2,10,10,0,0,22,nowin,win,dlbust,bust,20,0,17,205,0.43902439,0.034146341,0.614634146,2,0.609962544
22592,129,23766,10,9,0,0,0,19,2,10,10,0,0,22,nowin,win,dlbust,bust,20,0,19,201,0.422885572,0.064676617,0.55721393,0,0.027255383
22593,56,23766,7,3,4,0,0,14,2,10,10,0,0,22,nowin,win,dlbust,bust,20,0,10,175,0.4,0.057142857,0.582857143,0,0.026685297
22594,66,23766,10,6,0,0,0,16,2,10,10,0,0,22,nowin,win,dlbust,bust,20,0,16,217,0.456221198,0.064516129,0.626728111,3,0.924304367
22595,10,23766,10,10,0,0,0,20,2,10,10,0,0,22,nowin,win,dlbust,bust,20,0,20,191,0.413612565,0.057591623,0.596858639,2,0.574087175
22596,26,23767,4,10,0,1,10,25,8,10,0,0,0,18,nowin,loss,bust,plbust,0,10,14,203,0.463054187,0.0591133,0.541871921,1,0.306802864
22597,59,23767,11,10,0,0,0,21,8,10,0,0,0,18,win,win,plwin,beat,25,0,21,228,0.429824561,0.048245614,0.543859649,1,0.287885446
22598,106,23767,5,10,0,9,0,24,8,10,0,0,0,18,nowin,loss,bust,plbust,0,10,15,192,0.411458333,0.026041667,0.557291667,0,0.023854304
22599,142,23767,9,10,0,0,0,19,8,10,0,0,0,18,nowin,win,plwin,beat,20,0,19,211,0.417061611,0.047393365,0.526066351,1,0.271531309
22600,79,23767,9,10,0,0,0,19,8,10,0,0,0,18,nowin,win,plwin,beat,20,0,19,211,0.436018957,0.028436019,0.672985782,2,0.650131054
22601,64,23767,6,10,0,10,0,26,8,10,0,0,0,18,nowin,loss,bust,plbust,0,10,16,187,0.363636364,0.048128342,0.631016043,0,0.027594885
22602,12,23768,6,1,6,2,6,21,10,11,0,0,0,21,nowin,push,push,push,10,0,7,189,0.470899471,0.015873016,0.613756614,3,0.929171178
22603,70,23768,9,10,0,0,0,19,10,11,0,0,0,21,nowin,loss,beat,dlwin,0,10,19,228,0.385964912,0.039473684,0.557017544,0,0.016157125
22604,52,23768,7,10,0,0,0,17,10,11,0,0,0,21,nowin,loss,beat,dlwin,0,10,17,217,0.414746544,0.02764977,0.599078341,2,0.576736024
22605,134,23768,10,10,0,0,0,20,10,11,0,0,0,21,nowin,loss,beat,dlwin,0,10,20,185,0.443243243,0.021621622,0.545945946,1,0.296939509
22606,92,23768,9,6,0,10,0,25,10,11,0,0,0,21,nowin,loss,bust,plbust,0,10,15,186,0.446236559,0.059139785,0.564516129,1,0.307826125
22607,27,23768,10,2,0,6,0,18,10,11,0,0,0,21,nowin,loss,beat,dlwin,0,10,12,178,0.370786517,0.016853933,0.573033708,0,0.015536309
22608,123,23769,9,10,0,0,0,19,5,6,2,4,0,17,nowin,win,plwin,beat,20,0,19,205,0.43902439,0.034146341,0.614634146,2,0.609962544
22609,93,23769,10,8,0,0,0,18,5,6,2,4,0,17,nowin,win,plwin,beat,20,0,18,175,0.485714286,0.051428571,0.548571429,1,0.323648091
22610,132,23769,4,10,0,0,0,14,5,6,2,4,0,17,nowin,loss,beat,dlwin,0,10,14,194,0.412371134,0.036082474,0.649484536,2,0.611633238
22611,126,23769,10,10,0,0,0,20,5,6,2,4,0,17,nowin,win,plwin,beat,20,0,20,188,0.457446809,0.074468085,0.60106383,3,0.900633203
22612,56,23769,1,3,9,0,0,13,5,6,2,4,0,17,nowin,loss,beat,dlwin,0,10,4,175,0.4,0.057142857,0.582857143,0,0.026685297
22613,20,23769,4,9,0,0,0,13,5,6,2,4,0,17,nowin,loss,beat,dlwin,0,10,13,186,0.456989247,0.037634409,0.537634409,1,0.301097108
22614,143,23770,9,4,0,2,10,25,10,4,10,0,0,24,nowin,loss,bust,plbust,0,10,13,203,0.463054187,0.044334975,0.57635468,3,0.883143365
22615,126,23770,4,11,2,0,0,17,10,4,10,0,0,24,nowin,win,dlbust,bust,20,0,15,188,0.457446809,0.074468085,0.60106383,3,0.900633203
22616,140,23770,8,5,0,10,0,23,10,4,10,0,0,24,nowin,loss,bust,plbust,0,10,13,210,0.466666667,0.023809524,0.604761905,3,0.915293335
22617,79,23770,9,10,0,0,0,19,10,4,10,0,0,24,nowin,win,dlbust,bust,20,0,19,211,0.436018957,0.028436019,0.672985782,2,0.650131054
22618,131,23770,3,4,10,0,0,17,10,4,10,0,0,24,nowin,win,dlbust,bust,20,0,7,217,0.410138249,0.069124424,0.543778802,0,0.02015021
22619,77,23770,11,9,0,0,0,20,10,4,10,0,0,24,nowin,win,dlbust,bust,20,0,20,200,0.455,0.04,0.62,3,0.916252116
22620,147,23771,9,4,0,0,0,13,4,10,1,3,0,18,nowin,loss,beat,dlwin,0,10,13,205,0.380487805,0.014634146,0.536585366,0,0.00951447
22621,101,23771,4,7,5,0,0,16,4,10,1,3,0,18,nowin,loss,beat,dlwin,0,10,11,205,0.424390244,0.068292683,0.63902439,2,0.614740646
22622,118,23771,5,3,11,0,0,19,4,10,1,3,0,18,nowin,win,plwin,beat,20,0,8,216,0.393518519,0.037037037,0.555555556,0,0.018059873
22623,46,23771,4,10,0,0,0,14,4,10,1,3,0,18,nowin,loss,beat,dlwin,0,10,14,186,0.403225806,0.048387097,0.591397849,0,0.029742194
22624,45,23771,3,6,4,0,0,13,4,10,1,3,0,18,nowin,loss,beat,dlwin,0,10,9,196,0.428571429,0.051020408,0.612244898,2,0.598821767
22625,87,23771,2,8,5,0,0,15,4,10,1,3,0,18,nowin,loss,beat,dlwin,0,10,10,202,0.405940594,0.054455446,0.628712871,2,0.590599801
22626,73,23772,6,8,0,2,7,23,8,8,7,0,0,23,nowin,loss,bust,plbust,0,10,14,181,0.375690608,0.011049724,0.596685083,0,0.022795773
22627,54,23772,8,5,0,1,8,22,8,8,7,0,0,23,nowin,loss,bust,plbust,0,10,13,185,0.437837838,0.032432432,0.556756757,1,0.29899854
22628,8,23772,10,3,0,8,0,21,8,8,7,0,0,23,nowin,win,dlbust,bust,20,0,13,181,0.44198895,0.071823204,0.596685083,2,0.599438402
22629,108,23772,10,11,0,0,0,21,8,8,7,0,0,23,win,win,dlbust,bust,25,0,21,193,0.435233161,0.056994819,0.559585492,1,0.298824795
22630,13,23772,11,7,0,0,0,18,8,8,7,0,0,23,nowin,win,dlbust,bust,20,0,18,206,0.417475728,0.063106796,0.621359223,2,0.59555479
22631,99,23772,10,6,0,2,0,18,8,8,7,0,0,23,nowin,win,dlbust,bust,20,0,16,207,0.47826087,0.062801932,0.637681159,3,0.961418446
22632,130,23773,4,10,0,0,0,14,5,8,10,0,0,23,nowin,win,dlbust,bust,20,0,14,219,0.410958904,0.03652968,0.566210046,0,0.025888739
22633,47,23773,11,10,0,0,0,21,5,8,10,0,0,23,win,win,dlbust,bust,25,0,21,210,0.438095238,0.057142857,0.623809524,2,0.615868808
22634,146,23773,2,10,0,0,0,12,5,8,10,0,0,23,nowin,win,dlbust,bust,20,0,12,221,0.43438914,0.040723982,0.542986425,1,0.290190091
22635,69,23773,6,2,7,0,0,15,5,8,10,0,0,23,nowin,win,dlbust,bust,20,0,8,194,0.365979381,0.030927835,0.515463918,0,0
22636,133,23773,10,7,0,0,0,17,5,8,10,0,0,23,nowin,win,dlbust,bust,20,0,17,201,0.47761194,0.064676617,0.611940299,3,0.935428111
22637,42,23773,7,5,0,0,0,12,5,8,10,0,0,23,nowin,win,dlbust,bust,20,0,12,212,0.443396226,0.051886792,0.570754717,1,0.309181312
22638,147,23774,6,10,0,9,0,25,1,2,9,6,0,18,nowin,loss,bust,plbust,0,10,16,205,0.380487805,0.014634146,0.536585366,0,0.00951447
22639,66,23774,1,3,10,3,0,17,1,2,9,6,0,18,nowin,loss,beat,dlwin,0,10,4,217,0.456221198,0.064516129,0.626728111,3,0.924304367
22640,91,23774,10,9,0,0,0,19,1,2,9,6,0,18,nowin,win,plwin,beat,20,0,19,194,0.417525773,0.046391753,0.515463918,1,0.266616552
22641,24,23774,10,6,0,2,0,18,1,2,9,6,0,18,nowin,push,push,push,10,0,16,207,0.458937198,0.048309179,0.570048309,1,0.318138014
22642,24,23774,8,10,0,0,0,18,1,2,9,6,0,18,nowin,push,push,push,10,0,18,207,0.458937198,0.048309179,0.570048309,1,0.318138014
22643,146,23774,9,6,0,9,0,24,1,2,9,6,0,18,nowin,loss,bust,plbust,0,10,15,221,0.43438914,0.040723982,0.542986425,1,0.290190091
22644,74,23775,10,10,0,0,0,20,10,9,0,0,0,19,nowin,win,plwin,beat,20,0,20,209,0.411483254,0.04784689,0.531100478,0,0.017448125
22645,12,23775,3,8,9,0,0,20,10,9,0,0,0,19,nowin,win,plwin,beat,20,0,11,189,0.470899471,0.015873016,0.613756614,3,0.929171178
22646,2,23775,10,11,0,0,0,21,10,9,0,0,0,19,win,win,plwin,beat,25,0,21,200,0.445,0.035,0.64,2,0.633962549
22647,97,23775,11,10,0,0,0,21,10,9,0,0,0,19,win,win,plwin,beat,25,0,21,182,0.450549451,0.06043956,0.692307692,2,0.677372279
22648,148,23775,10,3,0,7,0,20,10,9,0,0,0,19,nowin,win,plwin,beat,20,0,13,204,0.401960784,0.078431373,0.593137255,0,0.029789521
22649,28,23775,10,10,0,0,0,20,10,9,0,0,0,19,nowin,win,plwin,beat,20,0,20,199,0.422110553,0.045226131,0.542713568,1,0.282706618
22650,109,23776,3,3,5,7,0,18,2,10,10,0,0,22,nowin,win,dlbust,bust,20,0,6,221,0.461538462,0.058823529,0.597285068,3,0.901830309
22651,131,23776,7,10,0,0,0,17,2,10,10,0,0,22,nowin,win,dlbust,bust,20,0,17,217,0.410138249,0.069124424,0.543778802,0,0.02015021
22652,15,23776,4,10,0,0,0,14,2,10,10,0,0,22,nowin,win,dlbust,bust,20,0,14,212,0.410377358,0.051886792,0.561320755,0,0.024517408
22653,90,23776,10,10,0,0,0,20,2,10,10,0,0,22,nowin,win,dlbust,bust,20,0,20,201,0.447761194,0.049751244,0.60199005,3,0.889945023
22654,72,23776,5,5,10,0,0,20,2,10,10,0,0,22,nowin,win,dlbust,bust,20,0,10,185,0.394594595,0.032432432,0.508108108,0,0.006763115
22655,47,23776,10,8,0,0,0,18,2,10,10,0,0,22,nowin,win,dlbust,bust,20,0,18,210,0.438095238,0.057142857,0.623809524,2,0.615868808
22656,87,23777,10,6,0,1,0,17,11,6,0,0,0,17,nowin,push,push,push,10,0,16,202,0.405940594,0.054455446,0.628712871,2,0.590599801
22657,114,23777,10,10,0,0,0,20,11,6,0,0,0,17,nowin,win,plwin,beat,20,0,20,198,0.47979798,0.025252525,0.611111111,3,0.937232995
22658,137,23777,4,10,0,1,4,19,11,6,0,0,0,17,nowin,win,plwin,beat,20,0,14,194,0.417525773,0.046391753,0.536082474,1,0.276714602
22659,60,23777,10,4,0,5,0,19,11,6,0,0,0,17,nowin,win,plwin,beat,20,0,14,227,0.418502203,0.022026432,0.559471366,0,0.026496258
22660,132,23777,8,10,0,0,0,18,11,6,0,0,0,17,nowin,win,plwin,beat,20,0,18,194,0.412371134,0.036082474,0.649484536,2,0.611633238
22661,9,23777,2,5,8,1,4,20,11,6,0,0,0,17,nowin,win,plwin,beat,20,0,7,194,0.37628866,0.015463918,0.541237113,0,0.009396796
22662,8,23778,6,5,1,0,0,12,4,10,4,0,0,18,nowin,loss,beat,dlwin,0,10,11,181,0.44198895,0.071823204,0.596685083,2,0.599438402
22663,34,23778,5,4,3,0,0,12,4,10,4,0,0,18,nowin,loss,beat,dlwin,0,10,9,202,0.5,0.079207921,0.618811881,3,0.968961434
22664,125,23778,10,9,0,0,0,19,4,10,4,0,0,18,nowin,win,plwin,beat,20,0,19,219,0.438356164,0.050228311,0.575342466,1,0.308411257
22665,150,23778,7,8,0,0,0,15,4,10,4,0,0,18,nowin,loss,beat,dlwin,0,10,15,192,0.401041667,0.036458333,0.567708333,0,0.023287458
22666,116,23778,10,6,0,0,0,16,4,10,4,0,0,18,nowin,loss,beat,dlwin,0,10,16,195,0.425641026,0.056410256,0.538461538,1,0.28273747
22667,149,23778,8,7,0,0,0,15,4,10,4,0,0,18,nowin,loss,beat,dlwin,0,10,15,225,0.457777778,0.057777778,0.648888889,2,0.651965595
22668,16,23779,11,7,0,0,0,18,4,7,10,0,0,21,nowin,loss,beat,dlwin,0,10,18,220,0.427272727,0.081818182,0.6,2,0.588660176
22669,45,23779,2,10,0,0,0,12,4,7,10,0,0,21,nowin,loss,beat,dlwin,0,10,12,196,0.428571429,0.051020408,0.612244898,2,0.598821767
22670,47,23779,2,2,10,0,0,14,4,7,10,0,0,21,nowin,loss,beat,dlwin,0,10,4,210,0.438095238,0.057142857,0.623809524,2,0.615868808
22671,75,23779,10,7,0,0,0,17,4,7,10,0,0,21,nowin,loss,beat,dlwin,0,10,17,191,0.418848168,0.052356021,0.570680628,0,0.029344702
22672,66,23779,11,10,0,0,0,21,4,7,10,0,0,21,win,push,push,push,10,0,21,217,0.456221198,0.064516129,0.626728111,3,0.924304367
22673,6,23779,5,8,0,0,0,13,4,7,10,0,0,21,nowin,loss,beat,dlwin,0,10,13,191,0.439790576,0.047120419,0.581151832,1,0.31211505
22674,10,23780,10,4,0,0,0,14,2,7,3,6,0,18,nowin,loss,beat,dlwin,0,10,14,191,0.413612565,0.057591623,0.596858639,2,0.574087175
22675,63,23780,10,5,0,0,0,15,2,7,3,6,0,18,nowin,loss,beat,dlwin,0,10,15,216,0.467592593,0.037037037,0.62037037,3,0.931690496
22676,76,23780,2,10,0,2,0,14,2,7,3,6,0,18,nowin,loss,beat,dlwin,0,10,12,189,0.534391534,0.079365079,0.608465608,3,1
22677,70,23780,2,4,10,0,0,16,2,7,3,6,0,18,nowin,loss,beat,dlwin,0,10,6,228,0.385964912,0.039473684,0.557017544,0,0.016157125
22678,21,23780,4,8,0,5,0,17,2,7,3,6,0,18,nowin,loss,beat,dlwin,0,10,12,214,0.359813084,0.042056075,0.626168224,0,0.025263474
22679,29,23780,10,5,0,0,0,15,2,7,3,6,0,18,nowin,loss,beat,dlwin,0,10,15,189,0.44973545,0.058201058,0.544973545,1,0.300349439
22680,131,23781,10,5,0,0,0,15,2,4,10,10,0,26,nowin,win,dlbust,bust,20,0,15,217,0.410138249,0.069124424,0.543778802,0,0.02015021
22681,133,23781,6,3,3,6,0,18,2,4,10,10,0,26,nowin,win,dlbust,bust,20,0,9,201,0.47761194,0.064676617,0.611940299,3,0.935428111
22682,60,23781,10,3,0,0,0,13,2,4,10,10,0,26,nowin,win,dlbust,bust,20,0,13,227,0.418502203,0.022026432,0.559471366,0,0.026496258
22683,148,23781,10,8,0,0,0,18,2,4,10,10,0,26,nowin,win,dlbust,bust,20,0,18,204,0.401960784,0.078431373,0.593137255,0,0.029789521
22684,100,23781,7,7,0,0,0,14,2,4,10,10,0,26,nowin,win,dlbust,bust,20,0,14,190,0.452631579,0.036842105,0.594736842,3,0.888671154
22685,76,23781,10,3,0,0,0,13,2,4,10,10,0,26,nowin,win,dlbust,bust,20,0,13,189,0.534391534,0.079365079,0.608465608,3,1
22686,140,23782,10,8,0,0,0,18,10,2,6,0,0,18,nowin,push,push,push,10,0,18,210,0.466666667,0.023809524,0.604761905,3,0.915293335
22687,90,23782,7,10,0,0,0,17,10,2,6,0,0,18,nowin,loss,beat,dlwin,0,10,17,201,0.447761194,0.049751244,0.60199005,3,0.889945023
22688,149,23782,8,2,10,0,0,20,10,2,6,0,0,18,nowin,win,plwin,beat,20,0,10,225,0.457777778,0.057777778,0.648888889,2,0.651965595
22689,27,23782,3,10,0,1,3,17,10,2,6,0,0,18,nowin,loss,beat,dlwin,0,10,13,178,0.370786517,0.016853933,0.573033708,0,0.015536309
22690,47,23782,10,10,0,0,0,20,10,2,6,0,0,18,nowin,win,plwin,beat,20,0,20,210,0.438095238,0.057142857,0.623809524,2,0.615868808
22691,118,23782,10,5,0,7,0,22,10,2,6,0,0,18,nowin,loss,bust,plbust,0,10,15,216,0.393518519,0.037037037,0.555555556,0,0.018059873
22692,50,23783,2,4,10,0,0,16,6,7,7,0,0,20,nowin,loss,beat,dlwin,0,10,6,202,0.405940594,0.04950495,0.54950495,0,0.020296079
22693,91,23783,3,11,6,0,0,20,6,7,7,0,0,20,nowin,push,push,push,10,0,14,194,0.417525773,0.046391753,0.515463918,1,0.266616552
22694,30,23783,10,6,0,0,0,16,6,7,7,0,0,20,nowin,loss,beat,dlwin,0,10,16,206,0.393203883,0.033980583,0.601941748,0,0.029324648
22695,40,23783,7,10,0,0,0,17,6,7,7,0,0,20,nowin,loss,beat,dlwin,0,10,17,196,0.367346939,0.030612245,0.617346939,0,0.025358183
22696,74,23783,1,3,9,0,0,13,6,7,7,0,0,20,nowin,loss,beat,dlwin,0,10,4,209,0.411483254,0.04784689,0.531100478,0,0.017448125
22697,53,23783,5,7,0,0,0,12,6,7,7,0,0,20,nowin,loss,beat,dlwin,0,10,12,250,0.372,0.064,0.564,0,0.013687345
22698,72,23784,5,8,0,0,0,13,6,6,10,0,0,22,nowin,win,dlbust,bust,20,0,13,185,0.394594595,0.032432432,0.508108108,0,0.006763115
22699,85,23784,7,4,3,0,0,14,6,6,10,0,0,22,nowin,win,dlbust,bust,20,0,11,195,0.41025641,0.066666667,0.594871795,0,0.03269711
22700,32,23784,11,10,0,0,0,21,6,6,10,0,0,22,win,win,dlbust,bust,25,0,21,189,0.391534392,0.037037037,0.53968254,0,0.013579086
22701,89,23784,6,5,6,0,0,17,6,6,10,0,0,22,nowin,win,dlbust,bust,20,0,11,212,0.537735849,0.047169811,0.594339623,3,0.990167191
22702,102,23784,10,7,0,0,0,17,6,6,10,0,0,22,nowin,win,dlbust,bust,20,0,17,192,0.338541667,0.046875,0.5625,0,0.003306118
22703,21,23784,4,10,0,0,0,14,6,6,10,0,0,22,nowin,win,dlbust,bust,20,0,14,214,0.359813084,0.042056075,0.626168224,0,0.025263474
22704,128,23785,10,4,0,10,0,24,10,10,0,0,0,20,nowin,loss,bust,plbust,0,10,14,227,0.356828194,0.052863436,0.577092511,0,0.012352564
22705,88,23785,2,11,7,0,0,20,10,10,0,0,0,20,nowin,push,push,push,10,0,13,206,0.466019417,0.033980583,0.54368932,1,0.309467903
22706,79,23785,5,3,10,0,0,18,10,10,0,0,0,20,nowin,loss,beat,dlwin,0,10,8,211,0.436018957,0.028436019,0.672985782,2,0.650131054
22707,88,23785,10,4,0,8,0,22,10,10,0,0,0,20,nowin,loss,bust,plbust,0,10,14,206,0.466019417,0.033980583,0.54368932,1,0.309467903
22708,130,23785,9,10,0,0,0,19,10,10,0,0,0,20,nowin,loss,beat,dlwin,0,10,19,219,0.410958904,0.03652968,0.566210046,0,0.025888739
22709,28,23785,10,2,0,5,0,17,10,10,0,0,0,20,nowin,loss,beat,dlwin,0,10,12,199,0.422110553,0.045226131,0.542713568,1,0.282706618
22710,3,23786,10,3,0,3,9,25,8,3,7,0,0,18,nowin,loss,bust,plbust,0,10,13,190,0.431578947,0.026315789,0.542105263,1,0.288076384
22711,7,23786,10,8,0,0,0,18,8,3,7,0,0,18,nowin,push,push,push,10,0,18,183,0.442622951,0.06010929,0.62295082,2,0.619303341
22712,25,23786,6,8,0,2,8,24,8,3,7,0,0,18,nowin,loss,bust,plbust,0,10,14,190,0.463157895,0.063157895,0.536842105,1,0.304401563
22713,123,23786,6,5,8,0,0,19,8,3,7,0,0,18,nowin,win,plwin,beat,20,0,11,205,0.43902439,0.034146341,0.614634146,2,0.609962544
22714,10,23786,2,2,6,2,3,15,8,3,7,0,0,18,nowin,loss,beat,dlwin,0,10,4,191,0.413612565,0.057591623,0.596858639,2,0.574087175
22715,67,23786,7,10,0,0,0,17,8,3,7,0,0,18,nowin,loss,beat,dlwin,0,10,17,195,0.369230769,0.041025641,0.569230769,0,0.014139427
22716,35,23787,2,8,2,9,0,21,9,5,9,0,0,23,nowin,win,dlbust,bust,20,0,10,202,0.410891089,0.044554455,0.633663366,2,0.598681573
22717,114,23787,3,1,10,8,0,22,9,5,9,0,0,23,nowin,loss,bust,plbust,0,10,4,198,0.47979798,0.025252525,0.611111111,3,0.937232995
22718,18,23787,10,2,0,8,0,20,9,5,9,0,0,23,nowin,win,dlbust,bust,20,0,12,182,0.461538462,0.043956044,0.587912088,3,0.892649374
22719,65,23787,3,10,0,8,0,21,9,5,9,0,0,23,nowin,win,dlbust,bust,20,0,13,203,0.492610837,0.054187192,0.571428571,3,0.913702814
22720,78,23787,10,10,0,0,0,20,9,5,9,0,0,23,nowin,win,dlbust,bust,20,0,20,201,0.517412935,0.034825871,0.587064677,3,0.95871112
22721,96,23787,10,11,0,0,0,21,9,5,9,0,0,23,win,win,dlbust,bust,25,0,21,190,0.468421053,0.057894737,0.584210526,3,0.897263354
22722,28,23788,9,10,0,0,0,19,10,8,0,0,0,18,nowin,win,plwin,beat,20,0,19,199,0.422110553,0.045226131,0.542713568,1,0.282706618
22723,110,23788,5,9,0,10,0,24,10,8,0,0,0,18,nowin,loss,bust,plbust,0,10,14,192,0.416666667,0.046875,0.557291667,0,0.025413132
22724,57,23788,11,2,1,9,0,23,10,8,0,0,0,18,nowin,loss,bust,plbust,0,10,13,192,0.46875,0.052083333,0.59375,3,0.907001181
22725,67,23788,10,2,0,6,0,18,10,8,0,0,0,18,nowin,push,push,push,10,0,12,195,0.369230769,0.041025641,0.569230769,0,0.014139427
22726,27,23788,10,7,0,0,0,17,10,8,0,0,0,18,nowin,loss,beat,dlwin,0,10,17,178,0.370786517,0.016853933,0.573033708,0,0.015536309
22727,35,23788,8,2,3,6,0,19,10,8,0,0,0,18,nowin,win,plwin,beat,20,0,10,202,0.410891089,0.044554455,0.633663366,2,0.598681573
22728,26,23789,6,5,5,0,0,16,2,10,8,0,0,20,nowin,loss,beat,dlwin,0,10,11,203,0.463054187,0.0591133,0.541871921,1,0.306802864
22729,85,23789,9,11,0,0,0,20,2,10,8,0,0,20,nowin,push,push,push,10,0,20,195,0.41025641,0.066666667,0.594871795,0,0.03269711
22730,40,23789,3,2,10,0,0,15,2,10,8,0,0,20,nowin,loss,beat,dlwin,0,10,5,196,0.367346939,0.030612245,0.617346939,0,0.025358183
22731,78,23789,2,7,11,0,0,20,2,10,8,0,0,20,nowin,push,push,push,10,0,9,201,0.517412935,0.034825871,0.587064677,3,0.95871112
22732,131,23789,10,10,0,0,0,20,2,10,8,0,0,20,nowin,push,push,push,10,0,20,217,0.410138249,0.069124424,0.543778802,0,0.02015021
22733,137,23789,10,10,0,0,0,20,2,10,8,0,0,20,nowin,push,push,push,10,0,20,194,0.417525773,0.046391753,0.536082474,1,0.276714602
22734,34,23790,10,11,0,0,0,21,2,5,10,0,0,17,win,win,plwin,beat,25,0,21,202,0.5,0.079207921,0.618811881,3,0.968961434
22735,125,23790,6,10,0,0,0,16,2,5,10,0,0,17,nowin,loss,beat,dlwin,0,10,16,219,0.438356164,0.050228311,0.575342466,1,0.308411257
22736,37,23790,10,2,0,7,0,19,2,5,10,0,0,17,nowin,win,plwin,beat,20,0,12,208,0.394230769,0.038461538,0.581730769,0,0.024682772
22737,33,23790,4,2,2,1,3,12,2,5,10,0,0,17,nowin,loss,beat,dlwin,0,10,6,192,0.4375,0.057291667,0.625,2,0.616208916
22738,3,23790,9,11,0,0,0,20,2,5,10,0,0,17,nowin,win,plwin,beat,20,0,20,190,0.431578947,0.026315789,0.542105263,1,0.288076384
22739,27,23790,3,2,9,0,0,14,2,5,10,0,0,17,nowin,loss,beat,dlwin,0,10,5,178,0.370786517,0.016853933,0.573033708,0,0.015536309
22740,73,23791,8,4,0,0,0,12,5,9,5,0,0,19,nowin,loss,beat,dlwin,0,10,12,181,0.375690608,0.011049724,0.596685083,0,0.022795773
22741,79,23791,4,5,6,0,0,15,5,9,5,0,0,19,nowin,loss,beat,dlwin,0,10,9,211,0.436018957,0.028436019,0.672985782,2,0.650131054
22742,74,23791,7,10,0,0,0,17,5,9,5,0,0,19,nowin,loss,beat,dlwin,0,10,17,209,0.411483254,0.04784689,0.531100478,0,0.017448125
22743,43,23791,5,10,0,0,0,15,5,9,5,0,0,19,nowin,loss,beat,dlwin,0,10,15,192,0.40625,0.041666667,0.609375,2,0.576671372
22744,95,23791,8,10,0,0,0,18,5,9,5,0,0,19,nowin,loss,beat,dlwin,0,10,18,218,0.412844037,0.04587156,0.559633028,0,0.024842385
22745,63,23791,7,10,0,0,0,17,5,9,5,0,0,19,nowin,loss,beat,dlwin,0,10,17,216,0.467592593,0.037037037,0.62037037,3,0.931690496
22746,16,23792,6,2,7,3,0,18,8,10,0,0,0,18,nowin,push,push,push,10,0,8,220,0.427272727,0.081818182,0.6,2,0.588660176
22747,121,23792,4,9,0,10,0,23,8,10,0,0,0,18,nowin,loss,bust,plbust,0,10,13,195,0.456410256,0.025641026,0.512820513,1,0.288597791
22748,54,23792,4,3,7,4,0,18,8,10,0,0,0,18,nowin,push,push,push,10,0,7,185,0.437837838,0.032432432,0.556756757,1,0.29899854
22749,105,23792,5,2,7,10,0,24,8,10,0,0,0,18,nowin,loss,bust,plbust,0,10,7,198,0.414141414,0.070707071,0.590909091,0,0.032889494
22750,122,23792,9,6,0,10,0,25,8,10,0,0,0,18,nowin,loss,bust,plbust,0,10,15,210,0.347619048,0.052380952,0.59047619,0,0.012873677
22751,51,23792,4,3,3,6,10,26,8,10,0,0,0,18,nowin,loss,bust,plbust,0,10,7,189,0.529100529,0.068783069,0.608465608,3,0.993665715
22752,84,23793,10,6,0,9,0,25,9,6,10,0,0,25,nowin,loss,bust,plbust,0,10,16,195,0.379487179,0.056410256,0.569230769,0,0.017209119
22753,4,23793,11,4,1,10,0,26,9,6,10,0,0,25,nowin,loss,bust,plbust,0,10,15,217,0.460829493,0.036866359,0.562211982,1,0.315432839
22754,26,23793,9,7,0,4,0,20,9,6,10,0,0,25,nowin,win,dlbust,bust,20,0,16,203,0.463054187,0.0591133,0.541871921,1,0.306802864
22755,117,23793,7,2,9,0,0,18,9,6,10,0,0,25,nowin,win,dlbust,bust,20,0,9,173,0.410404624,0.069364162,0.606936416,2,0.578610282
22756,146,23793,8,10,0,0,0,18,9,6,10,0,0,25,nowin,win,dlbust,bust,20,0,18,221,0.43438914,0.040723982,0.542986425,1,0.290190091
22757,105,23793,6,6,0,3,3,18,9,6,10,0,0,25,nowin,win,dlbust,bust,20,0,12,198,0.414141414,0.070707071,0.590909091,0,0.032889494
22758,6,23794,5,9,0,0,0,14,5,7,2,10,0,24,nowin,win,dlbust,bust,20,0,14,191,0.439790576,0.047120419,0.581151832,1,0.31211505
22759,48,23794,5,2,5,0,0,12,5,7,2,10,0,24,nowin,win,dlbust,bust,20,0,7,203,0.413793103,0.019704433,0.600985222,2,0.577280801
22760,35,23794,8,8,0,0,0,16,5,7,2,10,0,24,nowin,win,dlbust,bust,20,0,16,202,0.410891089,0.044554455,0.633663366,2,0.598681573
22761,45,23794,3,3,4,1,3,14,5,7,2,10,0,24,nowin,win,dlbust,bust,20,0,6,196,0.428571429,0.051020408,0.612244898,2,0.598821767
22762,149,23794,10,3,0,0,0,13,5,7,2,10,0,24,nowin,win,dlbust,bust,20,0,13,225,0.457777778,0.057777778,0.648888889,2,0.651965595
22763,97,23794,7,2,9,0,0,18,5,7,2,10,0,24,nowin,win,dlbust,bust,20,0,9,182,0.450549451,0.06043956,0.692307692,2,0.677372279
22764,118,23795,2,5,3,10,0,20,2,10,10,0,0,22,nowin,win,dlbust,bust,20,0,7,216,0.393518519,0.037037037,0.555555556,0,0.018059873
22765,146,23795,10,6,0,0,0,16,2,10,10,0,0,22,nowin,win,dlbust,bust,20,0,16,221,0.43438914,0.040723982,0.542986425,1,0.290190091
22766,96,23795,10,4,0,0,0,14,2,10,10,0,0,22,nowin,win,dlbust,bust,20,0,14,190,0.468421053,0.057894737,0.584210526,3,0.897263354
22767,40,23795,5,2,7,0,0,14,2,10,10,0,0,22,nowin,win,dlbust,bust,20,0,7,196,0.367346939,0.030612245,0.617346939,0,0.025358183
22768,57,23795,10,10,0,0,0,20,2,10,10,0,0,22,nowin,win,dlbust,bust,20,0,20,192,0.46875,0.052083333,0.59375,3,0.907001181
22769,69,23795,10,10,0,0,0,20,2,10,10,0,0,22,nowin,win,dlbust,bust,20,0,20,194,0.365979381,0.030927835,0.515463918,0,0
22770,61,23796,10,11,0,0,0,21,3,7,9,0,0,19,win,win,plwin,beat,25,0,21,194,0.427835052,0.077319588,0.603092784,2,0.591437139
22771,30,23796,10,6,0,0,0,16,3,7,9,0,0,19,nowin,loss,beat,dlwin,0,10,16,206,0.393203883,0.033980583,0.601941748,0,0.029324648
22772,34,23796,10,2,0,10,0,22,3,7,9,0,0,19,nowin,loss,bust,plbust,0,10,12,202,0.5,0.079207921,0.618811881,3,0.968961434
22773,92,23796,10,10,0,0,0,20,3,7,9,0,0,19,nowin,win,plwin,beat,20,0,20,186,0.446236559,0.059139785,0.564516129,1,0.307826125
22774,144,23796,3,10,0,0,0,13,3,7,9,0,0,19,nowin,loss,beat,dlwin,0,10,13,202,0.386138614,0.054455446,0.564356436,0,0.018006244
22775,58,23796,10,10,0,0,0,20,3,7,9,0,0,19,nowin,win,plwin,beat,20,0,20,195,0.430769231,0.041025641,0.584615385,2,0.580497586
22776,144,23797,5,10,0,0,0,15,4,4,10,0,0,18,nowin,loss,beat,dlwin,0,10,15,202,0.386138614,0.054455446,0.564356436,0,0.018006244
22777,123,23797,10,4,0,0,0,14,4,4,10,0,0,18,nowin,loss,beat,dlwin,0,10,14,205,0.43902439,0.034146341,0.614634146,2,0.609962544
22778,22,23797,1,4,10,0,0,15,4,4,10,0,0,18,nowin,loss,beat,dlwin,0,10,5,187,0.481283422,0.042780749,0.577540107,3,0.906128176
22779,120,23797,6,9,0,0,0,15,4,4,10,0,0,18,nowin,loss,beat,dlwin,0,10,15,202,0.440594059,0.034653465,0.618811881,2,0.614441029
22780,86,23797,2,9,7,0,0,18,4,4,10,0,0,18,nowin,push,push,push,10,0,11,196,0.454081633,0.040816327,0.591836735,3,0.887566443
22781,69,23797,3,8,6,0,0,17,4,4,10,0,0,18,nowin,loss,beat,dlwin,0,10,11,194,0.365979381,0.030927835,0.515463918,0,0
22782,49,23798,6,9,0,5,0,20,9,7,10,0,0,26,nowin,win,dlbust,bust,20,0,15,207,0.396135266,0.053140097,0.594202899,0,0.028306925
22783,55,23798,5,10,0,4,0,19,9,7,10,0,0,26,nowin,win,dlbust,bust,20,0,15,191,0.371727749,0.057591623,0.54973822,0,0.01011347
22784,17,23798,2,6,5,10,0,23,9,7,10,0,0,26,nowin,loss,bust,plbust,0,10,8,171,0.444444444,0.070175439,0.555555556,1,0.302364894
22785,69,23798,8,2,11,0,0,21,9,7,10,0,0,26,nowin,win,dlbust,bust,20,0,10,194,0.365979381,0.030927835,0.515463918,0,0
22786,149,23798,2,9,6,0,0,17,9,7,10,0,0,26,nowin,win,dlbust,bust,20,0,11,225,0.457777778,0.057777778,0.648888889,2,0.651965595
22787,20,23798,10,2,0,10,0,22,9,7,10,0,0,26,nowin,loss,bust,plbust,0,10,12,186,0.456989247,0.037634409,0.537634409,1,0.301097108
22788,128,23799,9,10,0,0,0,19,9,10,0,0,0,19,nowin,push,push,push,10,0,19,227,0.356828194,0.052863436,0.577092511,0,0.012352564
22789,10,23799,10,10,0,0,0,20,9,10,0,0,0,19,nowin,win,plwin,beat,20,0,20,191,0.413612565,0.057591623,0.596858639,2,0.574087175
22790,127,23799,10,10,0,0,0,20,9,10,0,0,0,19,nowin,win,plwin,beat,20,0,20,201,0.402985075,0.029850746,0.60199005,0,0.032263937
22791,125,23799,2,4,11,0,0,17,9,10,0,0,0,19,nowin,loss,beat,dlwin,0,10,6,219,0.438356164,0.050228311,0.575342466,1,0.308411257
22792,39,23799,4,10,0,10,0,24,9,10,0,0,0,19,nowin,loss,bust,plbust,0,10,14,191,0.429319372,0.062827225,0.57591623,0,0.033760763
22793,48,23799,10,8,0,0,0,18,9,10,0,0,0,19,nowin,loss,beat,dlwin,0,10,18,203,0.413793103,0.019704433,0.600985222,2,0.577280801
22794,140,23800,10,6,0,3,0,19,8,2,6,8,0,24,nowin,win,dlbust,bust,20,0,16,210,0.466666667,0.023809524,0.604761905,3,0.915293335
22795,79,23800,5,1,8,10,0,24,8,2,6,8,0,24,nowin,loss,bust,plbust,0,10,6,211,0.436018957,0.028436019,0.672985782,2,0.650131054
22796,11,23800,8,8,0,10,0,26,8,2,6,8,0,24,nowin,loss,bust,plbust,0,10,16,236,0.457627119,0.016949153,0.588983051,3,0.889015813
22797,57,23800,10,10,0,0,0,20,8,2,6,8,0,24,nowin,win,dlbust,bust,20,0,20,192,0.46875,0.052083333,0.59375,3,0.907001181
22798,127,23800,1,1,10,5,0,17,8,2,6,8,0,24,nowin,win,dlbust,bust,20,0,2,201,0.402985075,0.029850746,0.60199005,0,0.032263937
22799,59,23800,10,11,0,0,0,21,8,2,6,8,0,24,win,win,dlbust,bust,25,0,21,228,0.429824561,0.048245614,0.543859649,1,0.287885446
22800,3,23801,8,10,0,0,0,18,7,9,7,0,0,23,nowin,win,dlbust,bust,20,0,18,190,0.431578947,0.026315789,0.542105263,1,0.288076384
22801,115,23801,10,10,0,0,0,20,7,9,7,0,0,23,nowin,win,dlbust,bust,20,0,20,194,0.427835052,0.041237113,0.592783505,2,0.583863602
22802,129,23801,9,8,0,0,0,17,7,9,7,0,0,23,nowin,win,dlbust,bust,20,0,17,201,0.422885572,0.064676617,0.55721393,0,0.027255383
22803,34,23801,10,7,0,0,0,17,7,9,7,0,0,23,nowin,win,dlbust,bust,20,0,17,202,0.5,0.079207921,0.618811881,3,0.968961434
22804,112,23801,10,5,0,9,0,24,7,9,7,0,0,23,nowin,loss,bust,plbust,0,10,15,203,0.448275862,0.054187192,0.600985222,3,0.889576933
22805,15,23801,7,10,0,0,0,17,7,9,7,0,0,23,nowin,win,dlbust,bust,20,0,17,212,0.410377358,0.051886792,0.561320755,0,0.024517408
22806,141,23802,8,9,0,0,0,17,10,8,0,0,0,18,nowin,loss,beat,dlwin,0,10,17,202,0.420792079,0.074257426,0.564356436,0,0.028377851
22807,106,23802,2,7,6,9,0,24,10,8,0,0,0,18,nowin,loss,bust,plbust,0,10,9,192,0.411458333,0.026041667,0.557291667,0,0.023854304
22808,18,23802,4,7,3,4,0,18,10,8,0,0,0,18,nowin,push,push,push,10,0,11,182,0.461538462,0.043956044,0.587912088,3,0.892649374
22809,139,23802,10,11,0,0,0,21,10,8,0,0,0,18,win,win,plwin,beat,25,0,21,192,0.380208333,0.036458333,0.59375,0,0.023429169
22810,87,23802,10,11,0,0,0,21,10,8,0,0,0,18,win,win,plwin,beat,25,0,21,202,0.405940594,0.054455446,0.628712871,2,0.590599801
22811,77,23802,10,7,0,0,0,17,10,8,0,0,0,18,nowin,loss,beat,dlwin,0,10,17,200,0.455,0.04,0.62,3,0.916252116
22812,71,23803,10,3,0,3,10,26,7,10,0,0,0,17,nowin,loss,bust,plbust,0,10,13,193,0.352331606,0.046632124,0.585492228,0,0.013063661
22813,98,23803,10,7,0,0,0,17,7,10,0,0,0,17,nowin,push,push,push,10,0,17,220,0.422727273,0.054545455,0.55,1,0.28664435
22814,138,23803,8,7,0,2,0,17,7,10,0,0,0,17,nowin,push,push,push,10,0,15,190,0.442105263,0.047368421,0.610526316,2,0.609711065
22815,139,23803,2,1,10,3,6,22,7,10,0,0,0,17,nowin,loss,bust,plbust,0,10,3,192,0.380208333,0.036458333,0.59375,0,0.023429169
22816,82,23803,10,4,0,1,8,23,7,10,0,0,0,17,nowin,loss,bust,plbust,0,10,14,225,0.408888889,0.075555556,0.577777778,0,0.028101874
22817,66,23803,6,10,0,4,0,20,7,10,0,0,0,17,nowin,win,plwin,beat,20,0,16,217,0.456221198,0.064516129,0.626728111,3,0.924304367
22818,83,23804,4,5,8,0,0,17,3,10,8,0,0,21,nowin,loss,beat,dlwin,0,10,9,193,0.424870466,0.051813472,0.678756477,2,0.644360335
22819,89,23804,10,4,0,0,0,14,3,10,8,0,0,21,nowin,loss,beat,dlwin,0,10,14,212,0.537735849,0.047169811,0.594339623,3,0.990167191
22820,11,23804,7,6,0,0,0,13,3,10,8,0,0,21,nowin,loss,beat,dlwin,0,10,13,236,0.457627119,0.016949153,0.588983051,3,0.889015813
22821,59,23804,4,10,0,0,0,14,3,10,8,0,0,21,nowin,loss,beat,dlwin,0,10,14,228,0.429824561,0.048245614,0.543859649,1,0.287885446
22822,46,23804,10,10,0,0,0,20,3,10,8,0,0,21,nowin,loss,beat,dlwin,0,10,20,186,0.403225806,0.048387097,0.591397849,0,0.029742194
22823,122,23804,11,10,0,0,0,21,3,10,8,0,0,21,win,push,push,push,10,0,21,210,0.347619048,0.052380952,0.59047619,0,0.012873677
22824,71,23805,3,3,11,0,0,17,7,10,0,0,0,17,nowin,push,push,push,10,0,6,193,0.352331606,0.046632124,0.585492228,0,0.013063661
22825,45,23805,4,8,0,10,0,22,7,10,0,0,0,17,nowin,loss,bust,plbust,0,10,12,196,0.428571429,0.051020408,0.612244898,2,0.598821767
22826,2,23805,4,5,5,6,0,20,7,10,0,0,0,17,nowin,win,plwin,beat,20,0,9,200,0.445,0.035,0.64,2,0.633962549
22827,34,23805,8,10,0,0,0,18,7,10,0,0,0,17,nowin,win,plwin,beat,20,0,18,202,0.5,0.079207921,0.618811881,3,0.968961434
22828,88,23805,5,4,11,0,0,20,7,10,0,0,0,17,nowin,win,plwin,beat,20,0,9,206,0.466019417,0.033980583,0.54368932,1,0.309467903
22829,58,23805,6,8,0,5,0,19,7,10,0,0,0,17,nowin,win,plwin,beat,20,0,14,195,0.430769231,0.041025641,0.584615385,2,0.580497586
22830,50,23806,1,2,10,3,1,17,10,8,0,0,0,18,nowin,loss,beat,dlwin,0,10,3,202,0.405940594,0.04950495,0.54950495,0,0.020296079
22831,72,23806,10,4,0,10,0,24,10,8,0,0,0,18,nowin,loss,bust,plbust,0,10,14,185,0.394594595,0.032432432,0.508108108,0,0.006763115
22832,12,23806,10,11,0,0,0,21,10,8,0,0,0,18,win,win,plwin,beat,25,0,21,189,0.470899471,0.015873016,0.613756614,3,0.929171178
22833,123,23806,5,10,0,5,0,20,10,8,0,0,0,18,nowin,win,plwin,beat,20,0,15,205,0.43902439,0.034146341,0.614634146,2,0.609962544
22834,138,23806,10,5,0,5,0,20,10,8,0,0,0,18,nowin,win,plwin,beat,20,0,15,190,0.442105263,0.047368421,0.610526316,2,0.609711065
22835,138,23806,4,10,0,9,0,23,10,8,0,0,0,18,nowin,loss,bust,plbust,0,10,14,190,0.442105263,0.047368421,0.610526316,2,0.609711065
22836,119,23807,2,10,0,1,0,13,3,3,5,10,0,21,nowin,loss,beat,dlwin,0,10,12,190,0.405263158,0.068421053,0.515789474,0,0.011837158
22837,44,23807,3,7,4,0,0,14,3,3,5,10,0,21,nowin,loss,beat,dlwin,0,10,10,219,0.433789954,0.050228311,0.534246575,1,0.285551035
22838,131,23807,8,7,0,0,0,15,3,3,5,10,0,21,nowin,loss,beat,dlwin,0,10,15,217,0.410138249,0.069124424,0.543778802,0,0.02015021
22839,78,23807,10,2,0,10,0,22,3,3,5,10,0,21,nowin,loss,bust,plbust,0,10,12,201,0.517412935,0.034825871,0.587064677,3,0.95871112
22840,83,23807,4,6,11,0,0,21,3,3,5,10,0,21,nowin,push,push,push,10,0,10,193,0.424870466,0.051813472,0.678756477,2,0.644360335
22841,50,23807,2,11,2,0,0,15,3,3,5,10,0,21,nowin,loss,beat,dlwin,0,10,13,202,0.405940594,0.04950495,0.54950495,0,0.020296079
22842,36,23808,8,3,5,0,0,16,5,6,7,0,0,18,nowin,loss,beat,dlwin,0,10,11,229,0.445414847,0.056768559,0.655021834,2,0.645370571
22843,59,23808,10,10,0,0,0,20,5,6,7,0,0,18,nowin,win,plwin,beat,20,0,20,228,0.429824561,0.048245614,0.543859649,1,0.287885446
22844,103,23808,10,5,0,0,0,15,5,6,7,0,0,18,nowin,loss,beat,dlwin,0,10,15,203,0.379310345,0.064039409,0.551724138,0,0.012869209
22845,149,23808,1,1,10,0,0,12,5,6,7,0,0,18,nowin,loss,beat,dlwin,0,10,2,225,0.457777778,0.057777778,0.648888889,2,0.651965595
22846,67,23808,6,7,0,0,0,13,5,6,7,0,0,18,nowin,loss,beat,dlwin,0,10,13,195,0.369230769,0.041025641,0.569230769,0,0.014139427
22847,87,23808,8,7,0,0,0,15,5,6,7,0,0,18,nowin,loss,beat,dlwin,0,10,15,202,0.405940594,0.054455446,0.628712871,2,0.590599801
22848,52,23809,6,5,8,0,0,19,6,2,10,0,0,18,nowin,win,plwin,beat,20,0,11,217,0.414746544,0.02764977,0.599078341,2,0.576736024
22849,36,23809,3,10,0,0,0,13,6,2,10,0,0,18,nowin,loss,beat,dlwin,0,10,13,229,0.445414847,0.056768559,0.655021834,2,0.645370571
22850,14,23809,5,9,0,0,0,14,6,2,10,0,0,18,nowin,loss,beat,dlwin,0,10,14,202,0.391089109,0.01980198,0.628712871,2,0.577264877
22851,113,23809,4,8,0,0,0,12,6,2,10,0,0,18,nowin,loss,beat,dlwin,0,10,12,199,0.407035176,0.055276382,0.668341709,2,0.620695264
22852,83,23809,2,9,3,0,0,14,6,2,10,0,0,18,nowin,loss,beat,dlwin,0,10,11,193,0.424870466,0.051813472,0.678756477,2,0.644360335
22853,147,23809,4,6,8,0,0,18,6,2,10,0,0,18,nowin,push,push,push,10,0,10,205,0.380487805,0.014634146,0.536585366,0,0.00951447
22854,82,23810,7,11,0,0,0,18,10,8,0,0,0,18,nowin,push,push,push,10,0,18,225,0.408888889,0.075555556,0.577777778,0,0.028101874
22855,75,23810,3,5,7,7,0,22,10,8,0,0,0,18,nowin,loss,bust,plbust,0,10,8,191,0.418848168,0.052356021,0.570680628,0,0.029344702
22856,82,23810,10,10,0,0,0,20,10,8,0,0,0,18,nowin,win,plwin,beat,20,0,20,225,0.408888889,0.075555556,0.577777778,0,0.028101874
22857,53,23810,5,10,0,6,0,21,10,8,0,0,0,18,nowin,win,plwin,beat,20,0,15,250,0.372,0.064,0.564,0,0.013687345
22858,11,23810,11,9,0,0,0,20,10,8,0,0,0,18,nowin,win,plwin,beat,20,0,20,236,0.457627119,0.016949153,0.588983051,3,0.889015813
22859,128,23810,6,7,0,10,0,23,10,8,0,0,0,18,nowin,loss,bust,plbust,0,10,13,227,0.356828194,0.052863436,0.577092511,0,0.012352564
22860,26,23811,8,10,0,0,0,18,10,4,10,0,0,24,nowin,win,dlbust,bust,20,0,18,203,0.463054187,0.0591133,0.541871921,1,0.306802864
22861,31,23811,10,4,0,10,0,24,10,4,10,0,0,24,nowin,loss,bust,plbust,0,10,14,188,0.473404255,0.058510638,0.515957447,1,0.300306557
22862,26,23811,11,1,5,0,0,17,10,4,10,0,0,24,nowin,win,dlbust,bust,20,0,12,203,0.463054187,0.0591133,0.541871921,1,0.306802864
22863,26,23811,11,10,0,0,0,21,10,4,10,0,0,24,win,win,dlbust,bust,25,0,21,203,0.463054187,0.0591133,0.541871921,1,0.306802864
22864,106,23811,3,6,4,6,0,19,10,4,10,0,0,24,nowin,win,dlbust,bust,20,0,9,192,0.411458333,0.026041667,0.557291667,0,0.023854304
22865,37,23811,5,6,10,0,0,21,10,4,10,0,0,24,nowin,win,dlbust,bust,20,0,11,208,0.394230769,0.038461538,0.581730769,0,0.024682772
22866,42,23812,5,6,10,0,0,21,10,4,8,0,0,22,nowin,win,dlbust,bust,20,0,11,212,0.443396226,0.051886792,0.570754717,1,0.309181312
22867,103,23812,3,9,0,6,0,18,10,4,8,0,0,22,nowin,win,dlbust,bust,20,0,12,203,0.379310345,0.064039409,0.551724138,0,0.012869209
22868,4,23812,8,2,8,0,0,18,10,4,8,0,0,22,nowin,win,dlbust,bust,20,0,10,217,0.460829493,0.036866359,0.562211982,1,0.315432839
22869,118,23812,2,11,7,0,0,20,10,4,8,0,0,22,nowin,win,dlbust,bust,20,0,13,216,0.393518519,0.037037037,0.555555556,0,0.018059873
22870,114,23812,3,2,10,10,0,25,10,4,8,0,0,22,nowin,loss,bust,plbust,0,10,5,198,0.47979798,0.025252525,0.611111111,3,0.937232995
22871,101,23812,10,11,0,0,0,21,10,4,8,0,0,22,win,win,dlbust,bust,25,0,21,205,0.424390244,0.068292683,0.63902439,2,0.614740646
22872,94,23813,10,4,0,3,0,17,8,6,8,0,0,22,nowin,win,dlbust,bust,20,0,14,183,0.43715847,0.043715847,0.540983607,1,0.290866892
22873,65,23813,3,4,6,1,9,23,8,6,8,0,0,22,nowin,loss,bust,plbust,0,10,7,203,0.492610837,0.054187192,0.571428571,3,0.913702814
22874,23,23813,11,10,0,0,0,21,8,6,8,0,0,22,win,win,dlbust,bust,25,0,21,208,0.427884615,0.0625,0.552884615,1,0.29114424
22875,19,23813,10,5,0,10,0,25,8,6,8,0,0,22,nowin,loss,bust,plbust,0,10,15,237,0.41350211,0.054852321,0.628691983,2,0.597373826
22876,43,23813,7,11,0,0,0,18,8,6,8,0,0,22,nowin,win,dlbust,bust,20,0,18,192,0.40625,0.041666667,0.609375,2,0.576671372
22877,5,23813,2,9,10,0,0,21,8,6,8,0,0,22,nowin,win,dlbust,bust,20,0,11,203,0.42364532,0.02955665,0.596059113,2,0.582508076
22878,107,23814,6,7,0,1,10,24,10,10,0,0,0,20,nowin,loss,bust,plbust,0,10,13,218,0.444954128,0.073394495,0.600917431,2,0.605210014
22879,144,23814,8,6,0,10,0,24,10,10,0,0,0,20,nowin,loss,bust,plbust,0,10,14,202,0.386138614,0.054455446,0.564356436,0,0.018006244
22880,99,23814,7,10,0,0,0,17,10,10,0,0,0,20,nowin,loss,beat,dlwin,0,10,17,207,0.47826087,0.062801932,0.637681159,3,0.961418446
22881,100,23814,10,4,0,7,0,21,10,10,0,0,0,20,nowin,win,plwin,beat,20,0,14,190,0.452631579,0.036842105,0.594736842,3,0.888671154
22882,21,23814,10,9,0,0,0,19,10,10,0,0,0,20,nowin,loss,beat,dlwin,0,10,19,214,0.359813084,0.042056075,0.626168224,0,0.025263474
22883,21,23814,10,10,0,0,0,20,10,10,0,0,0,20,nowin,push,push,push,10,0,20,214,0.359813084,0.042056075,0.626168224,0,0.025263474
22884,89,23815,6,10,0,0,0,16,4,10,9,0,0,23,nowin,win,dlbust,bust,20,0,16,212,0.537735849,0.047169811,0.594339623,3,0.990167191
22885,111,23815,4,9,0,0,0,13,4,10,9,0,0,23,nowin,win,dlbust,bust,20,0,13,180,0.433333333,0.055555556,0.611111111,2,0.602264492
22886,5,23815,11,7,0,0,0,18,4,10,9,0,0,23,nowin,win,dlbust,bust,20,0,18,203,0.42364532,0.02955665,0.596059113,2,0.582508076
22887,111,23815,1,3,10,0,0,14,4,10,9,0,0,23,nowin,win,dlbust,bust,20,0,4,180,0.433333333,0.055555556,0.611111111,2,0.602264492
22888,15,23815,9,11,0,0,0,20,4,10,9,0,0,23,nowin,win,dlbust,bust,20,0,20,212,0.410377358,0.051886792,0.561320755,0,0.024517408
22889,7,23815,5,8,0,0,0,13,4,10,9,0,0,23,nowin,win,dlbust,bust,20,0,13,183,0.442622951,0.06010929,0.62295082,2,0.619303341
22890,45,23816,10,5,0,0,0,15,3,3,10,5,0,21,nowin,loss,beat,dlwin,0,10,15,196,0.428571429,0.051020408,0.612244898,2,0.598821767
22891,133,23816,11,8,0,0,0,19,3,3,10,5,0,21,nowin,loss,beat,dlwin,0,10,19,201,0.47761194,0.064676617,0.611940299,3,0.935428111
22892,130,23816,3,4,3,10,0,20,3,3,10,5,0,21,nowin,loss,beat,dlwin,0,10,7,219,0.410958904,0.03652968,0.566210046,0,0.025888739
22893,134,23816,7,10,0,0,0,17,3,3,10,5,0,21,nowin,loss,beat,dlwin,0,10,17,185,0.443243243,0.021621622,0.545945946,1,0.296939509
22894,103,23816,10,9,0,0,0,19,3,3,10,5,0,21,nowin,loss,beat,dlwin,0,10,19,203,0.379310345,0.064039409,0.551724138,0,0.012869209
22895,26,23816,3,11,5,0,0,19,3,3,10,5,0,21,nowin,loss,beat,dlwin,0,10,14,203,0.463054187,0.0591133,0.541871921,1,0.306802864
22896,3,23817,9,4,0,0,0,13,5,5,2,7,0,19,nowin,loss,beat,dlwin,0,10,13,190,0.431578947,0.026315789,0.542105263,1,0.288076384
22897,78,23817,4,10,0,0,0,14,5,5,2,7,0,19,nowin,loss,beat,dlwin,0,10,14,201,0.517412935,0.034825871,0.587064677,3,0.95871112
22898,31,23817,10,11,0,0,0,21,5,5,2,7,0,19,win,win,plwin,beat,25,0,21,188,0.473404255,0.058510638,0.515957447,1,0.300306557
22899,81,23817,10,10,0,0,0,20,5,5,2,7,0,19,nowin,win,plwin,beat,20,0,20,182,0.395604396,0.043956044,0.60989011,2,0.567491261
22900,32,23817,2,8,6,0,0,16,5,5,2,7,0,19,nowin,loss,beat,dlwin,0,10,10,189,0.391534392,0.037037037,0.53968254,0,0.013579086
22901,44,23817,10,11,0,0,0,21,5,5,2,7,0,19,win,win,plwin,beat,25,0,21,219,0.433789954,0.050228311,0.534246575,1,0.285551035
22902,94,23818,5,3,10,0,0,18,3,2,11,10,0,26,nowin,win,dlbust,bust,20,0,8,183,0.43715847,0.043715847,0.540983607,1,0.290866892
22903,52,23818,7,6,0,0,0,13,3,2,11,10,0,26,nowin,win,dlbust,bust,20,0,13,217,0.414746544,0.02764977,0.599078341,2,0.576736024
22904,83,23818,4,10,0,0,0,14,3,2,11,10,0,26,nowin,win,dlbust,bust,20,0,14,193,0.424870466,0.051813472,0.678756477,2,0.644360335
22905,98,23818,5,11,4,0,0,20,3,2,11,10,0,26,nowin,win,dlbust,bust,20,0,16,220,0.422727273,0.054545455,0.55,1,0.28664435
22906,41,23818,10,9,0,0,0,19,3,2,11,10,0,26,nowin,win,dlbust,bust,20,0,19,192,0.364583333,0.036458333,0.520833333,0,0.00089702
22907,138,23818,9,10,0,0,0,19,3,2,11,10,0,26,nowin,win,dlbust,bust,20,0,19,190,0.442105263,0.047368421,0.610526316,2,0.609711065
22908,134,23819,10,4,0,0,0,14,2,8,10,0,0,20,nowin,loss,beat,dlwin,0,10,14,185,0.443243243,0.021621622,0.545945946,1,0.296939509
22909,14,23819,3,10,0,0,0,13,2,8,10,0,0,20,nowin,loss,beat,dlwin,0,10,13,202,0.391089109,0.01980198,0.628712871,2,0.577264877
22910,146,23819,11,1,5,0,0,17,2,8,10,0,0,20,nowin,loss,beat,dlwin,0,10,12,221,0.43438914,0.040723982,0.542986425,1,0.290190091
22911,74,23819,2,4,4,4,0,14,2,8,10,0,0,20,nowin,loss,beat,dlwin,0,10,6,209,0.411483254,0.04784689,0.531100478,0,0.017448125
22912,135,23819,9,11,0,0,0,20,2,8,10,0,0,20,nowin,push,push,push,10,0,20,179,0.391061453,0.067039106,0.586592179,0,0.024924662
22913,98,23819,11,9,0,0,0,20,2,8,10,0,0,20,nowin,push,push,push,10,0,20,220,0.422727273,0.054545455,0.55,1,0.28664435
22914,63,23820,10,10,0,0,0,20,2,3,5,7,0,17,nowin,win,plwin,beat,20,0,20,216,0.467592593,0.037037037,0.62037037,3,0.931690496
22915,131,23820,3,11,6,0,0,20,2,3,5,7,0,17,nowin,win,plwin,beat,20,0,14,217,0.410138249,0.069124424,0.543778802,0,0.02015021
22916,108,23820,10,11,0,0,0,21,2,3,5,7,0,17,win,win,plwin,beat,25,0,21,193,0.435233161,0.056994819,0.559585492,1,0.298824795
22917,24,23820,2,9,10,0,0,21,2,3,5,7,0,17,nowin,win,plwin,beat,20,0,11,207,0.458937198,0.048309179,0.570048309,1,0.318138014
22918,4,23820,10,2,0,10,0,22,2,3,5,7,0,17,nowin,loss,bust,plbust,0,10,12,217,0.460829493,0.036866359,0.562211982,1,0.315432839
22919,17,23820,10,3,0,0,0,13,2,3,5,7,0,17,nowin,loss,beat,dlwin,0,10,13,171,0.444444444,0.070175439,0.555555556,1,0.302364894
22920,89,23821,10,10,0,0,0,20,2,10,6,0,0,18,nowin,win,plwin,beat,20,0,20,212,0.537735849,0.047169811,0.594339623,3,0.990167191
22921,58,23821,8,2,6,0,0,16,2,10,6,0,0,18,nowin,loss,beat,dlwin,0,10,10,195,0.430769231,0.041025641,0.584615385,2,0.580497586
22922,53,23821,8,10,0,0,0,18,2,10,6,0,0,18,nowin,push,push,push,10,0,18,250,0.372,0.064,0.564,0,0.013687345
22923,147,23821,10,5,0,0,0,15,2,10,6,0,0,18,nowin,loss,beat,dlwin,0,10,15,205,0.380487805,0.014634146,0.536585366,0,0.00951447
22924,30,23821,3,6,4,0,0,13,2,10,6,0,0,18,nowin,loss,beat,dlwin,0,10,9,206,0.393203883,0.033980583,0.601941748,0,0.029324648
22925,150,23821,7,2,8,0,0,17,2,10,6,0,0,18,nowin,loss,beat,dlwin,0,10,9,192,0.401041667,0.036458333,0.567708333,0,0.023287458
22926,144,23822,7,10,0,0,0,17,9,7,4,0,0,20,nowin,loss,beat,dlwin,0,10,17,202,0.386138614,0.054455446,0.564356436,0,0.018006244
22927,87,23822,5,10,0,4,0,19,9,7,4,0,0,20,nowin,loss,beat,dlwin,0,10,15,202,0.405940594,0.054455446,0.628712871,2,0.590599801
22928,146,23822,10,10,0,0,0,20,9,7,4,0,0,20,nowin,push,push,push,10,0,20,221,0.43438914,0.040723982,0.542986425,1,0.290190091
22929,137,23822,9,11,0,0,0,20,9,7,4,0,0,20,nowin,push,push,push,10,0,20,194,0.417525773,0.046391753,0.536082474,1,0.276714602
22930,130,23822,10,10,0,0,0,20,9,7,4,0,0,20,nowin,push,push,push,10,0,20,219,0.410958904,0.03652968,0.566210046,0,0.025888739
22931,26,23822,10,5,0,2,0,17,9,7,4,0,0,20,nowin,loss,beat,dlwin,0,10,15,203,0.463054187,0.0591133,0.541871921,1,0.306802864
22932,74,23823,6,10,0,0,0,16,5,10,9,0,0,24,nowin,win,dlbust,bust,20,0,16,209,0.411483254,0.04784689,0.531100478,0,0.017448125
22933,138,23823,10,8,0,0,0,18,5,10,9,0,0,24,nowin,win,dlbust,bust,20,0,18,190,0.442105263,0.047368421,0.610526316,2,0.609711065
22934,88,23823,6,2,3,5,0,16,5,10,9,0,0,24,nowin,win,dlbust,bust,20,0,8,206,0.466019417,0.033980583,0.54368932,1,0.309467903
22935,63,23823,10,5,0,0,0,15,5,10,9,0,0,24,nowin,win,dlbust,bust,20,0,15,216,0.467592593,0.037037037,0.62037037,3,0.931690496
22936,82,23823,4,10,0,0,0,14,5,10,9,0,0,24,nowin,win,dlbust,bust,20,0,14,225,0.408888889,0.075555556,0.577777778,0,0.028101874
22937,125,23823,4,11,6,0,0,21,5,10,9,0,0,24,nowin,win,dlbust,bust,20,0,15,219,0.438356164,0.050228311,0.575342466,1,0.308411257
22938,83,23824,6,10,0,10,0,26,7,10,0,0,0,17,nowin,loss,bust,plbust,0,10,16,193,0.424870466,0.051813472,0.678756477,2,0.644360335
22939,68,23824,10,10,0,0,0,20,7,10,0,0,0,17,nowin,win,plwin,beat,20,0,20,205,0.434146341,0.029268293,0.6,2,0.59483189
22940,58,23824,10,8,0,0,0,18,7,10,0,0,0,17,nowin,win,plwin,beat,20,0,18,195,0.430769231,0.041025641,0.584615385,2,0.580497586
22941,44,23824,9,7,0,10,0,26,7,10,0,0,0,17,nowin,loss,bust,plbust,0,10,16,219,0.433789954,0.050228311,0.534246575,1,0.285551035
22942,123,23824,6,2,10,0,0,18,7,10,0,0,0,17,nowin,win,plwin,beat,20,0,8,205,0.43902439,0.034146341,0.614634146,2,0.609962544
22943,113,23824,7,10,0,0,0,17,7,10,0,0,0,17,nowin,push,push,push,10,0,17,199,0.407035176,0.055276382,0.668341709,2,0.620695264
22944,128,23825,2,7,3,3,10,25,9,11,0,0,0,20,nowin,loss,bust,plbust,0,10,9,227,0.356828194,0.052863436,0.577092511,0,0.012352564
22945,4,23825,10,10,0,0,0,20,9,11,0,0,0,20,nowin,push,push,push,10,0,20,217,0.460829493,0.036866359,0.562211982,1,0.315432839
22946,75,23825,8,10,0,0,0,18,9,11,0,0,0,20,nowin,loss,beat,dlwin,0,10,18,191,0.418848168,0.052356021,0.570680628,0,0.029344702
22947,130,23825,10,9,0,0,0,19,9,11,0,0,0,20,nowin,loss,beat,dlwin,0,10,19,219,0.410958904,0.03652968,0.566210046,0,0.025888739
22948,62,23825,7,11,0,0,0,18,9,11,0,0,0,20,nowin,loss,beat,dlwin,0,10,18,178,0.370786517,0.028089888,0.54494382,0,0.008657722
22949,97,23825,10,11,0,0,0,21,9,11,0,0,0,20,win,win,plwin,beat,25,0,21,182,0.450549451,0.06043956,0.692307692,2,0.677372279
22950,132,23826,3,10,0,9,0,22,10,5,4,0,0,19,nowin,loss,bust,plbust,0,10,13,194,0.412371134,0.036082474,0.649484536,2,0.611633238
22951,107,23826,9,10,0,0,0,19,10,5,4,0,0,19,nowin,push,push,push,10,0,19,218,0.444954128,0.073394495,0.600917431,2,0.605210014
22952,98,23826,1,3,10,10,0,24,10,5,4,0,0,19,nowin,loss,bust,plbust,0,10,4,220,0.422727273,0.054545455,0.55,1,0.28664435
22953,13,23826,3,10,0,2,8,23,10,5,4,0,0,19,nowin,loss,bust,plbust,0,10,13,206,0.417475728,0.063106796,0.621359223,2,0.59555479
22954,21,23826,3,9,0,1,4,17,10,5,4,0,0,19,nowin,loss,beat,dlwin,0,10,12,214,0.359813084,0.042056075,0.626168224,0,0.025263474
22955,95,23826,7,9,0,10,0,26,10,5,4,0,0,19,nowin,loss,bust,plbust,0,10,16,218,0.412844037,0.04587156,0.559633028,0,0.024842385
22956,136,23827,3,8,9,0,0,20,7,10,0,0,0,17,nowin,win,plwin,beat,20,0,11,194,0.396907216,0.025773196,0.597938144,0,0.029452644
22957,48,23827,5,9,0,10,0,24,7,10,0,0,0,17,nowin,loss,bust,plbust,0,10,14,203,0.413793103,0.019704433,0.600985222,2,0.577280801
22958,37,23827,10,2,0,4,5,21,7,10,0,0,0,17,nowin,win,plwin,beat,20,0,12,208,0.394230769,0.038461538,0.581730769,0,0.024682772
22959,18,23827,8,6,0,10,0,24,7,10,0,0,0,17,nowin,loss,bust,plbust,0,10,14,182,0.461538462,0.043956044,0.587912088,3,0.892649374
22960,14,23827,7,4,6,0,0,17,7,10,0,0,0,17,nowin,push,push,push,10,0,11,202,0.391089109,0.01980198,0.628712871,2,0.577264877
22961,58,23827,10,7,0,0,0,17,7,10,0,0,0,17,nowin,push,push,push,10,0,17,195,0.430769231,0.041025641,0.584615385,2,0.580497586
22962,126,23828,3,6,9,0,0,18,5,10,6,0,0,21,nowin,loss,beat,dlwin,0,10,9,188,0.457446809,0.074468085,0.60106383,3,0.900633203
22963,95,23828,8,3,1,0,0,12,5,10,6,0,0,21,nowin,loss,beat,dlwin,0,10,11,218,0.412844037,0.04587156,0.559633028,0,0.024842385
22964,145,23828,5,9,0,0,0,14,5,10,6,0,0,21,nowin,loss,beat,dlwin,0,10,14,188,0.441489362,0.031914894,0.622340426,2,0.617837093
22965,16,23828,5,9,0,0,0,14,5,10,6,0,0,21,nowin,loss,beat,dlwin,0,10,14,220,0.427272727,0.081818182,0.6,2,0.588660176
22966,107,23828,6,2,11,0,0,19,5,10,6,0,0,21,nowin,loss,beat,dlwin,0,10,8,218,0.444954128,0.073394495,0.600917431,2,0.605210014
22967,41,23828,4,2,11,0,0,17,5,10,6,0,0,21,nowin,loss,beat,dlwin,0,10,6,192,0.364583333,0.036458333,0.520833333,0,0.00089702
22968,40,23829,9,5,0,0,0,14,6,10,10,0,0,26,nowin,win,dlbust,bust,20,0,14,196,0.367346939,0.030612245,0.617346939,0,0.025358183
22969,20,23829,1,5,10,0,0,16,6,10,10,0,0,26,nowin,win,dlbust,bust,20,0,6,186,0.456989247,0.037634409,0.537634409,1,0.301097108
22970,125,23829,1,3,8,0,0,12,6,10,10,0,0,26,nowin,win,dlbust,bust,20,0,4,219,0.438356164,0.050228311,0.575342466,1,0.308411257
22971,102,23829,10,4,0,0,0,14,6,10,10,0,0,26,nowin,win,dlbust,bust,20,0,14,192,0.338541667,0.046875,0.5625,0,0.003306118
22972,44,23829,4,8,0,0,0,12,6,10,10,0,0,26,nowin,win,dlbust,bust,20,0,12,219,0.433789954,0.050228311,0.534246575,1,0.285551035
22973,86,23829,6,8,0,0,0,14,6,10,10,0,0,26,nowin,win,dlbust,bust,20,0,14,196,0.454081633,0.040816327,0.591836735,3,0.887566443
22974,100,23830,6,6,0,3,4,19,10,10,0,0,0,20,nowin,loss,beat,dlwin,0,10,12,190,0.452631579,0.036842105,0.594736842,3,0.888671154
22975,129,23830,9,3,0,2,9,23,10,10,0,0,0,20,nowin,loss,bust,plbust,0,10,12,201,0.422885572,0.064676617,0.55721393,0,0.027255383
22976,85,23830,10,2,0,2,3,17,10,10,0,0,0,20,nowin,loss,beat,dlwin,0,10,12,195,0.41025641,0.066666667,0.594871795,0,0.03269711
22977,70,23830,9,7,0,7,0,23,10,10,0,0,0,20,nowin,loss,bust,plbust,0,10,16,228,0.385964912,0.039473684,0.557017544,0,0.016157125
22978,133,23830,11,10,0,0,0,21,10,10,0,0,0,20,win,win,plwin,beat,25,0,21,201,0.47761194,0.064676617,0.611940299,3,0.935428111
22979,38,23830,9,10,0,0,0,19,10,10,0,0,0,20,nowin,loss,beat,dlwin,0,10,19,202,0.361386139,0.03960396,0.564356436,0,0.010597953
22980,49,23831,5,9,0,10,0,24,10,9,0,0,0,19,nowin,loss,bust,plbust,0,10,14,207,0.396135266,0.053140097,0.594202899,0,0.028306925
22981,136,23831,8,9,0,0,0,17,10,9,0,0,0,19,nowin,loss,beat,dlwin,0,10,17,194,0.396907216,0.025773196,0.597938144,0,0.029452644
22982,57,23831,10,5,0,10,0,25,10,9,0,0,0,19,nowin,loss,bust,plbust,0,10,15,192,0.46875,0.052083333,0.59375,3,0.907001181
22983,85,23831,11,8,0,0,0,19,10,9,0,0,0,19,nowin,push,push,push,10,0,19,195,0.41025641,0.066666667,0.594871795,0,0.03269711
22984,148,23831,7,3,2,10,0,22,10,9,0,0,0,19,nowin,loss,bust,plbust,0,10,10,204,0.401960784,0.078431373,0.593137255,0,0.029789521
22985,95,23831,10,11,0,0,0,21,10,9,0,0,0,19,win,win,plwin,beat,25,0,21,218,0.412844037,0.04587156,0.559633028,0,0.024842385
22986,133,23832,7,10,0,0,0,17,6,4,11,0,0,21,nowin,loss,beat,dlwin,0,10,17,201,0.47761194,0.064676617,0.611940299,3,0.935428111
22987,7,23832,7,11,0,0,0,18,6,4,11,0,0,21,nowin,loss,beat,dlwin,0,10,18,183,0.442622951,0.06010929,0.62295082,2,0.619303341
22988,38,23832,10,10,0,0,0,20,6,4,11,0,0,21,nowin,loss,beat,dlwin,0,10,20,202,0.361386139,0.03960396,0.564356436,0,0.010597953
22989,124,23832,10,3,0,0,0,13,6,4,11,0,0,21,nowin,loss,beat,dlwin,0,10,13,202,0.47029703,0.064356436,0.584158416,3,0.899458193
22990,52,23832,4,8,0,0,0,12,6,4,11,0,0,21,nowin,loss,beat,dlwin,0,10,12,217,0.414746544,0.02764977,0.599078341,2,0.576736024
22991,57,23832,10,3,0,0,0,13,6,4,11,0,0,21,nowin,loss,beat,dlwin,0,10,13,192,0.46875,0.052083333,0.59375,3,0.907001181
22992,104,23833,11,3,5,0,0,19,10,10,0,0,0,20,nowin,loss,beat,dlwin,0,10,14,209,0.363636364,0.052631579,0.593301435,0,0.018359419
22993,134,23833,7,10,0,0,0,17,10,10,0,0,0,20,nowin,loss,beat,dlwin,0,10,17,185,0.443243243,0.021621622,0.545945946,1,0.296939509
22994,10,23833,11,10,0,0,0,21,10,10,0,0,0,20,win,win,plwin,beat,25,0,21,191,0.413612565,0.057591623,0.596858639,2,0.574087175
22995,34,23833,11,10,0,0,0,21,10,10,0,0,0,20,win,win,plwin,beat,25,0,21,202,0.5,0.079207921,0.618811881,3,0.968961434
22996,123,23833,10,10,0,0,0,20,10,10,0,0,0,20,nowin,push,push,push,10,0,20,205,0.43902439,0.034146341,0.614634146,2,0.609962544
22997,125,23833,10,10,0,0,0,20,10,10,0,0,0,20,nowin,push,push,push,10,0,20,219,0.438356164,0.050228311,0.575342466,1,0.308411257
22998,50,23834,3,6,11,0,0,20,2,5,2,10,0,19,nowin,win,plwin,beat,20,0,9,202,0.405940594,0.04950495,0.54950495,0,0.020296079
22999,20,23834,3,11,2,0,0,16,2,5,2,10,0,19,nowin,loss,beat,dlwin,0,10,14,186,0.456989247,0.037634409,0.537634409,1,0.301097108
23000,119,23834,3,2,6,10,0,21,2,5,2,10,0,19,nowin,win,plwin,beat,20,0,5,190,0.405263158,0.068421053,0.515789474,0,0.011837158
23001,25,23834,10,10,0,0,0,20,2,5,2,10,0,19,nowin,win,plwin,beat,20,0,20,190,0.463157895,0.063157895,0.536842105,1,0.304401563
23002,53,23834,8,10,0,0,0,18,2,5,2,10,0,19,nowin,loss,beat,dlwin,0,10,18,250,0.372,0.064,0.564,0,0.013687345
23003,54,23834,6,9,0,0,0,15,2,5,2,10,0,19,nowin,loss,beat,dlwin,0,10,15,185,0.437837838,0.032432432,0.556756757,1,0.29899854
23004,130,23835,10,7,0,0,0,17,5,3,10,0,0,18,nowin,loss,beat,dlwin,0,10,17,219,0.410958904,0.03652968,0.566210046,0,0.025888739
23005,112,23835,3,2,10,0,0,15,5,3,10,0,0,18,nowin,loss,beat,dlwin,0,10,5,203,0.448275862,0.054187192,0.600985222,3,0.889576933
23006,27,23835,5,8,0,0,0,13,5,3,10,0,0,18,nowin,loss,beat,dlwin,0,10,13,178,0.370786517,0.016853933,0.573033708,0,0.015536309
23007,103,23835,9,5,0,0,0,14,5,3,10,0,0,18,nowin,loss,beat,dlwin,0,10,14,203,0.379310345,0.064039409,0.551724138,0,0.012869209
23008,41,23835,8,10,0,0,0,18,5,3,10,0,0,18,nowin,push,push,push,10,0,18,192,0.364583333,0.036458333,0.520833333,0,0.00089702
23009,49,23835,7,11,0,0,0,18,5,3,10,0,0,18,nowin,push,push,push,10,0,18,207,0.396135266,0.053140097,0.594202899,0,0.028306925
23010,28,23836,3,5,10,0,0,18,9,9,0,0,0,18,nowin,push,push,push,10,0,8,199,0.422110553,0.045226131,0.542713568,1,0.282706618
23011,130,23836,10,10,0,0,0,20,9,9,0,0,0,18,nowin,win,plwin,beat,20,0,20,219,0.410958904,0.03652968,0.566210046,0,0.025888739
23012,79,23836,10,3,0,1,8,22,9,9,0,0,0,18,nowin,loss,bust,plbust,0,10,13,211,0.436018957,0.028436019,0.672985782,2,0.650131054
23013,141,23836,3,10,0,9,0,22,9,9,0,0,0,18,nowin,loss,bust,plbust,0,10,13,202,0.420792079,0.074257426,0.564356436,0,0.028377851
23014,17,23836,9,8,0,0,0,17,9,9,0,0,0,18,nowin,loss,beat,dlwin,0,10,17,171,0.444444444,0.070175439,0.555555556,1,0.302364894
23015,74,23836,3,10,0,1,3,17,9,9,0,0,0,18,nowin,loss,beat,dlwin,0,10,13,209,0.411483254,0.04784689,0.531100478,0,0.017448125
23016,21,23837,10,11,0,0,0,21,10,9,0,0,0,19,win,win,plwin,beat,25,0,21,214,0.359813084,0.042056075,0.626168224,0,0.025263474
23017,122,23837,10,11,0,0,0,21,10,9,0,0,0,19,win,win,plwin,beat,25,0,21,210,0.347619048,0.052380952,0.59047619,0,0.012873677
23018,38,23837,10,7,0,0,0,17,10,9,0,0,0,19,nowin,loss,beat,dlwin,0,10,17,202,0.361386139,0.03960396,0.564356436,0,0.010597953
23019,135,23837,3,10,0,6,0,19,10,9,0,0,0,19,nowin,push,push,push,10,0,13,179,0.391061453,0.067039106,0.586592179,0,0.024924662
23020,68,23837,10,7,0,0,0,17,10,9,0,0,0,19,nowin,loss,beat,dlwin,0,10,17,205,0.434146341,0.029268293,0.6,2,0.59483189
23021,145,23837,4,7,10,0,0,21,10,9,0,0,0,19,nowin,win,plwin,beat,20,0,11,188,0.441489362,0.031914894,0.622340426,2,0.617837093
23022,84,23838,10,10,0,0,0,20,10,10,0,0,0,20,nowin,push,push,push,10,0,20,195,0.379487179,0.056410256,0.569230769,0,0.017209119
23023,60,23838,10,4,0,10,0,24,10,10,0,0,0,20,nowin,loss,bust,plbust,0,10,14,227,0.418502203,0.022026432,0.559471366,0,0.026496258
23024,26,23838,10,2,0,3,10,25,10,10,0,0,0,20,nowin,loss,bust,plbust,0,10,12,203,0.463054187,0.0591133,0.541871921,1,0.306802864
23025,79,23838,6,4,9,0,0,19,10,10,0,0,0,20,nowin,loss,beat,dlwin,0,10,10,211,0.436018957,0.028436019,0.672985782,2,0.650131054
23026,58,23838,4,10,0,2,10,26,10,10,0,0,0,20,nowin,loss,bust,plbust,0,10,14,195,0.430769231,0.041025641,0.584615385,2,0.580497586
23027,118,23838,1,6,6,2,10,25,10,10,0,0,0,20,nowin,loss,bust,plbust,0,10,7,216,0.393518519,0.037037037,0.555555556,0,0.018059873
23028,54,23839,10,2,0,2,10,24,10,6,8,0,0,24,nowin,loss,bust,plbust,0,10,12,185,0.437837838,0.032432432,0.556756757,1,0.29899854
23029,103,23839,2,10,0,6,0,18,10,6,8,0,0,24,nowin,win,dlbust,bust,20,0,12,203,0.379310345,0.064039409,0.551724138,0,0.012869209
23030,1,23839,4,4,8,10,0,26,10,6,8,0,0,24,nowin,loss,bust,plbust,0,10,8,197,0.406091371,0.025380711,0.649746193,2,0.606186955
23031,124,23839,7,10,0,0,0,17,10,6,8,0,0,24,nowin,win,dlbust,bust,20,0,17,202,0.47029703,0.064356436,0.584158416,3,0.899458193
23032,87,23839,10,10,0,0,0,20,10,6,8,0,0,24,nowin,win,dlbust,bust,20,0,20,202,0.405940594,0.054455446,0.628712871,2,0.590599801
23033,61,23839,10,5,0,7,0,22,10,6,8,0,0,24,nowin,loss,bust,plbust,0,10,15,194,0.427835052,0.077319588,0.603092784,2,0.591437139
23034,76,23840,10,3,0,0,0,13,5,6,4,1,10,26,nowin,win,dlbust,bust,20,0,13,189,0.534391534,0.079365079,0.608465608,3,1
23035,71,23840,3,10,0,0,0,13,5,6,4,1,10,26,nowin,win,dlbust,bust,20,0,13,193,0.352331606,0.046632124,0.585492228,0,0.013063661
23036,57,23840,7,10,0,0,0,17,5,6,4,1,10,26,nowin,win,dlbust,bust,20,0,17,192,0.46875,0.052083333,0.59375,3,0.907001181
23037,139,23840,10,8,0,0,0,18,5,6,4,1,10,26,nowin,win,dlbust,bust,20,0,18,192,0.380208333,0.036458333,0.59375,0,0.023429169
23038,37,23840,8,3,2,0,0,13,5,6,4,1,10,26,nowin,win,dlbust,bust,20,0,11,208,0.394230769,0.038461538,0.581730769,0,0.024682772
23039,37,23840,10,10,0,0,0,20,5,6,4,1,10,26,nowin,win,dlbust,bust,20,0,20,208,0.394230769,0.038461538,0.581730769,0,0.024682772
23040,20,23841,8,5,0,4,0,17,10,10,0,0,0,20,nowin,loss,beat,dlwin,0,10,13,186,0.456989247,0.037634409,0.537634409,1,0.301097108
23041,133,23841,7,10,0,0,0,17,10,10,0,0,0,20,nowin,loss,beat,dlwin,0,10,17,201,0.47761194,0.064676617,0.611940299,3,0.935428111
23042,74,23841,9,7,0,6,0,22,10,10,0,0,0,20,nowin,loss,bust,plbust,0,10,16,209,0.411483254,0.04784689,0.531100478,0,0.017448125
23043,69,23841,8,3,6,0,0,17,10,10,0,0,0,20,nowin,loss,beat,dlwin,0,10,11,194,0.365979381,0.030927835,0.515463918,0,0
23044,58,23841,11,10,0,0,0,21,10,10,0,0,0,20,win,win,plwin,beat,25,0,21,195,0.430769231,0.041025641,0.584615385,2,0.580497586
23045,15,23841,10,6,0,3,0,19,10,10,0,0,0,20,nowin,loss,beat,dlwin,0,10,16,212,0.410377358,0.051886792,0.561320755,0,0.024517408
23046,5,23842,10,2,0,10,0,22,9,3,10,0,0,22,nowin,loss,bust,plbust,0,10,12,203,0.42364532,0.02955665,0.596059113,2,0.582508076
23047,11,23842,8,3,8,0,0,19,9,3,10,0,0,22,nowin,win,dlbust,bust,20,0,11,236,0.457627119,0.016949153,0.588983051,3,0.889015813
23048,60,23842,5,4,2,5,1,17,9,3,10,0,0,22,nowin,win,dlbust,bust,20,0,9,227,0.418502203,0.022026432,0.559471366,0,0.026496258
23049,37,23842,9,4,0,3,8,24,9,3,10,0,0,22,nowin,loss,bust,plbust,0,10,13,208,0.394230769,0.038461538,0.581730769,0,0.024682772
23050,2,23842,10,10,0,0,0,20,9,3,10,0,0,22,nowin,win,dlbust,bust,20,0,20,200,0.445,0.035,0.64,2,0.633962549
23051,116,23842,2,10,0,9,0,21,9,3,10,0,0,22,nowin,win,dlbust,bust,20,0,12,195,0.425641026,0.056410256,0.538461538,1,0.28273747
23052,110,23843,2,3,6,1,1,13,11,10,0,0,0,21,nowin,loss,beat,dlwin,0,10,5,192,0.416666667,0.046875,0.557291667,0,0.025413132
23053,8,23843,3,7,6,10,0,26,11,10,0,0,0,21,nowin,loss,bust,plbust,0,10,10,181,0.44198895,0.071823204,0.596685083,2,0.599438402
23054,92,23843,5,10,0,3,0,18,11,10,0,0,0,21,nowin,loss,beat,dlwin,0,10,15,186,0.446236559,0.059139785,0.564516129,1,0.307826125
23055,39,23843,4,9,0,7,0,20,11,10,0,0,0,21,nowin,loss,beat,dlwin,0,10,13,191,0.429319372,0.062827225,0.57591623,0,0.033760763
23056,122,23843,7,5,0,9,0,21,11,10,0,0,0,21,nowin,push,push,push,10,0,12,210,0.347619048,0.052380952,0.59047619,0,0.012873677
23057,34,23843,4,7,10,0,0,21,11,10,0,0,0,21,nowin,push,push,push,10,0,11,202,0.5,0.079207921,0.618811881,3,0.968961434
23058,4,23844,10,7,0,0,0,17,2,9,6,0,0,17,nowin,push,push,push,10,0,17,217,0.460829493,0.036866359,0.562211982,1,0.315432839
23059,145,23844,10,11,0,0,0,21,2,9,6,0,0,17,win,win,plwin,beat,25,0,21,188,0.441489362,0.031914894,0.622340426,2,0.617837093
23060,127,23844,3,10,0,0,0,13,2,9,6,0,0,17,nowin,loss,beat,dlwin,0,10,13,201,0.402985075,0.029850746,0.60199005,0,0.032263937
23061,112,23844,6,10,0,0,0,16,2,9,6,0,0,17,nowin,loss,beat,dlwin,0,10,16,203,0.448275862,0.054187192,0.600985222,3,0.889576933
23062,53,23844,7,10,0,0,0,17,2,9,6,0,0,17,nowin,push,push,push,10,0,17,250,0.372,0.064,0.564,0,0.013687345
23063,68,23844,4,9,0,0,0,13,2,9,6,0,0,17,nowin,loss,beat,dlwin,0,10,13,205,0.434146341,0.029268293,0.6,2,0.59483189
23064,7,23845,10,6,0,7,0,23,10,8,0,0,0,18,nowin,loss,bust,plbust,0,10,16,183,0.442622951,0.06010929,0.62295082,2,0.619303341
23065,142,23845,8,7,0,5,0,20,10,8,0,0,0,18,nowin,win,plwin,beat,20,0,15,211,0.417061611,0.047393365,0.526066351,1,0.271531309
23066,52,23845,8,9,0,0,0,17,10,8,0,0,0,18,nowin,loss,beat,dlwin,0,10,17,217,0.414746544,0.02764977,0.599078341,2,0.576736024
23067,76,23845,3,5,4,8,0,20,10,8,0,0,0,18,nowin,win,plwin,beat,20,0,8,189,0.534391534,0.079365079,0.608465608,3,1
23068,49,23845,5,10,0,10,0,25,10,8,0,0,0,18,nowin,loss,bust,plbust,0,10,15,207,0.396135266,0.053140097,0.594202899,0,0.028306925
23069,50,23845,10,10,0,0,0,20,10,8,0,0,0,18,nowin,win,plwin,beat,20,0,20,202,0.405940594,0.04950495,0.54950495,0,0.020296079
23070,88,23846,7,9,0,0,0,16,6,7,10,0,0,23,nowin,win,dlbust,bust,20,0,16,206,0.466019417,0.033980583,0.54368932,1,0.309467903
23071,132,23846,5,10,0,0,0,15,6,7,10,0,0,23,nowin,win,dlbust,bust,20,0,15,194,0.412371134,0.036082474,0.649484536,2,0.611633238
23072,81,23846,11,9,0,0,0,20,6,7,10,0,0,23,nowin,win,dlbust,bust,20,0,20,182,0.395604396,0.043956044,0.60989011,2,0.567491261
23073,51,23846,10,8,0,0,0,18,6,7,10,0,0,23,nowin,win,dlbust,bust,20,0,18,189,0.529100529,0.068783069,0.608465608,3,0.993665715
23074,74,23846,9,9,0,0,0,18,6,7,10,0,0,23,nowin,win,dlbust,bust,20,0,18,209,0.411483254,0.04784689,0.531100478,0,0.017448125
23075,138,23846,11,10,0,0,0,21,6,7,10,0,0,23,win,win,dlbust,bust,25,0,21,190,0.442105263,0.047368421,0.610526316,2,0.609711065
23076,149,23847,10,10,0,0,0,20,6,2,6,4,0,18,nowin,win,plwin,beat,20,0,20,225,0.457777778,0.057777778,0.648888889,2,0.651965595
23077,132,23847,9,5,0,0,0,14,6,2,6,4,0,18,nowin,loss,beat,dlwin,0,10,14,194,0.412371134,0.036082474,0.649484536,2,0.611633238
23078,103,23847,3,4,10,0,0,17,6,2,6,4,0,18,nowin,loss,beat,dlwin,0,10,7,203,0.379310345,0.064039409,0.551724138,0,0.012869209
23079,144,23847,10,3,0,0,0,13,6,2,6,4,0,18,nowin,loss,beat,dlwin,0,10,13,202,0.386138614,0.054455446,0.564356436,0,0.018006244
23080,147,23847,8,2,10,0,0,20,6,2,6,4,0,18,nowin,win,plwin,beat,20,0,10,205,0.380487805,0.014634146,0.536585366,0,0.00951447
23081,66,23847,10,10,0,0,0,20,6,2,6,4,0,18,nowin,win,plwin,beat,20,0,20,217,0.456221198,0.064516129,0.626728111,3,0.924304367
23082,88,23848,10,5,0,1,7,23,7,5,1,10,0,23,nowin,loss,bust,plbust,0,10,15,206,0.466019417,0.033980583,0.54368932,1,0.309467903
23083,131,23848,6,6,0,3,4,19,7,5,1,10,0,23,nowin,win,dlbust,bust,20,0,12,217,0.410138249,0.069124424,0.543778802,0,0.02015021
23084,112,23848,1,5,10,2,0,18,7,5,1,10,0,23,nowin,win,dlbust,bust,20,0,6,203,0.448275862,0.054187192,0.600985222,3,0.889576933
23085,73,23848,9,3,0,6,0,18,7,5,1,10,0,23,nowin,win,dlbust,bust,20,0,12,181,0.375690608,0.011049724,0.596685083,0,0.022795773
23086,9,23848,9,6,0,3,0,18,7,5,1,10,0,23,nowin,win,dlbust,bust,20,0,15,194,0.37628866,0.015463918,0.541237113,0,0.009396796
23087,139,23848,3,10,0,5,0,18,7,5,1,10,0,23,nowin,win,dlbust,bust,20,0,13,192,0.380208333,0.036458333,0.59375,0,0.023429169
23088,95,23849,2,5,4,8,0,19,3,9,10,0,0,22,nowin,win,dlbust,bust,20,0,7,218,0.412844037,0.04587156,0.559633028,0,0.024842385
23089,106,23849,10,9,0,0,0,19,3,9,10,0,0,22,nowin,win,dlbust,bust,20,0,19,192,0.411458333,0.026041667,0.557291667,0,0.023854304
23090,52,23849,7,8,0,0,0,15,3,9,10,0,0,22,nowin,win,dlbust,bust,20,0,15,217,0.414746544,0.02764977,0.599078341,2,0.576736024
23091,1,23849,5,3,7,0,0,15,3,9,10,0,0,22,nowin,win,dlbust,bust,20,0,8,197,0.406091371,0.025380711,0.649746193,2,0.606186955
23092,16,23849,4,10,0,0,0,14,3,9,10,0,0,22,nowin,win,dlbust,bust,20,0,14,220,0.427272727,0.081818182,0.6,2,0.588660176
23093,121,23849,2,10,0,4,0,16,3,9,10,0,0,22,nowin,win,dlbust,bust,20,0,12,195,0.456410256,0.025641026,0.512820513,1,0.288597791
23094,120,23850,2,11,8,0,0,21,8,8,9,0,0,25,nowin,win,dlbust,bust,20,0,13,202,0.440594059,0.034653465,0.618811881,2,0.614441029
23095,139,23850,2,10,0,3,10,25,8,8,9,0,0,25,nowin,loss,bust,plbust,0,10,12,192,0.380208333,0.036458333,0.59375,0,0.023429169
23096,106,23850,4,6,8,0,0,18,8,8,9,0,0,25,nowin,win,dlbust,bust,20,0,10,192,0.411458333,0.026041667,0.557291667,0,0.023854304
23097,62,23850,8,3,9,0,0,20,8,8,9,0,0,25,nowin,win,dlbust,bust,20,0,11,178,0.370786517,0.028089888,0.54494382,0,0.008657722
23098,64,23850,8,10,0,0,0,18,8,8,9,0,0,25,nowin,win,dlbust,bust,20,0,18,187,0.363636364,0.048128342,0.631016043,0,0.027594885
23099,120,23850,7,6,0,10,0,23,8,8,9,0,0,25,nowin,loss,bust,plbust,0,10,13,202,0.440594059,0.034653465,0.618811881,2,0.614441029
23100,122,23851,6,10,0,0,0,16,2,10,8,0,0,20,nowin,loss,beat,dlwin,0,10,16,210,0.347619048,0.052380952,0.59047619,0,0.012873677
23101,6,23851,10,5,0,0,0,15,2,10,8,0,0,20,nowin,loss,beat,dlwin,0,10,15,191,0.439790576,0.047120419,0.581151832,1,0.31211505
23102,82,23851,7,11,0,0,0,18,2,10,8,0,0,20,nowin,loss,beat,dlwin,0,10,18,225,0.408888889,0.075555556,0.577777778,0,0.028101874
23103,106,23851,2,8,11,0,0,21,2,10,8,0,0,20,nowin,win,plwin,beat,20,0,10,192,0.411458333,0.026041667,0.557291667,0,0.023854304
23104,142,23851,6,9,0,0,0,15,2,10,8,0,0,20,nowin,loss,beat,dlwin,0,10,15,211,0.417061611,0.047393365,0.526066351,1,0.271531309
23105,135,23851,8,6,0,0,0,14,2,10,8,0,0,20,nowin,loss,beat,dlwin,0,10,14,179,0.391061453,0.067039106,0.586592179,0,0.024924662
23106,8,23852,10,7,0,0,0,17,10,3,1,9,0,23,nowin,win,dlbust,bust,20,0,17,181,0.44198895,0.071823204,0.596685083,2,0.599438402
23107,23,23852,8,3,8,0,0,19,10,3,1,9,0,23,nowin,win,dlbust,bust,20,0,11,208,0.427884615,0.0625,0.552884615,1,0.29114424
23108,41,23852,10,10,0,0,0,20,10,3,1,9,0,23,nowin,win,dlbust,bust,20,0,20,192,0.364583333,0.036458333,0.520833333,0,0.00089702
23109,91,23852,10,3,0,6,0,19,10,3,1,9,0,23,nowin,win,dlbust,bust,20,0,13,194,0.417525773,0.046391753,0.515463918,1,0.266616552
23110,10,23852,4,9,0,8,0,21,10,3,1,9,0,23,nowin,win,dlbust,bust,20,0,13,191,0.413612565,0.057591623,0.596858639,2,0.574087175
23111,129,23852,5,5,8,0,0,18,10,3,1,9,0,23,nowin,win,dlbust,bust,20,0,10,201,0.422885572,0.064676617,0.55721393,0,0.027255383
23112,36,23853,5,10,0,0,0,15,3,10,2,8,0,23,nowin,win,dlbust,bust,20,0,15,229,0.445414847,0.056768559,0.655021834,2,0.645370571
23113,2,23853,9,4,0,0,0,13,3,10,2,8,0,23,nowin,win,dlbust,bust,20,0,13,200,0.445,0.035,0.64,2,0.633962549
23114,120,23853,10,5,0,0,0,15,3,10,2,8,0,23,nowin,win,dlbust,bust,20,0,15,202,0.440594059,0.034653465,0.618811881,2,0.614441029
23115,17,23853,10,3,0,0,0,13,3,10,2,8,0,23,nowin,win,dlbust,bust,20,0,13,171,0.444444444,0.070175439,0.555555556,1,0.302364894
23116,96,23853,11,5,4,0,0,20,3,10,2,8,0,23,nowin,win,dlbust,bust,20,0,16,190,0.468421053,0.057894737,0.584210526,3,0.897263354
23117,9,23853,8,10,0,0,0,18,3,10,2,8,0,23,nowin,win,dlbust,bust,20,0,18,194,0.37628866,0.015463918,0.541237113,0,0.009396796
23118,126,23854,10,4,0,0,0,14,5,10,6,0,0,21,nowin,loss,beat,dlwin,0,10,14,188,0.457446809,0.074468085,0.60106383,3,0.900633203
23119,1,23854,10,3,0,0,0,13,5,10,6,0,0,21,nowin,loss,beat,dlwin,0,10,13,197,0.406091371,0.025380711,0.649746193,2,0.606186955
23120,140,23854,3,8,9,0,0,20,5,10,6,0,0,21,nowin,loss,beat,dlwin,0,10,11,210,0.466666667,0.023809524,0.604761905,3,0.915293335
23121,140,23854,10,3,0,0,0,13,5,10,6,0,0,21,nowin,loss,beat,dlwin,0,10,13,210,0.466666667,0.023809524,0.604761905,3,0.915293335
23122,119,23854,10,4,0,0,0,14,5,10,6,0,0,21,nowin,loss,beat,dlwin,0,10,14,190,0.405263158,0.068421053,0.515789474,0,0.011837158
23123,27,23854,11,3,4,0,0,18,5,10,6,0,0,21,nowin,loss,beat,dlwin,0,10,14,178,0.370786517,0.016853933,0.573033708,0,0.015536309
23124,109,23855,10,10,0,0,0,20,10,11,0,0,0,21,nowin,loss,beat,dlwin,0,10,20,221,0.461538462,0.058823529,0.597285068,3,0.901830309
23125,149,23855,11,10,0,0,0,21,10,11,0,0,0,21,win,push,push,push,10,0,21,225,0.457777778,0.057777778,0.648888889,2,0.651965595
23126,30,23855,10,10,0,0,0,20,10,11,0,0,0,21,nowin,loss,beat,dlwin,0,10,20,206,0.393203883,0.033980583,0.601941748,0,0.029324648
23127,85,23855,3,2,10,3,0,18,10,11,0,0,0,21,nowin,loss,beat,dlwin,0,10,5,195,0.41025641,0.066666667,0.594871795,0,0.03269711
23128,63,23855,9,10,0,0,0,19,10,11,0,0,0,21,nowin,loss,beat,dlwin,0,10,19,216,0.467592593,0.037037037,0.62037037,3,0.931690496
23129,77,23855,10,9,0,0,0,19,10,11,0,0,0,21,nowin,loss,beat,dlwin,0,10,19,200,0.455,0.04,0.62,3,0.916252116
23130,28,23856,4,10,0,0,0,14,3,11,6,0,0,20,nowin,loss,beat,dlwin,0,10,14,199,0.422110553,0.045226131,0.542713568,1,0.282706618
23131,130,23856,10,7,0,0,0,17,3,11,6,0,0,20,nowin,loss,beat,dlwin,0,10,17,219,0.410958904,0.03652968,0.566210046,0,0.025888739
23132,127,23856,10,9,0,0,0,19,3,11,6,0,0,20,nowin,loss,beat,dlwin,0,10,19,201,0.402985075,0.029850746,0.60199005,0,0.032263937
23133,46,23856,5,6,7,0,0,18,3,11,6,0,0,20,nowin,loss,beat,dlwin,0,10,11,186,0.403225806,0.048387097,0.591397849,0,0.029742194
23134,149,23856,6,8,0,0,0,14,3,11,6,0,0,20,nowin,loss,beat,dlwin,0,10,14,225,0.457777778,0.057777778,0.648888889,2,0.651965595
23135,78,23856,8,10,0,0,0,18,3,11,6,0,0,20,nowin,loss,beat,dlwin,0,10,18,201,0.517412935,0.034825871,0.587064677,3,0.95871112
23136,38,23857,3,10,0,1,5,19,10,10,0,0,0,20,nowin,loss,beat,dlwin,0,10,13,202,0.361386139,0.03960396,0.564356436,0,0.010597953
23137,104,23857,4,11,2,0,0,17,10,10,0,0,0,20,nowin,loss,beat,dlwin,0,10,15,209,0.363636364,0.052631579,0.593301435,0,0.018359419
23138,111,23857,7,4,3,10,0,24,10,10,0,0,0,20,nowin,loss,bust,plbust,0,10,11,180,0.433333333,0.055555556,0.611111111,2,0.602264492
23139,38,23857,8,6,0,1,10,25,10,10,0,0,0,20,nowin,loss,bust,plbust,0,10,14,202,0.361386139,0.03960396,0.564356436,0,0.010597953
23140,113,23857,2,10,0,10,0,22,10,10,0,0,0,20,nowin,loss,bust,plbust,0,10,12,199,0.407035176,0.055276382,0.668341709,2,0.620695264
23141,89,23857,10,10,0,0,0,20,10,10,0,0,0,20,nowin,push,push,push,10,0,20,212,0.537735849,0.047169811,0.594339623,3,0.990167191
23142,88,23858,10,9,0,0,0,19,10,4,1,4,0,19,nowin,push,push,push,10,0,19,206,0.466019417,0.033980583,0.54368932,1,0.309467903
23143,37,23858,3,4,5,5,0,17,10,4,1,4,0,19,nowin,loss,beat,dlwin,0,10,7,208,0.394230769,0.038461538,0.581730769,0,0.024682772
23144,56,23858,6,5,8,0,0,19,10,4,1,4,0,19,nowin,push,push,push,10,0,11,175,0.4,0.057142857,0.582857143,0,0.026685297
23145,28,23858,11,10,0,0,0,21,10,4,1,4,0,19,win,win,plwin,beat,25,0,21,199,0.422110553,0.045226131,0.542713568,1,0.282706618
23146,122,23858,10,5,0,9,0,24,10,4,1,4,0,19,nowin,loss,bust,plbust,0,10,15,210,0.347619048,0.052380952,0.59047619,0,0.012873677
23147,147,23858,7,11,0,0,0,18,10,4,1,4,0,19,nowin,loss,beat,dlwin,0,10,18,205,0.380487805,0.014634146,0.536585366,0,0.00951447
23148,41,23859,10,8,0,0,0,18,10,10,0,0,0,20,nowin,loss,beat,dlwin,0,10,18,192,0.364583333,0.036458333,0.520833333,0,0.00089702
23149,16,23859,6,2,11,0,0,19,10,10,0,0,0,20,nowin,loss,beat,dlwin,0,10,8,220,0.427272727,0.081818182,0.6,2,0.588660176
23150,21,23859,10,5,0,10,0,25,10,10,0,0,0,20,nowin,loss,bust,plbust,0,10,15,214,0.359813084,0.042056075,0.626168224,0,0.025263474
23151,110,23859,11,10,0,0,0,21,10,10,0,0,0,20,win,win,plwin,beat,25,0,21,192,0.416666667,0.046875,0.557291667,0,0.025413132
23152,117,23859,8,9,0,0,0,17,10,10,0,0,0,20,nowin,loss,beat,dlwin,0,10,17,173,0.410404624,0.069364162,0.606936416,2,0.578610282
23153,91,23859,6,11,3,0,0,20,10,10,0,0,0,20,nowin,push,push,push,10,0,17,194,0.417525773,0.046391753,0.515463918,1,0.266616552
23154,87,23860,5,2,8,8,0,23,10,9,0,0,0,19,nowin,loss,bust,plbust,0,10,7,202,0.405940594,0.054455446,0.628712871,2,0.590599801
23155,114,23860,6,3,10,0,0,19,10,9,0,0,0,19,nowin,push,push,push,10,0,9,198,0.47979798,0.025252525,0.611111111,3,0.937232995
23156,130,23860,10,10,0,0,0,20,10,9,0,0,0,19,nowin,win,plwin,beat,20,0,20,219,0.410958904,0.03652968,0.566210046,0,0.025888739
23157,65,23860,11,10,0,0,0,21,10,9,0,0,0,19,win,win,plwin,beat,25,0,21,203,0.492610837,0.054187192,0.571428571,3,0.913702814
23158,104,23860,10,5,0,8,0,23,10,9,0,0,0,19,nowin,loss,bust,plbust,0,10,15,209,0.363636364,0.052631579,0.593301435,0,0.018359419
23159,142,23860,2,8,8,0,0,18,10,9,0,0,0,19,nowin,loss,beat,dlwin,0,10,10,211,0.417061611,0.047393365,0.526066351,1,0.271531309
23160,6,23861,9,3,0,4,0,16,3,7,8,0,0,18,nowin,loss,beat,dlwin,0,10,12,191,0.439790576,0.047120419,0.581151832,1,0.31211505
23161,135,23861,4,6,10,0,0,20,3,7,8,0,0,18,nowin,win,plwin,beat,20,0,10,179,0.391061453,0.067039106,0.586592179,0,0.024924662
23162,16,23861,7,9,0,0,0,16,3,7,8,0,0,18,nowin,loss,beat,dlwin,0,10,16,220,0.427272727,0.081818182,0.6,2,0.588660176
23163,105,23861,10,11,0,0,0,21,3,7,8,0,0,18,win,win,plwin,beat,25,0,21,198,0.414141414,0.070707071,0.590909091,0,0.032889494
23164,43,23861,10,10,0,0,0,20,3,7,8,0,0,18,nowin,win,plwin,beat,20,0,20,192,0.40625,0.041666667,0.609375,2,0.576671372
23165,85,23861,10,10,0,0,0,20,3,7,8,0,0,18,nowin,win,plwin,beat,20,0,20,195,0.41025641,0.066666667,0.594871795,0,0.03269711
23166,126,23862,7,3,2,6,0,18,10,7,0,0,0,17,nowin,win,plwin,beat,20,0,10,188,0.457446809,0.074468085,0.60106383,3,0.900633203
23167,54,23862,3,10,0,4,0,17,10,7,0,0,0,17,nowin,push,push,push,10,0,13,185,0.437837838,0.032432432,0.556756757,1,0.29899854
23168,101,23862,8,3,10,0,0,21,10,7,0,0,0,17,nowin,win,plwin,beat,20,0,11,205,0.424390244,0.068292683,0.63902439,2,0.614740646
23169,31,23862,3,10,0,10,0,23,10,7,0,0,0,17,nowin,loss,bust,plbust,0,10,13,188,0.473404255,0.058510638,0.515957447,1,0.300306557
23170,95,23862,10,10,0,0,0,20,10,7,0,0,0,17,nowin,win,plwin,beat,20,0,20,218,0.412844037,0.04587156,0.559633028,0,0.024842385
23171,32,23862,10,10,0,0,0,20,10,7,0,0,0,17,nowin,win,plwin,beat,20,0,20,189,0.391534392,0.037037037,0.53968254,0,0.013579086
23172,111,23863,8,10,0,0,0,18,9,10,0,0,0,19,nowin,loss,beat,dlwin,0,10,18,180,0.433333333,0.055555556,0.611111111,2,0.602264492
23173,5,23863,7,2,6,3,0,18,9,10,0,0,0,19,nowin,loss,beat,dlwin,0,10,9,203,0.42364532,0.02955665,0.596059113,2,0.582508076
23174,98,23863,10,4,0,10,0,24,9,10,0,0,0,19,nowin,loss,bust,plbust,0,10,14,220,0.422727273,0.054545455,0.55,1,0.28664435
23175,95,23863,4,10,0,10,0,24,9,10,0,0,0,19,nowin,loss,bust,plbust,0,10,14,218,0.412844037,0.04587156,0.559633028,0,0.024842385
23176,63,23863,4,10,0,3,0,17,9,10,0,0,0,19,nowin,loss,beat,dlwin,0,10,14,216,0.467592593,0.037037037,0.62037037,3,0.931690496
23177,38,23863,8,3,7,0,0,18,9,10,0,0,0,19,nowin,loss,beat,dlwin,0,10,11,202,0.361386139,0.03960396,0.564356436,0,0.010597953
23178,1,23864,3,1,9,4,0,17,9,3,9,0,0,21,nowin,loss,beat,dlwin,0,10,4,197,0.406091371,0.025380711,0.649746193,2,0.606186955
23179,94,23864,7,4,10,0,0,21,9,3,9,0,0,21,nowin,push,push,push,10,0,11,183,0.43715847,0.043715847,0.540983607,1,0.290866892
23180,34,23864,4,10,0,8,0,22,9,3,9,0,0,21,nowin,loss,bust,plbust,0,10,14,202,0.5,0.079207921,0.618811881,3,0.968961434
23181,81,23864,4,7,9,0,0,20,9,3,9,0,0,21,nowin,loss,beat,dlwin,0,10,11,182,0.395604396,0.043956044,0.60989011,2,0.567491261
23182,131,23864,9,6,0,10,0,25,9,3,9,0,0,21,nowin,loss,bust,plbust,0,10,15,217,0.410138249,0.069124424,0.543778802,0,0.02015021
23183,34,23864,7,10,0,0,0,17,9,3,9,0,0,21,nowin,loss,beat,dlwin,0,10,17,202,0.5,0.079207921,0.618811881,3,0.968961434
23184,115,23865,5,10,0,7,0,22,11,9,0,0,0,20,nowin,loss,bust,plbust,0,10,15,194,0.427835052,0.041237113,0.592783505,2,0.583863602
23185,37,23865,10,11,0,0,0,21,11,9,0,0,0,20,win,win,plwin,beat,25,0,21,208,0.394230769,0.038461538,0.581730769,0,0.024682772
23186,79,23865,10,7,0,0,0,17,11,9,0,0,0,20,nowin,loss,beat,dlwin,0,10,17,211,0.436018957,0.028436019,0.672985782,2,0.650131054
23187,132,23865,10,8,0,0,0,18,11,9,0,0,0,20,nowin,loss,beat,dlwin,0,10,18,194,0.412371134,0.036082474,0.649484536,2,0.611633238
23188,8,23865,7,10,0,0,0,17,11,9,0,0,0,20,nowin,loss,beat,dlwin,0,10,17,181,0.44198895,0.071823204,0.596685083,2,0.599438402
23189,85,23865,10,8,0,0,0,18,11,9,0,0,0,20,nowin,loss,beat,dlwin,0,10,18,195,0.41025641,0.066666667,0.594871795,0,0.03269711
23190,112,23866,8,9,0,0,0,17,9,10,0,0,0,19,nowin,loss,beat,dlwin,0,10,17,203,0.448275862,0.054187192,0.600985222,3,0.889576933
23191,29,23866,9,10,0,0,0,19,9,10,0,0,0,19,nowin,push,push,push,10,0,19,189,0.44973545,0.058201058,0.544973545,1,0.300349439
23192,65,23866,6,5,2,1,6,20,9,10,0,0,0,19,nowin,win,plwin,beat,20,0,11,203,0.492610837,0.054187192,0.571428571,3,0.913702814
23193,35,23866,6,4,10,0,0,20,9,10,0,0,0,19,nowin,win,plwin,beat,20,0,10,202,0.410891089,0.044554455,0.633663366,2,0.598681573
23194,108,23866,3,10,0,9,0,22,9,10,0,0,0,19,nowin,loss,bust,plbust,0,10,13,193,0.435233161,0.056994819,0.559585492,1,0.298824795
23195,48,23866,10,3,0,9,0,22,9,10,0,0,0,19,nowin,loss,bust,plbust,0,10,13,203,0.413793103,0.019704433,0.600985222,2,0.577280801
23196,123,23867,10,10,0,0,0,20,2,9,4,6,0,21,nowin,loss,beat,dlwin,0,10,20,205,0.43902439,0.034146341,0.614634146,2,0.609962544
23197,122,23867,10,8,0,0,0,18,2,9,4,6,0,21,nowin,loss,beat,dlwin,0,10,18,210,0.347619048,0.052380952,0.59047619,0,0.012873677
23198,65,23867,10,6,0,0,0,16,2,9,4,6,0,21,nowin,loss,beat,dlwin,0,10,16,203,0.492610837,0.054187192,0.571428571,3,0.913702814
23199,23,23867,5,11,5,0,0,21,2,9,4,6,0,21,nowin,push,push,push,10,0,16,208,0.427884615,0.0625,0.552884615,1,0.29114424
23200,104,23867,8,6,0,0,0,14,2,9,4,6,0,21,nowin,loss,beat,dlwin,0,10,14,209,0.363636364,0.052631579,0.593301435,0,0.018359419
23201,41,23867,4,1,8,0,0,13,2,9,4,6,0,21,nowin,loss,beat,dlwin,0,10,5,192,0.364583333,0.036458333,0.520833333,0,0.00089702
23202,50,23868,2,7,7,0,0,16,3,10,6,0,0,19,nowin,loss,beat,dlwin,0,10,9,202,0.405940594,0.04950495,0.54950495,0,0.020296079
23203,79,23868,8,10,0,0,0,18,3,10,6,0,0,19,nowin,loss,beat,dlwin,0,10,18,211,0.436018957,0.028436019,0.672985782,2,0.650131054
23204,128,23868,6,7,0,0,0,13,3,10,6,0,0,19,nowin,loss,beat,dlwin,0,10,13,227,0.356828194,0.052863436,0.577092511,0,0.012352564
23205,71,23868,8,5,0,0,0,13,3,10,6,0,0,19,nowin,loss,beat,dlwin,0,10,13,193,0.352331606,0.046632124,0.585492228,0,0.013063661
23206,104,23868,6,3,5,0,0,14,3,10,6,0,0,19,nowin,loss,beat,dlwin,0,10,9,209,0.363636364,0.052631579,0.593301435,0,0.018359419
23207,38,23868,10,5,0,0,0,15,3,10,6,0,0,19,nowin,loss,beat,dlwin,0,10,15,202,0.361386139,0.03960396,0.564356436,0,0.010597953
23208,46,23869,2,1,10,4,0,17,10,5,6,0,0,21,nowin,loss,beat,dlwin,0,10,3,186,0.403225806,0.048387097,0.591397849,0,0.029742194
23209,24,23869,10,3,0,10,0,23,10,5,6,0,0,21,nowin,loss,bust,plbust,0,10,13,207,0.458937198,0.048309179,0.570048309,1,0.318138014
23210,29,23869,1,2,10,3,4,20,10,5,6,0,0,21,nowin,loss,beat,dlwin,0,10,3,189,0.44973545,0.058201058,0.544973545,1,0.300349439
23211,150,23869,8,5,0,10,0,23,10,5,6,0,0,21,nowin,loss,bust,plbust,0,10,13,192,0.401041667,0.036458333,0.567708333,0,0.023287458
23212,94,23869,9,2,3,6,0,20,10,5,6,0,0,21,nowin,loss,beat,dlwin,0,10,11,183,0.43715847,0.043715847,0.540983607,1,0.290866892
23213,115,23869,3,5,6,10,0,24,10,5,6,0,0,21,nowin,loss,bust,plbust,0,10,8,194,0.427835052,0.041237113,0.592783505,2,0.583863602
23214,56,23870,6,3,10,0,0,19,3,11,2,9,0,25,nowin,win,dlbust,bust,20,0,9,175,0.4,0.057142857,0.582857143,0,0.026685297
23215,28,23870,3,9,0,3,0,15,3,11,2,9,0,25,nowin,win,dlbust,bust,20,0,12,199,0.422110553,0.045226131,0.542713568,1,0.282706618
23216,66,23870,5,2,8,0,0,15,3,11,2,9,0,25,nowin,win,dlbust,bust,20,0,7,217,0.456221198,0.064516129,0.626728111,3,0.924304367
23217,41,23870,4,7,10,0,0,21,3,11,2,9,0,25,nowin,win,dlbust,bust,20,0,11,192,0.364583333,0.036458333,0.520833333,0,0.00089702
23218,131,23870,10,8,0,0,0,18,3,11,2,9,0,25,nowin,win,dlbust,bust,20,0,18,217,0.410138249,0.069124424,0.543778802,0,0.02015021
23219,61,23870,4,10,0,0,0,14,3,11,2,9,0,25,nowin,win,dlbust,bust,20,0,14,194,0.427835052,0.077319588,0.603092784,2,0.591437139
23220,65,23871,3,2,11,0,0,16,2,6,6,2,10,26,nowin,win,dlbust,bust,20,0,5,203,0.492610837,0.054187192,0.571428571,3,0.913702814
23221,42,23871,3,10,0,0,0,13,2,6,6,2,10,26,nowin,win,dlbust,bust,20,0,13,212,0.443396226,0.051886792,0.570754717,1,0.309181312
23222,77,23871,10,10,0,0,0,20,2,6,6,2,10,26,nowin,win,dlbust,bust,20,0,20,200,0.455,0.04,0.62,3,0.916252116
23223,135,23871,10,5,0,0,0,15,2,6,6,2,10,26,nowin,win,dlbust,bust,20,0,15,179,0.391061453,0.067039106,0.586592179,0,0.024924662
23224,25,23871,6,5,1,6,0,18,2,6,6,2,10,26,nowin,win,dlbust,bust,20,0,11,190,0.463157895,0.063157895,0.536842105,1,0.304401563
23225,55,23871,11,7,0,0,0,18,2,6,6,2,10,26,nowin,win,dlbust,bust,20,0,18,191,0.371727749,0.057591623,0.54973822,0,0.01011347
23226,127,23872,9,7,0,0,0,16,5,10,5,0,0,20,nowin,loss,beat,dlwin,0,10,16,201,0.402985075,0.029850746,0.60199005,0,0.032263937
23227,76,23872,6,2,2,7,0,17,5,10,5,0,0,20,nowin,loss,beat,dlwin,0,10,8,189,0.534391534,0.079365079,0.608465608,3,1
23228,18,23872,1,4,10,0,0,15,5,10,5,0,0,20,nowin,loss,beat,dlwin,0,10,5,182,0.461538462,0.043956044,0.587912088,3,0.892649374
23229,15,23872,3,10,0,0,0,13,5,10,5,0,0,20,nowin,loss,beat,dlwin,0,10,13,212,0.410377358,0.051886792,0.561320755,0,0.024517408
23230,138,23872,8,10,0,0,0,18,5,10,5,0,0,20,nowin,loss,beat,dlwin,0,10,18,190,0.442105263,0.047368421,0.610526316,2,0.609711065
23231,136,23872,10,9,0,0,0,19,5,10,5,0,0,20,nowin,loss,beat,dlwin,0,10,19,194,0.396907216,0.025773196,0.597938144,0,0.029452644
23232,121,23873,7,6,0,0,0,13,6,6,3,10,0,25,nowin,win,dlbust,bust,20,0,13,195,0.456410256,0.025641026,0.512820513,1,0.288597791
23233,129,23873,11,10,0,0,0,21,6,6,3,10,0,25,win,win,dlbust,bust,25,0,21,201,0.422885572,0.064676617,0.55721393,0,0.027255383
23234,19,23873,8,9,0,0,0,17,6,6,3,10,0,25,nowin,win,dlbust,bust,20,0,17,237,0.41350211,0.054852321,0.628691983,2,0.597373826
23235,101,23873,10,10,0,0,0,20,6,6,3,10,0,25,nowin,win,dlbust,bust,20,0,20,205,0.424390244,0.068292683,0.63902439,2,0.614740646
23236,91,23873,8,5,0,0,0,13,6,6,3,10,0,25,nowin,win,dlbust,bust,20,0,13,194,0.417525773,0.046391753,0.515463918,1,0.266616552
23237,136,23873,10,10,0,0,0,20,6,6,3,10,0,25,nowin,win,dlbust,bust,20,0,20,194,0.396907216,0.025773196,0.597938144,0,0.029452644
23238,78,23874,3,10,0,4,0,17,10,6,10,0,0,26,nowin,win,dlbust,bust,20,0,13,201,0.517412935,0.034825871,0.587064677,3,0.95871112
23239,115,23874,10,11,0,0,0,21,10,6,10,0,0,26,win,win,dlbust,bust,25,0,21,194,0.427835052,0.041237113,0.592783505,2,0.583863602
23240,103,23874,4,5,8,0,0,17,10,6,10,0,0,26,nowin,win,dlbust,bust,20,0,9,203,0.379310345,0.064039409,0.551724138,0,0.012869209
23241,111,23874,3,10,0,10,0,23,10,6,10,0,0,26,nowin,loss,bust,plbust,0,10,13,180,0.433333333,0.055555556,0.611111111,2,0.602264492
23242,125,23874,10,8,0,0,0,18,10,6,10,0,0,26,nowin,win,dlbust,bust,20,0,18,219,0.438356164,0.050228311,0.575342466,1,0.308411257
23243,114,23874,10,10,0,0,0,20,10,6,10,0,0,26,nowin,win,dlbust,bust,20,0,20,198,0.47979798,0.025252525,0.611111111,3,0.937232995
23244,18,23875,10,9,0,0,0,19,2,6,10,0,0,18,nowin,win,plwin,beat,20,0,19,182,0.461538462,0.043956044,0.587912088,3,0.892649374
23245,108,23875,5,9,0,0,0,14,2,6,10,0,0,18,nowin,loss,beat,dlwin,0,10,14,193,0.435233161,0.056994819,0.559585492,1,0.298824795
23246,102,23875,3,10,0,0,0,13,2,6,10,0,0,18,nowin,loss,beat,dlwin,0,10,13,192,0.338541667,0.046875,0.5625,0,0.003306118
23247,142,23875,3,9,0,6,0,18,2,6,10,0,0,18,nowin,push,push,push,10,0,12,211,0.417061611,0.047393365,0.526066351,1,0.271531309
23248,108,23875,11,10,0,0,0,21,2,6,10,0,0,18,win,win,plwin,beat,25,0,21,193,0.435233161,0.056994819,0.559585492,1,0.298824795
23249,13,23875,4,10,0,0,0,14,2,6,10,0,0,18,nowin,loss,beat,dlwin,0,10,14,206,0.417475728,0.063106796,0.621359223,2,0.59555479
23250,13,23876,9,8,0,0,0,17,8,5,1,10,0,24,nowin,win,dlbust,bust,20,0,17,206,0.417475728,0.063106796,0.621359223,2,0.59555479
23251,102,23876,4,10,0,5,0,19,8,5,1,10,0,24,nowin,win,dlbust,bust,20,0,14,192,0.338541667,0.046875,0.5625,0,0.003306118
23252,23,23876,4,10,0,10,0,24,8,5,1,10,0,24,nowin,loss,bust,plbust,0,10,14,208,0.427884615,0.0625,0.552884615,1,0.29114424
23253,3,23876,3,11,3,0,0,17,8,5,1,10,0,24,nowin,win,dlbust,bust,20,0,14,190,0.431578947,0.026315789,0.542105263,1,0.288076384
23254,113,23876,3,3,4,8,0,18,8,5,1,10,0,24,nowin,win,dlbust,bust,20,0,6,199,0.407035176,0.055276382,0.668341709,2,0.620695264
23255,150,23876,10,7,0,0,0,17,8,5,1,10,0,24,nowin,win,dlbust,bust,20,0,17,192,0.401041667,0.036458333,0.567708333,0,0.023287458
23256,83,23877,7,2,11,0,0,20,10,10,0,0,0,20,nowin,push,push,push,10,0,9,193,0.424870466,0.051813472,0.678756477,2,0.644360335
23257,21,23877,4,10,0,6,0,20,10,10,0,0,0,20,nowin,push,push,push,10,0,14,214,0.359813084,0.042056075,0.626168224,0,0.025263474
23258,97,23877,3,7,11,0,0,21,10,10,0,0,0,20,nowin,win,plwin,beat,20,0,10,182,0.450549451,0.06043956,0.692307692,2,0.677372279
23259,138,23877,9,9,0,0,0,18,10,10,0,0,0,20,nowin,loss,beat,dlwin,0,10,18,190,0.442105263,0.047368421,0.610526316,2,0.609711065
23260,66,23877,7,5,0,10,0,22,10,10,0,0,0,20,nowin,loss,bust,plbust,0,10,12,217,0.456221198,0.064516129,0.626728111,3,0.924304367
23261,85,23877,8,2,4,9,0,23,10,10,0,0,0,20,nowin,loss,bust,plbust,0,10,10,195,0.41025641,0.066666667,0.594871795,0,0.03269711
23262,115,23878,3,9,0,5,0,17,7,2,5,7,0,21,nowin,loss,beat,dlwin,0,10,12,194,0.427835052,0.041237113,0.592783505,2,0.583863602
23263,134,23878,3,3,2,8,9,25,7,2,5,7,0,21,nowin,loss,bust,plbust,0,10,6,185,0.443243243,0.021621622,0.545945946,1,0.296939509
23264,95,23878,7,6,0,4,0,17,7,2,5,7,0,21,nowin,loss,beat,dlwin,0,10,13,218,0.412844037,0.04587156,0.559633028,0,0.024842385
23265,141,23878,6,8,0,10,0,24,7,2,5,7,0,21,nowin,loss,bust,plbust,0,10,14,202,0.420792079,0.074257426,0.564356436,0,0.028377851
23266,13,23878,5,6,7,0,0,18,7,2,5,7,0,21,nowin,loss,beat,dlwin,0,10,11,206,0.417475728,0.063106796,0.621359223,2,0.59555479
23267,71,23878,11,1,8,0,0,20,7,2,5,7,0,21,nowin,loss,beat,dlwin,0,10,12,193,0.352331606,0.046632124,0.585492228,0,0.013063661
23268,119,23879,5,10,0,0,0,15,3,10,1,4,0,18,nowin,loss,beat,dlwin,0,10,15,190,0.405263158,0.068421053,0.515789474,0,0.011837158
23269,49,23879,10,6,0,0,0,16,3,10,1,4,0,18,nowin,loss,beat,dlwin,0,10,16,207,0.396135266,0.053140097,0.594202899,0,0.028306925
23270,46,23879,4,4,10,0,0,18,3,10,1,4,0,18,nowin,push,push,push,10,0,8,186,0.403225806,0.048387097,0.591397849,0,0.029742194
23271,35,23879,10,2,0,1,0,13,3,10,1,4,0,18,nowin,loss,beat,dlwin,0,10,12,202,0.410891089,0.044554455,0.633663366,2,0.598681573
23272,75,23879,10,2,0,10,0,22,3,10,1,4,0,18,nowin,loss,bust,plbust,0,10,12,191,0.418848168,0.052356021,0.570680628,0,0.029344702
23273,3,23879,2,3,7,7,0,19,3,10,1,4,0,18,nowin,win,plwin,beat,20,0,5,190,0.431578947,0.026315789,0.542105263,1,0.288076384
23274,123,23880,5,3,10,0,0,18,8,8,7,0,0,23,nowin,win,dlbust,bust,20,0,8,205,0.43902439,0.034146341,0.614634146,2,0.609962544
23275,63,23880,3,10,0,4,0,17,8,8,7,0,0,23,nowin,win,dlbust,bust,20,0,13,216,0.467592593,0.037037037,0.62037037,3,0.931690496
23276,15,23880,10,3,0,2,8,23,8,8,7,0,0,23,nowin,loss,bust,plbust,0,10,13,212,0.410377358,0.051886792,0.561320755,0,0.024517408
23277,142,23880,2,2,5,1,9,19,8,8,7,0,0,23,nowin,win,dlbust,bust,20,0,4,211,0.417061611,0.047393365,0.526066351,1,0.271531309
23278,38,23880,6,6,0,8,0,20,8,8,7,0,0,23,nowin,win,dlbust,bust,20,0,12,202,0.361386139,0.03960396,0.564356436,0,0.010597953
23279,86,23880,10,2,0,1,5,18,8,8,7,0,0,23,nowin,win,dlbust,bust,20,0,12,196,0.454081633,0.040816327,0.591836735,3,0.887566443
23280,82,23881,4,10,0,10,0,24,7,10,0,0,0,17,nowin,loss,bust,plbust,0,10,14,225,0.408888889,0.075555556,0.577777778,0,0.028101874
23281,67,23881,3,4,6,2,9,24,7,10,0,0,0,17,nowin,loss,bust,plbust,0,10,7,195,0.369230769,0.041025641,0.569230769,0,0.014139427
23282,7,23881,5,2,11,0,0,18,7,10,0,0,0,17,nowin,win,plwin,beat,20,0,7,183,0.442622951,0.06010929,0.62295082,2,0.619303341
23283,11,23881,10,10,0,0,0,20,7,10,0,0,0,17,nowin,win,plwin,beat,20,0,20,236,0.457627119,0.016949153,0.588983051,3,0.889015813
23284,132,23881,4,9,0,6,0,19,7,10,0,0,0,17,nowin,win,plwin,beat,20,0,13,194,0.412371134,0.036082474,0.649484536,2,0.611633238
23285,24,23881,1,5,10,2,0,18,7,10,0,0,0,17,nowin,win,plwin,beat,20,0,6,207,0.458937198,0.048309179,0.570048309,1,0.318138014
23286,134,23882,8,10,0,0,0,18,4,8,6,0,0,18,nowin,push,push,push,10,0,18,185,0.443243243,0.021621622,0.545945946,1,0.296939509
23287,54,23882,9,11,0,0,0,20,4,8,6,0,0,18,nowin,win,plwin,beat,20,0,20,185,0.437837838,0.032432432,0.556756757,1,0.29899854
23288,92,23882,7,3,10,0,0,20,4,8,6,0,0,18,nowin,win,plwin,beat,20,0,10,186,0.446236559,0.059139785,0.564516129,1,0.307826125
23289,32,23882,10,10,0,0,0,20,4,8,6,0,0,18,nowin,win,plwin,beat,20,0,20,189,0.391534392,0.037037037,0.53968254,0,0.013579086
23290,146,23882,7,10,0,0,0,17,4,8,6,0,0,18,nowin,loss,beat,dlwin,0,10,17,221,0.43438914,0.040723982,0.542986425,1,0.290190091
23291,101,23882,8,5,0,0,0,13,4,8,6,0,0,18,nowin,loss,beat,dlwin,0,10,13,205,0.424390244,0.068292683,0.63902439,2,0.614740646
23292,17,23883,11,7,0,0,0,18,8,5,4,0,0,17,nowin,win,plwin,beat,20,0,18,171,0.444444444,0.070175439,0.555555556,1,0.302364894
23293,2,23883,8,2,10,0,0,20,8,5,4,0,0,17,nowin,win,plwin,beat,20,0,10,200,0.445,0.035,0.64,2,0.633962549
23294,37,23883,5,6,9,0,0,20,8,5,4,0,0,17,nowin,win,plwin,beat,20,0,11,208,0.394230769,0.038461538,0.581730769,0,0.024682772
23295,7,23883,10,10,0,0,0,20,8,5,4,0,0,17,nowin,win,plwin,beat,20,0,20,183,0.442622951,0.06010929,0.62295082,2,0.619303341
23296,83,23883,9,5,0,10,0,24,8,5,4,0,0,17,nowin,loss,bust,plbust,0,10,14,193,0.424870466,0.051813472,0.678756477,2,0.644360335
23297,77,23883,10,4,0,2,10,26,8,5,4,0,0,17,nowin,loss,bust,plbust,0,10,14,200,0.455,0.04,0.62,3,0.916252116
23298,73,23884,9,2,1,0,0,12,5,4,10,0,0,19,nowin,loss,beat,dlwin,0,10,11,181,0.375690608,0.011049724,0.596685083,0,0.022795773
23299,53,23884,10,9,0,0,0,19,5,4,10,0,0,19,nowin,push,push,push,10,0,19,250,0.372,0.064,0.564,0,0.013687345
23300,124,23884,2,3,4,10,0,19,5,4,10,0,0,19,nowin,push,push,push,10,0,5,202,0.47029703,0.064356436,0.584158416,3,0.899458193
23301,138,23884,5,10,0,0,0,15,5,4,10,0,0,19,nowin,loss,beat,dlwin,0,10,15,190,0.442105263,0.047368421,0.610526316,2,0.609711065
23302,134,23884,4,5,2,10,0,21,5,4,10,0,0,19,nowin,win,plwin,beat,20,0,9,185,0.443243243,0.021621622,0.545945946,1,0.296939509
23303,4,23884,10,10,0,0,0,20,5,4,10,0,0,19,nowin,win,plwin,beat,20,0,20,217,0.460829493,0.036866359,0.562211982,1,0.315432839
23304,121,23885,10,6,0,0,0,16,4,4,10,0,0,18,nowin,loss,beat,dlwin,0,10,16,195,0.456410256,0.025641026,0.512820513,1,0.288597791
23305,70,23885,3,5,5,0,0,13,4,4,10,0,0,18,nowin,loss,beat,dlwin,0,10,8,228,0.385964912,0.039473684,0.557017544,0,0.016157125
23306,132,23885,4,6,5,0,0,15,4,4,10,0,0,18,nowin,loss,beat,dlwin,0,10,10,194,0.412371134,0.036082474,0.649484536,2,0.611633238
23307,60,23885,3,2,6,6,0,17,4,4,10,0,0,18,nowin,loss,beat,dlwin,0,10,5,227,0.418502203,0.022026432,0.559471366,0,0.026496258
23308,11,23885,5,10,0,0,0,15,4,4,10,0,0,18,nowin,loss,beat,dlwin,0,10,15,236,0.457627119,0.016949153,0.588983051,3,0.889015813
23309,56,23885,10,7,0,0,0,17,4,4,10,0,0,18,nowin,loss,beat,dlwin,0,10,17,175,0.4,0.057142857,0.582857143,0,0.026685297
23310,119,23886,10,3,0,0,0,13,4,5,5,10,0,24,nowin,win,dlbust,bust,20,0,13,190,0.405263158,0.068421053,0.515789474,0,0.011837158
23311,95,23886,7,2,6,0,0,15,4,5,5,10,0,24,nowin,win,dlbust,bust,20,0,9,218,0.412844037,0.04587156,0.559633028,0,0.024842385
23312,22,23886,4,8,0,0,0,12,4,5,5,10,0,24,nowin,win,dlbust,bust,20,0,12,187,0.481283422,0.042780749,0.577540107,3,0.906128176
23313,105,23886,4,5,8,0,0,17,4,5,5,10,0,24,nowin,win,dlbust,bust,20,0,9,198,0.414141414,0.070707071,0.590909091,0,0.032889494
23314,76,23886,5,1,10,0,0,16,4,5,5,10,0,24,nowin,win,dlbust,bust,20,0,6,189,0.534391534,0.079365079,0.608465608,3,1
23315,111,23886,10,3,0,0,0,13,4,5,5,10,0,24,nowin,win,dlbust,bust,20,0,13,180,0.433333333,0.055555556,0.611111111,2,0.602264492
23316,31,23887,10,10,0,0,0,20,5,9,8,0,0,22,nowin,win,dlbust,bust,20,0,20,188,0.473404255,0.058510638,0.515957447,1,0.300306557
23317,40,23887,9,5,0,0,0,14,5,9,8,0,0,22,nowin,win,dlbust,bust,20,0,14,196,0.367346939,0.030612245,0.617346939,0,0.025358183
23318,98,23887,10,8,0,0,0,18,5,9,8,0,0,22,nowin,win,dlbust,bust,20,0,18,220,0.422727273,0.054545455,0.55,1,0.28664435
23319,70,23887,10,10,0,0,0,20,5,9,8,0,0,22,nowin,win,dlbust,bust,20,0,20,228,0.385964912,0.039473684,0.557017544,0,0.016157125
23320,150,23887,7,6,0,0,0,13,5,9,8,0,0,22,nowin,win,dlbust,bust,20,0,13,192,0.401041667,0.036458333,0.567708333,0,0.023287458
23321,45,23887,2,2,10,0,0,14,5,9,8,0,0,22,nowin,win,dlbust,bust,20,0,4,196,0.428571429,0.051020408,0.612244898,2,0.598821767
23322,66,23888,2,2,9,10,0,23,11,4,2,0,0,17,nowin,loss,bust,plbust,0,10,4,217,0.456221198,0.064516129,0.626728111,3,0.924304367
23323,123,23888,10,4,0,4,0,18,11,4,2,0,0,17,nowin,win,plwin,beat,20,0,14,205,0.43902439,0.034146341,0.614634146,2,0.609962544
23324,121,23888,10,3,0,9,0,22,11,4,2,0,0,17,nowin,loss,bust,plbust,0,10,13,195,0.456410256,0.025641026,0.512820513,1,0.288597791
23325,113,23888,10,9,0,0,0,19,11,4,2,0,0,17,nowin,win,plwin,beat,20,0,19,199,0.407035176,0.055276382,0.668341709,2,0.620695264
23326,22,23888,10,8,0,0,0,18,11,4,2,0,0,17,nowin,win,plwin,beat,20,0,18,187,0.481283422,0.042780749,0.577540107,3,0.906128176
23327,110,23888,10,6,0,6,0,22,11,4,2,0,0,17,nowin,loss,bust,plbust,0,10,16,192,0.416666667,0.046875,0.557291667,0,0.025413132
23328,66,23889,8,5,0,0,0,13,2,5,9,1,0,17,nowin,loss,beat,dlwin,0,10,13,217,0.456221198,0.064516129,0.626728111,3,0.924304367
23329,24,23889,10,7,0,0,0,17,2,5,9,1,0,17,nowin,push,push,push,10,0,17,207,0.458937198,0.048309179,0.570048309,1,0.318138014
23330,36,23889,10,10,0,0,0,20,2,5,9,1,0,17,nowin,win,plwin,beat,20,0,20,229,0.445414847,0.056768559,0.655021834,2,0.645370571
23331,122,23889,9,3,0,10,0,22,2,5,9,1,0,17,nowin,loss,bust,plbust,0,10,12,210,0.347619048,0.052380952,0.59047619,0,0.012873677
23332,77,23889,8,8,0,0,0,16,2,5,9,1,0,17,nowin,loss,beat,dlwin,0,10,16,200,0.455,0.04,0.62,3,0.916252116
23333,83,23889,5,5,10,0,0,20,2,5,9,1,0,17,nowin,win,plwin,beat,20,0,10,193,0.424870466,0.051813472,0.678756477,2,0.644360335
23334,113,23890,8,5,0,1,10,24,8,2,4,10,0,24,nowin,loss,bust,plbust,0,10,13,199,0.407035176,0.055276382,0.668341709,2,0.620695264
23335,13,23890,4,4,8,10,0,26,8,2,4,10,0,24,nowin,loss,bust,plbust,0,10,8,206,0.417475728,0.063106796,0.621359223,2,0.59555479
23336,53,23890,10,9,0,0,0,19,8,2,4,10,0,24,nowin,win,dlbust,bust,20,0,19,250,0.372,0.064,0.564,0,0.013687345
23337,111,23890,10,10,0,0,0,20,8,2,4,10,0,24,nowin,win,dlbust,bust,20,0,20,180,0.433333333,0.055555556,0.611111111,2,0.602264492
23338,80,23890,5,6,10,0,0,21,8,2,4,10,0,24,nowin,win,dlbust,bust,20,0,11,186,0.419354839,0.059139785,0.623655914,2,0.59892924
23339,26,23890,11,1,5,0,0,17,8,2,4,10,0,24,nowin,win,dlbust,bust,20,0,12,203,0.463054187,0.0591133,0.541871921,1,0.306802864
23340,145,23891,8,4,0,10,0,22,10,10,0,0,0,20,nowin,loss,bust,plbust,0,10,12,188,0.441489362,0.031914894,0.622340426,2,0.617837093
23341,122,23891,5,6,10,0,0,21,10,10,0,0,0,20,nowin,win,plwin,beat,20,0,11,210,0.347619048,0.052380952,0.59047619,0,0.012873677
23342,146,23891,10,6,0,9,0,25,10,10,0,0,0,20,nowin,loss,bust,plbust,0,10,16,221,0.43438914,0.040723982,0.542986425,1,0.290190091
23343,117,23891,3,3,11,0,0,17,10,10,0,0,0,20,nowin,loss,beat,dlwin,0,10,6,173,0.410404624,0.069364162,0.606936416,2,0.578610282
23344,91,23891,3,11,4,0,0,18,10,10,0,0,0,20,nowin,loss,beat,dlwin,0,10,14,194,0.417525773,0.046391753,0.515463918,1,0.266616552
23345,47,23891,2,9,5,10,0,26,10,10,0,0,0,20,nowin,loss,bust,plbust,0,10,11,210,0.438095238,0.057142857,0.623809524,2,0.615868808
23346,90,23892,6,10,0,5,0,21,11,10,0,0,0,21,nowin,push,push,push,10,0,16,201,0.447761194,0.049751244,0.60199005,3,0.889945023
23347,31,23892,10,5,0,5,0,20,11,10,0,0,0,21,nowin,loss,beat,dlwin,0,10,15,188,0.473404255,0.058510638,0.515957447,1,0.300306557
23348,132,23892,10,2,0,4,9,25,11,10,0,0,0,21,nowin,loss,bust,plbust,0,10,12,194,0.412371134,0.036082474,0.649484536,2,0.611633238
23349,40,23892,10,10,0,0,0,20,11,10,0,0,0,21,nowin,loss,beat,dlwin,0,10,20,196,0.367346939,0.030612245,0.617346939,0,0.025358183
23350,121,23892,10,6,0,10,0,26,11,10,0,0,0,21,nowin,loss,bust,plbust,0,10,16,195,0.456410256,0.025641026,0.512820513,1,0.288597791
23351,13,23892,10,11,0,0,0,21,11,10,0,0,0,21,win,push,push,push,10,0,21,206,0.417475728,0.063106796,0.621359223,2,0.59555479
23352,134,23893,4,2,11,0,0,17,10,2,7,0,0,19,nowin,loss,beat,dlwin,0,10,6,185,0.443243243,0.021621622,0.545945946,1,0.296939509
23353,35,23893,10,9,0,0,0,19,10,2,7,0,0,19,nowin,push,push,push,10,0,19,202,0.410891089,0.044554455,0.633663366,2,0.598681573
23354,46,23893,6,10,0,5,0,21,10,2,7,0,0,19,nowin,win,plwin,beat,20,0,16,186,0.403225806,0.048387097,0.591397849,0,0.029742194
23355,140,23893,6,10,0,3,0,19,10,2,7,0,0,19,nowin,push,push,push,10,0,16,210,0.466666667,0.023809524,0.604761905,3,0.915293335
23356,81,23893,10,3,0,10,0,23,10,2,7,0,0,19,nowin,loss,bust,plbust,0,10,13,182,0.395604396,0.043956044,0.60989011,2,0.567491261
23357,33,23893,6,2,10,0,0,18,10,2,7,0,0,19,nowin,loss,beat,dlwin,0,10,8,192,0.4375,0.057291667,0.625,2,0.616208916
23358,92,23894,6,1,10,0,0,17,10,6,4,0,0,20,nowin,loss,beat,dlwin,0,10,7,186,0.446236559,0.059139785,0.564516129,1,0.307826125
23359,143,23894,11,10,0,0,0,21,10,6,4,0,0,20,win,win,plwin,beat,25,0,21,203,0.463054187,0.044334975,0.57635468,3,0.883143365
23360,2,23894,3,10,0,10,0,23,10,6,4,0,0,20,nowin,loss,bust,plbust,0,10,13,200,0.445,0.035,0.64,2,0.633962549
23361,67,23894,5,11,2,0,0,18,10,6,4,0,0,20,nowin,loss,beat,dlwin,0,10,16,195,0.369230769,0.041025641,0.569230769,0,0.014139427
23362,12,23894,10,10,0,0,0,20,10,6,4,0,0,20,nowin,push,push,push,10,0,20,189,0.470899471,0.015873016,0.613756614,3,0.929171178
23363,143,23894,10,10,0,0,0,20,10,6,4,0,0,20,nowin,push,push,push,10,0,20,203,0.463054187,0.044334975,0.57635468,3,0.883143365
23364,139,23895,5,10,0,0,0,15,2,10,2,3,0,17,nowin,loss,beat,dlwin,0,10,15,192,0.380208333,0.036458333,0.59375,0,0.023429169
23365,116,23895,10,10,0,0,0,20,2,10,2,3,0,17,nowin,win,plwin,beat,20,0,20,195,0.425641026,0.056410256,0.538461538,1,0.28273747
23366,22,23895,10,6,0,0,0,16,2,10,2,3,0,17,nowin,loss,beat,dlwin,0,10,16,187,0.481283422,0.042780749,0.577540107,3,0.906128176
23367,55,23895,8,9,0,0,0,17,2,10,2,3,0,17,nowin,push,push,push,10,0,17,191,0.371727749,0.057591623,0.54973822,0,0.01011347
23368,131,23895,8,4,0,10,0,22,2,10,2,3,0,17,nowin,loss,bust,plbust,0,10,12,217,0.410138249,0.069124424,0.543778802,0,0.02015021
23369,119,23895,11,10,0,0,0,21,2,10,2,3,0,17,win,win,plwin,beat,25,0,21,190,0.405263158,0.068421053,0.515789474,0,0.011837158
23370,65,23896,8,10,0,0,0,18,7,10,0,0,0,17,nowin,win,plwin,beat,20,0,18,203,0.492610837,0.054187192,0.571428571,3,0.913702814
23371,114,23896,3,11,5,0,0,19,7,10,0,0,0,17,nowin,win,plwin,beat,20,0,14,198,0.47979798,0.025252525,0.611111111,3,0.937232995
23372,125,23896,3,4,4,3,9,23,7,10,0,0,0,17,nowin,loss,bust,plbust,0,10,7,219,0.438356164,0.050228311,0.575342466,1,0.308411257
23373,34,23896,10,10,0,0,0,20,7,10,0,0,0,17,nowin,win,plwin,beat,20,0,20,202,0.5,0.079207921,0.618811881,3,0.968961434
23374,31,23896,9,4,0,1,7,21,7,10,0,0,0,17,nowin,win,plwin,beat,20,0,13,188,0.473404255,0.058510638,0.515957447,1,0.300306557
23375,143,23896,10,2,0,5,0,17,7,10,0,0,0,17,nowin,push,push,push,10,0,12,203,0.463054187,0.044334975,0.57635468,3,0.883143365
23376,99,23897,10,10,0,0,0,20,5,10,10,0,0,25,nowin,win,dlbust,bust,20,0,20,207,0.47826087,0.062801932,0.637681159,3,0.961418446
23377,81,23897,11,10,0,0,0,21,5,10,10,0,0,25,win,win,dlbust,bust,25,0,21,182,0.395604396,0.043956044,0.60989011,2,0.567491261
23378,61,23897,3,10,0,0,0,13,5,10,10,0,0,25,nowin,win,dlbust,bust,20,0,13,194,0.427835052,0.077319588,0.603092784,2,0.591437139
23379,67,23897,6,10,0,0,0,16,5,10,10,0,0,25,nowin,win,dlbust,bust,20,0,16,195,0.369230769,0.041025641,0.569230769,0,0.014139427
23380,120,23897,9,11,0,0,0,20,5,10,10,0,0,25,nowin,win,dlbust,bust,20,0,20,202,0.440594059,0.034653465,0.618811881,2,0.614441029
23381,134,23897,10,3,0,0,0,13,5,10,10,0,0,25,nowin,win,dlbust,bust,20,0,13,185,0.443243243,0.021621622,0.545945946,1,0.296939509
23382,138,23898,7,8,0,5,0,20,10,7,0,0,0,17,nowin,win,plwin,beat,20,0,15,190,0.442105263,0.047368421,0.610526316,2,0.609711065
23383,58,23898,8,10,0,0,0,18,10,7,0,0,0,17,nowin,win,plwin,beat,20,0,18,195,0.430769231,0.041025641,0.584615385,2,0.580497586
23384,101,23898,7,2,5,4,0,18,10,7,0,0,0,17,nowin,win,plwin,beat,20,0,9,205,0.424390244,0.068292683,0.63902439,2,0.614740646
23385,5,23898,3,2,10,9,0,24,10,7,0,0,0,17,nowin,loss,bust,plbust,0,10,5,203,0.42364532,0.02955665,0.596059113,2,0.582508076
23386,135,23898,10,9,0,0,0,19,10,7,0,0,0,17,nowin,win,plwin,beat,20,0,19,179,0.391061453,0.067039106,0.586592179,0,0.024924662
23387,146,23898,10,4,0,4,0,18,10,7,0,0,0,17,nowin,win,plwin,beat,20,0,14,221,0.43438914,0.040723982,0.542986425,1,0.290190091
23388,73,23899,10,9,0,0,0,19,10,10,0,0,0,20,nowin,loss,beat,dlwin,0,10,19,181,0.375690608,0.011049724,0.596685083,0,0.022795773
23389,138,23899,10,10,0,0,0,20,10,10,0,0,0,20,nowin,push,push,push,10,0,20,190,0.442105263,0.047368421,0.610526316,2,0.609711065
23390,113,23899,2,6,5,4,0,17,10,10,0,0,0,20,nowin,loss,beat,dlwin,0,10,8,199,0.407035176,0.055276382,0.668341709,2,0.620695264
23391,131,23899,10,8,0,0,0,18,10,10,0,0,0,20,nowin,loss,beat,dlwin,0,10,18,217,0.410138249,0.069124424,0.543778802,0,0.02015021
23392,21,23899,4,2,7,10,0,23,10,10,0,0,0,20,nowin,loss,bust,plbust,0,10,6,214,0.359813084,0.042056075,0.626168224,0,0.025263474
23393,42,23899,4,4,7,9,0,24,10,10,0,0,0,20,nowin,loss,bust,plbust,0,10,8,212,0.443396226,0.051886792,0.570754717,1,0.309181312
23394,34,23900,8,7,0,1,8,24,11,10,0,0,0,21,nowin,loss,bust,plbust,0,10,15,202,0.5,0.079207921,0.618811881,3,0.968961434
23395,140,23900,6,10,0,1,0,17,11,10,0,0,0,21,nowin,loss,beat,dlwin,0,10,16,210,0.466666667,0.023809524,0.604761905,3,0.915293335
23396,107,23900,10,11,0,0,0,21,11,10,0,0,0,21,win,push,push,push,10,0,21,218,0.444954128,0.073394495,0.600917431,2,0.605210014
23397,5,23900,4,7,2,6,0,19,11,10,0,0,0,21,nowin,loss,beat,dlwin,0,10,11,203,0.42364532,0.02955665,0.596059113,2,0.582508076
23398,10,23900,10,11,0,0,0,21,11,10,0,0,0,21,win,push,push,push,10,0,21,191,0.413612565,0.057591623,0.596858639,2,0.574087175
23399,14,23900,2,8,3,3,5,21,11,10,0,0,0,21,nowin,push,push,push,10,0,10,202,0.391089109,0.01980198,0.628712871,2,0.577264877
23400,37,23901,7,3,8,0,0,18,11,10,0,0,0,21,nowin,loss,beat,dlwin,0,10,10,208,0.394230769,0.038461538,0.581730769,0,0.024682772
23401,129,23901,3,4,4,7,0,18,11,10,0,0,0,21,nowin,loss,beat,dlwin,0,10,7,201,0.422885572,0.064676617,0.55721393,0,0.027255383
23402,90,23901,3,6,5,10,0,24,11,10,0,0,0,21,nowin,loss,bust,plbust,0,10,9,201,0.447761194,0.049751244,0.60199005,3,0.889945023
23403,18,23901,7,8,0,6,0,21,11,10,0,0,0,21,nowin,push,push,push,10,0,15,182,0.461538462,0.043956044,0.587912088,3,0.892649374
23404,146,23901,5,1,9,10,0,25,11,10,0,0,0,21,nowin,loss,bust,plbust,0,10,6,221,0.43438914,0.040723982,0.542986425,1,0.290190091
23405,68,23901,6,7,0,1,6,20,11,10,0,0,0,21,nowin,loss,beat,dlwin,0,10,13,205,0.434146341,0.029268293,0.6,2,0.59483189
23406,149,23902,10,10,0,0,0,20,9,10,0,0,0,19,nowin,win,plwin,beat,20,0,20,225,0.457777778,0.057777778,0.648888889,2,0.651965595
23407,95,23902,9,10,0,0,0,19,9,10,0,0,0,19,nowin,push,push,push,10,0,19,218,0.412844037,0.04587156,0.559633028,0,0.024842385
23408,76,23902,10,2,0,10,0,22,9,10,0,0,0,19,nowin,loss,bust,plbust,0,10,12,189,0.534391534,0.079365079,0.608465608,3,1
23409,105,23902,10,2,0,8,0,20,9,10,0,0,0,19,nowin,win,plwin,beat,20,0,12,198,0.414141414,0.070707071,0.590909091,0,0.032889494
23410,9,23902,8,4,0,8,0,20,9,10,0,0,0,19,nowin,win,plwin,beat,20,0,12,194,0.37628866,0.015463918,0.541237113,0,0.009396796
23411,88,23902,7,7,0,10,0,24,9,10,0,0,0,19,nowin,loss,bust,plbust,0,10,14,206,0.466019417,0.033980583,0.54368932,1,0.309467903
23412,79,23903,10,9,0,0,0,19,3,2,6,6,0,17,nowin,win,plwin,beat,20,0,19,211,0.436018957,0.028436019,0.672985782,2,0.650131054
23413,78,23903,10,4,0,0,0,14,3,2,6,6,0,17,nowin,loss,beat,dlwin,0,10,14,201,0.517412935,0.034825871,0.587064677,3,0.95871112
23414,35,23903,10,10,0,0,0,20,3,2,6,6,0,17,nowin,win,plwin,beat,20,0,20,202,0.410891089,0.044554455,0.633663366,2,0.598681573
23415,86,23903,2,7,11,0,0,20,3,2,6,6,0,17,nowin,win,plwin,beat,20,0,9,196,0.454081633,0.040816327,0.591836735,3,0.887566443
23416,37,23903,6,6,0,3,0,15,3,2,6,6,0,17,nowin,loss,beat,dlwin,0,10,12,208,0.394230769,0.038461538,0.581730769,0,0.024682772
23417,29,23903,10,9,0,0,0,19,3,2,6,6,0,17,nowin,win,plwin,beat,20,0,19,189,0.44973545,0.058201058,0.544973545,1,0.300349439
23418,127,23904,10,10,0,0,0,20,5,4,11,0,0,20,nowin,push,push,push,10,0,20,201,0.402985075,0.029850746,0.60199005,0,0.032263937
23419,110,23904,6,9,0,0,0,15,5,4,11,0,0,20,nowin,loss,beat,dlwin,0,10,15,192,0.416666667,0.046875,0.557291667,0,0.025413132
23420,118,23904,3,4,10,0,0,17,5,4,11,0,0,20,nowin,loss,beat,dlwin,0,10,7,216,0.393518519,0.037037037,0.555555556,0,0.018059873
23421,120,23904,10,7,0,0,0,17,5,4,11,0,0,20,nowin,loss,beat,dlwin,0,10,17,202,0.440594059,0.034653465,0.618811881,2,0.614441029
23422,104,23904,11,7,0,0,0,18,5,4,11,0,0,20,nowin,loss,beat,dlwin,0,10,18,209,0.363636364,0.052631579,0.593301435,0,0.018359419
23423,28,23904,10,2,0,0,0,12,5,4,11,0,0,20,nowin,loss,beat,dlwin,0,10,12,199,0.422110553,0.045226131,0.542713568,1,0.282706618
23424,150,23905,9,10,0,0,0,19,11,9,0,0,0,20,nowin,loss,beat,dlwin,0,10,19,192,0.401041667,0.036458333,0.567708333,0,0.023287458
23425,121,23905,2,10,0,4,7,23,11,9,0,0,0,20,nowin,loss,bust,plbust,0,10,12,195,0.456410256,0.025641026,0.512820513,1,0.288597791
23426,92,23905,10,10,0,0,0,20,11,9,0,0,0,20,nowin,push,push,push,10,0,20,186,0.446236559,0.059139785,0.564516129,1,0.307826125
23427,147,23905,5,10,0,6,0,21,11,9,0,0,0,20,nowin,win,plwin,beat,20,0,15,205,0.380487805,0.014634146,0.536585366,0,0.00951447
23428,13,23905,10,8,0,0,0,18,11,9,0,0,0,20,nowin,loss,beat,dlwin,0,10,18,206,0.417475728,0.063106796,0.621359223,2,0.59555479
23429,4,23905,5,8,0,10,0,23,11,9,0,0,0,20,nowin,loss,bust,plbust,0,10,13,217,0.460829493,0.036866359,0.562211982,1,0.315432839
23430,77,23906,10,10,0,0,0,20,2,4,10,2,0,18,nowin,win,plwin,beat,20,0,20,200,0.455,0.04,0.62,3,0.916252116
23431,142,23906,10,5,0,0,0,15,2,4,10,2,0,18,nowin,loss,beat,dlwin,0,10,15,211,0.417061611,0.047393365,0.526066351,1,0.271531309
23432,58,23906,10,6,0,0,0,16,2,4,10,2,0,18,nowin,loss,beat,dlwin,0,10,16,195,0.430769231,0.041025641,0.584615385,2,0.580497586
23433,131,23906,9,2,5,0,0,16,2,4,10,2,0,18,nowin,loss,beat,dlwin,0,10,11,217,0.410138249,0.069124424,0.543778802,0,0.02015021
23434,5,23906,2,5,4,9,0,20,2,4,10,2,0,18,nowin,win,plwin,beat,20,0,7,203,0.42364532,0.02955665,0.596059113,2,0.582508076
23435,122,23906,7,10,0,0,0,17,2,4,10,2,0,18,nowin,loss,beat,dlwin,0,10,17,210,0.347619048,0.052380952,0.59047619,0,0.012873677
23436,94,23907,11,6,4,0,0,21,8,6,10,0,0,24,nowin,win,dlbust,bust,20,0,17,183,0.43715847,0.043715847,0.540983607,1,0.290866892
23437,122,23907,10,10,0,0,0,20,8,6,10,0,0,24,nowin,win,dlbust,bust,20,0,20,210,0.347619048,0.052380952,0.59047619,0,0.012873677
23438,62,23907,5,4,10,0,0,19,8,6,10,0,0,24,nowin,win,dlbust,bust,20,0,9,178,0.370786517,0.028089888,0.54494382,0,0.008657722
23439,92,23907,7,4,10,0,0,21,8,6,10,0,0,24,nowin,win,dlbust,bust,20,0,11,186,0.446236559,0.059139785,0.564516129,1,0.307826125
23440,70,23907,6,11,2,0,0,19,8,6,10,0,0,24,nowin,win,dlbust,bust,20,0,17,228,0.385964912,0.039473684,0.557017544,0,0.016157125
23441,67,23907,11,7,0,0,0,18,8,6,10,0,0,24,nowin,win,dlbust,bust,20,0,18,195,0.369230769,0.041025641,0.569230769,0,0.014139427
23442,2,23908,1,3,10,9,0,23,1,4,9,10,0,24,nowin,loss,bust,plbust,0,10,4,200,0.445,0.035,0.64,2,0.633962549
23443,8,23908,5,10,0,10,0,25,1,4,9,10,0,24,nowin,loss,bust,plbust,0,10,15,181,0.44198895,0.071823204,0.596685083,2,0.599438402
23444,56,23908,6,3,6,5,0,20,1,4,9,10,0,24,nowin,win,dlbust,bust,20,0,9,175,0.4,0.057142857,0.582857143,0,0.026685297
23445,17,23908,9,5,0,5,0,19,1,4,9,10,0,24,nowin,win,dlbust,bust,20,0,14,171,0.444444444,0.070175439,0.555555556,1,0.302364894
23446,62,23908,8,10,0,0,0,18,1,4,9,10,0,24,nowin,win,dlbust,bust,20,0,18,178,0.370786517,0.028089888,0.54494382,0,0.008657722
23447,105,23908,5,6,7,0,0,18,1,4,9,10,0,24,nowin,win,dlbust,bust,20,0,11,198,0.414141414,0.070707071,0.590909091,0,0.032889494
23448,146,23909,3,10,0,10,0,23,10,4,7,0,0,21,nowin,loss,bust,plbust,0,10,13,221,0.43438914,0.040723982,0.542986425,1,0.290190091
23449,9,23909,10,10,0,0,0,20,10,4,7,0,0,21,nowin,loss,beat,dlwin,0,10,20,194,0.37628866,0.015463918,0.541237113,0,0.009396796
23450,144,23909,11,8,0,0,0,19,10,4,7,0,0,21,nowin,loss,beat,dlwin,0,10,19,202,0.386138614,0.054455446,0.564356436,0,0.018006244
23451,91,23909,10,11,0,0,0,21,10,4,7,0,0,21,win,push,push,push,10,0,21,194,0.417525773,0.046391753,0.515463918,1,0.266616552
23452,60,23909,3,10,0,7,0,20,10,4,7,0,0,21,nowin,loss,beat,dlwin,0,10,13,227,0.418502203,0.022026432,0.559471366,0,0.026496258
23453,8,23909,7,5,0,4,1,17,10,4,7,0,0,21,nowin,loss,beat,dlwin,0,10,12,181,0.44198895,0.071823204,0.596685083,2,0.599438402
23454,50,23910,6,6,0,10,0,22,3,10,3,4,0,20,nowin,loss,bust,plbust,0,10,12,202,0.405940594,0.04950495,0.54950495,0,0.020296079
23455,102,23910,9,2,3,0,0,14,3,10,3,4,0,20,nowin,loss,beat,dlwin,0,10,11,192,0.338541667,0.046875,0.5625,0,0.003306118
23456,17,23910,10,9,0,0,0,19,3,10,3,4,0,20,nowin,loss,beat,dlwin,0,10,19,171,0.444444444,0.070175439,0.555555556,1,0.302364894
23457,95,23910,11,10,0,0,0,21,3,10,3,4,0,20,win,win,plwin,beat,25,0,21,218,0.412844037,0.04587156,0.559633028,0,0.024842385
23458,82,23910,7,3,10,0,0,20,3,10,3,4,0,20,nowin,push,push,push,10,0,10,225,0.408888889,0.075555556,0.577777778,0,0.028101874
23459,132,23910,10,11,0,0,0,21,3,10,3,4,0,20,win,win,plwin,beat,25,0,21,194,0.412371134,0.036082474,0.649484536,2,0.611633238
23460,26,23911,10,8,0,0,0,18,1,4,7,4,7,23,nowin,win,dlbust,bust,20,0,18,203,0.463054187,0.0591133,0.541871921,1,0.306802864
23461,111,23911,10,8,0,0,0,18,1,4,7,4,7,23,nowin,win,dlbust,bust,20,0,18,180,0.433333333,0.055555556,0.611111111,2,0.602264492
23462,54,23911,10,7,0,0,0,17,1,4,7,4,7,23,nowin,win,dlbust,bust,20,0,17,185,0.437837838,0.032432432,0.556756757,1,0.29899854
23463,71,23911,11,5,1,0,0,17,1,4,7,4,7,23,nowin,win,dlbust,bust,20,0,16,193,0.352331606,0.046632124,0.585492228,0,0.013063661
23464,70,23911,10,10,0,0,0,20,1,4,7,4,7,23,nowin,win,dlbust,bust,20,0,20,228,0.385964912,0.039473684,0.557017544,0,0.016157125
23465,80,23911,2,9,4,10,0,25,1,4,7,4,7,23,nowin,loss,bust,plbust,0,10,11,186,0.419354839,0.059139785,0.623655914,2,0.59892924
23466,134,23912,8,10,0,0,0,18,8,11,0,0,0,19,nowin,loss,beat,dlwin,0,10,18,185,0.443243243,0.021621622,0.545945946,1,0.296939509
23467,116,23912,8,3,5,7,0,23,8,11,0,0,0,19,nowin,loss,bust,plbust,0,10,11,195,0.425641026,0.056410256,0.538461538,1,0.28273747
23468,1,23912,2,5,10,0,0,17,8,11,0,0,0,19,nowin,loss,beat,dlwin,0,10,7,197,0.406091371,0.025380711,0.649746193,2,0.606186955
23469,104,23912,10,4,0,4,0,18,8,11,0,0,0,19,nowin,loss,beat,dlwin,0,10,14,209,0.363636364,0.052631579,0.593301435,0,0.018359419
23470,79,23912,2,10,0,1,9,22,8,11,0,0,0,19,nowin,loss,bust,plbust,0,10,12,211,0.436018957,0.028436019,0.672985782,2,0.650131054
23471,55,23912,8,10,0,0,0,18,8,11,0,0,0,19,nowin,loss,beat,dlwin,0,10,18,191,0.371727749,0.057591623,0.54973822,0,0.01011347
23472,141,23913,9,2,5,0,0,16,4,1,10,8,0,23,nowin,win,dlbust,bust,20,0,11,202,0.420792079,0.074257426,0.564356436,0,0.028377851
23473,97,23913,10,4,0,0,0,14,4,1,10,8,0,23,nowin,win,dlbust,bust,20,0,14,182,0.450549451,0.06043956,0.692307692,2,0.677372279
23474,40,23913,5,10,0,0,0,15,4,1,10,8,0,23,nowin,win,dlbust,bust,20,0,15,196,0.367346939,0.030612245,0.617346939,0,0.025358183
23475,27,23913,5,10,0,0,0,15,4,1,10,8,0,23,nowin,win,dlbust,bust,20,0,15,178,0.370786517,0.016853933,0.573033708,0,0.015536309
23476,90,23913,10,5,0,0,0,15,4,1,10,8,0,23,nowin,win,dlbust,bust,20,0,15,201,0.447761194,0.049751244,0.60199005,3,0.889945023
23477,77,23913,6,10,0,0,0,16,4,1,10,8,0,23,nowin,win,dlbust,bust,20,0,16,200,0.455,0.04,0.62,3,0.916252116
23478,51,23914,7,6,0,0,0,13,2,10,10,0,0,22,nowin,win,dlbust,bust,20,0,13,189,0.529100529,0.068783069,0.608465608,3,0.993665715
23479,105,23914,9,10,0,0,0,19,2,10,10,0,0,22,nowin,win,dlbust,bust,20,0,19,198,0.414141414,0.070707071,0.590909091,0,0.032889494
23480,79,23914,10,10,0,0,0,20,2,10,10,0,0,22,nowin,win,dlbust,bust,20,0,20,211,0.436018957,0.028436019,0.672985782,2,0.650131054
23481,122,23914,3,9,0,8,0,20,2,10,10,0,0,22,nowin,win,dlbust,bust,20,0,12,210,0.347619048,0.052380952,0.59047619,0,0.012873677
23482,45,23914,11,10,0,0,0,21,2,10,10,0,0,22,win,win,dlbust,bust,25,0,21,196,0.428571429,0.051020408,0.612244898,2,0.598821767
23483,23,23914,11,4,4,0,0,19,2,10,10,0,0,22,nowin,win,dlbust,bust,20,0,15,208,0.427884615,0.0625,0.552884615,1,0.29114424
23484,33,23915,3,2,9,3,0,17,10,10,0,0,0,20,nowin,loss,beat,dlwin,0,10,5,192,0.4375,0.057291667,0.625,2,0.616208916
23485,80,23915,10,10,0,0,0,20,10,10,0,0,0,20,nowin,push,push,push,10,0,20,186,0.419354839,0.059139785,0.623655914,2,0.59892924
23486,52,23915,10,2,0,9,0,21,10,10,0,0,0,20,nowin,win,plwin,beat,20,0,12,217,0.414746544,0.02764977,0.599078341,2,0.576736024
23487,120,23915,7,3,9,0,0,19,10,10,0,0,0,20,nowin,loss,beat,dlwin,0,10,10,202,0.440594059,0.034653465,0.618811881,2,0.614441029
23488,125,23915,2,10,0,10,0,22,10,10,0,0,0,20,nowin,loss,bust,plbust,0,10,12,219,0.438356164,0.050228311,0.575342466,1,0.308411257
23489,120,23915,2,4,5,9,0,20,10,10,0,0,0,20,nowin,push,push,push,10,0,6,202,0.440594059,0.034653465,0.618811881,2,0.614441029
23490,44,23916,9,6,0,2,0,17,9,10,0,0,0,19,nowin,loss,beat,dlwin,0,10,15,219,0.433789954,0.050228311,0.534246575,1,0.285551035
23491,124,23916,5,1,9,6,0,21,9,10,0,0,0,19,nowin,win,plwin,beat,20,0,6,202,0.47029703,0.064356436,0.584158416,3,0.899458193
23492,109,23916,11,10,0,0,0,21,9,10,0,0,0,19,win,win,plwin,beat,25,0,21,221,0.461538462,0.058823529,0.597285068,3,0.901830309
23493,76,23916,7,4,1,10,0,22,9,10,0,0,0,19,nowin,loss,bust,plbust,0,10,11,189,0.534391534,0.079365079,0.608465608,3,1
23494,122,23916,5,2,8,10,0,25,9,10,0,0,0,19,nowin,loss,bust,plbust,0,10,7,210,0.347619048,0.052380952,0.59047619,0,0.012873677
23495,26,23916,10,9,0,0,0,19,9,10,0,0,0,19,nowin,push,push,push,10,0,19,203,0.463054187,0.0591133,0.541871921,1,0.306802864
23496,32,23917,7,3,8,0,0,18,2,5,2,1,7,17,nowin,win,plwin,beat,20,0,10,189,0.391534392,0.037037037,0.53968254,0,0.013579086
23497,36,23917,9,4,0,0,0,13,2,5,2,1,7,17,nowin,loss,beat,dlwin,0,10,13,229,0.445414847,0.056768559,0.655021834,2,0.645370571
23498,68,23917,7,10,0,0,0,17,2,5,2,1,7,17,nowin,push,push,push,10,0,17,205,0.434146341,0.029268293,0.6,2,0.59483189
23499,14,23917,4,7,10,0,0,21,2,5,2,1,7,17,nowin,win,plwin,beat,20,0,11,202,0.391089109,0.01980198,0.628712871,2,0.577264877
23500,78,23917,9,10,0,0,0,19,2,5,2,1,7,17,nowin,win,plwin,beat,20,0,19,201,0.517412935,0.034825871,0.587064677,3,0.95871112
23501,135,23917,2,11,1,0,0,14,2,5,2,1,7,17,nowin,loss,beat,dlwin,0,10,13,179,0.391061453,0.067039106,0.586592179,0,0.024924662
23502,29,23918,11,10,0,0,0,21,6,11,0,0,0,17,win,win,plwin,beat,25,0,21,189,0.44973545,0.058201058,0.544973545,1,0.300349439
23503,65,23918,5,10,0,0,0,15,6,11,0,0,0,17,nowin,loss,beat,dlwin,0,10,15,203,0.492610837,0.054187192,0.571428571,3,0.913702814
23504,149,23918,10,8,0,0,0,18,6,11,0,0,0,17,nowin,win,plwin,beat,20,0,18,225,0.457777778,0.057777778,0.648888889,2,0.651965595
23505,101,23918,10,7,0,0,0,17,6,11,0,0,0,17,nowin,push,push,push,10,0,17,205,0.424390244,0.068292683,0.63902439,2,0.614740646
23506,89,23918,3,10,0,0,0,13,6,11,0,0,0,17,nowin,loss,beat,dlwin,0,10,13,212,0.537735849,0.047169811,0.594339623,3,0.990167191
23507,136,23918,8,10,0,0,0,18,6,11,0,0,0,17,nowin,win,plwin,beat,20,0,18,194,0.396907216,0.025773196,0.597938144,0,0.029452644
23508,69,23919,3,3,11,0,0,17,9,10,0,0,0,19,nowin,loss,beat,dlwin,0,10,6,194,0.365979381,0.030927835,0.515463918,0,0
23509,112,23919,11,10,0,0,0,21,9,10,0,0,0,19,win,win,plwin,beat,25,0,21,203,0.448275862,0.054187192,0.600985222,3,0.889576933
23510,72,23919,8,4,0,10,0,22,9,10,0,0,0,19,nowin,loss,bust,plbust,0,10,12,185,0.394594595,0.032432432,0.508108108,0,0.006763115
23511,62,23919,8,3,7,0,0,18,9,10,0,0,0,19,nowin,loss,beat,dlwin,0,10,11,178,0.370786517,0.028089888,0.54494382,0,0.008657722
23512,77,23919,10,10,0,0,0,20,9,10,0,0,0,19,nowin,win,plwin,beat,20,0,20,200,0.455,0.04,0.62,3,0.916252116
23513,57,23919,8,2,10,0,0,20,9,10,0,0,0,19,nowin,win,plwin,beat,20,0,10,192,0.46875,0.052083333,0.59375,3,0.907001181
23514,12,23920,5,2,2,10,0,19,10,8,0,0,0,18,nowin,win,plwin,beat,20,0,7,189,0.470899471,0.015873016,0.613756614,3,0.929171178
23515,100,23920,3,4,10,0,0,17,10,8,0,0,0,18,nowin,loss,beat,dlwin,0,10,7,190,0.452631579,0.036842105,0.594736842,3,0.888671154
23516,105,23920,4,9,0,3,1,17,10,8,0,0,0,18,nowin,loss,beat,dlwin,0,10,13,198,0.414141414,0.070707071,0.590909091,0,0.032889494
23517,100,23920,3,10,0,5,0,18,10,8,0,0,0,18,nowin,push,push,push,10,0,13,190,0.452631579,0.036842105,0.594736842,3,0.888671154
23518,149,23920,5,3,10,0,0,18,10,8,0,0,0,18,nowin,push,push,push,10,0,8,225,0.457777778,0.057777778,0.648888889,2,0.651965595
23519,47,23920,9,4,0,10,0,23,10,8,0,0,0,18,nowin,loss,bust,plbust,0,10,13,210,0.438095238,0.057142857,0.623809524,2,0.615868808
23520,89,23921,11,10,0,0,0,21,2,6,10,0,0,18,win,win,plwin,beat,25,0,21,212,0.537735849,0.047169811,0.594339623,3,0.990167191
23521,102,23921,6,8,0,0,0,14,2,6,10,0,0,18,nowin,loss,beat,dlwin,0,10,14,192,0.338541667,0.046875,0.5625,0,0.003306118
23522,115,23921,11,10,0,0,0,21,2,6,10,0,0,18,win,win,plwin,beat,25,0,21,194,0.427835052,0.041237113,0.592783505,2,0.583863602
23523,74,23921,2,10,0,10,0,22,2,6,10,0,0,18,nowin,loss,bust,plbust,0,10,12,209,0.411483254,0.04784689,0.531100478,0,0.017448125
23524,75,23921,8,2,10,0,0,20,2,6,10,0,0,18,nowin,win,plwin,beat,20,0,10,191,0.418848168,0.052356021,0.570680628,0,0.029344702
23525,94,23921,7,9,0,0,0,16,2,6,10,0,0,18,nowin,loss,beat,dlwin,0,10,16,183,0.43715847,0.043715847,0.540983607,1,0.290866892
23526,146,23922,6,9,0,0,0,15,2,7,2,10,0,21,nowin,loss,beat,dlwin,0,10,15,221,0.43438914,0.040723982,0.542986425,1,0.290190091
23527,7,23922,10,7,0,0,0,17,2,7,2,10,0,21,nowin,loss,beat,dlwin,0,10,17,183,0.442622951,0.06010929,0.62295082,2,0.619303341
23528,32,23922,10,3,0,0,0,13,2,7,2,10,0,21,nowin,loss,beat,dlwin,0,10,13,189,0.391534392,0.037037037,0.53968254,0,0.013579086
23529,85,23922,9,10,0,0,0,19,2,7,2,10,0,21,nowin,loss,beat,dlwin,0,10,19,195,0.41025641,0.066666667,0.594871795,0,0.03269711
23530,86,23922,11,10,0,0,0,21,2,7,2,10,0,21,win,push,push,push,10,0,21,196,0.454081633,0.040816327,0.591836735,3,0.887566443
23531,139,23922,2,2,10,0,0,14,2,7,2,10,0,21,nowin,loss,beat,dlwin,0,10,4,192,0.380208333,0.036458333,0.59375,0,0.023429169
23532,60,23923,10,9,0,0,0,19,10,3,3,8,0,24,nowin,win,dlbust,bust,20,0,19,227,0.418502203,0.022026432,0.559471366,0,0.026496258
23533,88,23923,8,10,0,0,0,18,10,3,3,8,0,24,nowin,win,dlbust,bust,20,0,18,206,0.466019417,0.033980583,0.54368932,1,0.309467903
23534,133,23923,5,4,11,0,0,20,10,3,3,8,0,24,nowin,win,dlbust,bust,20,0,9,201,0.47761194,0.064676617,0.611940299,3,0.935428111
23535,100,23923,10,5,0,4,0,19,10,3,3,8,0,24,nowin,win,dlbust,bust,20,0,15,190,0.452631579,0.036842105,0.594736842,3,0.888671154
23536,63,23923,9,10,0,0,0,19,10,3,3,8,0,24,nowin,win,dlbust,bust,20,0,19,216,0.467592593,0.037037037,0.62037037,3,0.931690496
23537,90,23923,6,9,0,8,0,23,10,3,3,8,0,24,nowin,loss,bust,plbust,0,10,15,201,0.447761194,0.049751244,0.60199005,3,0.889945023
23538,9,23924,10,10,0,0,0,20,10,10,0,0,0,20,nowin,push,push,push,10,0,20,194,0.37628866,0.015463918,0.541237113,0,0.009396796
23539,130,23924,8,5,0,2,2,17,10,10,0,0,0,20,nowin,loss,beat,dlwin,0,10,13,219,0.410958904,0.03652968,0.566210046,0,0.025888739
23540,59,23924,6,7,0,10,0,23,10,10,0,0,0,20,nowin,loss,bust,plbust,0,10,13,228,0.429824561,0.048245614,0.543859649,1,0.287885446
23541,18,23924,9,6,0,10,0,25,10,10,0,0,0,20,nowin,loss,bust,plbust,0,10,15,182,0.461538462,0.043956044,0.587912088,3,0.892649374
23542,5,23924,5,10,0,6,0,21,10,10,0,0,0,20,nowin,win,plwin,beat,20,0,15,203,0.42364532,0.02955665,0.596059113,2,0.582508076
23543,19,23924,10,10,0,0,0,20,10,10,0,0,0,20,nowin,push,push,push,10,0,20,237,0.41350211,0.054852321,0.628691983,2,0.597373826
23544,60,23925,8,6,0,0,0,14,6,9,10,0,0,25,nowin,win,dlbust,bust,20,0,14,227,0.418502203,0.022026432,0.559471366,0,0.026496258
23545,83,23925,10,7,0,0,0,17,6,9,10,0,0,25,nowin,win,dlbust,bust,20,0,17,193,0.424870466,0.051813472,0.678756477,2,0.644360335
23546,28,23925,9,10,0,0,0,19,6,9,10,0,0,25,nowin,win,dlbust,bust,20,0,19,199,0.422110553,0.045226131,0.542713568,1,0.282706618
23547,42,23925,8,10,0,0,0,18,6,9,10,0,0,25,nowin,win,dlbust,bust,20,0,18,212,0.443396226,0.051886792,0.570754717,1,0.309181312
23548,135,23925,8,3,4,0,0,15,6,9,10,0,0,25,nowin,win,dlbust,bust,20,0,11,179,0.391061453,0.067039106,0.586592179,0,0.024924662
23549,15,23925,6,6,0,0,0,12,6,9,10,0,0,25,nowin,win,dlbust,bust,20,0,12,212,0.410377358,0.051886792,0.561320755,0,0.024517408
23550,25,23926,11,10,0,0,0,21,4,7,10,0,0,21,win,push,push,push,10,0,21,190,0.463157895,0.063157895,0.536842105,1,0.304401563
23551,134,23926,10,3,0,0,0,13,4,7,10,0,0,21,nowin,loss,beat,dlwin,0,10,13,185,0.443243243,0.021621622,0.545945946,1,0.296939509
23552,30,23926,3,5,5,0,0,13,4,7,10,0,0,21,nowin,loss,beat,dlwin,0,10,8,206,0.393203883,0.033980583,0.601941748,0,0.029324648
23553,132,23926,10,4,0,0,0,14,4,7,10,0,0,21,nowin,loss,beat,dlwin,0,10,14,194,0.412371134,0.036082474,0.649484536,2,0.611633238
23554,133,23926,4,1,9,0,0,14,4,7,10,0,0,21,nowin,loss,beat,dlwin,0,10,5,201,0.47761194,0.064676617,0.611940299,3,0.935428111
23555,14,23926,2,11,3,0,0,16,4,7,10,0,0,21,nowin,loss,beat,dlwin,0,10,13,202,0.391089109,0.01980198,0.628712871,2,0.577264877
23556,83,23927,10,4,0,8,0,22,10,5,10,0,0,25,nowin,loss,bust,plbust,0,10,14,193,0.424870466,0.051813472,0.678756477,2,0.644360335
23557,62,23927,2,6,9,0,0,17,10,5,10,0,0,25,nowin,win,dlbust,bust,20,0,8,178,0.370786517,0.028089888,0.54494382,0,0.008657722
23558,147,23927,2,10,0,6,0,18,10,5,10,0,0,25,nowin,win,dlbust,bust,20,0,12,205,0.380487805,0.014634146,0.536585366,0,0.00951447
23559,128,23927,2,9,3,6,0,20,10,5,10,0,0,25,nowin,win,dlbust,bust,20,0,11,227,0.356828194,0.052863436,0.577092511,0,0.012352564
23560,109,23927,7,8,0,7,0,22,10,5,10,0,0,25,nowin,loss,bust,plbust,0,10,15,221,0.461538462,0.058823529,0.597285068,3,0.901830309
23561,79,23927,5,10,0,3,0,18,10,5,10,0,0,25,nowin,win,dlbust,bust,20,0,15,211,0.436018957,0.028436019,0.672985782,2,0.650131054
23562,94,23928,7,4,3,0,0,14,2,8,9,0,0,19,nowin,loss,beat,dlwin,0,10,11,183,0.43715847,0.043715847,0.540983607,1,0.290866892
23563,61,23928,3,10,0,0,0,13,2,8,9,0,0,19,nowin,loss,beat,dlwin,0,10,13,194,0.427835052,0.077319588,0.603092784,2,0.591437139
23564,131,23928,10,8,0,0,0,18,2,8,9,0,0,19,nowin,loss,beat,dlwin,0,10,18,217,0.410138249,0.069124424,0.543778802,0,0.02015021
23565,134,23928,11,8,0,0,0,19,2,8,9,0,0,19,nowin,push,push,push,10,0,19,185,0.443243243,0.021621622,0.545945946,1,0.296939509
23566,74,23928,10,10,0,0,0,20,2,8,9,0,0,19,nowin,win,plwin,beat,20,0,20,209,0.411483254,0.04784689,0.531100478,0,0.017448125
23567,112,23928,11,5,5,0,0,21,2,8,9,0,0,19,nowin,win,plwin,beat,20,0,16,203,0.448275862,0.054187192,0.600985222,3,0.889576933
23568,114,23929,7,10,0,0,0,17,2,10,6,0,0,18,nowin,loss,beat,dlwin,0,10,17,198,0.47979798,0.025252525,0.611111111,3,0.937232995
23569,99,23929,8,11,0,0,0,19,2,10,6,0,0,18,nowin,win,plwin,beat,20,0,19,207,0.47826087,0.062801932,0.637681159,3,0.961418446
23570,31,23929,2,5,10,0,0,17,2,10,6,0,0,18,nowin,loss,beat,dlwin,0,10,7,188,0.473404255,0.058510638,0.515957447,1,0.300306557
23571,6,23929,6,10,0,0,0,16,2,10,6,0,0,18,nowin,loss,beat,dlwin,0,10,16,191,0.439790576,0.047120419,0.581151832,1,0.31211505
23572,139,23929,10,2,0,10,0,22,2,10,6,0,0,18,nowin,loss,bust,plbust,0,10,12,192,0.380208333,0.036458333,0.59375,0,0.023429169
23573,108,23929,5,6,7,0,0,18,2,10,6,0,0,18,nowin,push,push,push,10,0,11,193,0.435233161,0.056994819,0.559585492,1,0.298824795
23574,138,23930,5,1,10,0,0,16,6,11,0,0,0,17,nowin,loss,beat,dlwin,0,10,6,190,0.442105263,0.047368421,0.610526316,2,0.609711065
23575,109,23930,7,8,0,0,0,15,6,11,0,0,0,17,nowin,loss,beat,dlwin,0,10,15,221,0.461538462,0.058823529,0.597285068,3,0.901830309
23576,12,23930,5,8,0,0,0,13,6,11,0,0,0,17,nowin,loss,beat,dlwin,0,10,13,189,0.470899471,0.015873016,0.613756614,3,0.929171178
23577,118,23930,2,2,10,0,0,14,6,11,0,0,0,17,nowin,loss,beat,dlwin,0,10,4,216,0.393518519,0.037037037,0.555555556,0,0.018059873
23578,111,23930,6,9,0,0,0,15,6,11,0,0,0,17,nowin,loss,beat,dlwin,0,10,15,180,0.433333333,0.055555556,0.611111111,2,0.602264492
23579,140,23930,6,4,4,0,0,14,6,11,0,0,0,17,nowin,loss,beat,dlwin,0,10,10,210,0.466666667,0.023809524,0.604761905,3,0.915293335
23580,77,23931,2,1,10,4,0,17,7,10,0,0,0,17,nowin,push,push,push,10,0,3,200,0.455,0.04,0.62,3,0.916252116
23581,10,23931,2,10,0,10,0,22,7,10,0,0,0,17,nowin,loss,bust,plbust,0,10,12,191,0.413612565,0.057591623,0.596858639,2,0.574087175
23582,138,23931,5,10,0,2,0,17,7,10,0,0,0,17,nowin,push,push,push,10,0,15,190,0.442105263,0.047368421,0.610526316,2,0.609711065
23583,66,23931,7,11,0,0,0,18,7,10,0,0,0,17,nowin,win,plwin,beat,20,0,18,217,0.456221198,0.064516129,0.626728111,3,0.924304367
23584,51,23931,10,11,0,0,0,21,7,10,0,0,0,17,win,win,plwin,beat,25,0,21,189,0.529100529,0.068783069,0.608465608,3,0.993665715
23585,64,23931,10,4,0,1,7,22,7,10,0,0,0,17,nowin,loss,bust,plbust,0,10,14,187,0.363636364,0.048128342,0.631016043,0,0.027594885
23586,86,23932,4,8,0,10,0,22,7,8,6,0,0,21,nowin,loss,bust,plbust,0,10,12,196,0.454081633,0.040816327,0.591836735,3,0.887566443
23587,95,23932,3,10,0,10,0,23,7,8,6,0,0,21,nowin,loss,bust,plbust,0,10,13,218,0.412844037,0.04587156,0.559633028,0,0.024842385
23588,14,23932,6,9,0,10,0,25,7,8,6,0,0,21,nowin,loss,bust,plbust,0,10,15,202,0.391089109,0.01980198,0.628712871,2,0.577264877
23589,92,23932,10,10,0,0,0,20,7,8,6,0,0,21,nowin,loss,beat,dlwin,0,10,20,186,0.446236559,0.059139785,0.564516129,1,0.307826125
23590,125,23932,2,4,9,7,0,22,7,8,6,0,0,21,nowin,loss,bust,plbust,0,10,6,219,0.438356164,0.050228311,0.575342466,1,0.308411257
23591,140,23932,10,10,0,0,0,20,7,8,6,0,0,21,nowin,loss,beat,dlwin,0,10,20,210,0.466666667,0.023809524,0.604761905,3,0.915293335
23592,42,23933,10,3,0,5,0,18,10,2,6,0,0,18,nowin,push,push,push,10,0,13,212,0.443396226,0.051886792,0.570754717,1,0.309181312
23593,45,23933,7,11,0,0,0,18,10,2,6,0,0,18,nowin,push,push,push,10,0,18,196,0.428571429,0.051020408,0.612244898,2,0.598821767
23594,10,23933,3,10,0,10,0,23,10,2,6,0,0,18,nowin,loss,bust,plbust,0,10,13,191,0.413612565,0.057591623,0.596858639,2,0.574087175
23595,123,23933,9,9,0,0,0,18,10,2,6,0,0,18,nowin,push,push,push,10,0,18,205,0.43902439,0.034146341,0.614634146,2,0.609962544
23596,143,23933,10,9,0,0,0,19,10,2,6,0,0,18,nowin,win,plwin,beat,20,0,19,203,0.463054187,0.044334975,0.57635468,3,0.883143365
23597,26,23933,9,6,0,4,0,19,10,2,6,0,0,18,nowin,win,plwin,beat,20,0,15,203,0.463054187,0.0591133,0.541871921,1,0.306802864
23598,114,23934,4,9,0,7,0,20,8,10,0,0,0,18,nowin,win,plwin,beat,20,0,13,198,0.47979798,0.025252525,0.611111111,3,0.937232995
23599,65,23934,6,5,3,7,0,21,8,10,0,0,0,18,nowin,win,plwin,beat,20,0,11,203,0.492610837,0.054187192,0.571428571,3,0.913702814
23600,32,23934,10,2,0,10,0,22,8,10,0,0,0,18,nowin,loss,bust,plbust,0,10,12,189,0.391534392,0.037037037,0.53968254,0,0.013579086
23601,124,23934,3,7,4,6,0,20,8,10,0,0,0,18,nowin,win,plwin,beat,20,0,10,202,0.47029703,0.064356436,0.584158416,3,0.899458193
23602,27,23934,5,11,3,0,0,19,8,10,0,0,0,18,nowin,win,plwin,beat,20,0,16,178,0.370786517,0.016853933,0.573033708,0,0.015536309
23603,44,23934,10,5,0,4,0,19,8,10,0,0,0,18,nowin,win,plwin,beat,20,0,15,219,0.433789954,0.050228311,0.534246575,1,0.285551035
23604,59,23935,2,10,0,4,5,21,10,6,3,0,0,19,nowin,win,plwin,beat,20,0,12,228,0.429824561,0.048245614,0.543859649,1,0.287885446
23605,140,23935,4,7,4,10,0,25,10,6,3,0,0,19,nowin,loss,bust,plbust,0,10,11,210,0.466666667,0.023809524,0.604761905,3,0.915293335
23606,85,23935,10,7,0,0,0,17,10,6,3,0,0,19,nowin,loss,beat,dlwin,0,10,17,195,0.41025641,0.066666667,0.594871795,0,0.03269711
23607,52,23935,10,6,0,2,0,18,10,6,3,0,0,19,nowin,loss,beat,dlwin,0,10,16,217,0.414746544,0.02764977,0.599078341,2,0.576736024
23608,8,23935,6,1,10,0,0,17,10,6,3,0,0,19,nowin,loss,beat,dlwin,0,10,7,181,0.44198895,0.071823204,0.596685083,2,0.599438402
23609,114,23935,1,1,10,10,0,22,10,6,3,0,0,19,nowin,loss,bust,plbust,0,10,2,198,0.47979798,0.025252525,0.611111111,3,0.937232995
23610,72,23936,6,9,0,3,0,18,10,5,3,0,0,18,nowin,push,push,push,10,0,15,185,0.394594595,0.032432432,0.508108108,0,0.006763115
23611,37,23936,11,4,5,0,0,20,10,5,3,0,0,18,nowin,win,plwin,beat,20,0,15,208,0.394230769,0.038461538,0.581730769,0,0.024682772
23612,97,23936,10,11,0,0,0,21,10,5,3,0,0,18,win,win,plwin,beat,25,0,21,182,0.450549451,0.06043956,0.692307692,2,0.677372279
23613,32,23936,6,6,0,10,0,22,10,5,3,0,0,18,nowin,loss,bust,plbust,0,10,12,189,0.391534392,0.037037037,0.53968254,0,0.013579086
23614,109,23936,10,10,0,0,0,20,10,5,3,0,0,18,nowin,win,plwin,beat,20,0,20,221,0.461538462,0.058823529,0.597285068,3,0.901830309
23615,22,23936,7,8,0,10,0,25,10,5,3,0,0,18,nowin,loss,bust,plbust,0,10,15,187,0.481283422,0.042780749,0.577540107,3,0.906128176
23616,45,23937,9,10,0,0,0,19,7,11,0,0,0,18,nowin,win,plwin,beat,20,0,19,196,0.428571429,0.051020408,0.612244898,2,0.598821767
23617,71,23937,10,5,0,9,0,24,7,11,0,0,0,18,nowin,loss,bust,plbust,0,10,15,193,0.352331606,0.046632124,0.585492228,0,0.013063661
23618,128,23937,8,10,0,0,0,18,7,11,0,0,0,18,nowin,push,push,push,10,0,18,227,0.356828194,0.052863436,0.577092511,0,0.012352564
23619,83,23937,4,7,3,1,10,25,7,11,0,0,0,18,nowin,loss,bust,plbust,0,10,11,193,0.424870466,0.051813472,0.678756477,2,0.644360335
23620,138,23937,4,1,7,5,0,17,7,11,0,0,0,18,nowin,loss,beat,dlwin,0,10,5,190,0.442105263,0.047368421,0.610526316,2,0.609711065
23621,119,23937,10,11,0,0,0,21,7,11,0,0,0,18,win,win,plwin,beat,25,0,21,190,0.405263158,0.068421053,0.515789474,0,0.011837158
23622,55,23938,7,10,0,0,0,17,5,7,9,0,0,21,nowin,loss,beat,dlwin,0,10,17,191,0.371727749,0.057591623,0.54973822,0,0.01011347
23623,25,23938,4,1,7,0,0,12,5,7,9,0,0,21,nowin,loss,beat,dlwin,0,10,5,190,0.463157895,0.063157895,0.536842105,1,0.304401563
23624,69,23938,11,10,0,0,0,21,5,7,9,0,0,21,win,push,push,push,10,0,21,194,0.365979381,0.030927835,0.515463918,0,0
23625,83,23938,7,11,0,0,0,18,5,7,9,0,0,21,nowin,loss,beat,dlwin,0,10,18,193,0.424870466,0.051813472,0.678756477,2,0.644360335
23626,8,23938,4,5,7,0,0,16,5,7,9,0,0,21,nowin,loss,beat,dlwin,0,10,9,181,0.44198895,0.071823204,0.596685083,2,0.599438402
23627,22,23938,2,8,10,0,0,20,5,7,9,0,0,21,nowin,loss,beat,dlwin,0,10,10,187,0.481283422,0.042780749,0.577540107,3,0.906128176
23628,41,23939,5,5,8,0,0,18,6,5,9,0,0,20,nowin,loss,beat,dlwin,0,10,10,192,0.364583333,0.036458333,0.520833333,0,0.00089702
23629,106,23939,1,5,10,0,0,16,6,5,9,0,0,20,nowin,loss,beat,dlwin,0,10,6,192,0.411458333,0.026041667,0.557291667,0,0.023854304
23630,82,23939,2,7,7,0,0,16,6,5,9,0,0,20,nowin,loss,beat,dlwin,0,10,9,225,0.408888889,0.075555556,0.577777778,0,0.028101874
23631,37,23939,10,9,0,0,0,19,6,5,9,0,0,20,nowin,loss,beat,dlwin,0,10,19,208,0.394230769,0.038461538,0.581730769,0,0.024682772
23632,112,23939,3,4,6,0,0,13,6,5,9,0,0,20,nowin,loss,beat,dlwin,0,10,7,203,0.448275862,0.054187192,0.600985222,3,0.889576933
23633,35,23939,10,10,0,0,0,20,6,5,9,0,0,20,nowin,push,push,push,10,0,20,202,0.410891089,0.044554455,0.633663366,2,0.598681573
23634,1,23940,7,10,0,0,0,17,6,8,3,0,0,17,nowin,push,push,push,10,0,17,197,0.406091371,0.025380711,0.649746193,2,0.606186955
23635,48,23940,8,10,0,0,0,18,6,8,3,0,0,17,nowin,win,plwin,beat,20,0,18,203,0.413793103,0.019704433,0.600985222,2,0.577280801
23636,9,23940,8,8,0,0,0,16,6,8,3,0,0,17,nowin,loss,beat,dlwin,0,10,16,194,0.37628866,0.015463918,0.541237113,0,0.009396796
23637,73,23940,9,7,0,0,0,16,6,8,3,0,0,17,nowin,loss,beat,dlwin,0,10,16,181,0.375690608,0.011049724,0.596685083,0,0.022795773
23638,123,23940,9,10,0,0,0,19,6,8,3,0,0,17,nowin,win,plwin,beat,20,0,19,205,0.43902439,0.034146341,0.614634146,2,0.609962544
23639,64,23940,7,11,0,0,0,18,6,8,3,0,0,17,nowin,win,plwin,beat,20,0,18,187,0.363636364,0.048128342,0.631016043,0,0.027594885
23640,12,23941,10,10,0,0,0,20,9,2,2,10,0,23,nowin,win,dlbust,bust,20,0,20,189,0.470899471,0.015873016,0.613756614,3,0.929171178
23641,141,23941,11,6,3,0,0,20,9,2,2,10,0,23,nowin,win,dlbust,bust,20,0,17,202,0.420792079,0.074257426,0.564356436,0,0.028377851
23642,23,23941,2,4,6,10,0,22,9,2,2,10,0,23,nowin,loss,bust,plbust,0,10,6,208,0.427884615,0.0625,0.552884615,1,0.29114424
23643,90,23941,4,10,0,4,0,18,9,2,2,10,0,23,nowin,win,dlbust,bust,20,0,14,201,0.447761194,0.049751244,0.60199005,3,0.889945023
23644,38,23941,10,11,0,0,0,21,9,2,2,10,0,23,win,win,dlbust,bust,25,0,21,202,0.361386139,0.03960396,0.564356436,0,0.010597953
23645,109,23941,10,10,0,0,0,20,9,2,2,10,0,23,nowin,win,dlbust,bust,20,0,20,221,0.461538462,0.058823529,0.597285068,3,0.901830309
23646,65,23942,2,5,8,0,0,15,4,10,8,0,0,22,nowin,win,dlbust,bust,20,0,7,203,0.492610837,0.054187192,0.571428571,3,0.913702814
23647,59,23942,4,9,0,0,0,13,4,10,8,0,0,22,nowin,win,dlbust,bust,20,0,13,228,0.429824561,0.048245614,0.543859649,1,0.287885446
23648,34,23942,10,6,0,0,0,16,4,10,8,0,0,22,nowin,win,dlbust,bust,20,0,16,202,0.5,0.079207921,0.618811881,3,0.968961434
23649,4,23942,4,7,10,0,0,21,4,10,8,0,0,22,nowin,win,dlbust,bust,20,0,11,217,0.460829493,0.036866359,0.562211982,1,0.315432839
23650,5,23942,7,5,0,0,0,12,4,10,8,0,0,22,nowin,win,dlbust,bust,20,0,12,203,0.42364532,0.02955665,0.596059113,2,0.582508076
23651,108,23942,4,2,10,0,0,16,4,10,8,0,0,22,nowin,win,dlbust,bust,20,0,6,193,0.435233161,0.056994819,0.559585492,1,0.298824795
23652,131,23943,8,10,0,0,0,18,10,8,0,0,0,18,nowin,push,push,push,10,0,18,217,0.410138249,0.069124424,0.543778802,0,0.02015021
23653,57,23943,2,2,6,10,0,20,10,8,0,0,0,18,nowin,win,plwin,beat,20,0,4,192,0.46875,0.052083333,0.59375,3,0.907001181
23654,93,23943,3,5,4,9,0,21,10,8,0,0,0,18,nowin,win,plwin,beat,20,0,8,175,0.485714286,0.051428571,0.548571429,1,0.323648091
23655,111,23943,10,8,0,0,0,18,10,8,0,0,0,18,nowin,push,push,push,10,0,18,180,0.433333333,0.055555556,0.611111111,2,0.602264492
23656,53,23943,11,10,0,0,0,21,10,8,0,0,0,18,win,win,plwin,beat,25,0,21,250,0.372,0.064,0.564,0,0.013687345
23657,39,23943,6,10,0,1,0,17,10,8,0,0,0,18,nowin,loss,beat,dlwin,0,10,16,191,0.429319372,0.062827225,0.57591623,0,0.033760763
23658,130,23944,10,4,0,10,0,24,10,8,0,0,0,18,nowin,loss,bust,plbust,0,10,14,219,0.410958904,0.03652968,0.566210046,0,0.025888739
23659,42,23944,4,10,0,8,0,22,10,8,0,0,0,18,nowin,loss,bust,plbust,0,10,14,212,0.443396226,0.051886792,0.570754717,1,0.309181312
23660,136,23944,9,10,0,0,0,19,10,8,0,0,0,18,nowin,win,plwin,beat,20,0,19,194,0.396907216,0.025773196,0.597938144,0,0.029452644
23661,31,23944,8,6,0,1,5,20,10,8,0,0,0,18,nowin,win,plwin,beat,20,0,14,188,0.473404255,0.058510638,0.515957447,1,0.300306557
23662,94,23944,8,10,0,0,0,18,10,8,0,0,0,18,nowin,push,push,push,10,0,18,183,0.43715847,0.043715847,0.540983607,1,0.290866892
23663,85,23944,7,5,0,10,0,22,10,8,0,0,0,18,nowin,loss,bust,plbust,0,10,12,195,0.41025641,0.066666667,0.594871795,0,0.03269711
23664,103,23945,2,10,0,5,0,17,2,10,8,0,0,20,nowin,loss,beat,dlwin,0,10,12,203,0.379310345,0.064039409,0.551724138,0,0.012869209
23665,96,23945,2,7,9,0,0,18,2,10,8,0,0,20,nowin,loss,beat,dlwin,0,10,9,190,0.468421053,0.057894737,0.584210526,3,0.897263354
23666,107,23945,11,10,0,0,0,21,2,10,8,0,0,20,win,win,plwin,beat,25,0,21,218,0.444954128,0.073394495,0.600917431,2,0.605210014
23667,43,23945,5,3,10,0,0,18,2,10,8,0,0,20,nowin,loss,beat,dlwin,0,10,8,192,0.40625,0.041666667,0.609375,2,0.576671372
23668,125,23945,10,8,0,0,0,18,2,10,8,0,0,20,nowin,loss,beat,dlwin,0,10,18,219,0.438356164,0.050228311,0.575342466,1,0.308411257
23669,46,23945,7,5,0,10,0,22,2,10,8,0,0,20,nowin,loss,bust,plbust,0,10,12,186,0.403225806,0.048387097,0.591397849,0,0.029742194
23670,132,23946,10,5,0,10,0,25,10,11,0,0,0,21,nowin,loss,bust,plbust,0,10,15,194,0.412371134,0.036082474,0.649484536,2,0.611633238
23671,10,23946,6,7,0,2,2,17,10,11,0,0,0,21,nowin,loss,beat,dlwin,0,10,13,191,0.413612565,0.057591623,0.596858639,2,0.574087175
23672,75,23946,8,5,0,8,0,21,10,11,0,0,0,21,nowin,push,push,push,10,0,13,191,0.418848168,0.052356021,0.570680628,0,0.029344702
23673,9,23946,5,10,0,8,0,23,10,11,0,0,0,21,nowin,loss,bust,plbust,0,10,15,194,0.37628866,0.015463918,0.541237113,0,0.009396796
23674,129,23946,8,4,0,5,0,17,10,11,0,0,0,21,nowin,loss,beat,dlwin,0,10,12,201,0.422885572,0.064676617,0.55721393,0,0.027255383
23675,40,23946,11,10,0,0,0,21,10,11,0,0,0,21,win,push,push,push,10,0,21,196,0.367346939,0.030612245,0.617346939,0,0.025358183
23676,136,23947,2,10,0,0,0,12,4,6,11,0,0,21,nowin,loss,beat,dlwin,0,10,12,194,0.396907216,0.025773196,0.597938144,0,0.029452644
23677,137,23947,1,3,8,0,0,12,4,6,11,0,0,21,nowin,loss,beat,dlwin,0,10,4,194,0.417525773,0.046391753,0.536082474,1,0.276714602
23678,35,23947,6,4,4,0,0,14,4,6,11,0,0,21,nowin,loss,beat,dlwin,0,10,10,202,0.410891089,0.044554455,0.633663366,2,0.598681573
23679,41,23947,3,6,3,0,0,12,4,6,11,0,0,21,nowin,loss,beat,dlwin,0,10,9,192,0.364583333,0.036458333,0.520833333,0,0.00089702
23680,3,23947,6,10,0,0,0,16,4,6,11,0,0,21,nowin,loss,beat,dlwin,0,10,16,190,0.431578947,0.026315789,0.542105263,1,0.288076384
23681,13,23947,7,10,0,0,0,17,4,6,11,0,0,21,nowin,loss,beat,dlwin,0,10,17,206,0.417475728,0.063106796,0.621359223,2,0.59555479
23682,38,23948,10,9,0,0,0,19,5,10,1,3,0,19,nowin,push,push,push,10,0,19,202,0.361386139,0.03960396,0.564356436,0,0.010597953
23683,4,23948,3,3,10,0,0,16,5,10,1,3,0,19,nowin,loss,beat,dlwin,0,10,6,217,0.460829493,0.036866359,0.562211982,1,0.315432839
23684,83,23948,7,8,0,0,0,15,5,10,1,3,0,19,nowin,loss,beat,dlwin,0,10,15,193,0.424870466,0.051813472,0.678756477,2,0.644360335
23685,141,23948,10,10,0,0,0,20,5,10,1,3,0,19,nowin,win,plwin,beat,20,0,20,202,0.420792079,0.074257426,0.564356436,0,0.028377851
23686,131,23948,10,10,0,0,0,20,5,10,1,3,0,19,nowin,win,plwin,beat,20,0,20,217,0.410138249,0.069124424,0.543778802,0,0.02015021
23687,142,23948,10,2,0,0,0,12,5,10,1,3,0,19,nowin,loss,beat,dlwin,0,10,12,211,0.417061611,0.047393365,0.526066351,1,0.271531309
23688,99,23949,4,10,0,3,0,17,8,3,1,1,1,14,nowin,win,plwin,beat,20,0,14,207,0.47826087,0.062801932,0.637681159,3,0.961418446
23689,121,23949,10,10,0,0,0,20,8,3,1,1,1,14,nowin,win,plwin,beat,20,0,20,195,0.456410256,0.025641026,0.512820513,1,0.288597791
23690,15,23949,10,6,0,10,0,26,8,3,1,1,1,14,nowin,loss,bust,plbust,0,10,16,212,0.410377358,0.051886792,0.561320755,0,0.024517408
23691,80,23949,2,6,4,6,0,18,8,3,1,1,1,14,nowin,win,plwin,beat,20,0,8,186,0.419354839,0.059139785,0.623655914,2,0.59892924
23692,65,23949,9,10,0,0,0,19,8,3,1,1,1,14,nowin,win,plwin,beat,20,0,19,203,0.492610837,0.054187192,0.571428571,3,0.913702814
23693,39,23949,3,5,11,0,0,19,8,3,1,1,1,14,nowin,win,plwin,beat,20,0,8,191,0.429319372,0.062827225,0.57591623,0,0.033760763
23694,62,23950,10,5,0,0,0,15,5,10,4,0,0,19,nowin,loss,beat,dlwin,0,10,15,178,0.370786517,0.028089888,0.54494382,0,0.008657722
23695,142,23950,7,2,7,0,0,16,5,10,4,0,0,19,nowin,loss,beat,dlwin,0,10,9,211,0.417061611,0.047393365,0.526066351,1,0.271531309
23696,85,23950,6,10,0,0,0,16,5,10,4,0,0,19,nowin,loss,beat,dlwin,0,10,16,195,0.41025641,0.066666667,0.594871795,0,0.03269711
23697,135,23950,2,1,10,0,0,13,5,10,4,0,0,19,nowin,loss,beat,dlwin,0,10,3,179,0.391061453,0.067039106,0.586592179,0,0.024924662
23698,36,23950,4,10,0,0,0,14,5,10,4,0,0,19,nowin,loss,beat,dlwin,0,10,14,229,0.445414847,0.056768559,0.655021834,2,0.645370571
23699,122,23950,7,11,0,0,0,18,5,10,4,0,0,19,nowin,loss,beat,dlwin,0,10,18,210,0.347619048,0.052380952,0.59047619,0,0.012873677
23700,95,23951,10,9,0,0,0,19,2,4,7,10,0,23,nowin,win,dlbust,bust,20,0,19,218,0.412844037,0.04587156,0.559633028,0,0.024842385
23701,42,23951,8,2,10,0,0,20,2,4,7,10,0,23,nowin,win,dlbust,bust,20,0,10,212,0.443396226,0.051886792,0.570754717,1,0.309181312
23702,72,23951,3,2,6,5,0,16,2,4,7,10,0,23,nowin,win,dlbust,bust,20,0,5,185,0.394594595,0.032432432,0.508108108,0,0.006763115
23703,87,23951,7,10,0,0,0,17,2,4,7,10,0,23,nowin,win,dlbust,bust,20,0,17,202,0.405940594,0.054455446,0.628712871,2,0.590599801
23704,138,23951,10,7,0,0,0,17,2,4,7,10,0,23,nowin,win,dlbust,bust,20,0,17,190,0.442105263,0.047368421,0.610526316,2,0.609711065
23705,72,23951,6,1,5,4,0,16,2,4,7,10,0,23,nowin,win,dlbust,bust,20,0,7,185,0.394594595,0.032432432,0.508108108,0,0.006763115
23706,127,23952,10,7,0,0,0,17,4,6,10,0,0,20,nowin,loss,beat,dlwin,0,10,17,201,0.402985075,0.029850746,0.60199005,0,0.032263937
23707,62,23952,5,4,3,0,0,12,4,6,10,0,0,20,nowin,loss,beat,dlwin,0,10,9,178,0.370786517,0.028089888,0.54494382,0,0.008657722
23708,8,23952,9,8,0,0,0,17,4,6,10,0,0,20,nowin,loss,beat,dlwin,0,10,17,181,0.44198895,0.071823204,0.596685083,2,0.599438402
23709,62,23952,7,7,0,0,0,14,4,6,10,0,0,20,nowin,loss,beat,dlwin,0,10,14,178,0.370786517,0.028089888,0.54494382,0,0.008657722
23710,101,23952,5,4,6,0,0,15,4,6,10,0,0,20,nowin,loss,beat,dlwin,0,10,9,205,0.424390244,0.068292683,0.63902439,2,0.614740646
23711,4,23952,11,7,0,0,0,18,4,6,10,0,0,20,nowin,loss,beat,dlwin,0,10,18,217,0.460829493,0.036866359,0.562211982,1,0.315432839
23712,138,23953,7,3,3,8,0,21,8,5,3,10,0,26,nowin,win,dlbust,bust,20,0,10,190,0.442105263,0.047368421,0.610526316,2,0.609711065
23713,55,23953,11,10,0,0,0,21,8,5,3,10,0,26,win,win,dlbust,bust,25,0,21,191,0.371727749,0.057591623,0.54973822,0,0.01011347
23714,136,23953,8,10,0,0,0,18,8,5,3,10,0,26,nowin,win,dlbust,bust,20,0,18,194,0.396907216,0.025773196,0.597938144,0,0.029452644
23715,126,23953,10,11,0,0,0,21,8,5,3,10,0,26,win,win,dlbust,bust,25,0,21,188,0.457446809,0.074468085,0.60106383,3,0.900633203
23716,72,23953,2,6,10,0,0,18,8,5,3,10,0,26,nowin,win,dlbust,bust,20,0,8,185,0.394594595,0.032432432,0.508108108,0,0.006763115
23717,8,23953,4,9,0,7,0,20,8,5,3,10,0,26,nowin,win,dlbust,bust,20,0,13,181,0.44198895,0.071823204,0.596685083,2,0.599438402
23718,92,23954,10,9,0,0,0,19,2,10,10,0,0,22,nowin,win,dlbust,bust,20,0,19,186,0.446236559,0.059139785,0.564516129,1,0.307826125
23719,79,23954,7,11,0,0,0,18,2,10,10,0,0,22,nowin,win,dlbust,bust,20,0,18,211,0.436018957,0.028436019,0.672985782,2,0.650131054
23720,118,23954,8,2,10,0,0,20,2,10,10,0,0,22,nowin,win,dlbust,bust,20,0,10,216,0.393518519,0.037037037,0.555555556,0,0.018059873
23721,62,23954,10,10,0,0,0,20,2,10,10,0,0,22,nowin,win,dlbust,bust,20,0,20,178,0.370786517,0.028089888,0.54494382,0,0.008657722
23722,118,23954,10,3,0,0,0,13,2,10,10,0,0,22,nowin,win,dlbust,bust,20,0,13,216,0.393518519,0.037037037,0.555555556,0,0.018059873
23723,53,23954,6,10,0,0,0,16,2,10,10,0,0,22,nowin,win,dlbust,bust,20,0,16,250,0.372,0.064,0.564,0,0.013687345
23724,78,23955,5,7,0,4,3,19,9,5,10,0,0,24,nowin,win,dlbust,bust,20,0,12,201,0.517412935,0.034825871,0.587064677,3,0.95871112
23725,110,23955,3,10,0,2,8,23,9,5,10,0,0,24,nowin,loss,bust,plbust,0,10,13,192,0.416666667,0.046875,0.557291667,0,0.025413132
23726,109,23955,2,6,6,10,0,24,9,5,10,0,0,24,nowin,loss,bust,plbust,0,10,8,221,0.461538462,0.058823529,0.597285068,3,0.901830309
23727,11,23955,10,7,0,0,0,17,9,5,10,0,0,24,nowin,win,dlbust,bust,20,0,17,236,0.457627119,0.016949153,0.588983051,3,0.889015813
23728,1,23955,10,4,0,9,0,23,9,5,10,0,0,24,nowin,loss,bust,plbust,0,10,14,197,0.406091371,0.025380711,0.649746193,2,0.606186955
23729,115,23955,2,4,8,1,3,18,9,5,10,0,0,24,nowin,win,dlbust,bust,20,0,6,194,0.427835052,0.041237113,0.592783505,2,0.583863602
23730,10,23956,5,10,0,0,0,15,6,6,9,0,0,21,nowin,loss,beat,dlwin,0,10,15,191,0.413612565,0.057591623,0.596858639,2,0.574087175
23731,62,23956,7,11,0,0,0,18,6,6,9,0,0,21,nowin,loss,beat,dlwin,0,10,18,178,0.370786517,0.028089888,0.54494382,0,0.008657722
23732,97,23956,3,8,2,0,0,13,6,6,9,0,0,21,nowin,loss,beat,dlwin,0,10,11,182,0.450549451,0.06043956,0.692307692,2,0.677372279
23733,100,23956,8,2,10,0,0,20,6,6,9,0,0,21,nowin,loss,beat,dlwin,0,10,10,190,0.452631579,0.036842105,0.594736842,3,0.888671154
23734,83,23956,4,11,4,0,0,19,6,6,9,0,0,21,nowin,loss,beat,dlwin,0,10,15,193,0.424870466,0.051813472,0.678756477,2,0.644360335
23735,98,23956,4,4,10,0,0,18,6,6,9,0,0,21,nowin,loss,beat,dlwin,0,10,8,220,0.422727273,0.054545455,0.55,1,0.28664435
23736,12,23957,5,6,2,10,0,23,10,6,8,0,0,24,nowin,loss,bust,plbust,0,10,11,189,0.470899471,0.015873016,0.613756614,3,0.929171178
23737,116,23957,8,10,0,0,0,18,10,6,8,0,0,24,nowin,win,dlbust,bust,20,0,18,195,0.425641026,0.056410256,0.538461538,1,0.28273747
23738,142,23957,10,6,0,3,0,19,10,6,8,0,0,24,nowin,win,dlbust,bust,20,0,16,211,0.417061611,0.047393365,0.526066351,1,0.271531309
23739,72,23957,6,10,0,1,0,17,10,6,8,0,0,24,nowin,win,dlbust,bust,20,0,16,185,0.394594595,0.032432432,0.508108108,0,0.006763115
23740,72,23957,8,10,0,0,0,18,10,6,8,0,0,24,nowin,win,dlbust,bust,20,0,18,185,0.394594595,0.032432432,0.508108108,0,0.006763115
23741,65,23957,10,4,0,5,0,19,10,6,8,0,0,24,nowin,win,dlbust,bust,20,0,14,203,0.492610837,0.054187192,0.571428571,3,0.913702814
23742,12,23958,2,8,4,0,0,14,4,10,10,0,0,24,nowin,win,dlbust,bust,20,0,10,189,0.470899471,0.015873016,0.613756614,3,0.929171178
23743,104,23958,10,11,0,0,0,21,4,10,10,0,0,24,win,win,dlbust,bust,25,0,21,209,0.363636364,0.052631579,0.593301435,0,0.018359419
23744,42,23958,7,8,0,0,0,15,4,10,10,0,0,24,nowin,win,dlbust,bust,20,0,15,212,0.443396226,0.051886792,0.570754717,1,0.309181312
23745,49,23958,8,2,10,0,0,20,4,10,10,0,0,24,nowin,win,dlbust,bust,20,0,10,207,0.396135266,0.053140097,0.594202899,0,0.028306925
23746,6,23958,9,11,0,0,0,20,4,10,10,0,0,24,nowin,win,dlbust,bust,20,0,20,191,0.439790576,0.047120419,0.581151832,1,0.31211505
23747,144,23958,9,10,0,0,0,19,4,10,10,0,0,24,nowin,win,dlbust,bust,20,0,19,202,0.386138614,0.054455446,0.564356436,0,0.018006244
23748,138,23959,11,10,0,0,0,21,10,8,0,0,0,18,win,win,plwin,beat,25,0,21,190,0.442105263,0.047368421,0.610526316,2,0.609711065
23749,54,23959,4,2,5,10,0,21,10,8,0,0,0,18,nowin,win,plwin,beat,20,0,6,185,0.437837838,0.032432432,0.556756757,1,0.29899854
23750,43,23959,10,10,0,0,0,20,10,8,0,0,0,18,nowin,win,plwin,beat,20,0,20,192,0.40625,0.041666667,0.609375,2,0.576671372
23751,21,23959,10,11,0,0,0,21,10,8,0,0,0,18,win,win,plwin,beat,25,0,21,214,0.359813084,0.042056075,0.626168224,0,0.025263474
23752,43,23959,2,6,5,1,5,19,10,8,0,0,0,18,nowin,win,plwin,beat,20,0,8,192,0.40625,0.041666667,0.609375,2,0.576671372
23753,148,23959,2,9,10,0,0,21,10,8,0,0,0,18,nowin,win,plwin,beat,20,0,11,204,0.401960784,0.078431373,0.593137255,0,0.029789521
23754,127,23960,2,3,10,3,0,18,10,10,0,0,0,20,nowin,loss,beat,dlwin,0,10,5,201,0.402985075,0.029850746,0.60199005,0,0.032263937
23755,95,23960,6,6,0,1,10,23,10,10,0,0,0,20,nowin,loss,bust,plbust,0,10,12,218,0.412844037,0.04587156,0.559633028,0,0.024842385
23756,50,23960,10,5,0,3,0,18,10,10,0,0,0,20,nowin,loss,beat,dlwin,0,10,15,202,0.405940594,0.04950495,0.54950495,0,0.020296079
23757,31,23960,3,10,0,10,0,23,10,10,0,0,0,20,nowin,loss,bust,plbust,0,10,13,188,0.473404255,0.058510638,0.515957447,1,0.300306557
23758,43,23960,4,9,0,8,0,21,10,10,0,0,0,20,nowin,win,plwin,beat,20,0,13,192,0.40625,0.041666667,0.609375,2,0.576671372
23759,31,23960,10,3,0,2,10,25,10,10,0,0,0,20,nowin,loss,bust,plbust,0,10,13,188,0.473404255,0.058510638,0.515957447,1,0.300306557
23760,111,23961,10,5,0,0,0,15,3,9,10,0,0,22,nowin,win,dlbust,bust,20,0,15,180,0.433333333,0.055555556,0.611111111,2,0.602264492
23761,114,23961,9,10,0,0,0,19,3,9,10,0,0,22,nowin,win,dlbust,bust,20,0,19,198,0.47979798,0.025252525,0.611111111,3,0.937232995
23762,61,23961,4,5,2,3,0,14,3,9,10,0,0,22,nowin,win,dlbust,bust,20,0,9,194,0.427835052,0.077319588,0.603092784,2,0.591437139
23763,2,23961,10,10,0,0,0,20,3,9,10,0,0,22,nowin,win,dlbust,bust,20,0,20,200,0.445,0.035,0.64,2,0.633962549
23764,87,23961,10,2,0,10,0,22,3,9,10,0,0,22,nowin,loss,bust,plbust,0,10,12,202,0.405940594,0.054455446,0.628712871,2,0.590599801
23765,19,23961,11,7,0,0,0,18,3,9,10,0,0,22,nowin,win,dlbust,bust,20,0,18,237,0.41350211,0.054852321,0.628691983,2,0.597373826
23766,53,23962,7,6,0,2,2,17,10,5,10,0,0,25,nowin,win,dlbust,bust,20,0,13,250,0.372,0.064,0.564,0,0.013687345
23767,142,23962,6,10,0,2,0,18,10,5,10,0,0,25,nowin,win,dlbust,bust,20,0,16,211,0.417061611,0.047393365,0.526066351,1,0.271531309
23768,39,23962,6,3,5,2,10,26,10,5,10,0,0,25,nowin,loss,bust,plbust,0,10,9,191,0.429319372,0.062827225,0.57591623,0,0.033760763
23769,101,23962,10,10,0,0,0,20,10,5,10,0,0,25,nowin,win,dlbust,bust,20,0,20,205,0.424390244,0.068292683,0.63902439,2,0.614740646
23770,146,23962,11,7,0,0,0,18,10,5,10,0,0,25,nowin,win,dlbust,bust,20,0,18,221,0.43438914,0.040723982,0.542986425,1,0.290190091
23771,88,23962,4,7,10,0,0,21,10,5,10,0,0,25,nowin,win,dlbust,bust,20,0,11,206,0.466019417,0.033980583,0.54368932,1,0.309467903
23772,101,23963,3,7,8,0,0,18,6,10,7,0,0,23,nowin,win,dlbust,bust,20,0,10,205,0.424390244,0.068292683,0.63902439,2,0.614740646
23773,48,23963,6,1,5,0,0,12,6,10,7,0,0,23,nowin,win,dlbust,bust,20,0,7,203,0.413793103,0.019704433,0.600985222,2,0.577280801
23774,100,23963,4,11,5,0,0,20,6,10,7,0,0,23,nowin,win,dlbust,bust,20,0,15,190,0.452631579,0.036842105,0.594736842,3,0.888671154
23775,126,23963,10,11,0,0,0,21,6,10,7,0,0,23,win,win,dlbust,bust,25,0,21,188,0.457446809,0.074468085,0.60106383,3,0.900633203
23776,17,23963,6,6,0,0,0,12,6,10,7,0,0,23,nowin,win,dlbust,bust,20,0,12,171,0.444444444,0.070175439,0.555555556,1,0.302364894
23777,128,23963,2,10,0,0,0,12,6,10,7,0,0,23,nowin,win,dlbust,bust,20,0,12,227,0.356828194,0.052863436,0.577092511,0,0.012352564
23778,92,23964,9,8,0,0,0,17,10,7,0,0,0,17,nowin,push,push,push,10,0,17,186,0.446236559,0.059139785,0.564516129,1,0.307826125
23779,75,23964,10,10,0,0,0,20,10,7,0,0,0,17,nowin,win,plwin,beat,20,0,20,191,0.418848168,0.052356021,0.570680628,0,0.029344702
23780,63,23964,10,6,0,10,0,26,10,7,0,0,0,17,nowin,loss,bust,plbust,0,10,16,216,0.467592593,0.037037037,0.62037037,3,0.931690496
23781,138,23964,7,10,0,0,0,17,10,7,0,0,0,17,nowin,push,push,push,10,0,17,190,0.442105263,0.047368421,0.610526316,2,0.609711065
23782,65,23964,5,5,10,0,0,20,10,7,0,0,0,17,nowin,win,plwin,beat,20,0,10,203,0.492610837,0.054187192,0.571428571,3,0.913702814
23783,28,23964,8,10,0,0,0,18,10,7,0,0,0,17,nowin,win,plwin,beat,20,0,18,199,0.422110553,0.045226131,0.542713568,1,0.282706618
23784,30,23965,2,9,6,0,0,17,11,5,1,0,0,17,nowin,push,push,push,10,0,11,206,0.393203883,0.033980583,0.601941748,0,0.029324648
23785,34,23965,10,8,0,0,0,18,11,5,1,0,0,17,nowin,win,plwin,beat,20,0,18,202,0.5,0.079207921,0.618811881,3,0.968961434
23786,144,23965,11,10,0,0,0,21,11,5,1,0,0,17,win,win,plwin,beat,25,0,21,202,0.386138614,0.054455446,0.564356436,0,0.018006244
23787,136,23965,4,10,0,4,0,18,11,5,1,0,0,17,nowin,win,plwin,beat,20,0,14,194,0.396907216,0.025773196,0.597938144,0,0.029452644
23788,27,23965,10,5,0,9,0,24,11,5,1,0,0,17,nowin,loss,bust,plbust,0,10,15,178,0.370786517,0.016853933,0.573033708,0,0.015536309
23789,125,23965,10,10,0,0,0,20,11,5,1,0,0,17,nowin,win,plwin,beat,20,0,20,219,0.438356164,0.050228311,0.575342466,1,0.308411257
23790,13,23966,6,10,0,7,0,23,9,7,5,0,0,21,nowin,loss,bust,plbust,0,10,16,206,0.417475728,0.063106796,0.621359223,2,0.59555479
23791,23,23966,4,10,0,4,0,18,9,7,5,0,0,21,nowin,loss,beat,dlwin,0,10,14,208,0.427884615,0.0625,0.552884615,1,0.29114424
23792,136,23966,10,10,0,0,0,20,9,7,5,0,0,21,nowin,loss,beat,dlwin,0,10,20,194,0.396907216,0.025773196,0.597938144,0,0.029452644
23793,141,23966,4,10,0,10,0,24,9,7,5,0,0,21,nowin,loss,bust,plbust,0,10,14,202,0.420792079,0.074257426,0.564356436,0,0.028377851
23794,143,23966,2,3,5,3,8,21,9,7,5,0,0,21,nowin,push,push,push,10,0,5,203,0.463054187,0.044334975,0.57635468,3,0.883143365
23795,112,23966,10,11,0,0,0,21,9,7,5,0,0,21,win,push,push,push,10,0,21,203,0.448275862,0.054187192,0.600985222,3,0.889576933
23796,96,23967,2,10,0,0,0,12,4,3,5,6,0,18,nowin,loss,beat,dlwin,0,10,12,190,0.468421053,0.057894737,0.584210526,3,0.897263354
23797,37,23967,3,8,10,0,0,21,4,3,5,6,0,18,nowin,win,plwin,beat,20,0,11,208,0.394230769,0.038461538,0.581730769,0,0.024682772
23798,48,23967,6,10,0,0,0,16,4,3,5,6,0,18,nowin,loss,beat,dlwin,0,10,16,203,0.413793103,0.019704433,0.600985222,2,0.577280801
23799,30,23967,3,7,6,0,0,16,4,3,5,6,0,18,nowin,loss,beat,dlwin,0,10,10,206,0.393203883,0.033980583,0.601941748,0,0.029324648
23800,124,23967,4,3,7,0,0,14,4,3,5,6,0,18,nowin,loss,beat,dlwin,0,10,7,202,0.47029703,0.064356436,0.584158416,3,0.899458193
23801,98,23967,3,10,0,0,0,13,4,3,5,6,0,18,nowin,loss,beat,dlwin,0,10,13,220,0.422727273,0.054545455,0.55,1,0.28664435
23802,135,23968,3,10,0,0,0,13,4,10,8,0,0,22,nowin,win,dlbust,bust,20,0,13,179,0.391061453,0.067039106,0.586592179,0,0.024924662
23803,146,23968,10,3,0,0,0,13,4,10,8,0,0,22,nowin,win,dlbust,bust,20,0,13,221,0.43438914,0.040723982,0.542986425,1,0.290190091
23804,8,23968,4,9,0,0,0,13,4,10,8,0,0,22,nowin,win,dlbust,bust,20,0,13,181,0.44198895,0.071823204,0.596685083,2,0.599438402
23805,60,23968,10,3,0,0,0,13,4,10,8,0,0,22,nowin,win,dlbust,bust,20,0,13,227,0.418502203,0.022026432,0.559471366,0,0.026496258
23806,81,23968,8,10,0,0,0,18,4,10,8,0,0,22,nowin,win,dlbust,bust,20,0,18,182,0.395604396,0.043956044,0.60989011,2,0.567491261
23807,57,23968,10,11,0,0,0,21,4,10,8,0,0,22,win,win,dlbust,bust,25,0,21,192,0.46875,0.052083333,0.59375,3,0.907001181
23808,148,23969,10,10,0,0,0,20,8,10,0,0,0,18,nowin,win,plwin,beat,20,0,20,204,0.401960784,0.078431373,0.593137255,0,0.029789521
23809,132,23969,7,8,0,10,0,25,8,10,0,0,0,18,nowin,loss,bust,plbust,0,10,15,194,0.412371134,0.036082474,0.649484536,2,0.611633238
23810,18,23969,10,4,0,4,0,18,8,10,0,0,0,18,nowin,push,push,push,10,0,14,182,0.461538462,0.043956044,0.587912088,3,0.892649374
23811,137,23969,6,5,7,0,0,18,8,10,0,0,0,18,nowin,push,push,push,10,0,11,194,0.417525773,0.046391753,0.536082474,1,0.276714602
23812,61,23969,7,10,0,0,0,17,8,10,0,0,0,18,nowin,loss,beat,dlwin,0,10,17,194,0.427835052,0.077319588,0.603092784,2,0.591437139
23813,138,23969,10,8,0,0,0,18,8,10,0,0,0,18,nowin,push,push,push,10,0,18,190,0.442105263,0.047368421,0.610526316,2,0.609711065
23814,13,23970,3,3,10,10,0,26,7,7,10,0,0,24,nowin,loss,bust,plbust,0,10,6,206,0.417475728,0.063106796,0.621359223,2,0.59555479
23815,148,23970,11,10,0,0,0,21,7,7,10,0,0,24,win,win,dlbust,bust,25,0,21,204,0.401960784,0.078431373,0.593137255,0,0.029789521
23816,65,23970,10,4,0,1,4,19,7,7,10,0,0,24,nowin,win,dlbust,bust,20,0,14,203,0.492610837,0.054187192,0.571428571,3,0.913702814
23817,105,23970,1,6,5,8,0,20,7,7,10,0,0,24,nowin,win,dlbust,bust,20,0,7,198,0.414141414,0.070707071,0.590909091,0,0.032889494
23818,97,23970,10,11,0,0,0,21,7,7,10,0,0,24,win,win,dlbust,bust,25,0,21,182,0.450549451,0.06043956,0.692307692,2,0.677372279
23819,53,23970,10,11,0,0,0,21,7,7,10,0,0,24,win,win,dlbust,bust,25,0,21,250,0.372,0.064,0.564,0,0.013687345
23820,59,23971,6,3,7,0,0,16,5,7,4,10,0,26,nowin,win,dlbust,bust,20,0,9,228,0.429824561,0.048245614,0.543859649,1,0.287885446
23821,4,23971,10,2,0,0,0,12,5,7,4,10,0,26,nowin,win,dlbust,bust,20,0,12,217,0.460829493,0.036866359,0.562211982,1,0.315432839
23822,56,23971,4,6,10,0,0,20,5,7,4,10,0,26,nowin,win,dlbust,bust,20,0,10,175,0.4,0.057142857,0.582857143,0,0.026685297
23823,43,23971,6,3,3,0,0,12,5,7,4,10,0,26,nowin,win,dlbust,bust,20,0,9,192,0.40625,0.041666667,0.609375,2,0.576671372
23824,125,23971,3,4,5,0,0,12,5,7,4,10,0,26,nowin,win,dlbust,bust,20,0,7,219,0.438356164,0.050228311,0.575342466,1,0.308411257
23825,60,23971,9,3,0,0,0,12,5,7,4,10,0,26,nowin,win,dlbust,bust,20,0,12,227,0.418502203,0.022026432,0.559471366,0,0.026496258
23826,103,23972,3,10,0,1,10,24,10,10,0,0,0,20,nowin,loss,bust,plbust,0,10,13,203,0.379310345,0.064039409,0.551724138,0,0.012869209
23827,130,23972,8,11,0,0,0,19,10,10,0,0,0,20,nowin,loss,beat,dlwin,0,10,19,219,0.410958904,0.03652968,0.566210046,0,0.025888739
23828,58,23972,7,7,0,10,0,24,10,10,0,0,0,20,nowin,loss,bust,plbust,0,10,14,195,0.430769231,0.041025641,0.584615385,2,0.580497586
23829,11,23972,10,6,0,7,0,23,10,10,0,0,0,20,nowin,loss,bust,plbust,0,10,16,236,0.457627119,0.016949153,0.588983051,3,0.889015813
23830,45,23972,10,11,0,0,0,21,10,10,0,0,0,20,win,win,plwin,beat,25,0,21,196,0.428571429,0.051020408,0.612244898,2,0.598821767
23831,137,23972,8,10,0,0,0,18,10,10,0,0,0,20,nowin,loss,beat,dlwin,0,10,18,194,0.417525773,0.046391753,0.536082474,1,0.276714602
23832,44,23973,8,4,0,4,4,20,10,3,3,2,0,18,nowin,win,plwin,beat,20,0,12,219,0.433789954,0.050228311,0.534246575,1,0.285551035
23833,9,23973,9,9,0,0,0,18,10,3,3,2,0,18,nowin,push,push,push,10,0,18,194,0.37628866,0.015463918,0.541237113,0,0.009396796
23834,134,23973,10,4,0,4,0,18,10,3,3,2,0,18,nowin,push,push,push,10,0,14,185,0.443243243,0.021621622,0.545945946,1,0.296939509
23835,113,23973,7,10,0,0,0,17,10,3,3,2,0,18,nowin,loss,beat,dlwin,0,10,17,199,0.407035176,0.055276382,0.668341709,2,0.620695264
23836,42,23973,5,10,0,6,0,21,10,3,3,2,0,18,nowin,win,plwin,beat,20,0,15,212,0.443396226,0.051886792,0.570754717,1,0.309181312
23837,138,23973,10,6,0,4,0,20,10,3,3,2,0,18,nowin,win,plwin,beat,20,0,16,190,0.442105263,0.047368421,0.610526316,2,0.609711065
23838,33,23974,10,5,0,7,0,22,7,10,0,0,0,17,nowin,loss,bust,plbust,0,10,15,192,0.4375,0.057291667,0.625,2,0.616208916
23839,111,23974,10,9,0,0,0,19,7,10,0,0,0,17,nowin,win,plwin,beat,20,0,19,180,0.433333333,0.055555556,0.611111111,2,0.602264492
23840,39,23974,7,9,0,10,0,26,7,10,0,0,0,17,nowin,loss,bust,plbust,0,10,16,191,0.429319372,0.062827225,0.57591623,0,0.033760763
23841,51,23974,2,10,0,6,0,18,7,10,0,0,0,17,nowin,win,plwin,beat,20,0,12,189,0.529100529,0.068783069,0.608465608,3,0.993665715
23842,94,23974,7,11,0,0,0,18,7,10,0,0,0,17,nowin,win,plwin,beat,20,0,18,183,0.43715847,0.043715847,0.540983607,1,0.290866892
23843,70,23974,3,4,10,0,0,17,7,10,0,0,0,17,nowin,push,push,push,10,0,7,228,0.385964912,0.039473684,0.557017544,0,0.016157125
23844,99,23975,2,10,0,9,0,21,10,5,7,0,0,22,nowin,win,dlbust,bust,20,0,12,207,0.47826087,0.062801932,0.637681159,3,0.961418446
23845,105,23975,10,4,0,8,0,22,10,5,7,0,0,22,nowin,loss,bust,plbust,0,10,14,198,0.414141414,0.070707071,0.590909091,0,0.032889494
23846,114,23975,10,10,0,0,0,20,10,5,7,0,0,22,nowin,win,dlbust,bust,20,0,20,198,0.47979798,0.025252525,0.611111111,3,0.937232995
23847,112,23975,10,10,0,0,0,20,10,5,7,0,0,22,nowin,win,dlbust,bust,20,0,20,203,0.448275862,0.054187192,0.600985222,3,0.889576933
23848,150,23975,10,7,0,0,0,17,10,5,7,0,0,22,nowin,win,dlbust,bust,20,0,17,192,0.401041667,0.036458333,0.567708333,0,0.023287458
23849,71,23975,5,3,11,0,0,19,10,5,7,0,0,22,nowin,win,dlbust,bust,20,0,8,193,0.352331606,0.046632124,0.585492228,0,0.013063661
23850,65,23976,8,7,0,3,0,18,9,10,0,0,0,19,nowin,loss,beat,dlwin,0,10,15,203,0.492610837,0.054187192,0.571428571,3,0.913702814
23851,59,23976,5,4,2,10,0,21,9,10,0,0,0,19,nowin,win,plwin,beat,20,0,9,228,0.429824561,0.048245614,0.543859649,1,0.287885446
23852,13,23976,3,7,11,0,0,21,9,10,0,0,0,19,nowin,win,plwin,beat,20,0,10,206,0.417475728,0.063106796,0.621359223,2,0.59555479
23853,13,23976,11,3,6,0,0,20,9,10,0,0,0,19,nowin,win,plwin,beat,20,0,14,206,0.417475728,0.063106796,0.621359223,2,0.59555479
23854,106,23976,9,11,0,0,0,20,9,10,0,0,0,19,nowin,win,plwin,beat,20,0,20,192,0.411458333,0.026041667,0.557291667,0,0.023854304
23855,24,23976,10,7,0,0,0,17,9,10,0,0,0,19,nowin,loss,beat,dlwin,0,10,17,207,0.458937198,0.048309179,0.570048309,1,0.318138014
23856,99,23977,8,3,8,0,0,19,7,2,5,8,0,22,nowin,win,dlbust,bust,20,0,11,207,0.47826087,0.062801932,0.637681159,3,0.961418446
23857,136,23977,4,10,0,1,1,16,7,2,5,8,0,22,nowin,win,dlbust,bust,20,0,14,194,0.396907216,0.025773196,0.597938144,0,0.029452644
23858,69,23977,10,6,0,2,0,18,7,2,5,8,0,22,nowin,win,dlbust,bust,20,0,16,194,0.365979381,0.030927835,0.515463918,0,0
23859,1,23977,9,5,0,6,0,20,7,2,5,8,0,22,nowin,win,dlbust,bust,20,0,14,197,0.406091371,0.025380711,0.649746193,2,0.606186955
23860,11,23977,10,2,0,2,4,18,7,2,5,8,0,22,nowin,win,dlbust,bust,20,0,12,236,0.457627119,0.016949153,0.588983051,3,0.889015813
23861,130,23977,6,2,4,10,0,22,7,2,5,8,0,22,nowin,loss,bust,plbust,0,10,8,219,0.410958904,0.03652968,0.566210046,0,0.025888739
23862,128,23978,7,9,0,4,0,20,10,6,4,0,0,20,nowin,push,push,push,10,0,16,227,0.356828194,0.052863436,0.577092511,0,0.012352564
23863,144,23978,11,10,0,0,0,21,10,6,4,0,0,20,win,win,plwin,beat,25,0,21,202,0.386138614,0.054455446,0.564356436,0,0.018006244
23864,57,23978,2,6,7,10,0,25,10,6,4,0,0,20,nowin,loss,bust,plbust,0,10,8,192,0.46875,0.052083333,0.59375,3,0.907001181
23865,136,23978,2,7,6,2,0,17,10,6,4,0,0,20,nowin,loss,beat,dlwin,0,10,9,194,0.396907216,0.025773196,0.597938144,0,0.029452644
23866,138,23978,9,8,0,0,0,17,10,6,4,0,0,20,nowin,loss,beat,dlwin,0,10,17,190,0.442105263,0.047368421,0.610526316,2,0.609711065
23867,124,23978,6,10,0,10,0,26,10,6,4,0,0,20,nowin,loss,bust,plbust,0,10,16,202,0.47029703,0.064356436,0.584158416,3,0.899458193
23868,29,23979,11,3,7,0,0,21,8,8,3,0,0,19,nowin,win,plwin,beat,20,0,14,189,0.44973545,0.058201058,0.544973545,1,0.300349439
23869,102,23979,1,3,10,8,0,22,8,8,3,0,0,19,nowin,loss,bust,plbust,0,10,4,192,0.338541667,0.046875,0.5625,0,0.003306118
23870,145,23979,9,2,9,0,0,20,8,8,3,0,0,19,nowin,win,plwin,beat,20,0,11,188,0.441489362,0.031914894,0.622340426,2,0.617837093
23871,77,23979,3,4,4,10,0,21,8,8,3,0,0,19,nowin,win,plwin,beat,20,0,7,200,0.455,0.04,0.62,3,0.916252116
23872,62,23979,3,10,0,5,0,18,8,8,3,0,0,19,nowin,loss,beat,dlwin,0,10,13,178,0.370786517,0.028089888,0.54494382,0,0.008657722
23873,40,23979,4,10,0,4,0,18,8,8,3,0,0,19,nowin,loss,beat,dlwin,0,10,14,196,0.367346939,0.030612245,0.617346939,0,0.025358183
23874,122,23980,11,10,0,0,0,21,8,9,0,0,0,17,win,win,plwin,beat,25,0,21,210,0.347619048,0.052380952,0.59047619,0,0.012873677
23875,121,23980,10,5,0,8,0,23,8,9,0,0,0,17,nowin,loss,bust,plbust,0,10,15,195,0.456410256,0.025641026,0.512820513,1,0.288597791
23876,80,23980,3,3,2,10,0,18,8,9,0,0,0,17,nowin,win,plwin,beat,20,0,6,186,0.419354839,0.059139785,0.623655914,2,0.59892924
23877,68,23980,3,6,10,0,0,19,8,9,0,0,0,17,nowin,win,plwin,beat,20,0,9,205,0.434146341,0.029268293,0.6,2,0.59483189
23878,111,23980,11,7,0,0,0,18,8,9,0,0,0,17,nowin,win,plwin,beat,20,0,18,180,0.433333333,0.055555556,0.611111111,2,0.602264492
23879,65,23980,10,5,0,2,0,17,8,9,0,0,0,17,nowin,push,push,push,10,0,15,203,0.492610837,0.054187192,0.571428571,3,0.913702814
23880,70,23981,10,11,0,0,0,21,3,8,10,0,0,21,win,push,push,push,10,0,21,228,0.385964912,0.039473684,0.557017544,0,0.016157125
23881,150,23981,7,7,0,0,0,14,3,8,10,0,0,21,nowin,loss,beat,dlwin,0,10,14,192,0.401041667,0.036458333,0.567708333,0,0.023287458
23882,14,23981,10,9,0,0,0,19,3,8,10,0,0,21,nowin,loss,beat,dlwin,0,10,19,202,0.391089109,0.01980198,0.628712871,2,0.577264877
23883,60,23981,5,10,0,0,0,15,3,8,10,0,0,21,nowin,loss,beat,dlwin,0,10,15,227,0.418502203,0.022026432,0.559471366,0,0.026496258
23884,79,23981,10,10,0,0,0,20,3,8,10,0,0,21,nowin,loss,beat,dlwin,0,10,20,211,0.436018957,0.028436019,0.672985782,2,0.650131054
23885,19,23981,3,10,0,0,0,13,3,8,10,0,0,21,nowin,loss,beat,dlwin,0,10,13,237,0.41350211,0.054852321,0.628691983,2,0.597373826
23886,94,23982,2,10,0,7,0,19,10,2,3,8,0,23,nowin,win,dlbust,bust,20,0,12,183,0.43715847,0.043715847,0.540983607,1,0.290866892
23887,80,23982,9,7,0,2,0,18,10,2,3,8,0,23,nowin,win,dlbust,bust,20,0,16,186,0.419354839,0.059139785,0.623655914,2,0.59892924
23888,64,23982,10,6,0,9,0,25,10,2,3,8,0,23,nowin,loss,bust,plbust,0,10,16,187,0.363636364,0.048128342,0.631016043,0,0.027594885
23889,13,23982,5,2,6,7,0,20,10,2,3,8,0,23,nowin,win,dlbust,bust,20,0,7,206,0.417475728,0.063106796,0.621359223,2,0.59555479
23890,118,23982,2,10,0,2,4,18,10,2,3,8,0,23,nowin,win,dlbust,bust,20,0,12,216,0.393518519,0.037037037,0.555555556,0,0.018059873
23891,92,23982,10,2,0,7,0,19,10,2,3,8,0,23,nowin,win,dlbust,bust,20,0,12,186,0.446236559,0.059139785,0.564516129,1,0.307826125
23892,71,23983,5,4,4,5,0,18,10,2,10,0,0,22,nowin,win,dlbust,bust,20,0,9,193,0.352331606,0.046632124,0.585492228,0,0.013063661
23893,107,23983,7,5,0,10,0,22,10,2,10,0,0,22,nowin,loss,bust,plbust,0,10,12,218,0.444954128,0.073394495,0.600917431,2,0.605210014
23894,142,23983,11,1,8,0,0,20,10,2,10,0,0,22,nowin,win,dlbust,bust,20,0,12,211,0.417061611,0.047393365,0.526066351,1,0.271531309
23895,11,23983,7,3,7,0,0,17,10,2,10,0,0,22,nowin,win,dlbust,bust,20,0,10,236,0.457627119,0.016949153,0.588983051,3,0.889015813
23896,143,23983,10,4,0,5,0,19,10,2,10,0,0,22,nowin,win,dlbust,bust,20,0,14,203,0.463054187,0.044334975,0.57635468,3,0.883143365
23897,49,23983,1,6,6,2,7,22,10,2,10,0,0,22,nowin,loss,bust,plbust,0,10,7,207,0.396135266,0.053140097,0.594202899,0,0.028306925
23898,74,23984,3,10,0,10,0,23,10,6,10,0,0,26,nowin,loss,bust,plbust,0,10,13,209,0.411483254,0.04784689,0.531100478,0,0.017448125
23899,150,23984,10,10,0,0,0,20,10,6,10,0,0,26,nowin,win,dlbust,bust,20,0,20,192,0.401041667,0.036458333,0.567708333,0,0.023287458
23900,148,23984,4,4,8,10,0,26,10,6,10,0,0,26,nowin,loss,bust,plbust,0,10,8,204,0.401960784,0.078431373,0.593137255,0,0.029789521
23901,103,23984,2,7,2,1,2,14,10,6,10,0,0,26,nowin,win,dlbust,bust,20,0,9,203,0.379310345,0.064039409,0.551724138,0,0.012869209
23902,125,23984,10,10,0,0,0,20,10,6,10,0,0,26,nowin,win,dlbust,bust,20,0,20,219,0.438356164,0.050228311,0.575342466,1,0.308411257
23903,68,23984,2,11,2,5,0,20,10,6,10,0,0,26,nowin,win,dlbust,bust,20,0,13,205,0.434146341,0.029268293,0.6,2,0.59483189
23904,2,23985,10,10,0,0,0,20,9,6,10,0,0,25,nowin,win,dlbust,bust,20,0,20,200,0.445,0.035,0.64,2,0.633962549
23905,48,23985,8,5,0,5,0,18,9,6,10,0,0,25,nowin,win,dlbust,bust,20,0,13,203,0.413793103,0.019704433,0.600985222,2,0.577280801
23906,42,23985,9,9,0,0,0,18,9,6,10,0,0,25,nowin,win,dlbust,bust,20,0,18,212,0.443396226,0.051886792,0.570754717,1,0.309181312
23907,150,23985,7,6,0,10,0,23,9,6,10,0,0,25,nowin,loss,bust,plbust,0,10,13,192,0.401041667,0.036458333,0.567708333,0,0.023287458
23908,135,23985,11,10,0,0,0,21,9,6,10,0,0,25,win,win,dlbust,bust,25,0,21,179,0.391061453,0.067039106,0.586592179,0,0.024924662
23909,65,23985,8,2,3,10,0,23,9,6,10,0,0,25,nowin,loss,bust,plbust,0,10,10,203,0.492610837,0.054187192,0.571428571,3,0.913702814
23910,29,23986,8,2,8,0,0,18,10,3,10,0,0,23,nowin,win,dlbust,bust,20,0,10,189,0.44973545,0.058201058,0.544973545,1,0.300349439
23911,111,23986,6,8,0,10,0,24,10,3,10,0,0,23,nowin,loss,bust,plbust,0,10,14,180,0.433333333,0.055555556,0.611111111,2,0.602264492
23912,31,23986,11,10,0,0,0,21,10,3,10,0,0,23,win,win,dlbust,bust,25,0,21,188,0.473404255,0.058510638,0.515957447,1,0.300306557
23913,97,23986,10,10,0,0,0,20,10,3,10,0,0,23,nowin,win,dlbust,bust,20,0,20,182,0.450549451,0.06043956,0.692307692,2,0.677372279
23914,103,23986,2,9,4,7,0,22,10,3,10,0,0,23,nowin,loss,bust,plbust,0,10,11,203,0.379310345,0.064039409,0.551724138,0,0.012869209
23915,61,23986,3,10,0,10,0,23,10,3,10,0,0,23,nowin,loss,bust,plbust,0,10,13,194,0.427835052,0.077319588,0.603092784,2,0.591437139
23916,65,23987,2,1,10,3,2,18,7,6,8,0,0,21,nowin,loss,beat,dlwin,0,10,3,203,0.492610837,0.054187192,0.571428571,3,0.913702814
23917,25,23987,2,1,9,5,0,17,7,6,8,0,0,21,nowin,loss,beat,dlwin,0,10,3,190,0.463157895,0.063157895,0.536842105,1,0.304401563
23918,25,23987,10,6,0,10,0,26,7,6,8,0,0,21,nowin,loss,bust,plbust,0,10,16,190,0.463157895,0.063157895,0.536842105,1,0.304401563
23919,20,23987,10,5,0,10,0,25,7,6,8,0,0,21,nowin,loss,bust,plbust,0,10,15,186,0.456989247,0.037634409,0.537634409,1,0.301097108
23920,55,23987,10,10,0,0,0,20,7,6,8,0,0,21,nowin,loss,beat,dlwin,0,10,20,191,0.371727749,0.057591623,0.54973822,0,0.01011347
23921,131,23987,8,7,0,4,0,19,7,6,8,0,0,21,nowin,loss,beat,dlwin,0,10,15,217,0.410138249,0.069124424,0.543778802,0,0.02015021
23922,70,23988,6,3,9,0,0,18,2,4,10,3,0,19,nowin,loss,beat,dlwin,0,10,9,228,0.385964912,0.039473684,0.557017544,0,0.016157125
23923,95,23988,11,10,0,0,0,21,2,4,10,3,0,19,win,win,plwin,beat,25,0,21,218,0.412844037,0.04587156,0.559633028,0,0.024842385
23924,74,23988,5,3,10,0,0,18,2,4,10,3,0,19,nowin,loss,beat,dlwin,0,10,8,209,0.411483254,0.04784689,0.531100478,0,0.017448125
23925,133,23988,10,2,0,10,0,22,2,4,10,3,0,19,nowin,loss,bust,plbust,0,10,12,201,0.47761194,0.064676617,0.611940299,3,0.935428111
23926,52,23988,2,10,0,6,0,18,2,4,10,3,0,19,nowin,loss,beat,dlwin,0,10,12,217,0.414746544,0.02764977,0.599078341,2,0.576736024
23927,58,23988,9,11,0,0,0,20,2,4,10,3,0,19,nowin,win,plwin,beat,20,0,20,195,0.430769231,0.041025641,0.584615385,2,0.580497586
23928,8,23989,3,8,6,0,0,17,9,3,8,0,0,20,nowin,loss,beat,dlwin,0,10,11,181,0.44198895,0.071823204,0.596685083,2,0.599438402
23929,52,23989,7,4,5,2,0,18,9,3,8,0,0,20,nowin,loss,beat,dlwin,0,10,11,217,0.414746544,0.02764977,0.599078341,2,0.576736024
23930,112,23989,10,4,0,8,0,22,9,3,8,0,0,20,nowin,loss,bust,plbust,0,10,14,203,0.448275862,0.054187192,0.600985222,3,0.889576933
23931,121,23989,9,7,0,10,0,26,9,3,8,0,0,20,nowin,loss,bust,plbust,0,10,16,195,0.456410256,0.025641026,0.512820513,1,0.288597791
23932,33,23989,10,10,0,0,0,20,9,3,8,0,0,20,nowin,push,push,push,10,0,20,192,0.4375,0.057291667,0.625,2,0.616208916
23933,72,23989,10,5,0,10,0,25,9,3,8,0,0,20,nowin,loss,bust,plbust,0,10,15,185,0.394594595,0.032432432,0.508108108,0,0.006763115
23934,89,23990,10,3,0,0,0,13,6,10,10,0,0,26,nowin,win,dlbust,bust,20,0,13,212,0.537735849,0.047169811,0.594339623,3,0.990167191
23935,97,23990,4,4,10,0,0,18,6,10,10,0,0,26,nowin,win,dlbust,bust,20,0,8,182,0.450549451,0.06043956,0.692307692,2,0.677372279
23936,120,23990,8,11,0,0,0,19,6,10,10,0,0,26,nowin,win,dlbust,bust,20,0,19,202,0.440594059,0.034653465,0.618811881,2,0.614441029
23937,37,23990,2,10,0,0,0,12,6,10,10,0,0,26,nowin,win,dlbust,bust,20,0,12,208,0.394230769,0.038461538,0.581730769,0,0.024682772
23938,21,23990,10,5,0,0,0,15,6,10,10,0,0,26,nowin,win,dlbust,bust,20,0,15,214,0.359813084,0.042056075,0.626168224,0,0.025263474
23939,57,23990,9,2,10,0,0,21,6,10,10,0,0,26,nowin,win,dlbust,bust,20,0,11,192,0.46875,0.052083333,0.59375,3,0.907001181
23940,29,23991,5,5,11,0,0,21,9,3,10,0,0,22,nowin,win,dlbust,bust,20,0,10,189,0.44973545,0.058201058,0.544973545,1,0.300349439
23941,89,23991,10,10,0,0,0,20,9,3,10,0,0,22,nowin,win,dlbust,bust,20,0,20,212,0.537735849,0.047169811,0.594339623,3,0.990167191
23942,67,23991,11,10,0,0,0,21,9,3,10,0,0,22,win,win,dlbust,bust,25,0,21,195,0.369230769,0.041025641,0.569230769,0,0.014139427
23943,13,23991,1,2,10,7,0,20,9,3,10,0,0,22,nowin,win,dlbust,bust,20,0,3,206,0.417475728,0.063106796,0.621359223,2,0.59555479
23944,14,23991,9,4,0,10,0,23,9,3,10,0,0,22,nowin,loss,bust,plbust,0,10,13,202,0.391089109,0.01980198,0.628712871,2,0.577264877
23945,11,23991,9,3,0,8,0,20,9,3,10,0,0,22,nowin,win,dlbust,bust,20,0,12,236,0.457627119,0.016949153,0.588983051,3,0.889015813
23946,112,23992,6,5,10,0,0,21,11,10,0,0,0,21,nowin,push,push,push,10,0,11,203,0.448275862,0.054187192,0.600985222,3,0.889576933
23947,3,23992,11,10,0,0,0,21,11,10,0,0,0,21,win,push,push,push,10,0,21,190,0.431578947,0.026315789,0.542105263,1,0.288076384
23948,56,23992,10,6,0,10,0,26,11,10,0,0,0,21,nowin,loss,bust,plbust,0,10,16,175,0.4,0.057142857,0.582857143,0,0.026685297
23949,148,23992,5,9,0,10,0,24,11,10,0,0,0,21,nowin,loss,bust,plbust,0,10,14,204,0.401960784,0.078431373,0.593137255,0,0.029789521
23950,57,23992,10,10,0,0,0,20,11,10,0,0,0,21,nowin,loss,beat,dlwin,0,10,20,192,0.46875,0.052083333,0.59375,3,0.907001181
23951,88,23992,3,9,0,2,1,15,11,10,0,0,0,21,nowin,loss,beat,dlwin,0,10,12,206,0.466019417,0.033980583,0.54368932,1,0.309467903
23952,11,23993,10,3,0,1,10,24,9,6,10,0,0,25,nowin,loss,bust,plbust,0,10,13,236,0.457627119,0.016949153,0.588983051,3,0.889015813
23953,100,23993,5,8,0,6,0,19,9,6,10,0,0,25,nowin,win,dlbust,bust,20,0,13,190,0.452631579,0.036842105,0.594736842,3,0.888671154
23954,60,23993,6,3,10,0,0,19,9,6,10,0,0,25,nowin,win,dlbust,bust,20,0,9,227,0.418502203,0.022026432,0.559471366,0,0.026496258
23955,74,23993,10,10,0,0,0,20,9,6,10,0,0,25,nowin,win,dlbust,bust,20,0,20,209,0.411483254,0.04784689,0.531100478,0,0.017448125
23956,32,23993,5,5,7,0,0,17,9,6,10,0,0,25,nowin,win,dlbust,bust,20,0,10,189,0.391534392,0.037037037,0.53968254,0,0.013579086
23957,57,23993,10,10,0,0,0,20,9,6,10,0,0,25,nowin,win,dlbust,bust,20,0,20,192,0.46875,0.052083333,0.59375,3,0.907001181
23958,90,23994,6,4,10,0,0,20,6,9,10,0,0,25,nowin,win,dlbust,bust,20,0,10,201,0.447761194,0.049751244,0.60199005,3,0.889945023
23959,122,23994,8,10,0,0,0,18,6,9,10,0,0,25,nowin,win,dlbust,bust,20,0,18,210,0.347619048,0.052380952,0.59047619,0,0.012873677
23960,92,23994,10,10,0,0,0,20,6,9,10,0,0,25,nowin,win,dlbust,bust,20,0,20,186,0.446236559,0.059139785,0.564516129,1,0.307826125
23961,96,23994,5,1,10,0,0,16,6,9,10,0,0,25,nowin,win,dlbust,bust,20,0,6,190,0.468421053,0.057894737,0.584210526,3,0.897263354
23962,81,23994,8,3,10,0,0,21,6,9,10,0,0,25,nowin,win,dlbust,bust,20,0,11,182,0.395604396,0.043956044,0.60989011,2,0.567491261
23963,105,23994,9,10,0,0,0,19,6,9,10,0,0,25,nowin,win,dlbust,bust,20,0,19,198,0.414141414,0.070707071,0.590909091,0,0.032889494
23964,42,23995,7,6,0,10,0,23,7,3,7,0,0,17,nowin,loss,bust,plbust,0,10,13,212,0.443396226,0.051886792,0.570754717,1,0.309181312
23965,15,23995,10,2,0,9,0,21,7,3,7,0,0,17,nowin,win,plwin,beat,20,0,12,212,0.410377358,0.051886792,0.561320755,0,0.024517408
23966,140,23995,9,11,0,0,0,20,7,3,7,0,0,17,nowin,win,plwin,beat,20,0,20,210,0.466666667,0.023809524,0.604761905,3,0.915293335
23967,51,23995,3,9,0,9,0,21,7,3,7,0,0,17,nowin,win,plwin,beat,20,0,12,189,0.529100529,0.068783069,0.608465608,3,0.993665715
23968,81,23995,8,6,0,6,0,20,7,3,7,0,0,17,nowin,win,plwin,beat,20,0,14,182,0.395604396,0.043956044,0.60989011,2,0.567491261
23969,121,23995,8,9,0,0,0,17,7,3,7,0,0,17,nowin,push,push,push,10,0,17,195,0.456410256,0.025641026,0.512820513,1,0.288597791
23970,77,23996,10,2,0,10,0,22,7,6,4,0,0,17,nowin,loss,bust,plbust,0,10,12,200,0.455,0.04,0.62,3,0.916252116
23971,117,23996,10,4,0,3,0,17,7,6,4,0,0,17,nowin,push,push,push,10,0,14,173,0.410404624,0.069364162,0.606936416,2,0.578610282
23972,31,23996,6,10,0,2,0,18,7,6,4,0,0,17,nowin,win,plwin,beat,20,0,16,188,0.473404255,0.058510638,0.515957447,1,0.300306557
23973,61,23996,8,10,0,0,0,18,7,6,4,0,0,17,nowin,win,plwin,beat,20,0,18,194,0.427835052,0.077319588,0.603092784,2,0.591437139
23974,135,23996,7,5,0,3,2,17,7,6,4,0,0,17,nowin,push,push,push,10,0,12,179,0.391061453,0.067039106,0.586592179,0,0.024924662
23975,79,23996,5,3,10,0,0,18,7,6,4,0,0,17,nowin,win,plwin,beat,20,0,8,211,0.436018957,0.028436019,0.672985782,2,0.650131054
23976,80,23997,8,2,11,0,0,21,8,4,1,10,0,23,nowin,win,dlbust,bust,20,0,10,186,0.419354839,0.059139785,0.623655914,2,0.59892924
23977,150,23997,10,10,0,0,0,20,8,4,1,10,0,23,nowin,win,dlbust,bust,20,0,20,192,0.401041667,0.036458333,0.567708333,0,0.023287458
23978,131,23997,8,7,0,8,0,23,8,4,1,10,0,23,nowin,loss,bust,plbust,0,10,15,217,0.410138249,0.069124424,0.543778802,0,0.02015021
23979,3,23997,6,10,0,3,0,19,8,4,1,10,0,23,nowin,win,dlbust,bust,20,0,16,190,0.431578947,0.026315789,0.542105263,1,0.288076384
23980,74,23997,10,7,0,0,0,17,8,4,1,10,0,23,nowin,win,dlbust,bust,20,0,17,209,0.411483254,0.04784689,0.531100478,0,0.017448125
23981,111,23997,10,10,0,0,0,20,8,4,1,10,0,23,nowin,win,dlbust,bust,20,0,20,180,0.433333333,0.055555556,0.611111111,2,0.602264492
23982,144,23998,7,5,0,10,0,22,10,10,0,0,0,20,nowin,loss,bust,plbust,0,10,12,202,0.386138614,0.054455446,0.564356436,0,0.018006244
23983,35,23998,10,8,0,0,0,18,10,10,0,0,0,20,nowin,loss,beat,dlwin,0,10,18,202,0.410891089,0.044554455,0.633663366,2,0.598681573
23984,22,23998,5,10,0,5,0,20,10,10,0,0,0,20,nowin,push,push,push,10,0,15,187,0.481283422,0.042780749,0.577540107,3,0.906128176
23985,35,23998,1,4,10,7,0,22,10,10,0,0,0,20,nowin,loss,bust,plbust,0,10,5,202,0.410891089,0.044554455,0.633663366,2,0.598681573
23986,98,23998,2,2,2,10,10,26,10,10,0,0,0,20,nowin,loss,bust,plbust,0,10,4,220,0.422727273,0.054545455,0.55,1,0.28664435
23987,79,23998,10,10,0,0,0,20,10,10,0,0,0,20,nowin,push,push,push,10,0,20,211,0.436018957,0.028436019,0.672985782,2,0.650131054
23988,50,23999,5,1,7,0,0,13,4,4,10,0,0,18,nowin,loss,beat,dlwin,0,10,6,202,0.405940594,0.04950495,0.54950495,0,0.020296079
23989,81,23999,1,6,7,0,0,14,4,4,10,0,0,18,nowin,loss,beat,dlwin,0,10,7,182,0.395604396,0.043956044,0.60989011,2,0.567491261
23990,13,23999,10,10,0,0,0,20,4,4,10,0,0,18,nowin,win,plwin,beat,20,0,20,206,0.417475728,0.063106796,0.621359223,2,0.59555479
23991,110,23999,5,4,8,0,0,17,4,4,10,0,0,18,nowin,loss,beat,dlwin,0,10,9,192,0.416666667,0.046875,0.557291667,0,0.025413132
23992,94,23999,9,10,0,0,0,19,4,4,10,0,0,18,nowin,win,plwin,beat,20,0,19,183,0.43715847,0.043715847,0.540983607,1,0.290866892
23993,12,23999,3,6,5,0,0,14,4,4,10,0,0,18,nowin,loss,beat,dlwin,0,10,9,189,0.470899471,0.015873016,0.613756614,3,0.929171178
23994,115,24000,8,7,0,7,0,22,7,9,9,0,0,25,nowin,loss,bust,plbust,0,10,15,194,0.427835052,0.041237113,0.592783505,2,0.583863602
23995,121,24000,10,6,0,2,0,18,7,9,9,0,0,25,nowin,win,dlbust,bust,20,0,16,195,0.456410256,0.025641026,0.512820513,1,0.288597791
23996,54,24000,10,10,0,0,0,20,7,9,9,0,0,25,nowin,win,dlbust,bust,20,0,20,185,0.437837838,0.032432432,0.556756757,1,0.29899854
23997,7,24000,10,10,0,0,0,20,7,9,9,0,0,25,nowin,win,dlbust,bust,20,0,20,183,0.442622951,0.06010929,0.62295082,2,0.619303341
23998,142,24000,8,10,0,0,0,18,7,9,9,0,0,25,nowin,win,dlbust,bust,20,0,18,211,0.417061611,0.047393365,0.526066351,1,0.271531309
23999,18,24000,2,10,0,8,0,20,7,9,9,0,0,25,nowin,win,dlbust,bust,20,0,12,182,0.461538462,0.043956044,0.587912088,3,0.892649374
24000,145,24001,10,4,0,10,0,24,8,3,1,5,0,17,nowin,loss,bust,plbust,0,10,14,188,0.441489362,0.031914894,0.622340426,2,0.617837093
24001,143,24001,8,11,0,0,0,19,8,3,1,5,0,17,nowin,win,plwin,beat,20,0,19,203,0.463054187,0.044334975,0.57635468,3,0.883143365
24002,17,24001,4,7,10,0,0,21,8,3,1,5,0,17,nowin,win,plwin,beat,20,0,11,171,0.444444444,0.070175439,0.555555556,1,0.302364894
24003,39,24001,5,10,0,10,0,25,8,3,1,5,0,17,nowin,loss,bust,plbust,0,10,15,191,0.429319372,0.062827225,0.57591623,0,0.033760763
24004,91,24001,10,10,0,0,0,20,8,3,1,5,0,17,nowin,win,plwin,beat,20,0,20,194,0.417525773,0.046391753,0.515463918,1,0.266616552
24005,55,24001,5,2,3,8,0,18,8,3,1,5,0,17,nowin,win,plwin,beat,20,0,7,191,0.371727749,0.057591623,0.54973822,0,0.01011347
24006,36,24002,4,11,4,0,0,19,2,8,10,0,0,20,nowin,loss,beat,dlwin,0,10,15,229,0.445414847,0.056768559,0.655021834,2,0.645370571
24007,94,24002,8,8,0,0,0,16,2,8,10,0,0,20,nowin,loss,beat,dlwin,0,10,16,183,0.43715847,0.043715847,0.540983607,1,0.290866892
24008,137,24002,10,10,0,0,0,20,2,8,10,0,0,20,nowin,push,push,push,10,0,20,194,0.417525773,0.046391753,0.536082474,1,0.276714602
24009,16,24002,2,9,5,0,0,16,2,8,10,0,0,20,nowin,loss,beat,dlwin,0,10,11,220,0.427272727,0.081818182,0.6,2,0.588660176
24010,104,24002,9,10,0,0,0,19,2,8,10,0,0,20,nowin,loss,beat,dlwin,0,10,19,209,0.363636364,0.052631579,0.593301435,0,0.018359419
24011,80,24002,8,5,0,0,0,13,2,8,10,0,0,20,nowin,loss,beat,dlwin,0,10,13,186,0.419354839,0.059139785,0.623655914,2,0.59892924
24012,55,24003,7,4,9,0,0,20,3,10,10,0,0,23,nowin,win,dlbust,bust,20,0,11,191,0.371727749,0.057591623,0.54973822,0,0.01011347
24013,125,24003,6,2,10,0,0,18,3,10,10,0,0,23,nowin,win,dlbust,bust,20,0,8,219,0.438356164,0.050228311,0.575342466,1,0.308411257
24014,49,24003,7,10,0,0,0,17,3,10,10,0,0,23,nowin,win,dlbust,bust,20,0,17,207,0.396135266,0.053140097,0.594202899,0,0.028306925
24015,143,24003,10,10,0,0,0,20,3,10,10,0,0,23,nowin,win,dlbust,bust,20,0,20,203,0.463054187,0.044334975,0.57635468,3,0.883143365
24016,20,24003,10,8,0,0,0,18,3,10,10,0,0,23,nowin,win,dlbust,bust,20,0,18,186,0.456989247,0.037634409,0.537634409,1,0.301097108
24017,79,24003,6,7,0,0,0,13,3,10,10,0,0,23,nowin,win,dlbust,bust,20,0,13,211,0.436018957,0.028436019,0.672985782,2,0.650131054
24018,80,24004,4,11,3,0,0,18,10,2,6,0,0,18,nowin,push,push,push,10,0,15,186,0.419354839,0.059139785,0.623655914,2,0.59892924
24019,3,24004,2,9,5,9,0,25,10,2,6,0,0,18,nowin,loss,bust,plbust,0,10,11,190,0.431578947,0.026315789,0.542105263,1,0.288076384
24020,141,24004,10,7,0,0,0,17,10,2,6,0,0,18,nowin,loss,beat,dlwin,0,10,17,202,0.420792079,0.074257426,0.564356436,0,0.028377851
24021,122,24004,2,10,0,7,0,19,10,2,6,0,0,18,nowin,win,plwin,beat,20,0,12,210,0.347619048,0.052380952,0.59047619,0,0.012873677
24022,140,24004,10,10,0,0,0,20,10,2,6,0,0,18,nowin,win,plwin,beat,20,0,20,210,0.466666667,0.023809524,0.604761905,3,0.915293335
24023,72,24004,10,11,0,0,0,21,10,2,6,0,0,18,win,win,plwin,beat,25,0,21,185,0.394594595,0.032432432,0.508108108,0,0.006763115
24024,150,24005,10,2,0,2,1,15,10,11,0,0,0,21,nowin,loss,beat,dlwin,0,10,12,192,0.401041667,0.036458333,0.567708333,0,0.023287458
24025,39,24005,5,2,11,0,0,18,10,11,0,0,0,21,nowin,loss,beat,dlwin,0,10,7,191,0.429319372,0.062827225,0.57591623,0,0.033760763
24026,134,24005,3,4,10,0,0,17,10,11,0,0,0,21,nowin,loss,beat,dlwin,0,10,7,185,0.443243243,0.021621622,0.545945946,1,0.296939509
24027,47,24005,6,10,0,6,0,22,10,11,0,0,0,21,nowin,loss,bust,plbust,0,10,16,210,0.438095238,0.057142857,0.623809524,2,0.615868808
24028,41,24005,3,4,6,6,0,19,10,11,0,0,0,21,nowin,loss,beat,dlwin,0,10,7,192,0.364583333,0.036458333,0.520833333,0,0.00089702
24029,46,24005,6,8,0,8,0,22,10,11,0,0,0,21,nowin,loss,bust,plbust,0,10,14,186,0.403225806,0.048387097,0.591397849,0,0.029742194
24030,50,24006,9,10,0,0,0,19,5,10,10,0,0,25,nowin,win,dlbust,bust,20,0,19,202,0.405940594,0.04950495,0.54950495,0,0.020296079
24031,128,24006,9,6,0,0,0,15,5,10,10,0,0,25,nowin,win,dlbust,bust,20,0,15,227,0.356828194,0.052863436,0.577092511,0,0.012352564
24032,124,24006,6,1,10,0,0,17,5,10,10,0,0,25,nowin,win,dlbust,bust,20,0,7,202,0.47029703,0.064356436,0.584158416,3,0.899458193
24033,54,24006,10,9,0,0,0,19,5,10,10,0,0,25,nowin,win,dlbust,bust,20,0,19,185,0.437837838,0.032432432,0.556756757,1,0.29899854
24034,35,24006,3,3,11,0,0,17,5,10,10,0,0,25,nowin,win,dlbust,bust,20,0,6,202,0.410891089,0.044554455,0.633663366,2,0.598681573
24035,23,24006,9,5,0,0,0,14,5,10,10,0,0,25,nowin,win,dlbust,bust,20,0,14,208,0.427884615,0.0625,0.552884615,1,0.29114424
24036,52,24007,10,9,0,0,0,19,6,8,10,0,0,24,nowin,win,dlbust,bust,20,0,19,217,0.414746544,0.02764977,0.599078341,2,0.576736024
24037,19,24007,10,10,0,0,0,20,6,8,10,0,0,24,nowin,win,dlbust,bust,20,0,20,237,0.41350211,0.054852321,0.628691983,2,0.597373826
24038,41,24007,4,10,0,0,0,14,6,8,10,0,0,24,nowin,win,dlbust,bust,20,0,14,192,0.364583333,0.036458333,0.520833333,0,0.00089702
24039,31,24007,5,10,0,0,0,15,6,8,10,0,0,24,nowin,win,dlbust,bust,20,0,15,188,0.473404255,0.058510638,0.515957447,1,0.300306557
24040,61,24007,9,6,0,0,0,15,6,8,10,0,0,24,nowin,win,dlbust,bust,20,0,15,194,0.427835052,0.077319588,0.603092784,2,0.591437139
24041,35,24007,9,10,0,0,0,19,6,8,10,0,0,24,nowin,win,dlbust,bust,20,0,19,202,0.410891089,0.044554455,0.633663366,2,0.598681573
24042,114,24008,10,9,0,0,0,19,6,11,0,0,0,17,nowin,win,plwin,beat,20,0,19,198,0.47979798,0.025252525,0.611111111,3,0.937232995
24043,5,24008,6,10,0,0,0,16,6,11,0,0,0,17,nowin,loss,beat,dlwin,0,10,16,203,0.42364532,0.02955665,0.596059113,2,0.582508076
24044,40,24008,9,9,0,0,0,18,6,11,0,0,0,17,nowin,win,plwin,beat,20,0,18,196,0.367346939,0.030612245,0.617346939,0,0.025358183
24045,88,24008,10,2,0,0,0,12,6,11,0,0,0,17,nowin,loss,beat,dlwin,0,10,12,206,0.466019417,0.033980583,0.54368932,1,0.309467903
24046,141,24008,2,10,0,0,0,12,6,11,0,0,0,17,nowin,loss,beat,dlwin,0,10,12,202,0.420792079,0.074257426,0.564356436,0,0.028377851
24047,21,24008,4,1,10,0,0,15,6,11,0,0,0,17,nowin,loss,beat,dlwin,0,10,5,214,0.359813084,0.042056075,0.626168224,0,0.025263474
24048,86,24009,2,10,0,8,0,20,8,7,9,0,0,24,nowin,win,dlbust,bust,20,0,12,196,0.454081633,0.040816327,0.591836735,3,0.887566443
24049,34,24009,10,7,0,0,0,17,8,7,9,0,0,24,nowin,win,dlbust,bust,20,0,17,202,0.5,0.079207921,0.618811881,3,0.968961434
24050,60,24009,4,10,0,7,0,21,8,7,9,0,0,24,nowin,win,dlbust,bust,20,0,14,227,0.418502203,0.022026432,0.559471366,0,0.026496258
24051,75,24009,10,6,0,10,0,26,8,7,9,0,0,24,nowin,loss,bust,plbust,0,10,16,191,0.418848168,0.052356021,0.570680628,0,0.029344702
24052,134,24009,5,10,0,8,0,23,8,7,9,0,0,24,nowin,loss,bust,plbust,0,10,15,185,0.443243243,0.021621622,0.545945946,1,0.296939509
24053,16,24009,4,6,5,7,0,22,8,7,9,0,0,24,nowin,loss,bust,plbust,0,10,10,220,0.427272727,0.081818182,0.6,2,0.588660176
24054,105,24010,6,9,0,0,0,15,4,7,8,0,0,19,nowin,loss,beat,dlwin,0,10,15,198,0.414141414,0.070707071,0.590909091,0,0.032889494
24055,56,24010,11,10,0,0,0,21,4,7,8,0,0,19,win,win,plwin,beat,25,0,21,175,0.4,0.057142857,0.582857143,0,0.026685297
24056,95,24010,10,6,0,0,0,16,4,7,8,0,0,19,nowin,loss,beat,dlwin,0,10,16,218,0.412844037,0.04587156,0.559633028,0,0.024842385
24057,86,24010,10,10,0,0,0,20,4,7,8,0,0,19,nowin,win,plwin,beat,20,0,20,196,0.454081633,0.040816327,0.591836735,3,0.887566443
24058,50,24010,5,5,7,0,0,17,4,7,8,0,0,19,nowin,loss,beat,dlwin,0,10,10,202,0.405940594,0.04950495,0.54950495,0,0.020296079
24059,125,24010,10,10,0,0,0,20,4,7,8,0,0,19,nowin,win,plwin,beat,20,0,20,219,0.438356164,0.050228311,0.575342466,1,0.308411257
24060,20,24011,2,8,8,0,0,18,11,6,0,0,0,17,nowin,win,plwin,beat,20,0,10,186,0.456989247,0.037634409,0.537634409,1,0.301097108
24061,114,24011,3,8,4,9,0,24,11,6,0,0,0,17,nowin,loss,bust,plbust,0,10,11,198,0.47979798,0.025252525,0.611111111,3,0.937232995
24062,26,24011,3,9,0,6,0,18,11,6,0,0,0,17,nowin,win,plwin,beat,20,0,12,203,0.463054187,0.0591133,0.541871921,1,0.306802864
24063,95,24011,10,9,0,0,0,19,11,6,0,0,0,17,nowin,win,plwin,beat,20,0,19,218,0.412844037,0.04587156,0.559633028,0,0.024842385
24064,118,24011,11,10,0,0,0,21,11,6,0,0,0,17,win,win,plwin,beat,25,0,21,216,0.393518519,0.037037037,0.555555556,0,0.018059873
24065,76,24011,9,11,0,0,0,20,11,6,0,0,0,17,nowin,win,plwin,beat,20,0,20,189,0.534391534,0.079365079,0.608465608,3,1
24066,36,24012,10,2,0,8,0,20,10,7,0,0,0,17,nowin,win,plwin,beat,20,0,12,229,0.445414847,0.056768559,0.655021834,2,0.645370571
24067,149,24012,3,9,0,3,4,19,10,7,0,0,0,17,nowin,win,plwin,beat,20,0,12,225,0.457777778,0.057777778,0.648888889,2,0.651965595
24068,53,24012,5,7,0,6,0,18,10,7,0,0,0,17,nowin,win,plwin,beat,20,0,12,250,0.372,0.064,0.564,0,0.013687345
24069,148,24012,10,8,0,0,0,18,10,7,0,0,0,17,nowin,win,plwin,beat,20,0,18,204,0.401960784,0.078431373,0.593137255,0,0.029789521
24070,34,24012,3,4,6,9,0,22,10,7,0,0,0,17,nowin,loss,bust,plbust,0,10,7,202,0.5,0.079207921,0.618811881,3,0.968961434
24071,63,24012,10,11,0,0,0,21,10,7,0,0,0,17,win,win,plwin,beat,25,0,21,216,0.467592593,0.037037037,0.62037037,3,0.931690496
24072,26,24013,3,8,10,0,0,21,6,10,9,0,0,25,nowin,win,dlbust,bust,20,0,11,203,0.463054187,0.0591133,0.541871921,1,0.306802864
24073,5,24013,10,10,0,0,0,20,6,10,9,0,0,25,nowin,win,dlbust,bust,20,0,20,203,0.42364532,0.02955665,0.596059113,2,0.582508076
24074,132,24013,2,4,10,0,0,16,6,10,9,0,0,25,nowin,win,dlbust,bust,20,0,6,194,0.412371134,0.036082474,0.649484536,2,0.611633238
24075,50,24013,6,11,3,0,0,20,6,10,9,0,0,25,nowin,win,dlbust,bust,20,0,17,202,0.405940594,0.04950495,0.54950495,0,0.020296079
24076,24,24013,9,2,6,0,0,17,6,10,9,0,0,25,nowin,win,dlbust,bust,20,0,11,207,0.458937198,0.048309179,0.570048309,1,0.318138014
24077,20,24013,4,11,4,0,0,19,6,10,9,0,0,25,nowin,win,dlbust,bust,20,0,15,186,0.456989247,0.037634409,0.537634409,1,0.301097108
24078,121,24014,9,6,0,6,0,21,11,7,0,0,0,18,nowin,win,plwin,beat,20,0,15,195,0.456410256,0.025641026,0.512820513,1,0.288597791
24079,111,24014,4,4,8,10,0,26,11,7,0,0,0,18,nowin,loss,bust,plbust,0,10,8,180,0.433333333,0.055555556,0.611111111,2,0.602264492
24080,79,24014,9,9,0,0,0,18,11,7,0,0,0,18,nowin,push,push,push,10,0,18,211,0.436018957,0.028436019,0.672985782,2,0.650131054
24081,3,24014,11,7,0,0,0,18,11,7,0,0,0,18,nowin,push,push,push,10,0,18,190,0.431578947,0.026315789,0.542105263,1,0.288076384
24082,120,24014,6,1,5,8,0,20,11,7,0,0,0,18,nowin,win,plwin,beat,20,0,7,202,0.440594059,0.034653465,0.618811881,2,0.614441029
24083,26,24014,5,4,11,0,0,20,11,7,0,0,0,18,nowin,win,plwin,beat,20,0,9,203,0.463054187,0.0591133,0.541871921,1,0.306802864
24084,59,24015,10,4,0,0,0,14,3,6,5,10,0,24,nowin,win,dlbust,bust,20,0,14,228,0.429824561,0.048245614,0.543859649,1,0.287885446
24085,64,24015,11,6,1,0,0,18,3,6,5,10,0,24,nowin,win,dlbust,bust,20,0,17,187,0.363636364,0.048128342,0.631016043,0,0.027594885
24086,46,24015,10,7,0,0,0,17,3,6,5,10,0,24,nowin,win,dlbust,bust,20,0,17,186,0.403225806,0.048387097,0.591397849,0,0.029742194
24087,86,24015,6,10,0,0,0,16,3,6,5,10,0,24,nowin,win,dlbust,bust,20,0,16,196,0.454081633,0.040816327,0.591836735,3,0.887566443
24088,85,24015,9,10,0,0,0,19,3,6,5,10,0,24,nowin,win,dlbust,bust,20,0,19,195,0.41025641,0.066666667,0.594871795,0,0.03269711
24089,88,24015,9,7,0,0,0,16,3,6,5,10,0,24,nowin,win,dlbust,bust,20,0,16,206,0.466019417,0.033980583,0.54368932,1,0.309467903
24090,98,24016,5,10,0,9,0,24,10,7,0,0,0,17,nowin,loss,bust,plbust,0,10,15,220,0.422727273,0.054545455,0.55,1,0.28664435
24091,91,24016,10,4,0,4,0,18,10,7,0,0,0,17,nowin,win,plwin,beat,20,0,14,194,0.417525773,0.046391753,0.515463918,1,0.266616552
24092,107,24016,10,10,0,0,0,20,10,7,0,0,0,17,nowin,win,plwin,beat,20,0,20,218,0.444954128,0.073394495,0.600917431,2,0.605210014
24093,96,24016,6,7,0,7,0,20,10,7,0,0,0,17,nowin,win,plwin,beat,20,0,13,190,0.468421053,0.057894737,0.584210526,3,0.897263354
24094,31,24016,3,4,3,2,1,13,10,7,0,0,0,17,nowin,loss,beat,dlwin,0,10,7,188,0.473404255,0.058510638,0.515957447,1,0.300306557
24095,71,24016,9,10,0,0,0,19,10,7,0,0,0,17,nowin,win,plwin,beat,20,0,19,193,0.352331606,0.046632124,0.585492228,0,0.013063661
24096,122,24017,1,3,10,0,0,14,3,10,5,0,0,18,nowin,loss,beat,dlwin,0,10,4,210,0.347619048,0.052380952,0.59047619,0,0.012873677
24097,93,24017,3,6,10,0,0,19,3,10,5,0,0,18,nowin,win,plwin,beat,20,0,9,175,0.485714286,0.051428571,0.548571429,1,0.323648091
24098,60,24017,10,10,0,0,0,20,3,10,5,0,0,18,nowin,win,plwin,beat,20,0,20,227,0.418502203,0.022026432,0.559471366,0,0.026496258
24099,137,24017,10,4,0,0,0,14,3,10,5,0,0,18,nowin,loss,beat,dlwin,0,10,14,194,0.417525773,0.046391753,0.536082474,1,0.276714602
24100,104,24017,4,1,8,0,0,13,3,10,5,0,0,18,nowin,loss,beat,dlwin,0,10,5,209,0.363636364,0.052631579,0.593301435,0,0.018359419
24101,111,24017,3,8,10,0,0,21,3,10,5,0,0,18,nowin,win,plwin,beat,20,0,11,180,0.433333333,0.055555556,0.611111111,2,0.602264492
24102,79,24018,1,4,7,10,0,22,10,4,2,7,0,23,nowin,loss,bust,plbust,0,10,5,211,0.436018957,0.028436019,0.672985782,2,0.650131054
24103,89,24018,8,3,10,0,0,21,10,4,2,7,0,23,nowin,win,dlbust,bust,20,0,11,212,0.537735849,0.047169811,0.594339623,3,0.990167191
24104,112,24018,2,9,4,10,0,25,10,4,2,7,0,23,nowin,loss,bust,plbust,0,10,11,203,0.448275862,0.054187192,0.600985222,3,0.889576933
24105,119,24018,9,6,0,10,0,25,10,4,2,7,0,23,nowin,loss,bust,plbust,0,10,15,190,0.405263158,0.068421053,0.515789474,0,0.011837158
24106,69,24018,3,10,0,10,0,23,10,4,2,7,0,23,nowin,loss,bust,plbust,0,10,13,194,0.365979381,0.030927835,0.515463918,0,0
24107,48,24018,10,10,0,0,0,20,10,4,2,7,0,23,nowin,win,dlbust,bust,20,0,20,203,0.413793103,0.019704433,0.600985222,2,0.577280801
24108,21,24019,3,10,0,2,6,21,7,10,0,0,0,17,nowin,win,plwin,beat,20,0,13,214,0.359813084,0.042056075,0.626168224,0,0.025263474
24109,9,24019,4,8,0,1,1,14,7,10,0,0,0,17,nowin,loss,beat,dlwin,0,10,12,194,0.37628866,0.015463918,0.541237113,0,0.009396796
24110,123,24019,10,5,0,4,0,19,7,10,0,0,0,17,nowin,win,plwin,beat,20,0,15,205,0.43902439,0.034146341,0.614634146,2,0.609962544
24111,89,24019,10,2,0,7,0,19,7,10,0,0,0,17,nowin,win,plwin,beat,20,0,12,212,0.537735849,0.047169811,0.594339623,3,0.990167191
24112,92,24019,4,4,10,0,0,18,7,10,0,0,0,17,nowin,win,plwin,beat,20,0,8,186,0.446236559,0.059139785,0.564516129,1,0.307826125
24113,136,24019,1,4,10,10,0,25,7,10,0,0,0,17,nowin,loss,bust,plbust,0,10,5,194,0.396907216,0.025773196,0.597938144,0,0.029452644
24114,39,24020,6,8,0,10,0,24,10,3,8,0,0,21,nowin,loss,bust,plbust,0,10,14,191,0.429319372,0.062827225,0.57591623,0,0.033760763
24115,8,24020,7,10,0,0,0,17,10,3,8,0,0,21,nowin,loss,beat,dlwin,0,10,17,181,0.44198895,0.071823204,0.596685083,2,0.599438402
24116,3,24020,10,2,0,5,0,17,10,3,8,0,0,21,nowin,loss,beat,dlwin,0,10,12,190,0.431578947,0.026315789,0.542105263,1,0.288076384
24117,36,24020,10,10,0,0,0,20,10,3,8,0,0,21,nowin,loss,beat,dlwin,0,10,20,229,0.445414847,0.056768559,0.655021834,2,0.645370571
24118,100,24020,10,4,0,9,0,23,10,3,8,0,0,21,nowin,loss,bust,plbust,0,10,14,190,0.452631579,0.036842105,0.594736842,3,0.888671154
24119,84,24020,10,9,0,0,0,19,10,3,8,0,0,21,nowin,loss,beat,dlwin,0,10,19,195,0.379487179,0.056410256,0.569230769,0,0.017209119
24120,73,24021,4,10,0,3,0,17,10,10,0,0,0,20,nowin,loss,beat,dlwin,0,10,14,181,0.375690608,0.011049724,0.596685083,0,0.022795773
24121,22,24021,4,4,11,0,0,19,10,10,0,0,0,20,nowin,loss,beat,dlwin,0,10,8,187,0.481283422,0.042780749,0.577540107,3,0.906128176
24122,104,24021,2,4,5,7,0,18,10,10,0,0,0,20,nowin,loss,beat,dlwin,0,10,6,209,0.363636364,0.052631579,0.593301435,0,0.018359419
24123,84,24021,8,4,0,10,0,22,10,10,0,0,0,20,nowin,loss,bust,plbust,0,10,12,195,0.379487179,0.056410256,0.569230769,0,0.017209119
24124,17,24021,3,10,0,5,0,18,10,10,0,0,0,20,nowin,loss,beat,dlwin,0,10,13,171,0.444444444,0.070175439,0.555555556,1,0.302364894
24125,131,24021,3,6,3,8,0,20,10,10,0,0,0,20,nowin,push,push,push,10,0,9,217,0.410138249,0.069124424,0.543778802,0,0.02015021
24126,121,24022,1,4,7,8,0,20,10,11,0,0,0,21,nowin,loss,beat,dlwin,0,10,5,195,0.456410256,0.025641026,0.512820513,1,0.288597791
24127,22,24022,9,11,0,0,0,20,10,11,0,0,0,21,nowin,loss,beat,dlwin,0,10,20,187,0.481283422,0.042780749,0.577540107,3,0.906128176
24128,69,24022,10,10,0,0,0,20,10,11,0,0,0,21,nowin,loss,beat,dlwin,0,10,20,194,0.365979381,0.030927835,0.515463918,0,0
24129,66,24022,10,7,0,0,0,17,10,11,0,0,0,21,nowin,loss,beat,dlwin,0,10,17,217,0.456221198,0.064516129,0.626728111,3,0.924304367
24130,140,24022,10,8,0,0,0,18,10,11,0,0,0,21,nowin,loss,beat,dlwin,0,10,18,210,0.466666667,0.023809524,0.604761905,3,0.915293335
24131,85,24022,10,3,0,10,0,23,10,11,0,0,0,21,nowin,loss,bust,plbust,0,10,13,195,0.41025641,0.066666667,0.594871795,0,0.03269711
24132,23,24023,6,10,0,0,0,16,3,10,4,0,0,17,nowin,loss,beat,dlwin,0,10,16,208,0.427884615,0.0625,0.552884615,1,0.29114424
24133,15,24023,7,10,0,0,0,17,3,10,4,0,0,17,nowin,push,push,push,10,0,17,212,0.410377358,0.051886792,0.561320755,0,0.024517408
24134,113,24023,9,10,0,0,0,19,3,10,4,0,0,17,nowin,win,plwin,beat,20,0,19,199,0.407035176,0.055276382,0.668341709,2,0.620695264
24135,103,24023,10,6,0,0,0,16,3,10,4,0,0,17,nowin,loss,beat,dlwin,0,10,16,203,0.379310345,0.064039409,0.551724138,0,0.012869209
24136,109,24023,10,6,0,0,0,16,3,10,4,0,0,17,nowin,loss,beat,dlwin,0,10,16,221,0.461538462,0.058823529,0.597285068,3,0.901830309
24137,15,24023,10,7,0,0,0,17,3,10,4,0,0,17,nowin,push,push,push,10,0,17,212,0.410377358,0.051886792,0.561320755,0,0.024517408
24138,7,24024,9,10,0,0,0,19,10,10,0,0,0,20,nowin,loss,beat,dlwin,0,10,19,183,0.442622951,0.06010929,0.62295082,2,0.619303341
24139,52,24024,11,2,2,9,0,24,10,10,0,0,0,20,nowin,loss,bust,plbust,0,10,13,217,0.414746544,0.02764977,0.599078341,2,0.576736024
24140,11,24024,2,10,0,6,0,18,10,10,0,0,0,20,nowin,loss,beat,dlwin,0,10,12,236,0.457627119,0.016949153,0.588983051,3,0.889015813
24141,36,24024,2,9,2,9,0,22,10,10,0,0,0,20,nowin,loss,bust,plbust,0,10,11,229,0.445414847,0.056768559,0.655021834,2,0.645370571
24142,8,24024,6,3,5,7,0,21,10,10,0,0,0,20,nowin,win,plwin,beat,20,0,9,181,0.44198895,0.071823204,0.596685083,2,0.599438402
24143,120,24024,8,10,0,0,0,18,10,10,0,0,0,20,nowin,loss,beat,dlwin,0,10,18,202,0.440594059,0.034653465,0.618811881,2,0.614441029
24144,146,24025,10,10,0,0,0,20,11,10,0,0,0,21,nowin,loss,beat,dlwin,0,10,20,221,0.43438914,0.040723982,0.542986425,1,0.290190091
24145,133,24025,10,10,0,0,0,20,11,10,0,0,0,21,nowin,loss,beat,dlwin,0,10,20,201,0.47761194,0.064676617,0.611940299,3,0.935428111
24146,85,24025,9,9,0,0,0,18,11,10,0,0,0,21,nowin,loss,beat,dlwin,0,10,18,195,0.41025641,0.066666667,0.594871795,0,0.03269711
24147,127,24025,10,4,0,9,0,23,11,10,0,0,0,21,nowin,loss,bust,plbust,0,10,14,201,0.402985075,0.029850746,0.60199005,0,0.032263937
24148,4,24025,4,10,0,10,0,24,11,10,0,0,0,21,nowin,loss,bust,plbust,0,10,14,217,0.460829493,0.036866359,0.562211982,1,0.315432839
24149,125,24025,2,8,10,0,0,20,11,10,0,0,0,21,nowin,loss,beat,dlwin,0,10,10,219,0.438356164,0.050228311,0.575342466,1,0.308411257
24150,88,24026,3,2,4,10,0,19,9,8,0,0,0,17,nowin,win,plwin,beat,20,0,5,206,0.466019417,0.033980583,0.54368932,1,0.309467903
24151,53,24026,10,7,0,0,0,17,9,8,0,0,0,17,nowin,push,push,push,10,0,17,250,0.372,0.064,0.564,0,0.013687345
24152,128,24026,8,10,0,0,0,18,9,8,0,0,0,17,nowin,win,plwin,beat,20,0,18,227,0.356828194,0.052863436,0.577092511,0,0.012352564
24153,47,24026,6,10,0,10,0,26,9,8,0,0,0,17,nowin,loss,bust,plbust,0,10,16,210,0.438095238,0.057142857,0.623809524,2,0.615868808
24154,86,24026,10,8,0,0,0,18,9,8,0,0,0,17,nowin,win,plwin,beat,20,0,18,196,0.454081633,0.040816327,0.591836735,3,0.887566443
24155,109,24026,10,10,0,0,0,20,9,8,0,0,0,17,nowin,win,plwin,beat,20,0,20,221,0.461538462,0.058823529,0.597285068,3,0.901830309
24156,39,24027,7,10,0,0,0,17,10,2,9,0,0,21,nowin,loss,beat,dlwin,0,10,17,191,0.429319372,0.062827225,0.57591623,0,0.033760763
24157,93,24027,10,10,0,0,0,20,10,2,9,0,0,21,nowin,loss,beat,dlwin,0,10,20,175,0.485714286,0.051428571,0.548571429,1,0.323648091
24158,76,24027,7,10,0,0,0,17,10,2,9,0,0,21,nowin,loss,beat,dlwin,0,10,17,189,0.534391534,0.079365079,0.608465608,3,1
24159,22,24027,10,7,0,0,0,17,10,2,9,0,0,21,nowin,loss,beat,dlwin,0,10,17,187,0.481283422,0.042780749,0.577540107,3,0.906128176
24160,18,24027,1,6,10,0,0,17,10,2,9,0,0,21,nowin,loss,beat,dlwin,0,10,7,182,0.461538462,0.043956044,0.587912088,3,0.892649374
24161,70,24027,6,10,0,10,0,26,10,2,9,0,0,21,nowin,loss,bust,plbust,0,10,16,228,0.385964912,0.039473684,0.557017544,0,0.016157125
24162,22,24028,5,7,0,7,0,19,11,10,0,0,0,21,nowin,loss,beat,dlwin,0,10,12,187,0.481283422,0.042780749,0.577540107,3,0.906128176
24163,139,24028,10,10,0,0,0,20,11,10,0,0,0,21,nowin,loss,beat,dlwin,0,10,20,192,0.380208333,0.036458333,0.59375,0,0.023429169
24164,28,24028,3,1,10,8,0,22,11,10,0,0,0,21,nowin,loss,bust,plbust,0,10,4,199,0.422110553,0.045226131,0.542713568,1,0.282706618
24165,134,24028,9,9,0,0,0,18,11,10,0,0,0,21,nowin,loss,beat,dlwin,0,10,18,185,0.443243243,0.021621622,0.545945946,1,0.296939509
24166,19,24028,5,9,0,10,0,24,11,10,0,0,0,21,nowin,loss,bust,plbust,0,10,14,237,0.41350211,0.054852321,0.628691983,2,0.597373826
24167,3,24028,8,7,0,10,0,25,11,10,0,0,0,21,nowin,loss,bust,plbust,0,10,15,190,0.431578947,0.026315789,0.542105263,1,0.288076384
24168,130,24029,10,6,0,0,0,16,2,10,7,0,0,19,nowin,loss,beat,dlwin,0,10,16,219,0.410958904,0.03652968,0.566210046,0,0.025888739
24169,93,24029,10,10,0,0,0,20,2,10,7,0,0,19,nowin,win,plwin,beat,20,0,20,175,0.485714286,0.051428571,0.548571429,1,0.323648091
24170,73,24029,5,3,9,0,0,17,2,10,7,0,0,19,nowin,loss,beat,dlwin,0,10,8,181,0.375690608,0.011049724,0.596685083,0,0.022795773
24171,107,24029,2,10,0,9,0,21,2,10,7,0,0,19,nowin,win,plwin,beat,20,0,12,218,0.444954128,0.073394495,0.600917431,2,0.605210014
24172,71,24029,11,7,0,0,0,18,2,10,7,0,0,19,nowin,loss,beat,dlwin,0,10,18,193,0.352331606,0.046632124,0.585492228,0,0.013063661
24173,69,24029,3,6,10,0,0,19,2,10,7,0,0,19,nowin,push,push,push,10,0,9,194,0.365979381,0.030927835,0.515463918,0,0
24174,93,24030,2,10,0,10,0,22,7,10,0,0,0,17,nowin,loss,bust,plbust,0,10,12,175,0.485714286,0.051428571,0.548571429,1,0.323648091
24175,86,24030,9,11,0,0,0,20,7,10,0,0,0,17,nowin,win,plwin,beat,20,0,20,196,0.454081633,0.040816327,0.591836735,3,0.887566443
24176,12,24030,5,4,5,7,0,21,7,10,0,0,0,17,nowin,win,plwin,beat,20,0,9,189,0.470899471,0.015873016,0.613756614,3,0.929171178
24177,26,24030,5,8,0,10,0,23,7,10,0,0,0,17,nowin,loss,bust,plbust,0,10,13,203,0.463054187,0.0591133,0.541871921,1,0.306802864
24178,140,24030,7,4,9,0,0,20,7,10,0,0,0,17,nowin,win,plwin,beat,20,0,11,210,0.466666667,0.023809524,0.604761905,3,0.915293335
24179,76,24030,10,7,0,0,0,17,7,10,0,0,0,17,nowin,push,push,push,10,0,17,189,0.534391534,0.079365079,0.608465608,3,1
24180,113,24031,1,6,8,2,0,17,10,10,0,0,0,20,nowin,loss,beat,dlwin,0,10,7,199,0.407035176,0.055276382,0.668341709,2,0.620695264
24181,53,24031,10,2,0,2,10,24,10,10,0,0,0,20,nowin,loss,bust,plbust,0,10,12,250,0.372,0.064,0.564,0,0.013687345
24182,46,24031,2,3,6,10,0,21,10,10,0,0,0,20,nowin,win,plwin,beat,20,0,5,186,0.403225806,0.048387097,0.591397849,0,0.029742194
24183,53,24031,10,2,0,10,0,22,10,10,0,0,0,20,nowin,loss,bust,plbust,0,10,12,250,0.372,0.064,0.564,0,0.013687345
24184,2,24031,3,2,11,10,0,26,10,10,0,0,0,20,nowin,loss,bust,plbust,0,10,5,200,0.445,0.035,0.64,2,0.633962549
24185,44,24031,3,8,10,0,0,21,10,10,0,0,0,20,nowin,win,plwin,beat,20,0,11,219,0.433789954,0.050228311,0.534246575,1,0.285551035
24186,107,24032,6,10,0,4,0,20,8,11,0,0,0,19,nowin,win,plwin,beat,20,0,16,218,0.444954128,0.073394495,0.600917431,2,0.605210014
24187,43,24032,4,10,0,8,0,22,8,11,0,0,0,19,nowin,loss,bust,plbust,0,10,14,192,0.40625,0.041666667,0.609375,2,0.576671372
24188,2,24032,10,11,0,0,0,21,8,11,0,0,0,19,win,win,plwin,beat,25,0,21,200,0.445,0.035,0.64,2,0.633962549
24189,14,24032,3,10,0,1,10,24,8,11,0,0,0,19,nowin,loss,bust,plbust,0,10,13,202,0.391089109,0.01980198,0.628712871,2,0.577264877
24190,73,24032,6,9,0,2,0,17,8,11,0,0,0,19,nowin,loss,beat,dlwin,0,10,15,181,0.375690608,0.011049724,0.596685083,0,0.022795773
24191,43,24032,2,2,10,5,0,19,8,11,0,0,0,19,nowin,push,push,push,10,0,4,192,0.40625,0.041666667,0.609375,2,0.576671372
24192,141,24033,9,4,0,9,0,22,7,6,2,3,0,18,nowin,loss,bust,plbust,0,10,13,202,0.420792079,0.074257426,0.564356436,0,0.028377851
24193,24,24033,8,10,0,0,0,18,7,6,2,3,0,18,nowin,push,push,push,10,0,18,207,0.458937198,0.048309179,0.570048309,1,0.318138014
24194,109,24033,11,10,0,0,0,21,7,6,2,3,0,18,win,win,plwin,beat,25,0,21,221,0.461538462,0.058823529,0.597285068,3,0.901830309
24195,113,24033,8,4,0,5,0,17,7,6,2,3,0,18,nowin,loss,beat,dlwin,0,10,12,199,0.407035176,0.055276382,0.668341709,2,0.620695264
24196,9,24033,11,8,0,0,0,19,7,6,2,3,0,18,nowin,win,plwin,beat,20,0,19,194,0.37628866,0.015463918,0.541237113,0,0.009396796
24197,75,24033,5,4,11,0,0,20,7,6,2,3,0,18,nowin,win,plwin,beat,20,0,9,191,0.418848168,0.052356021,0.570680628,0,0.029344702
24198,147,24034,7,7,0,10,0,24,10,8,0,0,0,18,nowin,loss,bust,plbust,0,10,14,205,0.380487805,0.014634146,0.536585366,0,0.00951447
24199,32,24034,10,9,0,0,0,19,10,8,0,0,0,18,nowin,win,plwin,beat,20,0,19,189,0.391534392,0.037037037,0.53968254,0,0.013579086
24200,108,24034,3,5,10,0,0,18,10,8,0,0,0,18,nowin,push,push,push,10,0,8,193,0.435233161,0.056994819,0.559585492,1,0.298824795
24201,121,24034,10,3,0,10,0,23,10,8,0,0,0,18,nowin,loss,bust,plbust,0,10,13,195,0.456410256,0.025641026,0.512820513,1,0.288597791
24202,55,24034,10,3,0,9,0,22,10,8,0,0,0,18,nowin,loss,bust,plbust,0,10,13,191,0.371727749,0.057591623,0.54973822,0,0.01011347
24203,102,24034,10,5,0,6,0,21,10,8,0,0,0,18,nowin,win,plwin,beat,20,0,15,192,0.338541667,0.046875,0.5625,0,0.003306118
24204,141,24035,6,5,3,5,0,19,10,10,0,0,0,20,nowin,loss,beat,dlwin,0,10,11,202,0.420792079,0.074257426,0.564356436,0,0.028377851
24205,50,24035,3,4,10,0,0,17,10,10,0,0,0,20,nowin,loss,beat,dlwin,0,10,7,202,0.405940594,0.04950495,0.54950495,0,0.020296079
24206,103,24035,3,8,4,5,0,20,10,10,0,0,0,20,nowin,push,push,push,10,0,11,203,0.379310345,0.064039409,0.551724138,0,0.012869209
24207,111,24035,8,10,0,0,0,18,10,10,0,0,0,20,nowin,loss,beat,dlwin,0,10,18,180,0.433333333,0.055555556,0.611111111,2,0.602264492
24208,33,24035,10,3,0,7,0,20,10,10,0,0,0,20,nowin,push,push,push,10,0,13,192,0.4375,0.057291667,0.625,2,0.616208916
24209,64,24035,7,10,0,0,0,17,10,10,0,0,0,20,nowin,loss,beat,dlwin,0,10,17,187,0.363636364,0.048128342,0.631016043,0,0.027594885
24210,62,24036,8,8,0,2,0,18,10,8,0,0,0,18,nowin,push,push,push,10,0,16,178,0.370786517,0.028089888,0.54494382,0,0.008657722
24211,61,24036,5,10,0,2,0,17,10,8,0,0,0,18,nowin,loss,beat,dlwin,0,10,15,194,0.427835052,0.077319588,0.603092784,2,0.591437139
24212,83,24036,10,4,0,7,0,21,10,8,0,0,0,18,nowin,win,plwin,beat,20,0,14,193,0.424870466,0.051813472,0.678756477,2,0.644360335
24213,26,24036,3,10,0,10,0,23,10,8,0,0,0,18,nowin,loss,bust,plbust,0,10,13,203,0.463054187,0.0591133,0.541871921,1,0.306802864
24214,138,24036,8,3,9,0,0,20,10,8,0,0,0,18,nowin,win,plwin,beat,20,0,11,190,0.442105263,0.047368421,0.610526316,2,0.609711065
24215,62,24036,6,2,7,10,0,25,10,8,0,0,0,18,nowin,loss,bust,plbust,0,10,8,178,0.370786517,0.028089888,0.54494382,0,0.008657722
24216,88,24037,6,5,10,0,0,21,6,5,4,8,0,23,nowin,win,dlbust,bust,20,0,11,206,0.466019417,0.033980583,0.54368932,1,0.309467903
24217,4,24037,11,10,0,0,0,21,6,5,4,8,0,23,win,win,dlbust,bust,25,0,21,217,0.460829493,0.036866359,0.562211982,1,0.315432839
24218,137,24037,10,3,0,0,0,13,6,5,4,8,0,23,nowin,win,dlbust,bust,20,0,13,194,0.417525773,0.046391753,0.536082474,1,0.276714602
24219,129,24037,10,5,0,0,0,15,6,5,4,8,0,23,nowin,win,dlbust,bust,20,0,15,201,0.422885572,0.064676617,0.55721393,0,0.027255383
24220,143,24037,6,9,0,0,0,15,6,5,4,8,0,23,nowin,win,dlbust,bust,20,0,15,203,0.463054187,0.044334975,0.57635468,3,0.883143365
24221,117,24037,8,4,0,0,0,12,6,5,4,8,0,23,nowin,win,dlbust,bust,20,0,12,173,0.410404624,0.069364162,0.606936416,2,0.578610282
24222,125,24038,3,10,0,4,0,17,10,10,0,0,0,20,nowin,loss,beat,dlwin,0,10,13,219,0.438356164,0.050228311,0.575342466,1,0.308411257
24223,117,24038,10,10,0,0,0,20,10,10,0,0,0,20,nowin,push,push,push,10,0,20,173,0.410404624,0.069364162,0.606936416,2,0.578610282
24224,126,24038,4,10,0,10,0,24,10,10,0,0,0,20,nowin,loss,bust,plbust,0,10,14,188,0.457446809,0.074468085,0.60106383,3,0.900633203
24225,68,24038,2,10,0,9,0,21,10,10,0,0,0,20,nowin,win,plwin,beat,20,0,12,205,0.434146341,0.029268293,0.6,2,0.59483189
24226,88,24038,2,10,0,9,0,21,10,10,0,0,0,20,nowin,win,plwin,beat,20,0,12,206,0.466019417,0.033980583,0.54368932,1,0.309467903
24227,22,24038,2,3,9,10,0,24,10,10,0,0,0,20,nowin,loss,bust,plbust,0,10,5,187,0.481283422,0.042780749,0.577540107,3,0.906128176
24228,33,24039,10,10,0,0,0,20,10,2,1,2,4,19,nowin,win,plwin,beat,20,0,20,192,0.4375,0.057291667,0.625,2,0.616208916
24229,66,24039,11,7,0,0,0,18,10,2,1,2,4,19,nowin,loss,beat,dlwin,0,10,18,217,0.456221198,0.064516129,0.626728111,3,0.924304367
24230,132,24039,9,7,0,10,0,26,10,2,1,2,4,19,nowin,loss,bust,plbust,0,10,16,194,0.412371134,0.036082474,0.649484536,2,0.611633238
24231,86,24039,10,10,0,0,0,20,10,2,1,2,4,19,nowin,win,plwin,beat,20,0,20,196,0.454081633,0.040816327,0.591836735,3,0.887566443
24232,41,24039,5,5,3,10,0,23,10,2,1,2,4,19,nowin,loss,bust,plbust,0,10,10,192,0.364583333,0.036458333,0.520833333,0,0.00089702
24233,113,24039,3,6,8,0,0,17,10,2,1,2,4,19,nowin,loss,beat,dlwin,0,10,9,199,0.407035176,0.055276382,0.668341709,2,0.620695264
24234,58,24040,10,2,0,2,10,24,10,9,0,0,0,19,nowin,loss,bust,plbust,0,10,12,195,0.430769231,0.041025641,0.584615385,2,0.580497586
24235,117,24040,7,9,0,6,0,22,10,9,0,0,0,19,nowin,loss,bust,plbust,0,10,16,173,0.410404624,0.069364162,0.606936416,2,0.578610282
24236,61,24040,4,10,0,10,0,24,10,9,0,0,0,19,nowin,loss,bust,plbust,0,10,14,194,0.427835052,0.077319588,0.603092784,2,0.591437139
24237,129,24040,10,11,0,0,0,21,10,9,0,0,0,19,win,win,plwin,beat,25,0,21,201,0.422885572,0.064676617,0.55721393,0,0.027255383
24238,150,24040,5,3,3,4,2,17,10,9,0,0,0,19,nowin,loss,beat,dlwin,0,10,8,192,0.401041667,0.036458333,0.567708333,0,0.023287458
24239,120,24040,3,3,3,10,0,19,10,9,0,0,0,19,nowin,push,push,push,10,0,6,202,0.440594059,0.034653465,0.618811881,2,0.614441029
24240,146,24041,10,3,0,10,0,23,9,2,8,0,0,19,nowin,loss,bust,plbust,0,10,13,221,0.43438914,0.040723982,0.542986425,1,0.290190091
24241,138,24041,10,7,0,0,0,17,9,2,8,0,0,19,nowin,loss,beat,dlwin,0,10,17,190,0.442105263,0.047368421,0.610526316,2,0.609711065
24242,74,24041,3,3,7,10,0,23,9,2,8,0,0,19,nowin,loss,bust,plbust,0,10,6,209,0.411483254,0.04784689,0.531100478,0,0.017448125
24243,41,24041,2,2,10,10,0,24,9,2,8,0,0,19,nowin,loss,bust,plbust,0,10,4,192,0.364583333,0.036458333,0.520833333,0,0.00089702
24244,93,24041,10,10,0,0,0,20,9,2,8,0,0,19,nowin,win,plwin,beat,20,0,20,175,0.485714286,0.051428571,0.548571429,1,0.323648091
24245,63,24041,5,11,3,0,0,19,9,2,8,0,0,19,nowin,push,push,push,10,0,16,216,0.467592593,0.037037037,0.62037037,3,0.931690496
24246,145,24042,4,2,5,7,0,18,7,10,0,0,0,17,nowin,win,plwin,beat,20,0,6,188,0.441489362,0.031914894,0.622340426,2,0.617837093
24247,25,24042,2,8,7,0,0,17,7,10,0,0,0,17,nowin,push,push,push,10,0,10,190,0.463157895,0.063157895,0.536842105,1,0.304401563
24248,112,24042,4,9,0,1,7,21,7,10,0,0,0,17,nowin,win,plwin,beat,20,0,13,203,0.448275862,0.054187192,0.600985222,3,0.889576933
24249,60,24042,10,10,0,0,0,20,7,10,0,0,0,17,nowin,win,plwin,beat,20,0,20,227,0.418502203,0.022026432,0.559471366,0,0.026496258
24250,68,24042,6,10,0,4,0,20,7,10,0,0,0,17,nowin,win,plwin,beat,20,0,16,205,0.434146341,0.029268293,0.6,2,0.59483189
24251,41,24042,10,3,0,8,0,21,7,10,0,0,0,17,nowin,win,plwin,beat,20,0,13,192,0.364583333,0.036458333,0.520833333,0,0.00089702
24252,5,24043,7,10,0,0,0,17,2,2,2,10,3,19,nowin,loss,beat,dlwin,0,10,17,203,0.42364532,0.02955665,0.596059113,2,0.582508076
24253,77,24043,10,5,0,0,0,15,2,2,2,10,3,19,nowin,loss,beat,dlwin,0,10,15,200,0.455,0.04,0.62,3,0.916252116
24254,64,24043,6,1,10,0,0,17,2,2,2,10,3,19,nowin,loss,beat,dlwin,0,10,7,187,0.363636364,0.048128342,0.631016043,0,0.027594885
24255,88,24043,10,6,0,0,0,16,2,2,2,10,3,19,nowin,loss,beat,dlwin,0,10,16,206,0.466019417,0.033980583,0.54368932,1,0.309467903
24256,50,24043,9,2,9,0,0,20,2,2,2,10,3,19,nowin,win,plwin,beat,20,0,11,202,0.405940594,0.04950495,0.54950495,0,0.020296079
24257,108,24043,10,2,0,10,0,22,2,2,2,10,3,19,nowin,loss,bust,plbust,0,10,12,193,0.435233161,0.056994819,0.559585492,1,0.298824795
24258,81,24044,3,2,10,8,0,23,10,7,0,0,0,17,nowin,loss,bust,plbust,0,10,5,182,0.395604396,0.043956044,0.60989011,2,0.567491261
24259,15,24044,4,1,7,10,0,22,10,7,0,0,0,17,nowin,loss,bust,plbust,0,10,5,212,0.410377358,0.051886792,0.561320755,0,0.024517408
24260,2,24044,10,11,0,0,0,21,10,7,0,0,0,17,win,win,plwin,beat,25,0,21,200,0.445,0.035,0.64,2,0.633962549
24261,30,24044,3,9,0,10,0,22,10,7,0,0,0,17,nowin,loss,bust,plbust,0,10,12,206,0.393203883,0.033980583,0.601941748,0,0.029324648
24262,37,24044,11,9,0,0,0,20,10,7,0,0,0,17,nowin,win,plwin,beat,20,0,20,208,0.394230769,0.038461538,0.581730769,0,0.024682772
24263,146,24044,6,3,7,4,0,20,10,7,0,0,0,17,nowin,win,plwin,beat,20,0,9,221,0.43438914,0.040723982,0.542986425,1,0.290190091
24264,138,24045,11,10,0,0,0,21,11,10,0,0,0,21,win,push,push,push,10,0,21,190,0.442105263,0.047368421,0.610526316,2,0.609711065
24265,33,24045,8,7,0,1,8,24,11,10,0,0,0,21,nowin,loss,bust,plbust,0,10,15,192,0.4375,0.057291667,0.625,2,0.616208916
24266,48,24045,6,2,9,0,0,17,11,10,0,0,0,21,nowin,loss,beat,dlwin,0,10,8,203,0.413793103,0.019704433,0.600985222,2,0.577280801
24267,84,24045,10,2,0,10,0,22,11,10,0,0,0,21,nowin,loss,bust,plbust,0,10,12,195,0.379487179,0.056410256,0.569230769,0,0.017209119
24268,113,24045,6,8,0,4,0,18,11,10,0,0,0,21,nowin,loss,beat,dlwin,0,10,14,199,0.407035176,0.055276382,0.668341709,2,0.620695264
24269,65,24045,4,10,0,7,0,21,11,10,0,0,0,21,nowin,push,push,push,10,0,14,203,0.492610837,0.054187192,0.571428571,3,0.913702814
24270,39,24046,2,6,10,0,0,18,10,3,7,0,0,20,nowin,loss,beat,dlwin,0,10,8,191,0.429319372,0.062827225,0.57591623,0,0.033760763
24271,26,24046,10,10,0,0,0,20,10,3,7,0,0,20,nowin,push,push,push,10,0,20,203,0.463054187,0.0591133,0.541871921,1,0.306802864
24272,78,24046,2,3,6,10,0,21,10,3,7,0,0,20,nowin,win,plwin,beat,20,0,5,201,0.517412935,0.034825871,0.587064677,3,0.95871112
24273,47,24046,10,8,0,0,0,18,10,3,7,0,0,20,nowin,loss,beat,dlwin,0,10,18,210,0.438095238,0.057142857,0.623809524,2,0.615868808
24274,19,24046,6,3,10,0,0,19,10,3,7,0,0,20,nowin,loss,beat,dlwin,0,10,9,237,0.41350211,0.054852321,0.628691983,2,0.597373826
24275,52,24046,10,6,0,10,0,26,10,3,7,0,0,20,nowin,loss,bust,plbust,0,10,16,217,0.414746544,0.02764977,0.599078341,2,0.576736024
24276,60,24047,3,10,0,0,0,13,4,11,4,0,0,19,nowin,loss,beat,dlwin,0,10,13,227,0.418502203,0.022026432,0.559471366,0,0.026496258
24277,60,24047,10,10,0,0,0,20,4,11,4,0,0,19,nowin,win,plwin,beat,20,0,20,227,0.418502203,0.022026432,0.559471366,0,0.026496258
24278,33,24047,4,10,0,0,0,14,4,11,4,0,0,19,nowin,loss,beat,dlwin,0,10,14,192,0.4375,0.057291667,0.625,2,0.616208916
24279,109,24047,8,5,0,0,0,13,4,11,4,0,0,19,nowin,loss,beat,dlwin,0,10,13,221,0.461538462,0.058823529,0.597285068,3,0.901830309
24280,147,24047,1,6,6,0,0,13,4,11,4,0,0,19,nowin,loss,beat,dlwin,0,10,7,205,0.380487805,0.014634146,0.536585366,0,0.00951447
24281,85,24047,6,10,0,0,0,16,4,11,4,0,0,19,nowin,loss,beat,dlwin,0,10,16,195,0.41025641,0.066666667,0.594871795,0,0.03269711
24282,97,24048,10,7,0,0,0,17,10,11,0,0,0,21,nowin,loss,beat,dlwin,0,10,17,182,0.450549451,0.06043956,0.692307692,2,0.677372279
24283,53,24048,9,11,0,0,0,20,10,11,0,0,0,21,nowin,loss,beat,dlwin,0,10,20,250,0.372,0.064,0.564,0,0.013687345
24284,150,24048,11,5,3,0,0,19,10,11,0,0,0,21,nowin,loss,beat,dlwin,0,10,16,192,0.401041667,0.036458333,0.567708333,0,0.023287458
24285,121,24048,5,2,2,8,0,17,10,11,0,0,0,21,nowin,loss,beat,dlwin,0,10,7,195,0.456410256,0.025641026,0.512820513,1,0.288597791
24286,83,24048,4,2,10,6,0,22,10,11,0,0,0,21,nowin,loss,bust,plbust,0,10,6,193,0.424870466,0.051813472,0.678756477,2,0.644360335
24287,47,24048,9,5,0,8,0,22,10,11,0,0,0,21,nowin,loss,bust,plbust,0,10,14,210,0.438095238,0.057142857,0.623809524,2,0.615868808
24288,27,24049,4,10,0,0,0,14,3,11,7,0,0,21,nowin,loss,beat,dlwin,0,10,14,178,0.370786517,0.016853933,0.573033708,0,0.015536309
24289,141,24049,5,5,10,0,0,20,3,11,7,0,0,21,nowin,loss,beat,dlwin,0,10,10,202,0.420792079,0.074257426,0.564356436,0,0.028377851
24290,16,24049,11,4,3,0,0,18,3,11,7,0,0,21,nowin,loss,beat,dlwin,0,10,15,220,0.427272727,0.081818182,0.6,2,0.588660176
24291,108,24049,2,10,0,4,0,16,3,11,7,0,0,21,nowin,loss,beat,dlwin,0,10,12,193,0.435233161,0.056994819,0.559585492,1,0.298824795
24292,135,24049,8,10,0,0,0,18,3,11,7,0,0,21,nowin,loss,beat,dlwin,0,10,18,179,0.391061453,0.067039106,0.586592179,0,0.024924662
24293,36,24049,10,8,0,0,0,18,3,11,7,0,0,21,nowin,loss,beat,dlwin,0,10,18,229,0.445414847,0.056768559,0.655021834,2,0.645370571
24294,11,24050,10,10,0,0,0,20,10,10,0,0,0,20,nowin,push,push,push,10,0,20,236,0.457627119,0.016949153,0.588983051,3,0.889015813
24295,127,24050,9,5,0,8,0,22,10,10,0,0,0,20,nowin,loss,bust,plbust,0,10,14,201,0.402985075,0.029850746,0.60199005,0,0.032263937
24296,101,24050,10,3,0,10,0,23,10,10,0,0,0,20,nowin,loss,bust,plbust,0,10,13,205,0.424390244,0.068292683,0.63902439,2,0.614740646
24297,57,24050,10,6,0,6,0,22,10,10,0,0,0,20,nowin,loss,bust,plbust,0,10,16,192,0.46875,0.052083333,0.59375,3,0.907001181
24298,11,24050,10,3,0,10,0,23,10,10,0,0,0,20,nowin,loss,bust,plbust,0,10,13,236,0.457627119,0.016949153,0.588983051,3,0.889015813
24299,14,24050,10,10,0,0,0,20,10,10,0,0,0,20,nowin,push,push,push,10,0,20,202,0.391089109,0.01980198,0.628712871,2,0.577264877
24300,19,24051,8,4,0,3,7,22,10,10,0,0,0,20,nowin,loss,bust,plbust,0,10,12,237,0.41350211,0.054852321,0.628691983,2,0.597373826
24301,124,24051,2,7,10,0,0,19,10,10,0,0,0,20,nowin,loss,beat,dlwin,0,10,9,202,0.47029703,0.064356436,0.584158416,3,0.899458193
24302,64,24051,7,10,0,0,0,17,10,10,0,0,0,20,nowin,loss,beat,dlwin,0,10,17,187,0.363636364,0.048128342,0.631016043,0,0.027594885
24303,5,24051,9,10,0,0,0,19,10,10,0,0,0,20,nowin,loss,beat,dlwin,0,10,19,203,0.42364532,0.02955665,0.596059113,2,0.582508076
24304,29,24051,2,8,5,7,0,22,10,10,0,0,0,20,nowin,loss,bust,plbust,0,10,10,189,0.44973545,0.058201058,0.544973545,1,0.300349439
24305,66,24051,8,10,0,0,0,18,10,10,0,0,0,20,nowin,loss,beat,dlwin,0,10,18,217,0.456221198,0.064516129,0.626728111,3,0.924304367
24306,2,24052,3,4,11,0,0,18,7,2,6,10,0,25,nowin,win,dlbust,bust,20,0,7,200,0.445,0.035,0.64,2,0.633962549
24307,114,24052,10,7,0,0,0,17,7,2,6,10,0,25,nowin,win,dlbust,bust,20,0,17,198,0.47979798,0.025252525,0.611111111,3,0.937232995
24308,83,24052,11,10,0,0,0,21,7,2,6,10,0,25,win,win,dlbust,bust,25,0,21,193,0.424870466,0.051813472,0.678756477,2,0.644360335
24309,137,24052,6,6,0,7,0,19,7,2,6,10,0,25,nowin,win,dlbust,bust,20,0,12,194,0.417525773,0.046391753,0.536082474,1,0.276714602
24310,36,24052,10,10,0,0,0,20,7,2,6,10,0,25,nowin,win,dlbust,bust,20,0,20,229,0.445414847,0.056768559,0.655021834,2,0.645370571
24311,20,24052,10,10,0,0,0,20,7,2,6,10,0,25,nowin,win,dlbust,bust,20,0,20,186,0.456989247,0.037634409,0.537634409,1,0.301097108
24312,102,24053,9,3,0,2,2,16,9,10,0,0,0,19,nowin,loss,beat,dlwin,0,10,12,192,0.338541667,0.046875,0.5625,0,0.003306118
24313,20,24053,9,4,0,10,0,23,9,10,0,0,0,19,nowin,loss,bust,plbust,0,10,13,186,0.456989247,0.037634409,0.537634409,1,0.301097108
24314,40,24053,10,5,0,8,0,23,9,10,0,0,0,19,nowin,loss,bust,plbust,0,10,15,196,0.367346939,0.030612245,0.617346939,0,0.025358183
24315,53,24053,11,7,0,0,0,18,9,10,0,0,0,19,nowin,loss,beat,dlwin,0,10,18,250,0.372,0.064,0.564,0,0.013687345
24316,34,24053,8,10,0,0,0,18,9,10,0,0,0,19,nowin,loss,beat,dlwin,0,10,18,202,0.5,0.079207921,0.618811881,3,0.968961434
24317,42,24053,8,5,0,10,0,23,9,10,0,0,0,19,nowin,loss,bust,plbust,0,10,13,212,0.443396226,0.051886792,0.570754717,1,0.309181312
24318,70,24054,5,6,5,2,0,18,10,10,0,0,0,20,nowin,loss,beat,dlwin,0,10,11,228,0.385964912,0.039473684,0.557017544,0,0.016157125
24319,67,24054,6,8,0,10,0,24,10,10,0,0,0,20,nowin,loss,bust,plbust,0,10,14,195,0.369230769,0.041025641,0.569230769,0,0.014139427
24320,80,24054,7,8,0,8,0,23,10,10,0,0,0,20,nowin,loss,bust,plbust,0,10,15,186,0.419354839,0.059139785,0.623655914,2,0.59892924
24321,7,24054,2,4,7,3,9,25,10,10,0,0,0,20,nowin,loss,bust,plbust,0,10,6,183,0.442622951,0.06010929,0.62295082,2,0.619303341
24322,126,24054,10,10,0,0,0,20,10,10,0,0,0,20,nowin,push,push,push,10,0,20,188,0.457446809,0.074468085,0.60106383,3,0.900633203
24323,51,24054,6,2,6,6,0,20,10,10,0,0,0,20,nowin,push,push,push,10,0,8,189,0.529100529,0.068783069,0.608465608,3,0.993665715
24324,148,24055,6,9,0,8,0,23,10,5,10,0,0,25,nowin,loss,bust,plbust,0,10,15,204,0.401960784,0.078431373,0.593137255,0,0.029789521
24325,1,24055,10,5,0,3,0,18,10,5,10,0,0,25,nowin,win,dlbust,bust,20,0,15,197,0.406091371,0.025380711,0.649746193,2,0.606186955
24326,82,24055,2,10,0,10,0,22,10,5,10,0,0,25,nowin,loss,bust,plbust,0,10,12,225,0.408888889,0.075555556,0.577777778,0,0.028101874
24327,70,24055,3,9,0,10,0,22,10,5,10,0,0,25,nowin,loss,bust,plbust,0,10,12,228,0.385964912,0.039473684,0.557017544,0,0.016157125
24328,139,24055,2,1,10,5,0,18,10,5,10,0,0,25,nowin,win,dlbust,bust,20,0,3,192,0.380208333,0.036458333,0.59375,0,0.023429169
24329,109,24055,4,4,4,4,10,26,10,5,10,0,0,25,nowin,loss,bust,plbust,0,10,8,221,0.461538462,0.058823529,0.597285068,3,0.901830309
24330,37,24056,7,8,0,5,0,20,10,10,0,0,0,20,nowin,push,push,push,10,0,15,208,0.394230769,0.038461538,0.581730769,0,0.024682772
24331,10,24056,9,5,0,6,0,20,10,10,0,0,0,20,nowin,push,push,push,10,0,14,191,0.413612565,0.057591623,0.596858639,2,0.574087175
24332,22,24056,9,3,0,4,10,26,10,10,0,0,0,20,nowin,loss,bust,plbust,0,10,12,187,0.481283422,0.042780749,0.577540107,3,0.906128176
24333,114,24056,7,2,11,0,0,20,10,10,0,0,0,20,nowin,push,push,push,10,0,9,198,0.47979798,0.025252525,0.611111111,3,0.937232995
24334,42,24056,7,5,0,9,0,21,10,10,0,0,0,20,nowin,win,plwin,beat,20,0,12,212,0.443396226,0.051886792,0.570754717,1,0.309181312
24335,111,24056,9,8,0,0,0,17,10,10,0,0,0,20,nowin,loss,beat,dlwin,0,10,17,180,0.433333333,0.055555556,0.611111111,2,0.602264492
24336,109,24057,11,3,5,0,0,19,4,10,4,0,0,18,nowin,win,plwin,beat,20,0,14,221,0.461538462,0.058823529,0.597285068,3,0.901830309
24337,74,24057,6,10,0,0,0,16,4,10,4,0,0,18,nowin,loss,beat,dlwin,0,10,16,209,0.411483254,0.04784689,0.531100478,0,0.017448125
24338,119,24057,11,10,0,0,0,21,4,10,4,0,0,18,win,win,plwin,beat,25,0,21,190,0.405263158,0.068421053,0.515789474,0,0.011837158
24339,94,24057,8,3,9,0,0,20,4,10,4,0,0,18,nowin,win,plwin,beat,20,0,11,183,0.43715847,0.043715847,0.540983607,1,0.290866892
24340,134,24057,3,10,0,0,0,13,4,10,4,0,0,18,nowin,loss,beat,dlwin,0,10,13,185,0.443243243,0.021621622,0.545945946,1,0.296939509
24341,113,24057,10,9,0,0,0,19,4,10,4,0,0,18,nowin,win,plwin,beat,20,0,19,199,0.407035176,0.055276382,0.668341709,2,0.620695264
24342,99,24058,1,3,8,2,8,22,11,10,0,0,0,21,nowin,loss,bust,plbust,0,10,4,207,0.47826087,0.062801932,0.637681159,3,0.961418446
24343,80,24058,4,10,0,2,9,25,11,10,0,0,0,21,nowin,loss,bust,plbust,0,10,14,186,0.419354839,0.059139785,0.623655914,2,0.59892924
24344,123,24058,10,4,0,10,0,24,11,10,0,0,0,21,nowin,loss,bust,plbust,0,10,14,205,0.43902439,0.034146341,0.614634146,2,0.609962544
24345,136,24058,5,10,0,4,0,19,11,10,0,0,0,21,nowin,loss,beat,dlwin,0,10,15,194,0.396907216,0.025773196,0.597938144,0,0.029452644
24346,2,24058,2,7,6,10,0,25,11,10,0,0,0,21,nowin,loss,bust,plbust,0,10,9,200,0.445,0.035,0.64,2,0.633962549
24347,120,24058,7,6,0,8,0,21,11,10,0,0,0,21,nowin,push,push,push,10,0,13,202,0.440594059,0.034653465,0.618811881,2,0.614441029
24348,64,24059,11,10,0,0,0,21,10,11,0,0,0,21,win,push,push,push,10,0,21,187,0.363636364,0.048128342,0.631016043,0,0.027594885
24349,55,24059,10,10,0,0,0,20,10,11,0,0,0,21,nowin,loss,beat,dlwin,0,10,20,191,0.371727749,0.057591623,0.54973822,0,0.01011347
24350,98,24059,5,8,0,5,0,18,10,11,0,0,0,21,nowin,loss,beat,dlwin,0,10,13,220,0.422727273,0.054545455,0.55,1,0.28664435
24351,108,24059,5,10,0,10,0,25,10,11,0,0,0,21,nowin,loss,bust,plbust,0,10,15,193,0.435233161,0.056994819,0.559585492,1,0.298824795
24352,32,24059,9,10,0,0,0,19,10,11,0,0,0,21,nowin,loss,beat,dlwin,0,10,19,189,0.391534392,0.037037037,0.53968254,0,0.013579086
24353,33,24059,5,10,0,8,0,23,10,11,0,0,0,21,nowin,loss,bust,plbust,0,10,15,192,0.4375,0.057291667,0.625,2,0.616208916
24354,76,24060,4,5,8,0,0,17,7,6,4,0,0,17,nowin,push,push,push,10,0,9,189,0.534391534,0.079365079,0.608465608,3,1
24355,114,24060,5,2,10,0,0,17,7,6,4,0,0,17,nowin,push,push,push,10,0,7,198,0.47979798,0.025252525,0.611111111,3,0.937232995
24356,79,24060,10,7,0,0,0,17,7,6,4,0,0,17,nowin,push,push,push,10,0,17,211,0.436018957,0.028436019,0.672985782,2,0.650131054
24357,2,24060,10,10,0,0,0,20,7,6,4,0,0,17,nowin,win,plwin,beat,20,0,20,200,0.445,0.035,0.64,2,0.633962549
24358,145,24060,3,4,10,0,0,17,7,6,4,0,0,17,nowin,push,push,push,10,0,7,188,0.441489362,0.031914894,0.622340426,2,0.617837093
24359,44,24060,9,10,0,0,0,19,7,6,4,0,0,17,nowin,win,plwin,beat,20,0,19,219,0.433789954,0.050228311,0.534246575,1,0.285551035
24360,66,24061,7,8,0,5,0,20,8,4,1,1,10,24,nowin,win,dlbust,bust,20,0,15,217,0.456221198,0.064516129,0.626728111,3,0.924304367
24361,49,24061,10,10,0,0,0,20,8,4,1,1,10,24,nowin,win,dlbust,bust,20,0,20,207,0.396135266,0.053140097,0.594202899,0,0.028306925
24362,99,24061,8,4,0,3,7,22,8,4,1,1,10,24,nowin,loss,bust,plbust,0,10,12,207,0.47826087,0.062801932,0.637681159,3,0.961418446
24363,46,24061,10,5,0,9,0,24,8,4,1,1,10,24,nowin,loss,bust,plbust,0,10,15,186,0.403225806,0.048387097,0.591397849,0,0.029742194
24364,46,24061,10,10,0,0,0,20,8,4,1,1,10,24,nowin,win,dlbust,bust,20,0,20,186,0.403225806,0.048387097,0.591397849,0,0.029742194
24365,96,24061,2,5,8,3,0,18,8,4,1,1,10,24,nowin,win,dlbust,bust,20,0,7,190,0.468421053,0.057894737,0.584210526,3,0.897263354
24366,63,24062,10,10,0,0,0,20,11,2,5,0,0,18,nowin,win,plwin,beat,20,0,20,216,0.467592593,0.037037037,0.62037037,3,0.931690496
24367,69,24062,4,6,10,0,0,20,11,2,5,0,0,18,nowin,win,plwin,beat,20,0,10,194,0.365979381,0.030927835,0.515463918,0,0
24368,101,24062,10,10,0,0,0,20,11,2,5,0,0,18,nowin,win,plwin,beat,20,0,20,205,0.424390244,0.068292683,0.63902439,2,0.614740646
24369,82,24062,8,11,0,0,0,19,11,2,5,0,0,18,nowin,win,plwin,beat,20,0,19,225,0.408888889,0.075555556,0.577777778,0,0.028101874
24370,1,24062,10,10,0,0,0,20,11,2,5,0,0,18,nowin,win,plwin,beat,20,0,20,197,0.406091371,0.025380711,0.649746193,2,0.606186955
24371,120,24062,10,4,0,4,0,18,11,2,5,0,0,18,nowin,push,push,push,10,0,14,202,0.440594059,0.034653465,0.618811881,2,0.614441029
24372,141,24063,10,4,0,6,0,20,11,9,0,0,0,20,nowin,push,push,push,10,0,14,202,0.420792079,0.074257426,0.564356436,0,0.028377851
24373,87,24063,2,8,5,2,0,17,11,9,0,0,0,20,nowin,loss,beat,dlwin,0,10,10,202,0.405940594,0.054455446,0.628712871,2,0.590599801
24374,53,24063,10,11,0,0,0,21,11,9,0,0,0,20,win,win,plwin,beat,25,0,21,250,0.372,0.064,0.564,0,0.013687345
24375,62,24063,6,6,0,10,0,22,11,9,0,0,0,20,nowin,loss,bust,plbust,0,10,12,178,0.370786517,0.028089888,0.54494382,0,0.008657722
24376,98,24063,3,8,10,0,0,21,11,9,0,0,0,20,nowin,win,plwin,beat,20,0,11,220,0.422727273,0.054545455,0.55,1,0.28664435
24377,95,24063,2,10,0,3,3,18,11,9,0,0,0,20,nowin,loss,beat,dlwin,0,10,12,218,0.412844037,0.04587156,0.559633028,0,0.024842385
24378,64,24064,10,7,0,0,0,17,5,6,8,0,0,19,nowin,loss,beat,dlwin,0,10,17,187,0.363636364,0.048128342,0.631016043,0,0.027594885
24379,14,24064,4,2,4,10,0,20,5,6,8,0,0,19,nowin,win,plwin,beat,20,0,6,202,0.391089109,0.01980198,0.628712871,2,0.577264877
24380,114,24064,4,7,10,0,0,21,5,6,8,0,0,19,nowin,win,plwin,beat,20,0,11,198,0.47979798,0.025252525,0.611111111,3,0.937232995
24381,101,24064,7,10,0,0,0,17,5,6,8,0,0,19,nowin,loss,beat,dlwin,0,10,17,205,0.424390244,0.068292683,0.63902439,2,0.614740646
24382,24,24064,4,2,10,0,0,16,5,6,8,0,0,19,nowin,loss,beat,dlwin,0,10,6,207,0.458937198,0.048309179,0.570048309,1,0.318138014
24383,69,24064,5,3,4,0,0,12,5,6,8,0,0,19,nowin,loss,beat,dlwin,0,10,8,194,0.365979381,0.030927835,0.515463918,0,0
24384,25,24065,3,2,4,9,0,18,2,7,11,0,0,20,nowin,loss,beat,dlwin,0,10,5,190,0.463157895,0.063157895,0.536842105,1,0.304401563
24385,29,24065,6,4,10,0,0,20,2,7,11,0,0,20,nowin,push,push,push,10,0,10,189,0.44973545,0.058201058,0.544973545,1,0.300349439
24386,86,24065,2,6,9,0,0,17,2,7,11,0,0,20,nowin,loss,beat,dlwin,0,10,8,196,0.454081633,0.040816327,0.591836735,3,0.887566443
24387,135,24065,1,3,10,0,0,14,2,7,11,0,0,20,nowin,loss,beat,dlwin,0,10,4,179,0.391061453,0.067039106,0.586592179,0,0.024924662
24388,124,24065,10,2,0,3,0,15,2,7,11,0,0,20,nowin,loss,beat,dlwin,0,10,12,202,0.47029703,0.064356436,0.584158416,3,0.899458193
24389,18,24065,6,1,10,0,0,17,2,7,11,0,0,20,nowin,loss,beat,dlwin,0,10,7,182,0.461538462,0.043956044,0.587912088,3,0.892649374
24390,42,24066,5,8,0,1,2,16,1,3,9,8,0,21,nowin,loss,beat,dlwin,0,10,13,212,0.443396226,0.051886792,0.570754717,1,0.309181312
24391,96,24066,4,10,0,8,0,22,1,3,9,8,0,21,nowin,loss,bust,plbust,0,10,14,190,0.468421053,0.057894737,0.584210526,3,0.897263354
24392,72,24066,5,7,0,10,0,22,1,3,9,8,0,21,nowin,loss,bust,plbust,0,10,12,185,0.394594595,0.032432432,0.508108108,0,0.006763115
24393,59,24066,7,10,0,0,0,17,1,3,9,8,0,21,nowin,loss,beat,dlwin,0,10,17,228,0.429824561,0.048245614,0.543859649,1,0.287885446
24394,143,24066,8,2,9,0,0,19,1,3,9,8,0,21,nowin,loss,beat,dlwin,0,10,10,203,0.463054187,0.044334975,0.57635468,3,0.883143365
24395,64,24066,10,11,0,0,0,21,1,3,9,8,0,21,win,push,push,push,10,0,21,187,0.363636364,0.048128342,0.631016043,0,0.027594885
24396,137,24067,5,8,0,0,0,13,6,11,0,0,0,17,nowin,loss,beat,dlwin,0,10,13,194,0.417525773,0.046391753,0.536082474,1,0.276714602
24397,61,24067,10,7,0,0,0,17,6,11,0,0,0,17,nowin,push,push,push,10,0,17,194,0.427835052,0.077319588,0.603092784,2,0.591437139
24398,105,24067,4,8,0,0,0,12,6,11,0,0,0,17,nowin,loss,beat,dlwin,0,10,12,198,0.414141414,0.070707071,0.590909091,0,0.032889494
24399,148,24067,2,10,0,0,0,12,6,11,0,0,0,17,nowin,loss,beat,dlwin,0,10,12,204,0.401960784,0.078431373,0.593137255,0,0.029789521
24400,137,24067,7,2,10,0,0,19,6,11,0,0,0,17,nowin,win,plwin,beat,20,0,9,194,0.417525773,0.046391753,0.536082474,1,0.276714602
24401,128,24067,10,4,0,0,0,14,6,11,0,0,0,17,nowin,loss,beat,dlwin,0,10,14,227,0.356828194,0.052863436,0.577092511,0,0.012352564
24402,8,24068,7,8,0,9,0,24,10,3,9,0,0,22,nowin,loss,bust,plbust,0,10,15,181,0.44198895,0.071823204,0.596685083,2,0.599438402
24403,76,24068,5,7,0,10,0,22,10,3,9,0,0,22,nowin,loss,bust,plbust,0,10,12,189,0.534391534,0.079365079,0.608465608,3,1
24404,63,24068,11,1,7,0,0,19,10,3,9,0,0,22,nowin,win,dlbust,bust,20,0,12,216,0.467592593,0.037037037,0.62037037,3,0.931690496
24405,61,24068,2,4,10,10,0,26,10,3,9,0,0,22,nowin,loss,bust,plbust,0,10,6,194,0.427835052,0.077319588,0.603092784,2,0.591437139
24406,87,24068,4,2,4,10,0,20,10,3,9,0,0,22,nowin,win,dlbust,bust,20,0,6,202,0.405940594,0.054455446,0.628712871,2,0.590599801
24407,127,24068,11,2,7,0,0,20,10,3,9,0,0,22,nowin,win,dlbust,bust,20,0,13,201,0.402985075,0.029850746,0.60199005,0,0.032263937
24408,57,24069,8,4,0,6,0,18,3,9,4,10,0,26,nowin,win,dlbust,bust,20,0,12,192,0.46875,0.052083333,0.59375,3,0.907001181
24409,30,24069,7,2,4,0,0,13,3,9,4,10,0,26,nowin,win,dlbust,bust,20,0,9,206,0.393203883,0.033980583,0.601941748,0,0.029324648
24410,65,24069,6,4,10,0,0,20,3,9,4,10,0,26,nowin,win,dlbust,bust,20,0,10,203,0.492610837,0.054187192,0.571428571,3,0.913702814
24411,118,24069,2,11,8,0,0,21,3,9,4,10,0,26,nowin,win,dlbust,bust,20,0,13,216,0.393518519,0.037037037,0.555555556,0,0.018059873
24412,112,24069,10,11,0,0,0,21,3,9,4,10,0,26,win,win,dlbust,bust,25,0,21,203,0.448275862,0.054187192,0.600985222,3,0.889576933
24413,142,24069,10,3,0,0,0,13,3,9,4,10,0,26,nowin,win,dlbust,bust,20,0,13,211,0.417061611,0.047393365,0.526066351,1,0.271531309
24414,69,24070,2,10,0,10,0,22,10,7,0,0,0,17,nowin,loss,bust,plbust,0,10,12,194,0.365979381,0.030927835,0.515463918,0,0
24415,70,24070,10,8,0,0,0,18,10,7,0,0,0,17,nowin,win,plwin,beat,20,0,18,228,0.385964912,0.039473684,0.557017544,0,0.016157125
24416,8,24070,8,7,0,7,0,22,10,7,0,0,0,17,nowin,loss,bust,plbust,0,10,15,181,0.44198895,0.071823204,0.596685083,2,0.599438402
24417,127,24070,10,9,0,0,0,19,10,7,0,0,0,17,nowin,win,plwin,beat,20,0,19,201,0.402985075,0.029850746,0.60199005,0,0.032263937
24418,67,24070,9,6,0,4,0,19,10,7,0,0,0,17,nowin,win,plwin,beat,20,0,15,195,0.369230769,0.041025641,0.569230769,0,0.014139427
24419,8,24070,4,10,0,10,0,24,10,7,0,0,0,17,nowin,loss,bust,plbust,0,10,14,181,0.44198895,0.071823204,0.596685083,2,0.599438402
24420,12,24071,10,9,0,0,0,19,11,1,4,10,0,26,nowin,win,dlbust,bust,20,0,19,189,0.470899471,0.015873016,0.613756614,3,0.929171178
24421,90,24071,8,7,0,10,0,25,11,1,4,10,0,26,nowin,loss,bust,plbust,0,10,15,201,0.447761194,0.049751244,0.60199005,3,0.889945023
24422,103,24071,11,7,0,0,0,18,11,1,4,10,0,26,nowin,win,dlbust,bust,20,0,18,203,0.379310345,0.064039409,0.551724138,0,0.012869209
24423,119,24071,9,10,0,0,0,19,11,1,4,10,0,26,nowin,win,dlbust,bust,20,0,19,190,0.405263158,0.068421053,0.515789474,0,0.011837158
24424,94,24071,11,1,7,0,0,19,11,1,4,10,0,26,nowin,win,dlbust,bust,20,0,12,183,0.43715847,0.043715847,0.540983607,1,0.290866892
24425,133,24071,10,9,0,0,0,19,11,1,4,10,0,26,nowin,win,dlbust,bust,20,0,19,201,0.47761194,0.064676617,0.611940299,3,0.935428111
24426,43,24072,10,10,0,0,0,20,9,3,10,0,0,22,nowin,win,dlbust,bust,20,0,20,192,0.40625,0.041666667,0.609375,2,0.576671372
24427,30,24072,3,5,10,0,0,18,9,3,10,0,0,22,nowin,win,dlbust,bust,20,0,8,206,0.393203883,0.033980583,0.601941748,0,0.029324648
24428,104,24072,3,4,10,0,0,17,9,3,10,0,0,22,nowin,win,dlbust,bust,20,0,7,209,0.363636364,0.052631579,0.593301435,0,0.018359419
24429,19,24072,11,7,0,0,0,18,9,3,10,0,0,22,nowin,win,dlbust,bust,20,0,18,237,0.41350211,0.054852321,0.628691983,2,0.597373826
24430,91,24072,5,5,10,0,0,20,9,3,10,0,0,22,nowin,win,dlbust,bust,20,0,10,194,0.417525773,0.046391753,0.515463918,1,0.266616552
24431,109,24072,10,4,0,10,0,24,9,3,10,0,0,22,nowin,loss,bust,plbust,0,10,14,221,0.461538462,0.058823529,0.597285068,3,0.901830309
24432,94,24073,10,10,0,0,0,20,4,10,10,0,0,24,nowin,win,dlbust,bust,20,0,20,183,0.43715847,0.043715847,0.540983607,1,0.290866892
24433,23,24073,10,2,0,0,0,12,4,10,10,0,0,24,nowin,win,dlbust,bust,20,0,12,208,0.427884615,0.0625,0.552884615,1,0.29114424
24434,63,24073,10,8,0,0,0,18,4,10,10,0,0,24,nowin,win,dlbust,bust,20,0,18,216,0.467592593,0.037037037,0.62037037,3,0.931690496
24435,41,24073,3,9,0,0,0,12,4,10,10,0,0,24,nowin,win,dlbust,bust,20,0,12,192,0.364583333,0.036458333,0.520833333,0,0.00089702
24436,93,24073,10,9,0,0,0,19,4,10,10,0,0,24,nowin,win,dlbust,bust,20,0,19,175,0.485714286,0.051428571,0.548571429,1,0.323648091
24437,115,24073,5,4,10,0,0,19,4,10,10,0,0,24,nowin,win,dlbust,bust,20,0,9,194,0.427835052,0.041237113,0.592783505,2,0.583863602
24438,56,24074,10,3,0,10,0,23,10,5,4,0,0,19,nowin,loss,bust,plbust,0,10,13,175,0.4,0.057142857,0.582857143,0,0.026685297
24439,15,24074,10,4,0,2,1,17,10,5,4,0,0,19,nowin,loss,beat,dlwin,0,10,14,212,0.410377358,0.051886792,0.561320755,0,0.024517408
24440,69,24074,8,5,0,1,1,15,10,5,4,0,0,19,nowin,loss,beat,dlwin,0,10,13,194,0.365979381,0.030927835,0.515463918,0,0
24441,43,24074,8,4,0,10,0,22,10,5,4,0,0,19,nowin,loss,bust,plbust,0,10,12,192,0.40625,0.041666667,0.609375,2,0.576671372
24442,68,24074,7,3,3,10,0,23,10,5,4,0,0,19,nowin,loss,bust,plbust,0,10,10,205,0.434146341,0.029268293,0.6,2,0.59483189
24443,52,24074,10,5,0,5,0,20,10,5,4,0,0,19,nowin,win,plwin,beat,20,0,15,217,0.414746544,0.02764977,0.599078341,2,0.576736024
24444,142,24075,10,2,0,0,0,12,5,3,9,0,0,17,nowin,loss,beat,dlwin,0,10,12,211,0.417061611,0.047393365,0.526066351,1,0.271531309
24445,26,24075,2,7,10,0,0,19,5,3,9,0,0,17,nowin,win,plwin,beat,20,0,9,203,0.463054187,0.0591133,0.541871921,1,0.306802864
24446,28,24075,5,5,7,0,0,17,5,3,9,0,0,17,nowin,push,push,push,10,0,10,199,0.422110553,0.045226131,0.542713568,1,0.282706618
24447,53,24075,10,6,0,0,0,16,5,3,9,0,0,17,nowin,loss,beat,dlwin,0,10,16,250,0.372,0.064,0.564,0,0.013687345
24448,130,24075,2,3,4,4,0,13,5,3,9,0,0,17,nowin,loss,beat,dlwin,0,10,5,219,0.410958904,0.03652968,0.566210046,0,0.025888739
24449,112,24075,8,11,0,0,0,19,5,3,9,0,0,17,nowin,win,plwin,beat,20,0,19,203,0.448275862,0.054187192,0.600985222,3,0.889576933
24450,91,24076,5,8,0,0,0,13,5,10,8,0,0,23,nowin,win,dlbust,bust,20,0,13,194,0.417525773,0.046391753,0.515463918,1,0.266616552
24451,63,24076,3,9,0,0,0,12,5,10,8,0,0,23,nowin,win,dlbust,bust,20,0,12,216,0.467592593,0.037037037,0.62037037,3,0.931690496
24452,19,24076,10,2,0,0,0,12,5,10,8,0,0,23,nowin,win,dlbust,bust,20,0,12,237,0.41350211,0.054852321,0.628691983,2,0.597373826
24453,126,24076,11,10,0,0,0,21,5,10,8,0,0,23,win,win,dlbust,bust,25,0,21,188,0.457446809,0.074468085,0.60106383,3,0.900633203
24454,29,24076,10,10,0,0,0,20,5,10,8,0,0,23,nowin,win,dlbust,bust,20,0,20,189,0.44973545,0.058201058,0.544973545,1,0.300349439
24455,25,24076,10,6,0,0,0,16,5,10,8,0,0,23,nowin,win,dlbust,bust,20,0,16,190,0.463157895,0.063157895,0.536842105,1,0.304401563
24456,131,24077,10,9,0,0,0,19,10,5,6,0,0,21,nowin,loss,beat,dlwin,0,10,19,217,0.410138249,0.069124424,0.543778802,0,0.02015021
24457,107,24077,2,10,0,10,0,22,10,5,6,0,0,21,nowin,loss,bust,plbust,0,10,12,218,0.444954128,0.073394495,0.600917431,2,0.605210014
24458,145,24077,10,6,0,1,0,17,10,5,6,0,0,21,nowin,loss,beat,dlwin,0,10,16,188,0.441489362,0.031914894,0.622340426,2,0.617837093
24459,115,24077,1,4,10,5,0,20,10,5,6,0,0,21,nowin,loss,beat,dlwin,0,10,5,194,0.427835052,0.041237113,0.592783505,2,0.583863602
24460,129,24077,11,10,0,0,0,21,10,5,6,0,0,21,win,push,push,push,10,0,21,201,0.422885572,0.064676617,0.55721393,0,0.027255383
24461,135,24077,5,7,0,2,8,22,10,5,6,0,0,21,nowin,loss,bust,plbust,0,10,12,179,0.391061453,0.067039106,0.586592179,0,0.024924662
24462,116,24078,2,8,3,1,3,17,8,10,0,0,0,18,nowin,loss,beat,dlwin,0,10,10,195,0.425641026,0.056410256,0.538461538,1,0.28273747
24463,21,24078,10,10,0,0,0,20,8,10,0,0,0,18,nowin,win,plwin,beat,20,0,20,214,0.359813084,0.042056075,0.626168224,0,0.025263474
24464,12,24078,2,10,0,10,0,22,8,10,0,0,0,18,nowin,loss,bust,plbust,0,10,12,189,0.470899471,0.015873016,0.613756614,3,0.929171178
24465,143,24078,10,9,0,0,0,19,8,10,0,0,0,18,nowin,win,plwin,beat,20,0,19,203,0.463054187,0.044334975,0.57635468,3,0.883143365
24466,46,24078,10,9,0,0,0,19,8,10,0,0,0,18,nowin,win,plwin,beat,20,0,19,186,0.403225806,0.048387097,0.591397849,0,0.029742194
24467,100,24078,8,10,0,0,0,18,8,10,0,0,0,18,nowin,push,push,push,10,0,18,190,0.452631579,0.036842105,0.594736842,3,0.888671154
24468,35,24079,7,2,2,7,0,18,7,2,8,0,0,17,nowin,win,plwin,beat,20,0,9,202,0.410891089,0.044554455,0.633663366,2,0.598681573
24469,34,24079,10,7,0,0,0,17,7,2,8,0,0,17,nowin,push,push,push,10,0,17,202,0.5,0.079207921,0.618811881,3,0.968961434
24470,58,24079,9,4,0,5,0,18,7,2,8,0,0,17,nowin,win,plwin,beat,20,0,13,195,0.430769231,0.041025641,0.584615385,2,0.580497586
24471,25,24079,11,10,0,0,0,21,7,2,8,0,0,17,win,win,plwin,beat,25,0,21,190,0.463157895,0.063157895,0.536842105,1,0.304401563
24472,70,24079,10,5,0,5,0,20,7,2,8,0,0,17,nowin,win,plwin,beat,20,0,15,228,0.385964912,0.039473684,0.557017544,0,0.016157125
24473,27,24079,11,2,3,7,0,23,7,2,8,0,0,17,nowin,loss,bust,plbust,0,10,13,178,0.370786517,0.016853933,0.573033708,0,0.015536309
24474,31,24080,10,10,0,0,0,20,5,6,8,0,0,19,nowin,win,plwin,beat,20,0,20,188,0.473404255,0.058510638,0.515957447,1,0.300306557
24475,90,24080,2,8,3,0,0,13,5,6,8,0,0,19,nowin,loss,beat,dlwin,0,10,10,201,0.447761194,0.049751244,0.60199005,3,0.889945023
24476,35,24080,6,6,0,0,0,12,5,6,8,0,0,19,nowin,loss,beat,dlwin,0,10,12,202,0.410891089,0.044554455,0.633663366,2,0.598681573
24477,32,24080,9,4,0,0,0,13,5,6,8,0,0,19,nowin,loss,beat,dlwin,0,10,13,189,0.391534392,0.037037037,0.53968254,0,0.013579086
24478,6,24080,5,9,0,0,0,14,5,6,8,0,0,19,nowin,loss,beat,dlwin,0,10,14,191,0.439790576,0.047120419,0.581151832,1,0.31211505
24479,93,24080,8,2,5,0,0,15,5,6,8,0,0,19,nowin,loss,beat,dlwin,0,10,10,175,0.485714286,0.051428571,0.548571429,1,0.323648091
24480,33,24081,4,10,0,0,0,14,6,8,8,0,0,22,nowin,win,dlbust,bust,20,0,14,192,0.4375,0.057291667,0.625,2,0.616208916
24481,85,24081,5,2,3,7,0,17,6,8,8,0,0,22,nowin,win,dlbust,bust,20,0,7,195,0.41025641,0.066666667,0.594871795,0,0.03269711
24482,104,24081,10,4,0,0,0,14,6,8,8,0,0,22,nowin,win,dlbust,bust,20,0,14,209,0.363636364,0.052631579,0.593301435,0,0.018359419
24483,35,24081,9,3,0,0,0,12,6,8,8,0,0,22,nowin,win,dlbust,bust,20,0,12,202,0.410891089,0.044554455,0.633663366,2,0.598681573
24484,91,24081,10,11,0,0,0,21,6,8,8,0,0,22,win,win,dlbust,bust,25,0,21,194,0.417525773,0.046391753,0.515463918,1,0.266616552
24485,127,24081,2,6,10,0,0,18,6,8,8,0,0,22,nowin,win,dlbust,bust,20,0,8,201,0.402985075,0.029850746,0.60199005,0,0.032263937
24486,50,24082,10,10,0,0,0,20,10,4,10,0,0,24,nowin,win,dlbust,bust,20,0,20,202,0.405940594,0.04950495,0.54950495,0,0.020296079
24487,10,24082,4,3,7,7,0,21,10,4,10,0,0,24,nowin,win,dlbust,bust,20,0,7,191,0.413612565,0.057591623,0.596858639,2,0.574087175
24488,121,24082,7,11,0,0,0,18,10,4,10,0,0,24,nowin,win,dlbust,bust,20,0,18,195,0.456410256,0.025641026,0.512820513,1,0.288597791
24489,48,24082,9,10,0,0,0,19,10,4,10,0,0,24,nowin,win,dlbust,bust,20,0,19,203,0.413793103,0.019704433,0.600985222,2,0.577280801
24490,108,24082,7,5,0,8,0,20,10,4,10,0,0,24,nowin,win,dlbust,bust,20,0,12,193,0.435233161,0.056994819,0.559585492,1,0.298824795
24491,51,24082,8,9,0,0,0,17,10,4,10,0,0,24,nowin,win,dlbust,bust,20,0,17,189,0.529100529,0.068783069,0.608465608,3,0.993665715
24492,68,24083,10,10,0,0,0,20,9,10,0,0,0,19,nowin,win,plwin,beat,20,0,20,205,0.434146341,0.029268293,0.6,2,0.59483189
24493,69,24083,7,6,0,6,0,19,9,10,0,0,0,19,nowin,push,push,push,10,0,13,194,0.365979381,0.030927835,0.515463918,0,0
24494,2,24083,7,9,0,8,0,24,9,10,0,0,0,19,nowin,loss,bust,plbust,0,10,16,200,0.445,0.035,0.64,2,0.633962549
24495,67,24083,5,10,0,10,0,25,9,10,0,0,0,19,nowin,loss,bust,plbust,0,10,15,195,0.369230769,0.041025641,0.569230769,0,0.014139427
24496,11,24083,6,5,6,0,0,17,9,10,0,0,0,19,nowin,loss,beat,dlwin,0,10,11,236,0.457627119,0.016949153,0.588983051,3,0.889015813
24497,111,24083,5,10,0,10,0,25,9,10,0,0,0,19,nowin,loss,bust,plbust,0,10,15,180,0.433333333,0.055555556,0.611111111,2,0.602264492
24498,53,24084,11,10,0,0,0,21,4,8,5,0,0,17,win,win,plwin,beat,25,0,21,250,0.372,0.064,0.564,0,0.013687345
24499,117,24084,9,2,2,0,0,13,4,8,5,0,0,17,nowin,loss,beat,dlwin,0,10,11,173,0.410404624,0.069364162,0.606936416,2,0.578610282
24500,86,24084,10,10,0,0,0,20,4,8,5,0,0,17,nowin,win,plwin,beat,20,0,20,196,0.454081633,0.040816327,0.591836735,3,0.887566443
24501,123,24084,3,8,3,0,0,14,4,8,5,0,0,17,nowin,loss,beat,dlwin,0,10,11,205,0.43902439,0.034146341,0.614634146,2,0.609962544
24502,108,24084,8,3,10,0,0,21,4,8,5,0,0,17,nowin,win,plwin,beat,20,0,11,193,0.435233161,0.056994819,0.559585492,1,0.298824795
24503,18,24084,3,10,0,0,0,13,4,8,5,0,0,17,nowin,loss,beat,dlwin,0,10,13,182,0.461538462,0.043956044,0.587912088,3,0.892649374
24504,124,24085,10,8,0,0,0,18,8,8,8,0,0,24,nowin,win,dlbust,bust,20,0,18,202,0.47029703,0.064356436,0.584158416,3,0.899458193
24505,128,24085,4,3,2,7,6,22,8,8,8,0,0,24,nowin,loss,bust,plbust,0,10,7,227,0.356828194,0.052863436,0.577092511,0,0.012352564
24506,58,24085,11,7,0,0,0,18,8,8,8,0,0,24,nowin,win,dlbust,bust,20,0,18,195,0.430769231,0.041025641,0.584615385,2,0.580497586
24507,1,24085,5,5,5,7,0,22,8,8,8,0,0,24,nowin,loss,bust,plbust,0,10,10,197,0.406091371,0.025380711,0.649746193,2,0.606186955
24508,104,24085,6,9,0,8,0,23,8,8,8,0,0,24,nowin,loss,bust,plbust,0,10,15,209,0.363636364,0.052631579,0.593301435,0,0.018359419
24509,16,24085,10,9,0,0,0,19,8,8,8,0,0,24,nowin,win,dlbust,bust,20,0,19,220,0.427272727,0.081818182,0.6,2,0.588660176
24510,78,24086,1,2,9,0,0,12,6,10,10,0,0,26,nowin,win,dlbust,bust,20,0,3,201,0.517412935,0.034825871,0.587064677,3,0.95871112
24511,43,24086,6,10,0,0,0,16,6,10,10,0,0,26,nowin,win,dlbust,bust,20,0,16,192,0.40625,0.041666667,0.609375,2,0.576671372
24512,6,24086,10,10,0,0,0,20,6,10,10,0,0,26,nowin,win,dlbust,bust,20,0,20,191,0.439790576,0.047120419,0.581151832,1,0.31211505
24513,61,24086,5,2,7,0,0,14,6,10,10,0,0,26,nowin,win,dlbust,bust,20,0,7,194,0.427835052,0.077319588,0.603092784,2,0.591437139
24514,35,24086,10,7,0,0,0,17,6,10,10,0,0,26,nowin,win,dlbust,bust,20,0,17,202,0.410891089,0.044554455,0.633663366,2,0.598681573
24515,116,24086,4,3,4,4,0,15,6,10,10,0,0,26,nowin,win,dlbust,bust,20,0,7,195,0.425641026,0.056410256,0.538461538,1,0.28273747
24516,93,24087,10,11,0,0,0,21,10,7,0,0,0,17,win,win,plwin,beat,25,0,21,175,0.485714286,0.051428571,0.548571429,1,0.323648091
24517,37,24087,10,10,0,0,0,20,10,7,0,0,0,17,nowin,win,plwin,beat,20,0,20,208,0.394230769,0.038461538,0.581730769,0,0.024682772
24518,130,24087,6,4,10,0,0,20,10,7,0,0,0,17,nowin,win,plwin,beat,20,0,10,219,0.410958904,0.03652968,0.566210046,0,0.025888739
24519,131,24087,7,10,0,0,0,17,10,7,0,0,0,17,nowin,push,push,push,10,0,17,217,0.410138249,0.069124424,0.543778802,0,0.02015021
24520,29,24087,3,10,0,10,0,23,10,7,0,0,0,17,nowin,loss,bust,plbust,0,10,13,189,0.44973545,0.058201058,0.544973545,1,0.300349439
24521,32,24087,2,10,0,4,10,26,10,7,0,0,0,17,nowin,loss,bust,plbust,0,10,12,189,0.391534392,0.037037037,0.53968254,0,0.013579086
24522,88,24088,9,7,0,0,0,16,5,1,10,7,0,23,nowin,win,dlbust,bust,20,0,16,206,0.466019417,0.033980583,0.54368932,1,0.309467903
24523,74,24088,4,2,6,0,0,12,5,1,10,7,0,23,nowin,win,dlbust,bust,20,0,6,209,0.411483254,0.04784689,0.531100478,0,0.017448125
24524,93,24088,9,2,10,0,0,21,5,1,10,7,0,23,nowin,win,dlbust,bust,20,0,11,175,0.485714286,0.051428571,0.548571429,1,0.323648091
24525,109,24088,3,7,10,0,0,20,5,1,10,7,0,23,nowin,win,dlbust,bust,20,0,10,221,0.461538462,0.058823529,0.597285068,3,0.901830309
24526,42,24088,9,4,0,0,0,13,5,1,10,7,0,23,nowin,win,dlbust,bust,20,0,13,212,0.443396226,0.051886792,0.570754717,1,0.309181312
24527,93,24088,6,6,0,0,0,12,5,1,10,7,0,23,nowin,win,dlbust,bust,20,0,12,175,0.485714286,0.051428571,0.548571429,1,0.323648091
24528,61,24089,3,3,10,7,0,23,8,2,11,0,0,21,nowin,loss,bust,plbust,0,10,6,194,0.427835052,0.077319588,0.603092784,2,0.591437139
24529,105,24089,10,11,0,0,0,21,8,2,11,0,0,21,win,push,push,push,10,0,21,198,0.414141414,0.070707071,0.590909091,0,0.032889494
24530,44,24089,10,2,0,2,4,18,8,2,11,0,0,21,nowin,loss,beat,dlwin,0,10,12,219,0.433789954,0.050228311,0.534246575,1,0.285551035
24531,3,24089,6,10,0,10,0,26,8,2,11,0,0,21,nowin,loss,bust,plbust,0,10,16,190,0.431578947,0.026315789,0.542105263,1,0.288076384
24532,77,24089,5,7,0,10,0,22,8,2,11,0,0,21,nowin,loss,bust,plbust,0,10,12,200,0.455,0.04,0.62,3,0.916252116
24533,49,24089,3,9,0,6,0,18,8,2,11,0,0,21,nowin,loss,beat,dlwin,0,10,12,207,0.396135266,0.053140097,0.594202899,0,0.028306925
24534,79,24090,2,8,10,0,0,20,6,3,10,0,0,19,nowin,win,plwin,beat,20,0,10,211,0.436018957,0.028436019,0.672985782,2,0.650131054
24535,19,24090,6,1,10,0,0,17,6,3,10,0,0,19,nowin,loss,beat,dlwin,0,10,7,237,0.41350211,0.054852321,0.628691983,2,0.597373826
24536,146,24090,10,11,0,0,0,21,6,3,10,0,0,19,win,win,plwin,beat,25,0,21,221,0.43438914,0.040723982,0.542986425,1,0.290190091
24537,73,24090,3,4,10,0,0,17,6,3,10,0,0,19,nowin,loss,beat,dlwin,0,10,7,181,0.375690608,0.011049724,0.596685083,0,0.022795773
24538,66,24090,5,1,9,0,0,15,6,3,10,0,0,19,nowin,loss,beat,dlwin,0,10,6,217,0.456221198,0.064516129,0.626728111,3,0.924304367
24539,136,24090,1,1,10,0,0,12,6,3,10,0,0,19,nowin,loss,beat,dlwin,0,10,2,194,0.396907216,0.025773196,0.597938144,0,0.029452644
24540,71,24091,2,10,0,10,0,22,7,10,0,0,0,17,nowin,loss,bust,plbust,0,10,12,193,0.352331606,0.046632124,0.585492228,0,0.013063661
24541,88,24091,11,1,6,0,0,18,7,10,0,0,0,17,nowin,win,plwin,beat,20,0,12,206,0.466019417,0.033980583,0.54368932,1,0.309467903
24542,7,24091,6,10,0,2,0,18,7,10,0,0,0,17,nowin,win,plwin,beat,20,0,16,183,0.442622951,0.06010929,0.62295082,2,0.619303341
24543,123,24091,10,7,0,0,0,17,7,10,0,0,0,17,nowin,push,push,push,10,0,17,205,0.43902439,0.034146341,0.614634146,2,0.609962544
24544,106,24091,1,1,10,3,10,25,7,10,0,0,0,17,nowin,loss,bust,plbust,0,10,2,192,0.411458333,0.026041667,0.557291667,0,0.023854304
24545,127,24091,10,10,0,0,0,20,7,10,0,0,0,17,nowin,win,plwin,beat,20,0,20,201,0.402985075,0.029850746,0.60199005,0,0.032263937
24546,41,24092,10,11,0,0,0,21,4,8,1,4,0,17,win,win,plwin,beat,25,0,21,192,0.364583333,0.036458333,0.520833333,0,0.00089702
24547,41,24092,4,7,7,0,0,18,4,8,1,4,0,17,nowin,win,plwin,beat,20,0,11,192,0.364583333,0.036458333,0.520833333,0,0.00089702
24548,12,24092,9,10,0,0,0,19,4,8,1,4,0,17,nowin,win,plwin,beat,20,0,19,189,0.470899471,0.015873016,0.613756614,3,0.929171178
24549,35,24092,10,10,0,0,0,20,4,8,1,4,0,17,nowin,win,plwin,beat,20,0,20,202,0.410891089,0.044554455,0.633663366,2,0.598681573
24550,76,24092,10,10,0,0,0,20,4,8,1,4,0,17,nowin,win,plwin,beat,20,0,20,189,0.534391534,0.079365079,0.608465608,3,1
24551,90,24092,10,10,0,0,0,20,4,8,1,4,0,17,nowin,win,plwin,beat,20,0,20,201,0.447761194,0.049751244,0.60199005,3,0.889945023
24552,69,24093,10,10,0,0,0,20,6,6,5,0,0,17,nowin,win,plwin,beat,20,0,20,194,0.365979381,0.030927835,0.515463918,0,0
24553,28,24093,5,10,0,0,0,15,6,6,5,0,0,17,nowin,loss,beat,dlwin,0,10,15,199,0.422110553,0.045226131,0.542713568,1,0.282706618
24554,103,24093,5,1,10,0,0,16,6,6,5,0,0,17,nowin,loss,beat,dlwin,0,10,6,203,0.379310345,0.064039409,0.551724138,0,0.012869209
24555,140,24093,11,4,3,0,0,18,6,6,5,0,0,17,nowin,win,plwin,beat,20,0,15,210,0.466666667,0.023809524,0.604761905,3,0.915293335
24556,43,24093,9,11,0,0,0,20,6,6,5,0,0,17,nowin,win,plwin,beat,20,0,20,192,0.40625,0.041666667,0.609375,2,0.576671372
24557,121,24093,9,10,0,0,0,19,6,6,5,0,0,17,nowin,win,plwin,beat,20,0,19,195,0.456410256,0.025641026,0.512820513,1,0.288597791
24558,48,24094,1,6,10,0,0,17,7,10,0,0,0,17,nowin,push,push,push,10,0,7,203,0.413793103,0.019704433,0.600985222,2,0.577280801
24559,24,24094,10,5,0,4,0,19,7,10,0,0,0,17,nowin,win,plwin,beat,20,0,15,207,0.458937198,0.048309179,0.570048309,1,0.318138014
24560,112,24094,10,7,0,0,0,17,7,10,0,0,0,17,nowin,push,push,push,10,0,17,203,0.448275862,0.054187192,0.600985222,3,0.889576933
24561,68,24094,10,6,0,8,0,24,7,10,0,0,0,17,nowin,loss,bust,plbust,0,10,16,205,0.434146341,0.029268293,0.6,2,0.59483189
24562,16,24094,5,10,0,10,0,25,7,10,0,0,0,17,nowin,loss,bust,plbust,0,10,15,220,0.427272727,0.081818182,0.6,2,0.588660176
24563,16,24094,10,8,0,0,0,18,7,10,0,0,0,17,nowin,win,plwin,beat,20,0,18,220,0.427272727,0.081818182,0.6,2,0.588660176
24564,100,24095,4,3,10,0,0,17,3,10,2,5,0,20,nowin,loss,beat,dlwin,0,10,7,190,0.452631579,0.036842105,0.594736842,3,0.888671154
24565,68,24095,11,5,4,0,0,20,3,10,2,5,0,20,nowin,push,push,push,10,0,16,205,0.434146341,0.029268293,0.6,2,0.59483189
24566,70,24095,4,4,9,0,0,17,3,10,2,5,0,20,nowin,loss,beat,dlwin,0,10,8,228,0.385964912,0.039473684,0.557017544,0,0.016157125
24567,33,24095,4,5,8,0,0,17,3,10,2,5,0,20,nowin,loss,beat,dlwin,0,10,9,192,0.4375,0.057291667,0.625,2,0.616208916
24568,86,24095,9,10,0,0,0,19,3,10,2,5,0,20,nowin,loss,beat,dlwin,0,10,19,196,0.454081633,0.040816327,0.591836735,3,0.887566443
24569,100,24095,6,10,0,0,0,16,3,10,2,5,0,20,nowin,loss,beat,dlwin,0,10,16,190,0.452631579,0.036842105,0.594736842,3,0.888671154
24570,107,24096,5,3,8,0,0,16,6,10,10,0,0,26,nowin,win,dlbust,bust,20,0,8,218,0.444954128,0.073394495,0.600917431,2,0.605210014
24571,74,24096,10,3,0,0,0,13,6,10,10,0,0,26,nowin,win,dlbust,bust,20,0,13,209,0.411483254,0.04784689,0.531100478,0,0.017448125
24572,135,24096,2,8,3,0,0,13,6,10,10,0,0,26,nowin,win,dlbust,bust,20,0,10,179,0.391061453,0.067039106,0.586592179,0,0.024924662
24573,145,24096,6,2,11,0,0,19,6,10,10,0,0,26,nowin,win,dlbust,bust,20,0,8,188,0.441489362,0.031914894,0.622340426,2,0.617837093
24574,60,24096,3,10,0,0,0,13,6,10,10,0,0,26,nowin,win,dlbust,bust,20,0,13,227,0.418502203,0.022026432,0.559471366,0,0.026496258
24575,38,24096,6,7,0,0,0,13,6,10,10,0,0,26,nowin,win,dlbust,bust,20,0,13,202,0.361386139,0.03960396,0.564356436,0,0.010597953
24576,54,24097,9,3,0,0,0,12,6,2,2,10,0,20,nowin,loss,beat,dlwin,0,10,12,185,0.437837838,0.032432432,0.556756757,1,0.29899854
24577,28,24097,11,2,2,0,0,15,6,2,2,10,0,20,nowin,loss,beat,dlwin,0,10,13,199,0.422110553,0.045226131,0.542713568,1,0.282706618
24578,79,24097,10,7,0,0,0,17,6,2,2,10,0,20,nowin,loss,beat,dlwin,0,10,17,211,0.436018957,0.028436019,0.672985782,2,0.650131054
24579,89,24097,9,11,0,0,0,20,6,2,2,10,0,20,nowin,push,push,push,10,0,20,212,0.537735849,0.047169811,0.594339623,3,0.990167191
24580,119,24097,4,3,2,10,0,19,6,2,2,10,0,20,nowin,loss,beat,dlwin,0,10,7,190,0.405263158,0.068421053,0.515789474,0,0.011837158
24581,70,24097,9,8,0,0,0,17,6,2,2,10,0,20,nowin,loss,beat,dlwin,0,10,17,228,0.385964912,0.039473684,0.557017544,0,0.016157125
24582,122,24098,4,10,0,4,0,18,10,7,0,0,0,17,nowin,win,plwin,beat,20,0,14,210,0.347619048,0.052380952,0.59047619,0,0.012873677
24583,130,24098,9,10,0,0,0,19,10,7,0,0,0,17,nowin,win,plwin,beat,20,0,19,219,0.410958904,0.03652968,0.566210046,0,0.025888739
24584,33,24098,6,5,10,0,0,21,10,7,0,0,0,17,nowin,win,plwin,beat,20,0,11,192,0.4375,0.057291667,0.625,2,0.616208916
24585,42,24098,10,10,0,0,0,20,10,7,0,0,0,17,nowin,win,plwin,beat,20,0,20,212,0.443396226,0.051886792,0.570754717,1,0.309181312
24586,142,24098,3,9,0,7,0,19,10,7,0,0,0,17,nowin,win,plwin,beat,20,0,12,211,0.417061611,0.047393365,0.526066351,1,0.271531309
24587,44,24098,2,8,4,10,0,24,10,7,0,0,0,17,nowin,loss,bust,plbust,0,10,10,219,0.433789954,0.050228311,0.534246575,1,0.285551035
24588,106,24099,4,5,10,0,0,19,8,2,10,0,0,20,nowin,loss,beat,dlwin,0,10,9,192,0.411458333,0.026041667,0.557291667,0,0.023854304
24589,5,24099,10,7,0,0,0,17,8,2,10,0,0,20,nowin,loss,beat,dlwin,0,10,17,203,0.42364532,0.02955665,0.596059113,2,0.582508076
24590,111,24099,3,10,0,9,0,22,8,2,10,0,0,20,nowin,loss,bust,plbust,0,10,13,180,0.433333333,0.055555556,0.611111111,2,0.602264492
24591,38,24099,7,3,10,0,0,20,8,2,10,0,0,20,nowin,push,push,push,10,0,10,202,0.361386139,0.03960396,0.564356436,0,0.010597953
24592,82,24099,2,9,9,0,0,20,8,2,10,0,0,20,nowin,push,push,push,10,0,11,225,0.408888889,0.075555556,0.577777778,0,0.028101874
24593,1,24099,10,9,0,0,0,19,8,2,10,0,0,20,nowin,loss,beat,dlwin,0,10,19,197,0.406091371,0.025380711,0.649746193,2,0.606186955
24594,67,24100,10,8,0,0,0,18,10,10,0,0,0,20,nowin,loss,beat,dlwin,0,10,18,195,0.369230769,0.041025641,0.569230769,0,0.014139427
24595,6,24100,9,5,0,8,0,22,10,10,0,0,0,20,nowin,loss,bust,plbust,0,10,14,191,0.439790576,0.047120419,0.581151832,1,0.31211505
24596,4,24100,5,8,0,10,0,23,10,10,0,0,0,20,nowin,loss,bust,plbust,0,10,13,217,0.460829493,0.036866359,0.562211982,1,0.315432839
24597,106,24100,7,5,0,5,0,17,10,10,0,0,0,20,nowin,loss,beat,dlwin,0,10,12,192,0.411458333,0.026041667,0.557291667,0,0.023854304
24598,123,24100,8,9,0,0,0,17,10,10,0,0,0,20,nowin,loss,beat,dlwin,0,10,17,205,0.43902439,0.034146341,0.614634146,2,0.609962544
24599,122,24100,3,1,10,3,0,17,10,10,0,0,0,20,nowin,loss,beat,dlwin,0,10,4,210,0.347619048,0.052380952,0.59047619,0,0.012873677
24600,120,24101,4,7,10,0,0,21,3,10,10,0,0,23,nowin,win,dlbust,bust,20,0,11,202,0.440594059,0.034653465,0.618811881,2,0.614441029
24601,38,24101,9,5,0,0,0,14,3,10,10,0,0,23,nowin,win,dlbust,bust,20,0,14,202,0.361386139,0.03960396,0.564356436,0,0.010597953
24602,4,24101,1,5,8,0,0,14,3,10,10,0,0,23,nowin,win,dlbust,bust,20,0,6,217,0.460829493,0.036866359,0.562211982,1,0.315432839
24603,36,24101,5,3,11,0,0,19,3,10,10,0,0,23,nowin,win,dlbust,bust,20,0,8,229,0.445414847,0.056768559,0.655021834,2,0.645370571
24604,40,24101,2,3,10,0,0,15,3,10,10,0,0,23,nowin,win,dlbust,bust,20,0,5,196,0.367346939,0.030612245,0.617346939,0,0.025358183
24605,60,24101,10,6,0,0,0,16,3,10,10,0,0,23,nowin,win,dlbust,bust,20,0,16,227,0.418502203,0.022026432,0.559471366,0,0.026496258
24606,84,24102,9,5,0,0,0,14,5,10,6,0,0,21,nowin,loss,beat,dlwin,0,10,14,195,0.379487179,0.056410256,0.569230769,0,0.017209119
24607,32,24102,2,10,0,0,0,12,5,10,6,0,0,21,nowin,loss,beat,dlwin,0,10,12,189,0.391534392,0.037037037,0.53968254,0,0.013579086
24608,86,24102,6,7,0,0,0,13,5,10,6,0,0,21,nowin,loss,beat,dlwin,0,10,13,196,0.454081633,0.040816327,0.591836735,3,0.887566443
24609,136,24102,7,6,0,0,0,13,5,10,6,0,0,21,nowin,loss,beat,dlwin,0,10,13,194,0.396907216,0.025773196,0.597938144,0,0.029452644
24610,2,24102,5,10,0,0,0,15,5,10,6,0,0,21,nowin,loss,beat,dlwin,0,10,15,200,0.445,0.035,0.64,2,0.633962549
24611,68,24102,4,10,0,0,0,14,5,10,6,0,0,21,nowin,loss,beat,dlwin,0,10,14,205,0.434146341,0.029268293,0.6,2,0.59483189
24612,10,24103,2,3,9,10,0,24,1,3,9,10,0,23,nowin,loss,bust,plbust,0,10,5,191,0.413612565,0.057591623,0.596858639,2,0.574087175
24613,56,24103,10,7,0,0,0,17,1,3,9,10,0,23,nowin,win,dlbust,bust,20,0,17,175,0.4,0.057142857,0.582857143,0,0.026685297
24614,144,24103,10,5,0,10,0,25,1,3,9,10,0,23,nowin,loss,bust,plbust,0,10,15,202,0.386138614,0.054455446,0.564356436,0,0.018006244
24615,90,24103,10,5,0,2,0,17,1,3,9,10,0,23,nowin,win,dlbust,bust,20,0,15,201,0.447761194,0.049751244,0.60199005,3,0.889945023
24616,149,24103,2,6,5,1,10,24,1,3,9,10,0,23,nowin,loss,bust,plbust,0,10,8,225,0.457777778,0.057777778,0.648888889,2,0.651965595
24617,139,24103,4,10,0,7,0,21,1,3,9,10,0,23,nowin,win,dlbust,bust,20,0,14,192,0.380208333,0.036458333,0.59375,0,0.023429169
24618,108,24104,10,4,0,0,0,14,4,1,10,10,0,25,nowin,win,dlbust,bust,20,0,14,193,0.435233161,0.056994819,0.559585492,1,0.298824795
24619,80,24104,9,11,0,0,0,20,4,1,10,10,0,25,nowin,win,dlbust,bust,20,0,20,186,0.419354839,0.059139785,0.623655914,2,0.59892924
24620,99,24104,11,8,0,0,0,19,4,1,10,10,0,25,nowin,win,dlbust,bust,20,0,19,207,0.47826087,0.062801932,0.637681159,3,0.961418446
24621,95,24104,1,3,10,0,0,14,4,1,10,10,0,25,nowin,win,dlbust,bust,20,0,4,218,0.412844037,0.04587156,0.559633028,0,0.024842385
24622,128,24104,5,5,10,0,0,20,4,1,10,10,0,25,nowin,win,dlbust,bust,20,0,10,227,0.356828194,0.052863436,0.577092511,0,0.012352564
24623,144,24104,2,5,10,0,0,17,4,1,10,10,0,25,nowin,win,dlbust,bust,20,0,7,202,0.386138614,0.054455446,0.564356436,0,0.018006244
24624,80,24105,9,3,0,0,0,12,5,7,10,0,0,22,nowin,win,dlbust,bust,20,0,12,186,0.419354839,0.059139785,0.623655914,2,0.59892924
24625,119,24105,7,5,0,0,0,12,5,7,10,0,0,22,nowin,win,dlbust,bust,20,0,12,190,0.405263158,0.068421053,0.515789474,0,0.011837158
24626,139,24105,2,3,6,10,0,21,5,7,10,0,0,22,nowin,win,dlbust,bust,20,0,5,192,0.380208333,0.036458333,0.59375,0,0.023429169
24627,28,24105,6,10,0,0,0,16,5,7,10,0,0,22,nowin,win,dlbust,bust,20,0,16,199,0.422110553,0.045226131,0.542713568,1,0.282706618
24628,30,24105,6,6,0,0,0,12,5,7,10,0,0,22,nowin,win,dlbust,bust,20,0,12,206,0.393203883,0.033980583,0.601941748,0,0.029324648
24629,85,24105,3,7,8,0,0,18,5,7,10,0,0,22,nowin,win,dlbust,bust,20,0,10,195,0.41025641,0.066666667,0.594871795,0,0.03269711
24630,21,24106,1,5,8,10,0,24,10,11,0,0,0,21,nowin,loss,bust,plbust,0,10,6,214,0.359813084,0.042056075,0.626168224,0,0.025263474
24631,92,24106,2,2,2,1,5,12,10,11,0,0,0,21,nowin,loss,beat,dlwin,0,10,4,186,0.446236559,0.059139785,0.564516129,1,0.307826125
24632,137,24106,10,10,0,0,0,20,10,11,0,0,0,21,nowin,loss,beat,dlwin,0,10,20,194,0.417525773,0.046391753,0.536082474,1,0.276714602
24633,70,24106,11,8,0,0,0,19,10,11,0,0,0,21,nowin,loss,beat,dlwin,0,10,19,228,0.385964912,0.039473684,0.557017544,0,0.016157125
24634,11,24106,11,7,0,0,0,18,10,11,0,0,0,21,nowin,loss,beat,dlwin,0,10,18,236,0.457627119,0.016949153,0.588983051,3,0.889015813
24635,118,24106,9,6,0,3,0,18,10,11,0,0,0,21,nowin,loss,beat,dlwin,0,10,15,216,0.393518519,0.037037037,0.555555556,0,0.018059873
24636,62,24107,9,10,0,0,0,19,5,4,3,9,0,21,nowin,loss,beat,dlwin,0,10,19,178,0.370786517,0.028089888,0.54494382,0,0.008657722
24637,39,24107,10,10,0,0,0,20,5,4,3,9,0,21,nowin,loss,beat,dlwin,0,10,20,191,0.429319372,0.062827225,0.57591623,0,0.033760763
24638,5,24107,8,6,0,0,0,14,5,4,3,9,0,21,nowin,loss,beat,dlwin,0,10,14,203,0.42364532,0.02955665,0.596059113,2,0.582508076
24639,7,24107,8,11,0,0,0,19,5,4,3,9,0,21,nowin,loss,beat,dlwin,0,10,19,183,0.442622951,0.06010929,0.62295082,2,0.619303341
24640,79,24107,3,2,11,0,0,16,5,4,3,9,0,21,nowin,loss,beat,dlwin,0,10,5,211,0.436018957,0.028436019,0.672985782,2,0.650131054
24641,110,24107,10,9,0,0,0,19,5,4,3,9,0,21,nowin,loss,beat,dlwin,0,10,19,192,0.416666667,0.046875,0.557291667,0,0.025413132
24642,119,24108,7,10,0,0,0,17,3,3,10,8,0,24,nowin,win,dlbust,bust,20,0,17,190,0.405263158,0.068421053,0.515789474,0,0.011837158
24643,147,24108,10,5,0,0,0,15,3,3,10,8,0,24,nowin,win,dlbust,bust,20,0,15,205,0.380487805,0.014634146,0.536585366,0,0.00951447
24644,21,24108,10,10,0,0,0,20,3,3,10,8,0,24,nowin,win,dlbust,bust,20,0,20,214,0.359813084,0.042056075,0.626168224,0,0.025263474
24645,146,24108,10,9,0,0,0,19,3,3,10,8,0,24,nowin,win,dlbust,bust,20,0,19,221,0.43438914,0.040723982,0.542986425,1,0.290190091
24646,126,24108,7,3,9,0,0,19,3,3,10,8,0,24,nowin,win,dlbust,bust,20,0,10,188,0.457446809,0.074468085,0.60106383,3,0.900633203
24647,3,24108,6,9,0,0,0,15,3,3,10,8,0,24,nowin,win,dlbust,bust,20,0,15,190,0.431578947,0.026315789,0.542105263,1,0.288076384
24648,68,24109,2,3,5,5,0,15,4,8,10,0,0,22,nowin,win,dlbust,bust,20,0,5,205,0.434146341,0.029268293,0.6,2,0.59483189
24649,65,24109,10,4,0,0,0,14,4,8,10,0,0,22,nowin,win,dlbust,bust,20,0,14,203,0.492610837,0.054187192,0.571428571,3,0.913702814
24650,76,24109,11,8,0,0,0,19,4,8,10,0,0,22,nowin,win,dlbust,bust,20,0,19,189,0.534391534,0.079365079,0.608465608,3,1
24651,65,24109,10,10,0,0,0,20,4,8,10,0,0,22,nowin,win,dlbust,bust,20,0,20,203,0.492610837,0.054187192,0.571428571,3,0.913702814
24652,16,24109,11,10,0,0,0,21,4,8,10,0,0,22,win,win,dlbust,bust,25,0,21,220,0.427272727,0.081818182,0.6,2,0.588660176
24653,132,24109,10,4,0,0,0,14,4,8,10,0,0,22,nowin,win,dlbust,bust,20,0,14,194,0.412371134,0.036082474,0.649484536,2,0.611633238
24654,49,24110,2,7,10,0,0,19,8,11,0,0,0,19,nowin,push,push,push,10,0,9,207,0.396135266,0.053140097,0.594202899,0,0.028306925
24655,146,24110,10,7,0,0,0,17,8,11,0,0,0,19,nowin,loss,beat,dlwin,0,10,17,221,0.43438914,0.040723982,0.542986425,1,0.290190091
24656,68,24110,2,1,10,8,0,21,8,11,0,0,0,19,nowin,win,plwin,beat,20,0,3,205,0.434146341,0.029268293,0.6,2,0.59483189
24657,132,24110,7,9,0,10,0,26,8,11,0,0,0,19,nowin,loss,bust,plbust,0,10,16,194,0.412371134,0.036082474,0.649484536,2,0.611633238
24658,44,24110,11,10,0,0,0,21,8,11,0,0,0,19,win,win,plwin,beat,25,0,21,219,0.433789954,0.050228311,0.534246575,1,0.285551035
24659,91,24110,11,7,0,0,0,18,8,11,0,0,0,19,nowin,loss,beat,dlwin,0,10,18,194,0.417525773,0.046391753,0.515463918,1,0.266616552
24660,143,24111,10,4,0,4,0,18,11,2,6,0,0,19,nowin,loss,beat,dlwin,0,10,14,203,0.463054187,0.044334975,0.57635468,3,0.883143365
24661,24,24111,4,10,0,1,3,18,11,2,6,0,0,19,nowin,loss,beat,dlwin,0,10,14,207,0.458937198,0.048309179,0.570048309,1,0.318138014
24662,84,24111,10,10,0,0,0,20,11,2,6,0,0,19,nowin,win,plwin,beat,20,0,20,195,0.379487179,0.056410256,0.569230769,0,0.017209119
24663,131,24111,7,8,0,7,0,22,11,2,6,0,0,19,nowin,loss,bust,plbust,0,10,15,217,0.410138249,0.069124424,0.543778802,0,0.02015021
24664,100,24111,8,9,0,0,0,17,11,2,6,0,0,19,nowin,loss,beat,dlwin,0,10,17,190,0.452631579,0.036842105,0.594736842,3,0.888671154
24665,104,24111,10,2,0,5,0,17,11,2,6,0,0,19,nowin,loss,beat,dlwin,0,10,12,209,0.363636364,0.052631579,0.593301435,0,0.018359419
24666,82,24112,10,4,0,4,0,18,10,7,0,0,0,17,nowin,win,plwin,beat,20,0,14,225,0.408888889,0.075555556,0.577777778,0,0.028101874
24667,21,24112,10,7,0,0,0,17,10,7,0,0,0,17,nowin,push,push,push,10,0,17,214,0.359813084,0.042056075,0.626168224,0,0.025263474
24668,136,24112,2,8,6,5,0,21,10,7,0,0,0,17,nowin,win,plwin,beat,20,0,10,194,0.396907216,0.025773196,0.597938144,0,0.029452644
24669,106,24112,2,10,0,6,0,18,10,7,0,0,0,17,nowin,win,plwin,beat,20,0,12,192,0.411458333,0.026041667,0.557291667,0,0.023854304
24670,10,24112,6,9,0,10,0,25,10,7,0,0,0,17,nowin,loss,bust,plbust,0,10,15,191,0.413612565,0.057591623,0.596858639,2,0.574087175
24671,20,24112,4,5,8,0,0,17,10,7,0,0,0,17,nowin,push,push,push,10,0,9,186,0.456989247,0.037634409,0.537634409,1,0.301097108
24672,70,24113,7,2,10,0,0,19,3,10,10,0,0,23,nowin,win,dlbust,bust,20,0,9,228,0.385964912,0.039473684,0.557017544,0,0.016157125
24673,25,24113,7,10,0,0,0,17,3,10,10,0,0,23,nowin,win,dlbust,bust,20,0,17,190,0.463157895,0.063157895,0.536842105,1,0.304401563
24674,144,24113,6,1,6,0,0,13,3,10,10,0,0,23,nowin,win,dlbust,bust,20,0,7,202,0.386138614,0.054455446,0.564356436,0,0.018006244
24675,95,24113,3,10,0,0,0,13,3,10,10,0,0,23,nowin,win,dlbust,bust,20,0,13,218,0.412844037,0.04587156,0.559633028,0,0.024842385
24676,35,24113,8,3,10,0,0,21,3,10,10,0,0,23,nowin,win,dlbust,bust,20,0,11,202,0.410891089,0.044554455,0.633663366,2,0.598681573
24677,44,24113,10,10,0,0,0,20,3,10,10,0,0,23,nowin,win,dlbust,bust,20,0,20,219,0.433789954,0.050228311,0.534246575,1,0.285551035
24678,89,24114,5,2,5,1,0,13,3,11,4,0,0,18,nowin,loss,beat,dlwin,0,10,7,212,0.537735849,0.047169811,0.594339623,3,0.990167191
24679,115,24114,3,7,10,0,0,20,3,11,4,0,0,18,nowin,win,plwin,beat,20,0,10,194,0.427835052,0.041237113,0.592783505,2,0.583863602
24680,53,24114,4,9,0,0,0,13,3,11,4,0,0,18,nowin,loss,beat,dlwin,0,10,13,250,0.372,0.064,0.564,0,0.013687345
24681,70,24114,9,2,10,0,0,21,3,11,4,0,0,18,nowin,win,plwin,beat,20,0,11,228,0.385964912,0.039473684,0.557017544,0,0.016157125
24682,144,24114,10,10,0,0,0,20,3,11,4,0,0,18,nowin,win,plwin,beat,20,0,20,202,0.386138614,0.054455446,0.564356436,0,0.018006244
24683,54,24114,2,10,0,5,0,17,3,11,4,0,0,18,nowin,loss,beat,dlwin,0,10,12,185,0.437837838,0.032432432,0.556756757,1,0.29899854
24684,39,24115,3,3,11,0,0,17,8,10,0,0,0,18,nowin,loss,beat,dlwin,0,10,6,191,0.429319372,0.062827225,0.57591623,0,0.033760763
24685,11,24115,10,10,0,0,0,20,8,10,0,0,0,18,nowin,win,plwin,beat,20,0,20,236,0.457627119,0.016949153,0.588983051,3,0.889015813
24686,111,24115,7,7,0,10,0,24,8,10,0,0,0,18,nowin,loss,bust,plbust,0,10,14,180,0.433333333,0.055555556,0.611111111,2,0.602264492
24687,34,24115,7,10,0,0,0,17,8,10,0,0,0,18,nowin,loss,beat,dlwin,0,10,17,202,0.5,0.079207921,0.618811881,3,0.968961434
24688,25,24115,5,6,10,0,0,21,8,10,0,0,0,18,nowin,win,plwin,beat,20,0,11,190,0.463157895,0.063157895,0.536842105,1,0.304401563
24689,92,24115,10,10,0,0,0,20,8,10,0,0,0,18,nowin,win,plwin,beat,20,0,20,186,0.446236559,0.059139785,0.564516129,1,0.307826125
24690,46,24116,9,10,0,0,0,19,7,10,0,0,0,17,nowin,win,plwin,beat,20,0,19,186,0.403225806,0.048387097,0.591397849,0,0.029742194
24691,7,24116,8,10,0,0,0,18,7,10,0,0,0,17,nowin,win,plwin,beat,20,0,18,183,0.442622951,0.06010929,0.62295082,2,0.619303341
24692,70,24116,3,2,2,6,9,22,7,10,0,0,0,17,nowin,loss,bust,plbust,0,10,5,228,0.385964912,0.039473684,0.557017544,0,0.016157125
24693,74,24116,8,5,0,10,0,23,7,10,0,0,0,17,nowin,loss,bust,plbust,0,10,13,209,0.411483254,0.04784689,0.531100478,0,0.017448125
24694,47,24116,5,5,5,6,0,21,7,10,0,0,0,17,nowin,win,plwin,beat,20,0,10,210,0.438095238,0.057142857,0.623809524,2,0.615868808
24695,63,24116,6,3,5,2,3,19,7,10,0,0,0,17,nowin,win,plwin,beat,20,0,9,216,0.467592593,0.037037037,0.62037037,3,0.931690496
24696,137,24117,9,10,0,0,0,19,7,9,7,0,0,23,nowin,win,dlbust,bust,20,0,19,194,0.417525773,0.046391753,0.536082474,1,0.276714602
24697,49,24117,4,5,3,10,0,22,7,9,7,0,0,23,nowin,loss,bust,plbust,0,10,9,207,0.396135266,0.053140097,0.594202899,0,0.028306925
24698,19,24117,6,2,8,4,0,20,7,9,7,0,0,23,nowin,win,dlbust,bust,20,0,8,237,0.41350211,0.054852321,0.628691983,2,0.597373826
24699,93,24117,6,3,10,0,0,19,7,9,7,0,0,23,nowin,win,dlbust,bust,20,0,9,175,0.485714286,0.051428571,0.548571429,1,0.323648091
24700,34,24117,8,10,0,0,0,18,7,9,7,0,0,23,nowin,win,dlbust,bust,20,0,18,202,0.5,0.079207921,0.618811881,3,0.968961434
24701,23,24117,3,8,10,0,0,21,7,9,7,0,0,23,nowin,win,dlbust,bust,20,0,11,208,0.427884615,0.0625,0.552884615,1,0.29114424
24702,130,24118,8,4,0,0,0,12,6,4,11,0,0,21,nowin,loss,beat,dlwin,0,10,12,219,0.410958904,0.03652968,0.566210046,0,0.025888739
24703,65,24118,10,10,0,0,0,20,6,4,11,0,0,21,nowin,loss,beat,dlwin,0,10,20,203,0.492610837,0.054187192,0.571428571,3,0.913702814
24704,28,24118,1,5,10,0,0,16,6,4,11,0,0,21,nowin,loss,beat,dlwin,0,10,6,199,0.422110553,0.045226131,0.542713568,1,0.282706618
24705,49,24118,10,10,0,0,0,20,6,4,11,0,0,21,nowin,loss,beat,dlwin,0,10,20,207,0.396135266,0.053140097,0.594202899,0,0.028306925
24706,96,24118,7,10,0,0,0,17,6,4,11,0,0,21,nowin,loss,beat,dlwin,0,10,17,190,0.468421053,0.057894737,0.584210526,3,0.897263354
24707,75,24118,8,8,0,0,0,16,6,4,11,0,0,21,nowin,loss,beat,dlwin,0,10,16,191,0.418848168,0.052356021,0.570680628,0,0.029344702
24708,39,24119,10,5,0,9,0,24,7,11,0,0,0,18,nowin,loss,bust,plbust,0,10,15,191,0.429319372,0.062827225,0.57591623,0,0.033760763
24709,110,24119,5,10,0,7,0,22,7,11,0,0,0,18,nowin,loss,bust,plbust,0,10,15,192,0.416666667,0.046875,0.557291667,0,0.025413132
24710,45,24119,10,4,0,8,0,22,7,11,0,0,0,18,nowin,loss,bust,plbust,0,10,14,196,0.428571429,0.051020408,0.612244898,2,0.598821767
24711,42,24119,11,10,0,0,0,21,7,11,0,0,0,18,win,win,plwin,beat,25,0,21,212,0.443396226,0.051886792,0.570754717,1,0.309181312
24712,75,24119,4,6,10,0,0,20,7,11,0,0,0,18,nowin,win,plwin,beat,20,0,10,191,0.418848168,0.052356021,0.570680628,0,0.029344702
24713,98,24119,7,5,0,8,0,20,7,11,0,0,0,18,nowin,win,plwin,beat,20,0,12,220,0.422727273,0.054545455,0.55,1,0.28664435
24714,31,24120,10,10,0,0,0,20,9,10,0,0,0,19,nowin,win,plwin,beat,20,0,20,188,0.473404255,0.058510638,0.515957447,1,0.300306557
24715,58,24120,10,8,0,0,0,18,9,10,0,0,0,19,nowin,loss,beat,dlwin,0,10,18,195,0.430769231,0.041025641,0.584615385,2,0.580497586
24716,126,24120,9,8,0,0,0,17,9,10,0,0,0,19,nowin,loss,beat,dlwin,0,10,17,188,0.457446809,0.074468085,0.60106383,3,0.900633203
24717,108,24120,3,10,0,6,0,19,9,10,0,0,0,19,nowin,push,push,push,10,0,13,193,0.435233161,0.056994819,0.559585492,1,0.298824795
24718,85,24120,3,10,0,10,0,23,9,10,0,0,0,19,nowin,loss,bust,plbust,0,10,13,195,0.41025641,0.066666667,0.594871795,0,0.03269711
24719,130,24120,2,1,10,10,0,23,9,10,0,0,0,19,nowin,loss,bust,plbust,0,10,3,219,0.410958904,0.03652968,0.566210046,0,0.025888739
24720,120,24121,8,11,0,0,0,19,5,10,10,0,0,25,nowin,win,dlbust,bust,20,0,19,202,0.440594059,0.034653465,0.618811881,2,0.614441029
24721,83,24121,10,5,0,0,0,15,5,10,10,0,0,25,nowin,win,dlbust,bust,20,0,15,193,0.424870466,0.051813472,0.678756477,2,0.644360335
24722,107,24121,10,10,0,0,0,20,5,10,10,0,0,25,nowin,win,dlbust,bust,20,0,20,218,0.444954128,0.073394495,0.600917431,2,0.605210014
24723,70,24121,6,8,0,0,0,14,5,10,10,0,0,25,nowin,win,dlbust,bust,20,0,14,228,0.385964912,0.039473684,0.557017544,0,0.016157125
24724,63,24121,4,7,6,0,0,17,5,10,10,0,0,25,nowin,win,dlbust,bust,20,0,11,216,0.467592593,0.037037037,0.62037037,3,0.931690496
24725,75,24121,7,4,3,0,0,14,5,10,10,0,0,25,nowin,win,dlbust,bust,20,0,11,191,0.418848168,0.052356021,0.570680628,0,0.029344702
24726,33,24122,7,4,10,0,0,21,4,10,1,10,0,25,nowin,win,dlbust,bust,20,0,11,192,0.4375,0.057291667,0.625,2,0.616208916
24727,111,24122,10,2,0,0,0,12,4,10,1,10,0,25,nowin,win,dlbust,bust,20,0,12,180,0.433333333,0.055555556,0.611111111,2,0.602264492
24728,53,24122,10,9,0,0,0,19,4,10,1,10,0,25,nowin,win,dlbust,bust,20,0,19,250,0.372,0.064,0.564,0,0.013687345
24729,118,24122,10,10,0,0,0,20,4,10,1,10,0,25,nowin,win,dlbust,bust,20,0,20,216,0.393518519,0.037037037,0.555555556,0,0.018059873
24730,40,24122,10,2,0,0,0,12,4,10,1,10,0,25,nowin,win,dlbust,bust,20,0,12,196,0.367346939,0.030612245,0.617346939,0,0.025358183
24731,47,24122,10,3,0,0,0,13,4,10,1,10,0,25,nowin,win,dlbust,bust,20,0,13,210,0.438095238,0.057142857,0.623809524,2,0.615868808
24732,110,24123,4,10,0,8,0,22,10,10,0,0,0,20,nowin,loss,bust,plbust,0,10,14,192,0.416666667,0.046875,0.557291667,0,0.025413132
24733,135,24123,9,3,0,2,1,15,10,10,0,0,0,20,nowin,loss,beat,dlwin,0,10,12,179,0.391061453,0.067039106,0.586592179,0,0.024924662
24734,69,24123,4,3,7,10,0,24,10,10,0,0,0,20,nowin,loss,bust,plbust,0,10,7,194,0.365979381,0.030927835,0.515463918,0,0
24735,71,24123,7,6,0,7,0,20,10,10,0,0,0,20,nowin,push,push,push,10,0,13,193,0.352331606,0.046632124,0.585492228,0,0.013063661
24736,134,24123,9,10,0,0,0,19,10,10,0,0,0,20,nowin,loss,beat,dlwin,0,10,19,185,0.443243243,0.021621622,0.545945946,1,0.296939509
24737,147,24123,4,11,4,0,0,19,10,10,0,0,0,20,nowin,loss,beat,dlwin,0,10,15,205,0.380487805,0.014634146,0.536585366,0,0.00951447
24738,128,24124,6,6,0,0,0,12,6,3,5,3,0,17,nowin,loss,beat,dlwin,0,10,12,227,0.356828194,0.052863436,0.577092511,0,0.012352564
24739,93,24124,11,9,0,0,0,20,6,3,5,3,0,17,nowin,win,plwin,beat,20,0,20,175,0.485714286,0.051428571,0.548571429,1,0.323648091
24740,50,24124,10,8,0,0,0,18,6,3,5,3,0,17,nowin,win,plwin,beat,20,0,18,202,0.405940594,0.04950495,0.54950495,0,0.020296079
24741,89,24124,10,8,0,0,0,18,6,3,5,3,0,17,nowin,win,plwin,beat,20,0,18,212,0.537735849,0.047169811,0.594339623,3,0.990167191
24742,75,24124,10,7,0,0,0,17,6,3,5,3,0,17,nowin,push,push,push,10,0,17,191,0.418848168,0.052356021,0.570680628,0,0.029344702
24743,44,24124,4,2,11,0,0,17,6,3,5,3,0,17,nowin,push,push,push,10,0,6,219,0.433789954,0.050228311,0.534246575,1,0.285551035
24744,104,24125,10,10,0,0,0,20,10,3,10,0,0,23,nowin,win,dlbust,bust,20,0,20,209,0.363636364,0.052631579,0.593301435,0,0.018359419
24745,127,24125,9,10,0,0,0,19,10,3,10,0,0,23,nowin,win,dlbust,bust,20,0,19,201,0.402985075,0.029850746,0.60199005,0,0.032263937
24746,57,24125,8,10,0,0,0,18,10,3,10,0,0,23,nowin,win,dlbust,bust,20,0,18,192,0.46875,0.052083333,0.59375,3,0.907001181
24747,122,24125,7,10,0,0,0,17,10,3,10,0,0,23,nowin,win,dlbust,bust,20,0,17,210,0.347619048,0.052380952,0.59047619,0,0.012873677
24748,28,24125,10,10,0,0,0,20,10,3,10,0,0,23,nowin,win,dlbust,bust,20,0,20,199,0.422110553,0.045226131,0.542713568,1,0.282706618
24749,59,24125,10,3,0,3,9,25,10,3,10,0,0,23,nowin,loss,bust,plbust,0,10,13,228,0.429824561,0.048245614,0.543859649,1,0.287885446
24750,88,24126,3,10,0,10,0,23,10,4,5,0,0,19,nowin,loss,bust,plbust,0,10,13,206,0.466019417,0.033980583,0.54368932,1,0.309467903
24751,79,24126,10,7,0,0,0,17,10,4,5,0,0,19,nowin,loss,beat,dlwin,0,10,17,211,0.436018957,0.028436019,0.672985782,2,0.650131054
24752,9,24126,2,10,0,7,0,19,10,4,5,0,0,19,nowin,push,push,push,10,0,12,194,0.37628866,0.015463918,0.541237113,0,0.009396796
24753,19,24126,4,6,3,10,0,23,10,4,5,0,0,19,nowin,loss,bust,plbust,0,10,10,237,0.41350211,0.054852321,0.628691983,2,0.597373826
24754,140,24126,4,10,0,10,0,24,10,4,5,0,0,19,nowin,loss,bust,plbust,0,10,14,210,0.466666667,0.023809524,0.604761905,3,0.915293335
24755,58,24126,6,9,0,4,0,19,10,4,5,0,0,19,nowin,push,push,push,10,0,15,195,0.430769231,0.041025641,0.584615385,2,0.580497586
24756,78,24127,10,10,0,0,0,20,1,2,10,5,0,18,nowin,win,plwin,beat,20,0,20,201,0.517412935,0.034825871,0.587064677,3,0.95871112
24757,55,24127,2,10,0,3,10,25,1,2,10,5,0,18,nowin,loss,bust,plbust,0,10,12,191,0.371727749,0.057591623,0.54973822,0,0.01011347
24758,45,24127,7,10,0,0,0,17,1,2,10,5,0,18,nowin,loss,beat,dlwin,0,10,17,196,0.428571429,0.051020408,0.612244898,2,0.598821767
24759,76,24127,9,9,0,0,0,18,1,2,10,5,0,18,nowin,push,push,push,10,0,18,189,0.534391534,0.079365079,0.608465608,3,1
24760,125,24127,8,3,4,2,0,17,1,2,10,5,0,18,nowin,loss,beat,dlwin,0,10,11,219,0.438356164,0.050228311,0.575342466,1,0.308411257
24761,45,24127,5,10,0,8,0,23,1,2,10,5,0,18,nowin,loss,bust,plbust,0,10,15,196,0.428571429,0.051020408,0.612244898,2,0.598821767
24762,131,24128,7,10,0,0,0,17,10,10,0,0,0,20,nowin,loss,beat,dlwin,0,10,17,217,0.410138249,0.069124424,0.543778802,0,0.02015021
24763,98,24128,3,8,8,0,0,19,10,10,0,0,0,20,nowin,loss,beat,dlwin,0,10,11,220,0.422727273,0.054545455,0.55,1,0.28664435
24764,85,24128,10,2,0,1,10,23,10,10,0,0,0,20,nowin,loss,bust,plbust,0,10,12,195,0.41025641,0.066666667,0.594871795,0,0.03269711
24765,44,24128,4,3,7,10,0,24,10,10,0,0,0,20,nowin,loss,bust,plbust,0,10,7,219,0.433789954,0.050228311,0.534246575,1,0.285551035
24766,34,24128,6,10,0,10,0,26,10,10,0,0,0,20,nowin,loss,bust,plbust,0,10,16,202,0.5,0.079207921,0.618811881,3,0.968961434
24767,37,24128,2,10,0,1,5,18,10,10,0,0,0,20,nowin,loss,beat,dlwin,0,10,12,208,0.394230769,0.038461538,0.581730769,0,0.024682772
24768,70,24129,7,10,0,0,0,17,4,10,8,0,0,22,nowin,win,dlbust,bust,20,0,17,228,0.385964912,0.039473684,0.557017544,0,0.016157125
24769,16,24129,3,7,7,0,0,17,4,10,8,0,0,22,nowin,win,dlbust,bust,20,0,10,220,0.427272727,0.081818182,0.6,2,0.588660176
24770,91,24129,11,4,6,0,0,21,4,10,8,0,0,22,nowin,win,dlbust,bust,20,0,15,194,0.417525773,0.046391753,0.515463918,1,0.266616552
24771,147,24129,10,5,0,0,0,15,4,10,8,0,0,22,nowin,win,dlbust,bust,20,0,15,205,0.380487805,0.014634146,0.536585366,0,0.00951447
24772,23,24129,7,10,0,0,0,17,4,10,8,0,0,22,nowin,win,dlbust,bust,20,0,17,208,0.427884615,0.0625,0.552884615,1,0.29114424
24773,101,24129,9,7,0,0,0,16,4,10,8,0,0,22,nowin,win,dlbust,bust,20,0,16,205,0.424390244,0.068292683,0.63902439,2,0.614740646
24774,102,24130,7,11,0,0,0,18,10,10,0,0,0,20,nowin,loss,beat,dlwin,0,10,18,192,0.338541667,0.046875,0.5625,0,0.003306118
24775,99,24130,10,10,0,0,0,20,10,10,0,0,0,20,nowin,push,push,push,10,0,20,207,0.47826087,0.062801932,0.637681159,3,0.961418446
24776,60,24130,5,10,0,10,0,25,10,10,0,0,0,20,nowin,loss,bust,plbust,0,10,15,227,0.418502203,0.022026432,0.559471366,0,0.026496258
24777,70,24130,10,10,0,0,0,20,10,10,0,0,0,20,nowin,push,push,push,10,0,20,228,0.385964912,0.039473684,0.557017544,0,0.016157125
24778,122,24130,10,7,0,0,0,17,10,10,0,0,0,20,nowin,loss,beat,dlwin,0,10,17,210,0.347619048,0.052380952,0.59047619,0,0.012873677
24779,19,24130,2,7,7,8,0,24,10,10,0,0,0,20,nowin,loss,bust,plbust,0,10,9,237,0.41350211,0.054852321,0.628691983,2,0.597373826
24780,14,24131,9,8,0,0,0,17,10,2,10,0,0,22,nowin,win,dlbust,bust,20,0,17,202,0.391089109,0.01980198,0.628712871,2,0.577264877
24781,149,24131,10,10,0,0,0,20,10,2,10,0,0,22,nowin,win,dlbust,bust,20,0,20,225,0.457777778,0.057777778,0.648888889,2,0.651965595
24782,55,24131,5,8,0,4,0,17,10,2,10,0,0,22,nowin,win,dlbust,bust,20,0,13,191,0.371727749,0.057591623,0.54973822,0,0.01011347
24783,36,24131,10,10,0,0,0,20,10,2,10,0,0,22,nowin,win,dlbust,bust,20,0,20,229,0.445414847,0.056768559,0.655021834,2,0.645370571
24784,82,24131,4,3,8,10,0,25,10,2,10,0,0,22,nowin,loss,bust,plbust,0,10,7,225,0.408888889,0.075555556,0.577777778,0,0.028101874
24785,15,24131,5,5,9,0,0,19,10,2,10,0,0,22,nowin,win,dlbust,bust,20,0,10,212,0.410377358,0.051886792,0.561320755,0,0.024517408
24786,86,24132,2,10,0,1,10,23,11,8,0,0,0,19,nowin,loss,bust,plbust,0,10,12,196,0.454081633,0.040816327,0.591836735,3,0.887566443
24787,75,24132,10,9,0,0,0,19,11,8,0,0,0,19,nowin,push,push,push,10,0,19,191,0.418848168,0.052356021,0.570680628,0,0.029344702
24788,1,24132,9,6,0,10,0,25,11,8,0,0,0,19,nowin,loss,bust,plbust,0,10,15,197,0.406091371,0.025380711,0.649746193,2,0.606186955
24789,55,24132,10,5,0,10,0,25,11,8,0,0,0,19,nowin,loss,bust,plbust,0,10,15,191,0.371727749,0.057591623,0.54973822,0,0.01011347
24790,143,24132,8,2,2,2,10,24,11,8,0,0,0,19,nowin,loss,bust,plbust,0,10,10,203,0.463054187,0.044334975,0.57635468,3,0.883143365
24791,116,24132,3,5,10,0,0,18,11,8,0,0,0,19,nowin,loss,beat,dlwin,0,10,8,195,0.425641026,0.056410256,0.538461538,1,0.28273747
24792,60,24133,10,3,0,0,0,13,5,10,6,0,0,21,nowin,loss,beat,dlwin,0,10,13,227,0.418502203,0.022026432,0.559471366,0,0.026496258
24793,53,24133,10,4,0,0,0,14,5,10,6,0,0,21,nowin,loss,beat,dlwin,0,10,14,250,0.372,0.064,0.564,0,0.013687345
24794,56,24133,7,3,10,0,0,20,5,10,6,0,0,21,nowin,loss,beat,dlwin,0,10,10,175,0.4,0.057142857,0.582857143,0,0.026685297
24795,116,24133,5,10,0,0,0,15,5,10,6,0,0,21,nowin,loss,beat,dlwin,0,10,15,195,0.425641026,0.056410256,0.538461538,1,0.28273747
24796,21,24133,2,9,8,0,0,19,5,10,6,0,0,21,nowin,loss,beat,dlwin,0,10,11,214,0.359813084,0.042056075,0.626168224,0,0.025263474
24797,75,24133,4,10,0,0,0,14,5,10,6,0,0,21,nowin,loss,beat,dlwin,0,10,14,191,0.418848168,0.052356021,0.570680628,0,0.029344702
24798,3,24134,3,10,0,0,0,13,6,6,5,0,0,17,nowin,loss,beat,dlwin,0,10,13,190,0.431578947,0.026315789,0.542105263,1,0.288076384
24799,62,24134,10,5,0,0,0,15,6,6,5,0,0,17,nowin,loss,beat,dlwin,0,10,15,178,0.370786517,0.028089888,0.54494382,0,0.008657722
24800,146,24134,10,2,0,0,0,12,6,6,5,0,0,17,nowin,loss,beat,dlwin,0,10,12,221,0.43438914,0.040723982,0.542986425,1,0.290190091
24801,65,24134,10,10,0,0,0,20,6,6,5,0,0,17,nowin,win,plwin,beat,20,0,20,203,0.492610837,0.054187192,0.571428571,3,0.913702814
24802,36,24134,11,7,0,0,0,18,6,6,5,0,0,17,nowin,win,plwin,beat,20,0,18,229,0.445414847,0.056768559,0.655021834,2,0.645370571
24803,130,24134,9,2,6,0,0,17,6,6,5,0,0,17,nowin,push,push,push,10,0,11,219,0.410958904,0.03652968,0.566210046,0,0.025888739
24804,110,24135,10,4,0,0,0,14,6,10,10,0,0,26,nowin,win,dlbust,bust,20,0,14,192,0.416666667,0.046875,0.557291667,0,0.025413132
24805,40,24135,8,11,0,0,0,19,6,10,10,0,0,26,nowin,win,dlbust,bust,20,0,19,196,0.367346939,0.030612245,0.617346939,0,0.025358183
24806,10,24135,11,9,0,0,0,20,6,10,10,0,0,26,nowin,win,dlbust,bust,20,0,20,191,0.413612565,0.057591623,0.596858639,2,0.574087175
24807,99,24135,4,7,9,0,0,20,6,10,10,0,0,26,nowin,win,dlbust,bust,20,0,11,207,0.47826087,0.062801932,0.637681159,3,0.961418446
24808,45,24135,8,5,0,0,0,13,6,10,10,0,0,26,nowin,win,dlbust,bust,20,0,13,196,0.428571429,0.051020408,0.612244898,2,0.598821767
24809,31,24135,5,6,3,0,0,14,6,10,10,0,0,26,nowin,win,dlbust,bust,20,0,11,188,0.473404255,0.058510638,0.515957447,1,0.300306557
24810,17,24136,10,5,0,7,0,22,11,1,8,0,0,20,nowin,loss,bust,plbust,0,10,15,171,0.444444444,0.070175439,0.555555556,1,0.302364894
24811,20,24136,4,5,4,10,0,23,11,1,8,0,0,20,nowin,loss,bust,plbust,0,10,9,186,0.456989247,0.037634409,0.537634409,1,0.301097108
24812,35,24136,2,1,10,6,0,19,11,1,8,0,0,20,nowin,loss,beat,dlwin,0,10,3,202,0.410891089,0.044554455,0.633663366,2,0.598681573
24813,109,24136,2,4,10,4,0,20,11,1,8,0,0,20,nowin,push,push,push,10,0,6,221,0.461538462,0.058823529,0.597285068,3,0.901830309
24814,90,24136,3,10,0,10,0,23,11,1,8,0,0,20,nowin,loss,bust,plbust,0,10,13,201,0.447761194,0.049751244,0.60199005,3,0.889945023
24815,106,24136,5,3,10,0,0,18,11,1,8,0,0,20,nowin,loss,beat,dlwin,0,10,8,192,0.411458333,0.026041667,0.557291667,0,0.023854304
24816,110,24137,4,9,0,0,0,13,5,10,3,0,0,18,nowin,loss,beat,dlwin,0,10,13,192,0.416666667,0.046875,0.557291667,0,0.025413132
24817,4,24137,7,2,10,0,0,19,5,10,3,0,0,18,nowin,win,plwin,beat,20,0,9,217,0.460829493,0.036866359,0.562211982,1,0.315432839
24818,22,24137,8,11,0,0,0,19,5,10,3,0,0,18,nowin,win,plwin,beat,20,0,19,187,0.481283422,0.042780749,0.577540107,3,0.906128176
24819,59,24137,10,10,0,0,0,20,5,10,3,0,0,18,nowin,win,plwin,beat,20,0,20,228,0.429824561,0.048245614,0.543859649,1,0.287885446
24820,56,24137,8,8,0,0,0,16,5,10,3,0,0,18,nowin,loss,beat,dlwin,0,10,16,175,0.4,0.057142857,0.582857143,0,0.026685297
24821,56,24137,5,7,0,0,0,12,5,10,3,0,0,18,nowin,loss,beat,dlwin,0,10,12,175,0.4,0.057142857,0.582857143,0,0.026685297
24822,108,24138,10,6,0,10,0,26,10,10,0,0,0,20,nowin,loss,bust,plbust,0,10,16,193,0.435233161,0.056994819,0.559585492,1,0.298824795
24823,115,24138,2,10,0,9,0,21,10,10,0,0,0,20,nowin,win,plwin,beat,20,0,12,194,0.427835052,0.041237113,0.592783505,2,0.583863602
24824,25,24138,8,5,0,9,0,22,10,10,0,0,0,20,nowin,loss,bust,plbust,0,10,13,190,0.463157895,0.063157895,0.536842105,1,0.304401563
24825,87,24138,3,1,10,10,0,24,10,10,0,0,0,20,nowin,loss,bust,plbust,0,10,4,202,0.405940594,0.054455446,0.628712871,2,0.590599801
24826,113,24138,9,10,0,0,0,19,10,10,0,0,0,20,nowin,loss,beat,dlwin,0,10,19,199,0.407035176,0.055276382,0.668341709,2,0.620695264
24827,7,24138,7,9,0,2,0,18,10,10,0,0,0,20,nowin,loss,beat,dlwin,0,10,16,183,0.442622951,0.06010929,0.62295082,2,0.619303341
24828,13,24139,8,10,0,0,0,18,10,10,0,0,0,20,nowin,loss,beat,dlwin,0,10,18,206,0.417475728,0.063106796,0.621359223,2,0.59555479
24829,28,24139,8,5,0,9,0,22,10,10,0,0,0,20,nowin,loss,bust,plbust,0,10,13,199,0.422110553,0.045226131,0.542713568,1,0.282706618
24830,37,24139,8,2,4,3,0,17,10,10,0,0,0,20,nowin,loss,beat,dlwin,0,10,10,208,0.394230769,0.038461538,0.581730769,0,0.024682772
24831,73,24139,10,3,0,9,0,22,10,10,0,0,0,20,nowin,loss,bust,plbust,0,10,13,181,0.375690608,0.011049724,0.596685083,0,0.022795773
24832,34,24139,8,10,0,0,0,18,10,10,0,0,0,20,nowin,loss,beat,dlwin,0,10,18,202,0.5,0.079207921,0.618811881,3,0.968961434
24833,121,24139,10,6,0,2,0,18,10,10,0,0,0,20,nowin,loss,beat,dlwin,0,10,16,195,0.456410256,0.025641026,0.512820513,1,0.288597791
24834,63,24140,10,2,0,0,0,12,6,3,10,0,0,19,nowin,loss,beat,dlwin,0,10,12,216,0.467592593,0.037037037,0.62037037,3,0.931690496
24835,85,24140,2,7,9,0,0,18,6,3,10,0,0,19,nowin,loss,beat,dlwin,0,10,9,195,0.41025641,0.066666667,0.594871795,0,0.03269711
24836,34,24140,2,1,9,0,0,12,6,3,10,0,0,19,nowin,loss,beat,dlwin,0,10,3,202,0.5,0.079207921,0.618811881,3,0.968961434
24837,117,24140,9,8,0,0,0,17,6,3,10,0,0,19,nowin,loss,beat,dlwin,0,10,17,173,0.410404624,0.069364162,0.606936416,2,0.578610282
24838,124,24140,4,7,10,0,0,21,6,3,10,0,0,19,nowin,win,plwin,beat,20,0,11,202,0.47029703,0.064356436,0.584158416,3,0.899458193
24839,89,24140,4,2,10,0,0,16,6,3,10,0,0,19,nowin,loss,beat,dlwin,0,10,6,212,0.537735849,0.047169811,0.594339623,3,0.990167191
24840,141,24141,10,10,0,0,0,20,3,10,5,0,0,18,nowin,win,plwin,beat,20,0,20,202,0.420792079,0.074257426,0.564356436,0,0.028377851
24841,83,24141,3,11,6,0,0,20,3,10,5,0,0,18,nowin,win,plwin,beat,20,0,14,193,0.424870466,0.051813472,0.678756477,2,0.644360335
24842,50,24141,7,10,0,0,0,17,3,10,5,0,0,18,nowin,loss,beat,dlwin,0,10,17,202,0.405940594,0.04950495,0.54950495,0,0.020296079
24843,54,24141,8,11,0,0,0,19,3,10,5,0,0,18,nowin,win,plwin,beat,20,0,19,185,0.437837838,0.032432432,0.556756757,1,0.29899854
24844,131,24141,11,9,0,0,0,20,3,10,5,0,0,18,nowin,win,plwin,beat,20,0,20,217,0.410138249,0.069124424,0.543778802,0,0.02015021
24845,4,24141,10,4,0,0,0,14,3,10,5,0,0,18,nowin,loss,beat,dlwin,0,10,14,217,0.460829493,0.036866359,0.562211982,1,0.315432839
24846,28,24142,8,5,0,0,0,13,5,10,9,0,0,24,nowin,win,dlbust,bust,20,0,13,199,0.422110553,0.045226131,0.542713568,1,0.282706618
24847,44,24142,10,10,0,0,0,20,5,10,9,0,0,24,nowin,win,dlbust,bust,20,0,20,219,0.433789954,0.050228311,0.534246575,1,0.285551035
24848,119,24142,7,6,0,0,0,13,5,10,9,0,0,24,nowin,win,dlbust,bust,20,0,13,190,0.405263158,0.068421053,0.515789474,0,0.011837158
24849,37,24142,8,6,0,0,0,14,5,10,9,0,0,24,nowin,win,dlbust,bust,20,0,14,208,0.394230769,0.038461538,0.581730769,0,0.024682772
24850,22,24142,2,11,2,0,0,15,5,10,9,0,0,24,nowin,win,dlbust,bust,20,0,13,187,0.481283422,0.042780749,0.577540107,3,0.906128176
24851,143,24142,10,10,0,0,0,20,5,10,9,0,0,24,nowin,win,dlbust,bust,20,0,20,203,0.463054187,0.044334975,0.57635468,3,0.883143365
24852,50,24143,7,9,0,2,0,18,8,8,7,0,0,23,nowin,win,dlbust,bust,20,0,16,202,0.405940594,0.04950495,0.54950495,0,0.020296079
24853,98,24143,6,6,0,10,0,22,8,8,7,0,0,23,nowin,loss,bust,plbust,0,10,12,220,0.422727273,0.054545455,0.55,1,0.28664435
24854,137,24143,10,3,0,10,0,23,8,8,7,0,0,23,nowin,loss,bust,plbust,0,10,13,194,0.417525773,0.046391753,0.536082474,1,0.276714602
24855,48,24143,10,9,0,0,0,19,8,8,7,0,0,23,nowin,win,dlbust,bust,20,0,19,203,0.413793103,0.019704433,0.600985222,2,0.577280801
24856,26,24143,10,5,0,5,0,20,8,8,7,0,0,23,nowin,win,dlbust,bust,20,0,15,203,0.463054187,0.0591133,0.541871921,1,0.306802864
24857,98,24143,7,7,0,2,6,22,8,8,7,0,0,23,nowin,loss,bust,plbust,0,10,14,220,0.422727273,0.054545455,0.55,1,0.28664435
24858,12,24144,10,10,0,0,0,20,3,8,10,0,0,21,nowin,loss,beat,dlwin,0,10,20,189,0.470899471,0.015873016,0.613756614,3,0.929171178
24859,43,24144,10,7,0,0,0,17,3,8,10,0,0,21,nowin,loss,beat,dlwin,0,10,17,192,0.40625,0.041666667,0.609375,2,0.576671372
24860,134,24144,9,10,0,0,0,19,3,8,10,0,0,21,nowin,loss,beat,dlwin,0,10,19,185,0.443243243,0.021621622,0.545945946,1,0.296939509
24861,96,24144,10,2,0,10,0,22,3,8,10,0,0,21,nowin,loss,bust,plbust,0,10,12,190,0.468421053,0.057894737,0.584210526,3,0.897263354
24862,65,24144,7,10,0,0,0,17,3,8,10,0,0,21,nowin,loss,beat,dlwin,0,10,17,203,0.492610837,0.054187192,0.571428571,3,0.913702814
24863,83,24144,3,5,10,0,0,18,3,8,10,0,0,21,nowin,loss,beat,dlwin,0,10,8,193,0.424870466,0.051813472,0.678756477,2,0.644360335
24864,26,24145,9,10,0,0,0,19,10,5,9,0,0,24,nowin,win,dlbust,bust,20,0,19,203,0.463054187,0.0591133,0.541871921,1,0.306802864
24865,111,24145,10,11,0,0,0,21,10,5,9,0,0,24,win,win,dlbust,bust,25,0,21,180,0.433333333,0.055555556,0.611111111,2,0.602264492
24866,133,24145,10,3,0,3,5,21,10,5,9,0,0,24,nowin,win,dlbust,bust,20,0,13,201,0.47761194,0.064676617,0.611940299,3,0.935428111
24867,117,24145,10,10,0,0,0,20,10,5,9,0,0,24,nowin,win,dlbust,bust,20,0,20,173,0.410404624,0.069364162,0.606936416,2,0.578610282
24868,15,24145,11,6,3,0,0,20,10,5,9,0,0,24,nowin,win,dlbust,bust,20,0,17,212,0.410377358,0.051886792,0.561320755,0,0.024517408
24869,132,24145,7,10,0,0,0,17,10,5,9,0,0,24,nowin,win,dlbust,bust,20,0,17,194,0.412371134,0.036082474,0.649484536,2,0.611633238
24870,44,24146,4,10,0,0,0,14,4,8,4,10,0,26,nowin,win,dlbust,bust,20,0,14,219,0.433789954,0.050228311,0.534246575,1,0.285551035
24871,121,24146,3,6,5,0,0,14,4,8,4,10,0,26,nowin,win,dlbust,bust,20,0,9,195,0.456410256,0.025641026,0.512820513,1,0.288597791
24872,73,24146,10,7,0,0,0,17,4,8,4,10,0,26,nowin,win,dlbust,bust,20,0,17,181,0.375690608,0.011049724,0.596685083,0,0.022795773
24873,43,24146,10,11,0,0,0,21,4,8,4,10,0,26,win,win,dlbust,bust,25,0,21,192,0.40625,0.041666667,0.609375,2,0.576671372
24874,124,24146,8,2,4,0,0,14,4,8,4,10,0,26,nowin,win,dlbust,bust,20,0,10,202,0.47029703,0.064356436,0.584158416,3,0.899458193
24875,77,24146,2,2,2,2,10,18,4,8,4,10,0,26,nowin,win,dlbust,bust,20,0,4,200,0.455,0.04,0.62,3,0.916252116
24876,119,24147,7,10,0,0,0,17,10,11,0,0,0,21,nowin,loss,beat,dlwin,0,10,17,190,0.405263158,0.068421053,0.515789474,0,0.011837158
24877,52,24147,3,7,10,0,0,20,10,11,0,0,0,21,nowin,loss,beat,dlwin,0,10,10,217,0.414746544,0.02764977,0.599078341,2,0.576736024
24878,64,24147,2,10,0,8,0,20,10,11,0,0,0,21,nowin,loss,beat,dlwin,0,10,12,187,0.363636364,0.048128342,0.631016043,0,0.027594885
24879,90,24147,9,9,0,0,0,18,10,11,0,0,0,21,nowin,loss,beat,dlwin,0,10,18,201,0.447761194,0.049751244,0.60199005,3,0.889945023
24880,29,24147,6,9,0,8,0,23,10,11,0,0,0,21,nowin,loss,bust,plbust,0,10,15,189,0.44973545,0.058201058,0.544973545,1,0.300349439
24881,63,24147,10,2,0,10,0,22,10,11,0,0,0,21,nowin,loss,bust,plbust,0,10,12,216,0.467592593,0.037037037,0.62037037,3,0.931690496
24882,124,24148,10,3,0,0,0,13,6,8,1,8,0,23,nowin,win,dlbust,bust,20,0,13,202,0.47029703,0.064356436,0.584158416,3,0.899458193
24883,63,24148,9,11,0,0,0,20,6,8,1,8,0,23,nowin,win,dlbust,bust,20,0,20,216,0.467592593,0.037037037,0.62037037,3,0.931690496
24884,26,24148,2,10,0,0,0,12,6,8,1,8,0,23,nowin,win,dlbust,bust,20,0,12,203,0.463054187,0.0591133,0.541871921,1,0.306802864
24885,4,24148,3,10,0,0,0,13,6,8,1,8,0,23,nowin,win,dlbust,bust,20,0,13,217,0.460829493,0.036866359,0.562211982,1,0.315432839
24886,11,24148,10,8,0,0,0,18,6,8,1,8,0,23,nowin,win,dlbust,bust,20,0,18,236,0.457627119,0.016949153,0.588983051,3,0.889015813
24887,147,24148,10,10,0,0,0,20,6,8,1,8,0,23,nowin,win,dlbust,bust,20,0,20,205,0.380487805,0.014634146,0.536585366,0,0.00951447
24888,76,24149,10,10,0,0,0,20,9,8,0,0,0,17,nowin,win,plwin,beat,20,0,20,189,0.534391534,0.079365079,0.608465608,3,1
24889,4,24149,7,10,0,0,0,17,9,8,0,0,0,17,nowin,push,push,push,10,0,17,217,0.460829493,0.036866359,0.562211982,1,0.315432839
24890,60,24149,9,10,0,0,0,19,9,8,0,0,0,17,nowin,win,plwin,beat,20,0,19,227,0.418502203,0.022026432,0.559471366,0,0.026496258
24891,70,24149,8,2,7,0,0,17,9,8,0,0,0,17,nowin,push,push,push,10,0,10,228,0.385964912,0.039473684,0.557017544,0,0.016157125
24892,80,24149,10,3,0,2,10,25,9,8,0,0,0,17,nowin,loss,bust,plbust,0,10,13,186,0.419354839,0.059139785,0.623655914,2,0.59892924
24893,147,24149,10,9,0,0,0,19,9,8,0,0,0,17,nowin,win,plwin,beat,20,0,19,205,0.380487805,0.014634146,0.536585366,0,0.00951447
24894,132,24150,10,5,0,0,0,15,4,8,1,2,4,19,nowin,loss,beat,dlwin,0,10,15,194,0.412371134,0.036082474,0.649484536,2,0.611633238
24895,44,24150,6,11,3,0,0,20,4,8,1,2,4,19,nowin,win,plwin,beat,20,0,17,219,0.433789954,0.050228311,0.534246575,1,0.285551035
24896,118,24150,6,5,3,0,0,14,4,8,1,2,4,19,nowin,loss,beat,dlwin,0,10,11,216,0.393518519,0.037037037,0.555555556,0,0.018059873
24897,145,24150,1,2,10,0,0,13,4,8,1,2,4,19,nowin,loss,beat,dlwin,0,10,3,188,0.441489362,0.031914894,0.622340426,2,0.617837093
24898,45,24150,8,4,0,0,0,12,4,8,1,2,4,19,nowin,loss,beat,dlwin,0,10,12,196,0.428571429,0.051020408,0.612244898,2,0.598821767
24899,36,24150,10,11,0,0,0,21,4,8,1,2,4,19,win,win,plwin,beat,25,0,21,229,0.445414847,0.056768559,0.655021834,2,0.645370571
24900,58,24151,10,8,0,0,0,18,10,6,1,0,0,17,nowin,win,plwin,beat,20,0,18,195,0.430769231,0.041025641,0.584615385,2,0.580497586
24901,57,24151,8,10,0,0,0,18,10,6,1,0,0,17,nowin,win,plwin,beat,20,0,18,192,0.46875,0.052083333,0.59375,3,0.907001181
24902,64,24151,10,10,0,0,0,20,10,6,1,0,0,17,nowin,win,plwin,beat,20,0,20,187,0.363636364,0.048128342,0.631016043,0,0.027594885
24903,85,24151,10,6,0,6,0,22,10,6,1,0,0,17,nowin,loss,bust,plbust,0,10,16,195,0.41025641,0.066666667,0.594871795,0,0.03269711
24904,33,24151,9,3,0,10,0,22,10,6,1,0,0,17,nowin,loss,bust,plbust,0,10,12,192,0.4375,0.057291667,0.625,2,0.616208916
24905,62,24151,5,6,1,10,0,22,10,6,1,0,0,17,nowin,loss,bust,plbust,0,10,11,178,0.370786517,0.028089888,0.54494382,0,0.008657722
24906,119,24152,7,8,0,10,0,25,10,6,10,0,0,26,nowin,loss,bust,plbust,0,10,15,190,0.405263158,0.068421053,0.515789474,0,0.011837158
24907,19,24152,9,8,0,0,0,17,10,6,10,0,0,26,nowin,win,dlbust,bust,20,0,17,237,0.41350211,0.054852321,0.628691983,2,0.597373826
24908,135,24152,11,1,5,0,0,17,10,6,10,0,0,26,nowin,win,dlbust,bust,20,0,12,179,0.391061453,0.067039106,0.586592179,0,0.024924662
24909,41,24152,9,8,0,0,0,17,10,6,10,0,0,26,nowin,win,dlbust,bust,20,0,17,192,0.364583333,0.036458333,0.520833333,0,0.00089702
24910,81,24152,2,5,6,7,0,20,10,6,10,0,0,26,nowin,win,dlbust,bust,20,0,7,182,0.395604396,0.043956044,0.60989011,2,0.567491261
24911,32,24152,10,4,0,10,0,24,10,6,10,0,0,26,nowin,loss,bust,plbust,0,10,14,189,0.391534392,0.037037037,0.53968254,0,0.013579086
24912,146,24153,9,10,0,0,0,19,9,10,0,0,0,19,nowin,push,push,push,10,0,19,221,0.43438914,0.040723982,0.542986425,1,0.290190091
24913,147,24153,5,1,6,3,2,17,9,10,0,0,0,19,nowin,loss,beat,dlwin,0,10,6,205,0.380487805,0.014634146,0.536585366,0,0.00951447
24914,57,24153,2,8,7,0,0,17,9,10,0,0,0,19,nowin,loss,beat,dlwin,0,10,10,192,0.46875,0.052083333,0.59375,3,0.907001181
24915,138,24153,10,10,0,0,0,20,9,10,0,0,0,19,nowin,win,plwin,beat,20,0,20,190,0.442105263,0.047368421,0.610526316,2,0.609711065
24916,48,24153,6,4,10,0,0,20,9,10,0,0,0,19,nowin,win,plwin,beat,20,0,10,203,0.413793103,0.019704433,0.600985222,2,0.577280801
24917,9,24153,6,5,10,0,0,21,9,10,0,0,0,19,nowin,win,plwin,beat,20,0,11,194,0.37628866,0.015463918,0.541237113,0,0.009396796
24918,125,24154,4,3,11,0,0,18,2,4,10,5,0,21,nowin,loss,beat,dlwin,0,10,7,219,0.438356164,0.050228311,0.575342466,1,0.308411257
24919,121,24154,10,2,0,7,0,19,2,4,10,5,0,21,nowin,loss,beat,dlwin,0,10,12,195,0.456410256,0.025641026,0.512820513,1,0.288597791
24920,46,24154,10,6,0,0,0,16,2,4,10,5,0,21,nowin,loss,beat,dlwin,0,10,16,186,0.403225806,0.048387097,0.591397849,0,0.029742194
24921,123,24154,8,9,0,0,0,17,2,4,10,5,0,21,nowin,loss,beat,dlwin,0,10,17,205,0.43902439,0.034146341,0.614634146,2,0.609962544
24922,5,24154,3,10,0,0,0,13,2,4,10,5,0,21,nowin,loss,beat,dlwin,0,10,13,203,0.42364532,0.02955665,0.596059113,2,0.582508076
24923,69,24154,10,4,0,0,0,14,2,4,10,5,0,21,nowin,loss,beat,dlwin,0,10,14,194,0.365979381,0.030927835,0.515463918,0,0
24924,139,24155,3,10,0,0,0,13,6,4,10,0,0,20,nowin,loss,beat,dlwin,0,10,13,192,0.380208333,0.036458333,0.59375,0,0.023429169
24925,139,24155,5,3,7,0,0,15,6,4,10,0,0,20,nowin,loss,beat,dlwin,0,10,8,192,0.380208333,0.036458333,0.59375,0,0.023429169
24926,77,24155,10,4,0,0,0,14,6,4,10,0,0,20,nowin,loss,beat,dlwin,0,10,14,200,0.455,0.04,0.62,3,0.916252116
24927,1,24155,7,4,1,0,0,12,6,4,10,0,0,20,nowin,loss,beat,dlwin,0,10,11,197,0.406091371,0.025380711,0.649746193,2,0.606186955
24928,129,24155,2,2,10,0,0,14,6,4,10,0,0,20,nowin,loss,beat,dlwin,0,10,4,201,0.422885572,0.064676617,0.55721393,0,0.027255383
24929,4,24155,10,5,0,0,0,15,6,4,10,0,0,20,nowin,loss,beat,dlwin,0,10,15,217,0.460829493,0.036866359,0.562211982,1,0.315432839
24930,36,24156,2,10,0,10,0,22,10,2,4,10,0,26,nowin,loss,bust,plbust,0,10,12,229,0.445414847,0.056768559,0.655021834,2,0.645370571
24931,82,24156,10,2,0,10,0,22,10,2,4,10,0,26,nowin,loss,bust,plbust,0,10,12,225,0.408888889,0.075555556,0.577777778,0,0.028101874
24932,50,24156,10,8,0,0,0,18,10,2,4,10,0,26,nowin,win,dlbust,bust,20,0,18,202,0.405940594,0.04950495,0.54950495,0,0.020296079
24933,133,24156,10,10,0,0,0,20,10,2,4,10,0,26,nowin,win,dlbust,bust,20,0,20,201,0.47761194,0.064676617,0.611940299,3,0.935428111
24934,25,24156,10,10,0,0,0,20,10,2,4,10,0,26,nowin,win,dlbust,bust,20,0,20,190,0.463157895,0.063157895,0.536842105,1,0.304401563
24935,42,24156,4,10,0,10,0,24,10,2,4,10,0,26,nowin,loss,bust,plbust,0,10,14,212,0.443396226,0.051886792,0.570754717,1,0.309181312
24936,71,24157,10,3,0,5,0,18,8,3,10,0,0,21,nowin,loss,beat,dlwin,0,10,13,193,0.352331606,0.046632124,0.585492228,0,0.013063661
24937,78,24157,5,10,0,7,0,22,8,3,10,0,0,21,nowin,loss,bust,plbust,0,10,15,201,0.517412935,0.034825871,0.587064677,3,0.95871112
24938,19,24157,10,8,0,0,0,18,8,3,10,0,0,21,nowin,loss,beat,dlwin,0,10,18,237,0.41350211,0.054852321,0.628691983,2,0.597373826
24939,149,24157,8,8,0,6,0,22,8,3,10,0,0,21,nowin,loss,bust,plbust,0,10,16,225,0.457777778,0.057777778,0.648888889,2,0.651965595
24940,6,24157,9,10,0,0,0,19,8,3,10,0,0,21,nowin,loss,beat,dlwin,0,10,19,191,0.439790576,0.047120419,0.581151832,1,0.31211505
24941,45,24157,2,6,3,8,0,19,8,3,10,0,0,21,nowin,loss,beat,dlwin,0,10,8,196,0.428571429,0.051020408,0.612244898,2,0.598821767
24942,110,24158,2,10,0,9,0,21,7,9,10,0,0,26,nowin,win,dlbust,bust,20,0,12,192,0.416666667,0.046875,0.557291667,0,0.025413132
24943,115,24158,5,2,7,8,0,22,7,9,10,0,0,26,nowin,loss,bust,plbust,0,10,7,194,0.427835052,0.041237113,0.592783505,2,0.583863602
24944,48,24158,7,10,0,0,0,17,7,9,10,0,0,26,nowin,win,dlbust,bust,20,0,17,203,0.413793103,0.019704433,0.600985222,2,0.577280801
24945,83,24158,2,10,0,5,0,17,7,9,10,0,0,26,nowin,win,dlbust,bust,20,0,12,193,0.424870466,0.051813472,0.678756477,2,0.644360335
24946,4,24158,4,8,0,1,10,23,7,9,10,0,0,26,nowin,loss,bust,plbust,0,10,12,217,0.460829493,0.036866359,0.562211982,1,0.315432839
24947,106,24158,10,2,0,8,0,20,7,9,10,0,0,26,nowin,win,dlbust,bust,20,0,12,192,0.411458333,0.026041667,0.557291667,0,0.023854304
24948,45,24159,3,5,10,0,0,18,11,1,9,0,0,21,nowin,loss,beat,dlwin,0,10,8,196,0.428571429,0.051020408,0.612244898,2,0.598821767
24949,4,24159,7,10,0,0,0,17,11,1,9,0,0,21,nowin,loss,beat,dlwin,0,10,17,217,0.460829493,0.036866359,0.562211982,1,0.315432839
24950,44,24159,10,7,0,0,0,17,11,1,9,0,0,21,nowin,loss,beat,dlwin,0,10,17,219,0.433789954,0.050228311,0.534246575,1,0.285551035
24951,128,24159,9,2,2,6,0,19,11,1,9,0,0,21,nowin,loss,beat,dlwin,0,10,11,227,0.356828194,0.052863436,0.577092511,0,0.012352564
24952,46,24159,11,10,0,0,0,21,11,1,9,0,0,21,win,push,push,push,10,0,21,186,0.403225806,0.048387097,0.591397849,0,0.029742194
24953,15,24159,2,10,0,1,9,22,11,1,9,0,0,21,nowin,loss,bust,plbust,0,10,12,212,0.410377358,0.051886792,0.561320755,0,0.024517408
24954,20,24160,2,6,4,6,0,18,9,10,0,0,0,19,nowin,loss,beat,dlwin,0,10,8,186,0.456989247,0.037634409,0.537634409,1,0.301097108
24955,81,24160,7,10,0,0,0,17,9,10,0,0,0,19,nowin,loss,beat,dlwin,0,10,17,182,0.395604396,0.043956044,0.60989011,2,0.567491261
24956,60,24160,4,11,2,0,0,17,9,10,0,0,0,19,nowin,loss,beat,dlwin,0,10,15,227,0.418502203,0.022026432,0.559471366,0,0.026496258
24957,45,24160,3,10,0,9,0,22,9,10,0,0,0,19,nowin,loss,bust,plbust,0,10,13,196,0.428571429,0.051020408,0.612244898,2,0.598821767
24958,91,24160,10,2,0,9,0,21,9,10,0,0,0,19,nowin,win,plwin,beat,20,0,12,194,0.417525773,0.046391753,0.515463918,1,0.266616552
24959,49,24160,10,11,0,0,0,21,9,10,0,0,0,19,win,win,plwin,beat,25,0,21,207,0.396135266,0.053140097,0.594202899,0,0.028306925
24960,109,24161,4,6,10,0,0,20,3,6,10,0,0,19,nowin,win,plwin,beat,20,0,10,221,0.461538462,0.058823529,0.597285068,3,0.901830309
24961,68,24161,5,4,8,0,0,17,3,6,10,0,0,19,nowin,loss,beat,dlwin,0,10,9,205,0.434146341,0.029268293,0.6,2,0.59483189
24962,124,24161,10,10,0,0,0,20,3,6,10,0,0,19,nowin,win,plwin,beat,20,0,20,202,0.47029703,0.064356436,0.584158416,3,0.899458193
24963,84,24161,3,5,10,0,0,18,3,6,10,0,0,19,nowin,loss,beat,dlwin,0,10,8,195,0.379487179,0.056410256,0.569230769,0,0.017209119
24964,54,24161,5,10,0,0,0,15,3,6,10,0,0,19,nowin,loss,beat,dlwin,0,10,15,185,0.437837838,0.032432432,0.556756757,1,0.29899854
24965,119,24161,3,7,11,0,0,21,3,6,10,0,0,19,nowin,win,plwin,beat,20,0,10,190,0.405263158,0.068421053,0.515789474,0,0.011837158
24966,79,24162,8,8,0,0,0,16,6,3,10,0,0,19,nowin,loss,beat,dlwin,0,10,16,211,0.436018957,0.028436019,0.672985782,2,0.650131054
24967,99,24162,10,6,0,0,0,16,6,3,10,0,0,19,nowin,loss,beat,dlwin,0,10,16,207,0.47826087,0.062801932,0.637681159,3,0.961418446
24968,127,24162,7,10,0,0,0,17,6,3,10,0,0,19,nowin,loss,beat,dlwin,0,10,17,201,0.402985075,0.029850746,0.60199005,0,0.032263937
24969,105,24162,5,10,0,0,0,15,6,3,10,0,0,19,nowin,loss,beat,dlwin,0,10,15,198,0.414141414,0.070707071,0.590909091,0,0.032889494
24970,144,24162,2,8,5,0,0,15,6,3,10,0,0,19,nowin,loss,beat,dlwin,0,10,10,202,0.386138614,0.054455446,0.564356436,0,0.018006244
24971,43,24162,6,6,0,0,0,12,6,3,10,0,0,19,nowin,loss,beat,dlwin,0,10,12,192,0.40625,0.041666667,0.609375,2,0.576671372
24972,30,24163,11,5,4,0,0,20,7,7,9,0,0,23,nowin,win,dlbust,bust,20,0,16,206,0.393203883,0.033980583,0.601941748,0,0.029324648
24973,45,24163,10,10,0,0,0,20,7,7,9,0,0,23,nowin,win,dlbust,bust,20,0,20,196,0.428571429,0.051020408,0.612244898,2,0.598821767
24974,50,24163,3,11,6,0,0,20,7,7,9,0,0,23,nowin,win,dlbust,bust,20,0,14,202,0.405940594,0.04950495,0.54950495,0,0.020296079
24975,40,24163,10,10,0,0,0,20,7,7,9,0,0,23,nowin,win,dlbust,bust,20,0,20,196,0.367346939,0.030612245,0.617346939,0,0.025358183
24976,101,24163,3,1,10,2,5,21,7,7,9,0,0,23,nowin,win,dlbust,bust,20,0,4,205,0.424390244,0.068292683,0.63902439,2,0.614740646
24977,109,24163,2,10,0,8,0,20,7,7,9,0,0,23,nowin,win,dlbust,bust,20,0,12,221,0.461538462,0.058823529,0.597285068,3,0.901830309
24978,22,24164,10,4,0,5,0,19,11,10,0,0,0,21,nowin,loss,beat,dlwin,0,10,14,187,0.481283422,0.042780749,0.577540107,3,0.906128176
24979,25,24164,6,10,0,10,0,26,11,10,0,0,0,21,nowin,loss,bust,plbust,0,10,16,190,0.463157895,0.063157895,0.536842105,1,0.304401563
24980,121,24164,2,7,10,0,0,19,11,10,0,0,0,21,nowin,loss,beat,dlwin,0,10,9,195,0.456410256,0.025641026,0.512820513,1,0.288597791
24981,142,24164,10,9,0,0,0,19,11,10,0,0,0,21,nowin,loss,beat,dlwin,0,10,19,211,0.417061611,0.047393365,0.526066351,1,0.271531309
24982,16,24164,6,10,0,5,0,21,11,10,0,0,0,21,nowin,push,push,push,10,0,16,220,0.427272727,0.081818182,0.6,2,0.588660176
24983,120,24164,8,8,0,6,0,22,11,10,0,0,0,21,nowin,loss,bust,plbust,0,10,16,202,0.440594059,0.034653465,0.618811881,2,0.614441029
24984,134,24165,3,10,0,10,0,23,10,7,0,0,0,17,nowin,loss,bust,plbust,0,10,13,185,0.443243243,0.021621622,0.545945946,1,0.296939509
24985,18,24165,5,2,11,0,0,18,10,7,0,0,0,17,nowin,win,plwin,beat,20,0,7,182,0.461538462,0.043956044,0.587912088,3,0.892649374
24986,139,24165,7,9,0,9,0,25,10,7,0,0,0,17,nowin,loss,bust,plbust,0,10,16,192,0.380208333,0.036458333,0.59375,0,0.023429169
24987,8,24165,6,3,10,0,0,19,10,7,0,0,0,17,nowin,win,plwin,beat,20,0,9,181,0.44198895,0.071823204,0.596685083,2,0.599438402
24988,4,24165,9,5,0,10,0,24,10,7,0,0,0,17,nowin,loss,bust,plbust,0,10,14,217,0.460829493,0.036866359,0.562211982,1,0.315432839
24989,72,24165,2,11,7,0,0,20,10,7,0,0,0,17,nowin,win,plwin,beat,20,0,13,185,0.394594595,0.032432432,0.508108108,0,0.006763115
24990,42,24166,10,11,0,0,0,21,6,8,4,0,0,18,win,win,plwin,beat,25,0,21,212,0.443396226,0.051886792,0.570754717,1,0.309181312
24991,33,24166,3,2,4,5,0,14,6,8,4,0,0,18,nowin,loss,beat,dlwin,0,10,5,192,0.4375,0.057291667,0.625,2,0.616208916
24992,150,24166,7,3,10,0,0,20,6,8,4,0,0,18,nowin,win,plwin,beat,20,0,10,192,0.401041667,0.036458333,0.567708333,0,0.023287458
24993,15,24166,5,8,0,0,0,13,6,8,4,0,0,18,nowin,loss,beat,dlwin,0,10,13,212,0.410377358,0.051886792,0.561320755,0,0.024517408
24994,102,24166,10,6,0,0,0,16,6,8,4,0,0,18,nowin,loss,beat,dlwin,0,10,16,192,0.338541667,0.046875,0.5625,0,0.003306118
24995,52,24166,9,8,0,0,0,17,6,8,4,0,0,18,nowin,loss,beat,dlwin,0,10,17,217,0.414746544,0.02764977,0.599078341,2,0.576736024
24996,114,24167,10,10,0,0,0,20,10,4,10,0,0,24,nowin,win,dlbust,bust,20,0,20,198,0.47979798,0.025252525,0.611111111,3,0.937232995
24997,119,24167,9,9,0,0,0,18,10,4,10,0,0,24,nowin,win,dlbust,bust,20,0,18,190,0.405263158,0.068421053,0.515789474,0,0.011837158
24998,139,24167,7,5,0,10,0,22,10,4,10,0,0,24,nowin,loss,bust,plbust,0,10,12,192,0.380208333,0.036458333,0.59375,0,0.023429169
24999,68,24167,10,10,0,0,0,20,10,4,10,0,0,24,nowin,win,dlbust,bust,20,0,20,205,0.434146341,0.029268293,0.6,2,0.59483189
25000,28,24167,6,4,10,0,0,20,10,4,10,0,0,24,nowin,win,dlbust,bust,20,0,10,199,0.422110553,0.045226131,0.542713568,1,0.282706618
25001,114,24167,6,8,0,10,0,24,10,4,10,0,0,24,nowin,loss,bust,plbust,0,10,14,198,0.47979798,0.025252525,0.611111111,3,0.937232995
25002,41,24168,9,6,0,1,9,25,11,9,0,0,0,20,nowin,loss,bust,plbust,0,10,15,192,0.364583333,0.036458333,0.520833333,0,0.00089702
25003,115,24168,8,10,0,0,0,18,11,9,0,0,0,20,nowin,loss,beat,dlwin,0,10,18,194,0.427835052,0.041237113,0.592783505,2,0.583863602
25004,125,24168,8,9,0,0,0,17,11,9,0,0,0,20,nowin,loss,beat,dlwin,0,10,17,219,0.438356164,0.050228311,0.575342466,1,0.308411257
25005,126,24168,4,9,0,6,0,19,11,9,0,0,0,20,nowin,loss,beat,dlwin,0,10,13,188,0.457446809,0.074468085,0.60106383,3,0.900633203
25006,114,24168,10,5,0,4,0,19,11,9,0,0,0,20,nowin,loss,beat,dlwin,0,10,15,198,0.47979798,0.025252525,0.611111111,3,0.937232995
25007,148,24168,10,7,0,0,0,17,11,9,0,0,0,20,nowin,loss,beat,dlwin,0,10,17,204,0.401960784,0.078431373,0.593137255,0,0.029789521
25008,79,24169,10,4,0,5,0,19,11,4,6,0,0,21,nowin,loss,beat,dlwin,0,10,14,211,0.436018957,0.028436019,0.672985782,2,0.650131054
25009,111,24169,3,5,10,0,0,18,11,4,6,0,0,21,nowin,loss,beat,dlwin,0,10,8,180,0.433333333,0.055555556,0.611111111,2,0.602264492
25010,36,24169,10,10,0,0,0,20,11,4,6,0,0,21,nowin,loss,beat,dlwin,0,10,20,229,0.445414847,0.056768559,0.655021834,2,0.645370571
25011,129,24169,3,9,0,10,0,22,11,4,6,0,0,21,nowin,loss,bust,plbust,0,10,12,201,0.422885572,0.064676617,0.55721393,0,0.027255383
25012,95,24169,5,10,0,9,0,24,11,4,6,0,0,21,nowin,loss,bust,plbust,0,10,15,218,0.412844037,0.04587156,0.559633028,0,0.024842385
25013,26,24169,2,3,2,4,6,17,11,4,6,0,0,21,nowin,loss,beat,dlwin,0,10,5,203,0.463054187,0.0591133,0.541871921,1,0.306802864
25014,88,24170,7,2,3,4,3,19,9,10,0,0,0,19,nowin,push,push,push,10,0,9,206,0.466019417,0.033980583,0.54368932,1,0.309467903
25015,21,24170,10,2,0,10,0,22,9,10,0,0,0,19,nowin,loss,bust,plbust,0,10,12,214,0.359813084,0.042056075,0.626168224,0,0.025263474
25016,19,24170,7,7,0,10,0,24,9,10,0,0,0,19,nowin,loss,bust,plbust,0,10,14,237,0.41350211,0.054852321,0.628691983,2,0.597373826
25017,124,24170,10,4,0,6,0,20,9,10,0,0,0,19,nowin,win,plwin,beat,20,0,14,202,0.47029703,0.064356436,0.584158416,3,0.899458193
25018,57,24170,5,9,0,7,0,21,9,10,0,0,0,19,nowin,win,plwin,beat,20,0,14,192,0.46875,0.052083333,0.59375,3,0.907001181
25019,108,24170,6,8,0,8,0,22,9,10,0,0,0,19,nowin,loss,bust,plbust,0,10,14,193,0.435233161,0.056994819,0.559585492,1,0.298824795
25020,85,24171,2,6,4,1,8,21,7,6,5,0,0,18,nowin,win,plwin,beat,20,0,8,195,0.41025641,0.066666667,0.594871795,0,0.03269711
25021,3,24171,10,10,0,0,0,20,7,6,5,0,0,18,nowin,win,plwin,beat,20,0,20,190,0.431578947,0.026315789,0.542105263,1,0.288076384
25022,72,24171,10,5,0,10,0,25,7,6,5,0,0,18,nowin,loss,bust,plbust,0,10,15,185,0.394594595,0.032432432,0.508108108,0,0.006763115
25023,99,24171,10,10,0,0,0,20,7,6,5,0,0,18,nowin,win,plwin,beat,20,0,20,207,0.47826087,0.062801932,0.637681159,3,0.961418446
25024,16,24171,3,5,6,3,0,17,7,6,5,0,0,18,nowin,loss,beat,dlwin,0,10,8,220,0.427272727,0.081818182,0.6,2,0.588660176
25025,40,24171,2,10,0,9,0,21,7,6,5,0,0,18,nowin,win,plwin,beat,20,0,12,196,0.367346939,0.030612245,0.617346939,0,0.025358183
25026,122,24172,10,6,0,0,0,16,4,10,10,0,0,24,nowin,win,dlbust,bust,20,0,16,210,0.347619048,0.052380952,0.59047619,0,0.012873677
25027,110,24172,7,5,0,0,0,12,4,10,10,0,0,24,nowin,win,dlbust,bust,20,0,12,192,0.416666667,0.046875,0.557291667,0,0.025413132
25028,82,24172,3,7,5,0,0,15,4,10,10,0,0,24,nowin,win,dlbust,bust,20,0,10,225,0.408888889,0.075555556,0.577777778,0,0.028101874
25029,61,24172,6,10,0,0,0,16,4,10,10,0,0,24,nowin,win,dlbust,bust,20,0,16,194,0.427835052,0.077319588,0.603092784,2,0.591437139
25030,96,24172,2,2,8,0,0,12,4,10,10,0,0,24,nowin,win,dlbust,bust,20,0,4,190,0.468421053,0.057894737,0.584210526,3,0.897263354
25031,34,24172,8,10,0,0,0,18,4,10,10,0,0,24,nowin,win,dlbust,bust,20,0,18,202,0.5,0.079207921,0.618811881,3,0.968961434
25032,15,24173,9,6,0,10,0,25,9,10,0,0,0,19,nowin,loss,bust,plbust,0,10,15,212,0.410377358,0.051886792,0.561320755,0,0.024517408
25033,146,24173,3,5,9,0,0,17,9,10,0,0,0,19,nowin,loss,beat,dlwin,0,10,8,221,0.43438914,0.040723982,0.542986425,1,0.290190091
25034,120,24173,5,1,7,9,0,22,9,10,0,0,0,19,nowin,loss,bust,plbust,0,10,6,202,0.440594059,0.034653465,0.618811881,2,0.614441029
25035,29,24173,10,10,0,0,0,20,9,10,0,0,0,19,nowin,win,plwin,beat,20,0,20,189,0.44973545,0.058201058,0.544973545,1,0.300349439
25036,141,24173,10,6,0,10,0,26,9,10,0,0,0,19,nowin,loss,bust,plbust,0,10,16,202,0.420792079,0.074257426,0.564356436,0,0.028377851
25037,131,24173,3,10,0,9,0,22,9,10,0,0,0,19,nowin,loss,bust,plbust,0,10,13,217,0.410138249,0.069124424,0.543778802,0,0.02015021
25038,22,24174,7,4,1,7,0,19,10,4,10,0,0,24,nowin,win,dlbust,bust,20,0,11,187,0.481283422,0.042780749,0.577540107,3,0.906128176
25039,71,24174,11,2,1,7,0,21,10,4,10,0,0,24,nowin,win,dlbust,bust,20,0,13,193,0.352331606,0.046632124,0.585492228,0,0.013063661
25040,143,24174,2,10,0,4,10,26,10,4,10,0,0,24,nowin,loss,bust,plbust,0,10,12,203,0.463054187,0.044334975,0.57635468,3,0.883143365
25041,72,24174,7,7,0,9,0,23,10,4,10,0,0,24,nowin,loss,bust,plbust,0,10,14,185,0.394594595,0.032432432,0.508108108,0,0.006763115
25042,52,24174,10,5,0,7,0,22,10,4,10,0,0,24,nowin,loss,bust,plbust,0,10,15,217,0.414746544,0.02764977,0.599078341,2,0.576736024
25043,13,24174,10,5,0,9,0,24,10,4,10,0,0,24,nowin,loss,bust,plbust,0,10,15,206,0.417475728,0.063106796,0.621359223,2,0.59555479
25044,76,24175,9,11,0,0,0,20,9,10,0,0,0,19,nowin,win,plwin,beat,20,0,20,189,0.534391534,0.079365079,0.608465608,3,1
25045,78,24175,11,2,7,0,0,20,9,10,0,0,0,19,nowin,win,plwin,beat,20,0,13,201,0.517412935,0.034825871,0.587064677,3,0.95871112
25046,97,24175,2,10,0,7,0,19,9,10,0,0,0,19,nowin,push,push,push,10,0,12,182,0.450549451,0.06043956,0.692307692,2,0.677372279
25047,101,24175,6,2,10,0,0,18,9,10,0,0,0,19,nowin,loss,beat,dlwin,0,10,8,205,0.424390244,0.068292683,0.63902439,2,0.614740646
25048,49,24175,10,3,0,3,4,20,9,10,0,0,0,19,nowin,win,plwin,beat,20,0,13,207,0.396135266,0.053140097,0.594202899,0,0.028306925
25049,118,24175,9,6,0,5,0,20,9,10,0,0,0,19,nowin,win,plwin,beat,20,0,15,216,0.393518519,0.037037037,0.555555556,0,0.018059873
25050,11,24176,9,10,0,0,0,19,10,10,0,0,0,20,nowin,loss,beat,dlwin,0,10,19,236,0.457627119,0.016949153,0.588983051,3,0.889015813
25051,22,24176,3,10,0,8,0,21,10,10,0,0,0,20,nowin,win,plwin,beat,20,0,13,187,0.481283422,0.042780749,0.577540107,3,0.906128176
25052,61,24176,4,10,0,10,0,24,10,10,0,0,0,20,nowin,loss,bust,plbust,0,10,14,194,0.427835052,0.077319588,0.603092784,2,0.591437139
25053,87,24176,7,11,0,0,0,18,10,10,0,0,0,20,nowin,loss,beat,dlwin,0,10,18,202,0.405940594,0.054455446,0.628712871,2,0.590599801
25054,12,24176,10,6,0,6,0,22,10,10,0,0,0,20,nowin,loss,bust,plbust,0,10,16,189,0.470899471,0.015873016,0.613756614,3,0.929171178
25055,120,24176,8,10,0,0,0,18,10,10,0,0,0,20,nowin,loss,beat,dlwin,0,10,18,202,0.440594059,0.034653465,0.618811881,2,0.614441029
25056,100,24177,10,9,0,0,0,19,10,5,1,10,0,26,nowin,win,dlbust,bust,20,0,19,190,0.452631579,0.036842105,0.594736842,3,0.888671154
25057,127,24177,1,4,10,10,0,25,10,5,1,10,0,26,nowin,loss,bust,plbust,0,10,5,201,0.402985075,0.029850746,0.60199005,0,0.032263937
25058,18,24177,8,3,10,0,0,21,10,5,1,10,0,26,nowin,win,dlbust,bust,20,0,11,182,0.461538462,0.043956044,0.587912088,3,0.892649374
25059,8,24177,8,10,0,0,0,18,10,5,1,10,0,26,nowin,win,dlbust,bust,20,0,18,181,0.44198895,0.071823204,0.596685083,2,0.599438402
25060,5,24177,7,10,0,0,0,17,10,5,1,10,0,26,nowin,win,dlbust,bust,20,0,17,203,0.42364532,0.02955665,0.596059113,2,0.582508076
25061,139,24177,5,7,0,10,0,22,10,5,1,10,0,26,nowin,loss,bust,plbust,0,10,12,192,0.380208333,0.036458333,0.59375,0,0.023429169
25062,134,24178,11,10,0,0,0,21,8,10,0,0,0,18,win,win,plwin,beat,25,0,21,185,0.443243243,0.021621622,0.545945946,1,0.296939509
25063,142,24178,4,6,10,0,0,20,8,10,0,0,0,18,nowin,win,plwin,beat,20,0,10,211,0.417061611,0.047393365,0.526066351,1,0.271531309
25064,60,24178,7,9,0,4,0,20,8,10,0,0,0,18,nowin,win,plwin,beat,20,0,16,227,0.418502203,0.022026432,0.559471366,0,0.026496258
25065,80,24178,10,11,0,0,0,21,8,10,0,0,0,18,win,win,plwin,beat,25,0,21,186,0.419354839,0.059139785,0.623655914,2,0.59892924
25066,89,24178,10,5,0,10,0,25,8,10,0,0,0,18,nowin,loss,bust,plbust,0,10,15,212,0.537735849,0.047169811,0.594339623,3,0.990167191
25067,62,24178,2,5,10,0,0,17,8,10,0,0,0,18,nowin,loss,beat,dlwin,0,10,7,178,0.370786517,0.028089888,0.54494382,0,0.008657722
25068,126,24179,10,10,0,0,0,20,11,10,0,0,0,21,nowin,loss,beat,dlwin,0,10,20,188,0.457446809,0.074468085,0.60106383,3,0.900633203
25069,37,24179,9,4,0,10,0,23,11,10,0,0,0,21,nowin,loss,bust,plbust,0,10,13,208,0.394230769,0.038461538,0.581730769,0,0.024682772
25070,150,24179,6,10,0,10,0,26,11,10,0,0,0,21,nowin,loss,bust,plbust,0,10,16,192,0.401041667,0.036458333,0.567708333,0,0.023287458
25071,140,24179,10,3,0,7,0,20,11,10,0,0,0,21,nowin,loss,beat,dlwin,0,10,13,210,0.466666667,0.023809524,0.604761905,3,0.915293335
25072,53,24179,7,5,0,3,10,25,11,10,0,0,0,21,nowin,loss,bust,plbust,0,10,12,250,0.372,0.064,0.564,0,0.013687345
25073,22,24179,8,5,0,6,0,19,11,10,0,0,0,21,nowin,loss,beat,dlwin,0,10,13,187,0.481283422,0.042780749,0.577540107,3,0.906128176
25074,53,24180,5,9,0,0,0,14,5,10,10,0,0,25,nowin,win,dlbust,bust,20,0,14,250,0.372,0.064,0.564,0,0.013687345
25075,33,24180,2,8,10,0,0,20,5,10,10,0,0,25,nowin,win,dlbust,bust,20,0,10,192,0.4375,0.057291667,0.625,2,0.616208916
25076,81,24180,6,3,10,0,0,19,5,10,10,0,0,25,nowin,win,dlbust,bust,20,0,9,182,0.395604396,0.043956044,0.60989011,2,0.567491261
25077,31,24180,10,10,0,0,0,20,5,10,10,0,0,25,nowin,win,dlbust,bust,20,0,20,188,0.473404255,0.058510638,0.515957447,1,0.300306557
25078,26,24180,3,10,0,0,0,13,5,10,10,0,0,25,nowin,win,dlbust,bust,20,0,13,203,0.463054187,0.0591133,0.541871921,1,0.306802864
25079,50,24180,5,5,10,0,0,20,5,10,10,0,0,25,nowin,win,dlbust,bust,20,0,10,202,0.405940594,0.04950495,0.54950495,0,0.020296079
25080,29,24181,4,10,0,0,0,14,3,10,10,0,0,23,nowin,win,dlbust,bust,20,0,14,189,0.44973545,0.058201058,0.544973545,1,0.300349439
25081,80,24181,8,10,0,0,0,18,3,10,10,0,0,23,nowin,win,dlbust,bust,20,0,18,186,0.419354839,0.059139785,0.623655914,2,0.59892924
25082,137,24181,9,3,0,9,0,21,3,10,10,0,0,23,nowin,win,dlbust,bust,20,0,12,194,0.417525773,0.046391753,0.536082474,1,0.276714602
25083,138,24181,10,10,0,0,0,20,3,10,10,0,0,23,nowin,win,dlbust,bust,20,0,20,190,0.442105263,0.047368421,0.610526316,2,0.609711065
25084,95,24181,2,9,8,0,0,19,3,10,10,0,0,23,nowin,win,dlbust,bust,20,0,11,218,0.412844037,0.04587156,0.559633028,0,0.024842385
25085,6,24181,3,6,9,0,0,18,3,10,10,0,0,23,nowin,win,dlbust,bust,20,0,9,191,0.439790576,0.047120419,0.581151832,1,0.31211505
25086,31,24182,10,11,0,0,0,21,7,2,10,0,0,19,win,win,plwin,beat,25,0,21,188,0.473404255,0.058510638,0.515957447,1,0.300306557
25087,89,24182,7,8,0,6,0,21,7,2,10,0,0,19,nowin,win,plwin,beat,20,0,15,212,0.537735849,0.047169811,0.594339623,3,0.990167191
25088,104,24182,10,4,0,5,0,19,7,2,10,0,0,19,nowin,push,push,push,10,0,14,209,0.363636364,0.052631579,0.593301435,0,0.018359419
25089,30,24182,10,7,0,0,0,17,7,2,10,0,0,19,nowin,loss,beat,dlwin,0,10,17,206,0.393203883,0.033980583,0.601941748,0,0.029324648
25090,26,24182,10,11,0,0,0,21,7,2,10,0,0,19,win,win,plwin,beat,25,0,21,203,0.463054187,0.0591133,0.541871921,1,0.306802864
25091,148,24182,2,2,10,10,0,24,7,2,10,0,0,19,nowin,loss,bust,plbust,0,10,4,204,0.401960784,0.078431373,0.593137255,0,0.029789521
25092,136,24183,9,6,0,8,0,23,8,4,7,0,0,19,nowin,loss,bust,plbust,0,10,15,194,0.396907216,0.025773196,0.597938144,0,0.029452644
25093,127,24183,11,10,0,0,0,21,8,4,7,0,0,19,win,win,plwin,beat,25,0,21,201,0.402985075,0.029850746,0.60199005,0,0.032263937
25094,88,24183,10,8,0,0,0,18,8,4,7,0,0,19,nowin,loss,beat,dlwin,0,10,18,206,0.466019417,0.033980583,0.54368932,1,0.309467903
25095,68,24183,3,9,0,3,6,21,8,4,7,0,0,19,nowin,win,plwin,beat,20,0,12,205,0.434146341,0.029268293,0.6,2,0.59483189
25096,80,24183,10,8,0,0,0,18,8,4,7,0,0,19,nowin,loss,beat,dlwin,0,10,18,186,0.419354839,0.059139785,0.623655914,2,0.59892924
25097,52,24183,7,7,0,6,0,20,8,4,7,0,0,19,nowin,win,plwin,beat,20,0,14,217,0.414746544,0.02764977,0.599078341,2,0.576736024
25098,113,24184,6,10,0,8,0,24,10,10,0,0,0,20,nowin,loss,bust,plbust,0,10,16,199,0.407035176,0.055276382,0.668341709,2,0.620695264
25099,120,24184,4,10,0,10,0,24,10,10,0,0,0,20,nowin,loss,bust,plbust,0,10,14,202,0.440594059,0.034653465,0.618811881,2,0.614441029
25100,45,24184,10,10,0,0,0,20,10,10,0,0,0,20,nowin,push,push,push,10,0,20,196,0.428571429,0.051020408,0.612244898,2,0.598821767
25101,36,24184,10,8,0,0,0,18,10,10,0,0,0,20,nowin,loss,beat,dlwin,0,10,18,229,0.445414847,0.056768559,0.655021834,2,0.645370571
25102,21,24184,9,10,0,0,0,19,10,10,0,0,0,20,nowin,loss,beat,dlwin,0,10,19,214,0.359813084,0.042056075,0.626168224,0,0.025263474
25103,137,24184,11,9,0,0,0,20,10,10,0,0,0,20,nowin,push,push,push,10,0,20,194,0.417525773,0.046391753,0.536082474,1,0.276714602
25104,122,24185,4,10,0,3,0,17,7,11,0,0,0,18,nowin,loss,beat,dlwin,0,10,14,210,0.347619048,0.052380952,0.59047619,0,0.012873677
25105,14,24185,7,10,0,0,0,17,7,11,0,0,0,18,nowin,loss,beat,dlwin,0,10,17,202,0.391089109,0.01980198,0.628712871,2,0.577264877
25106,78,24185,8,4,0,1,6,19,7,11,0,0,0,18,nowin,win,plwin,beat,20,0,12,201,0.517412935,0.034825871,0.587064677,3,0.95871112
25107,124,24185,2,4,4,10,0,20,7,11,0,0,0,18,nowin,win,plwin,beat,20,0,6,202,0.47029703,0.064356436,0.584158416,3,0.899458193
25108,5,24185,8,3,2,10,0,23,7,11,0,0,0,18,nowin,loss,bust,plbust,0,10,11,203,0.42364532,0.02955665,0.596059113,2,0.582508076
25109,107,24185,10,10,0,0,0,20,7,11,0,0,0,18,nowin,win,plwin,beat,20,0,20,218,0.444954128,0.073394495,0.600917431,2,0.605210014
25110,100,24186,10,2,0,6,0,18,11,5,5,0,0,21,nowin,loss,beat,dlwin,0,10,12,190,0.452631579,0.036842105,0.594736842,3,0.888671154
25111,43,24186,3,3,2,3,5,16,11,5,5,0,0,21,nowin,loss,beat,dlwin,0,10,6,192,0.40625,0.041666667,0.609375,2,0.576671372
25112,41,24186,3,2,10,7,0,22,11,5,5,0,0,21,nowin,loss,bust,plbust,0,10,5,192,0.364583333,0.036458333,0.520833333,0,0.00089702
25113,111,24186,8,3,9,0,0,20,11,5,5,0,0,21,nowin,loss,beat,dlwin,0,10,11,180,0.433333333,0.055555556,0.611111111,2,0.602264492
25114,50,24186,3,8,10,0,0,21,11,5,5,0,0,21,nowin,push,push,push,10,0,11,202,0.405940594,0.04950495,0.54950495,0,0.020296079
25115,68,24186,6,9,0,1,4,20,11,5,5,0,0,21,nowin,loss,beat,dlwin,0,10,15,205,0.434146341,0.029268293,0.6,2,0.59483189
25116,40,24187,7,10,0,0,0,17,10,9,0,0,0,19,nowin,loss,beat,dlwin,0,10,17,196,0.367346939,0.030612245,0.617346939,0,0.025358183
25117,7,24187,8,8,0,10,0,26,10,9,0,0,0,19,nowin,loss,bust,plbust,0,10,16,183,0.442622951,0.06010929,0.62295082,2,0.619303341
25118,60,24187,7,2,10,0,0,19,10,9,0,0,0,19,nowin,push,push,push,10,0,9,227,0.418502203,0.022026432,0.559471366,0,0.026496258
25119,1,24187,4,5,10,0,0,19,10,9,0,0,0,19,nowin,push,push,push,10,0,9,197,0.406091371,0.025380711,0.649746193,2,0.606186955
25120,45,24187,9,11,0,0,0,20,10,9,0,0,0,19,nowin,win,plwin,beat,20,0,20,196,0.428571429,0.051020408,0.612244898,2,0.598821767
25121,67,24187,4,6,10,0,0,20,10,9,0,0,0,19,nowin,win,plwin,beat,20,0,10,195,0.369230769,0.041025641,0.569230769,0,0.014139427
25122,16,24188,6,4,7,0,0,17,10,7,0,0,0,17,nowin,push,push,push,10,0,10,220,0.427272727,0.081818182,0.6,2,0.588660176
25123,120,24188,10,10,0,0,0,20,10,7,0,0,0,17,nowin,win,plwin,beat,20,0,20,202,0.440594059,0.034653465,0.618811881,2,0.614441029
25124,140,24188,2,10,0,3,10,25,10,7,0,0,0,17,nowin,loss,bust,plbust,0,10,12,210,0.466666667,0.023809524,0.604761905,3,0.915293335
25125,88,24188,11,7,0,0,0,18,10,7,0,0,0,17,nowin,win,plwin,beat,20,0,18,206,0.466019417,0.033980583,0.54368932,1,0.309467903
25126,5,24188,9,10,0,0,0,19,10,7,0,0,0,17,nowin,win,plwin,beat,20,0,19,203,0.42364532,0.02955665,0.596059113,2,0.582508076
25127,127,24188,10,4,0,5,0,19,10,7,0,0,0,17,nowin,win,plwin,beat,20,0,14,201,0.402985075,0.029850746,0.60199005,0,0.032263937
25128,97,24189,10,7,0,0,0,17,11,7,0,0,0,18,nowin,loss,beat,dlwin,0,10,17,182,0.450549451,0.06043956,0.692307692,2,0.677372279
25129,111,24189,9,3,0,6,0,18,11,7,0,0,0,18,nowin,push,push,push,10,0,12,180,0.433333333,0.055555556,0.611111111,2,0.602264492
25130,43,24189,7,3,8,0,0,18,11,7,0,0,0,18,nowin,push,push,push,10,0,10,192,0.40625,0.041666667,0.609375,2,0.576671372
25131,98,24189,4,10,0,9,0,23,11,7,0,0,0,18,nowin,loss,bust,plbust,0,10,14,220,0.422727273,0.054545455,0.55,1,0.28664435
25132,11,24189,10,4,0,10,0,24,11,7,0,0,0,18,nowin,loss,bust,plbust,0,10,14,236,0.457627119,0.016949153,0.588983051,3,0.889015813
25133,24,24189,7,10,0,0,0,17,11,7,0,0,0,18,nowin,loss,beat,dlwin,0,10,17,207,0.458937198,0.048309179,0.570048309,1,0.318138014
25134,56,24190,9,3,0,7,0,19,9,4,1,1,4,19,nowin,push,push,push,10,0,12,175,0.4,0.057142857,0.582857143,0,0.026685297
25135,39,24190,9,2,10,0,0,21,9,4,1,1,4,19,nowin,win,plwin,beat,20,0,11,191,0.429319372,0.062827225,0.57591623,0,0.033760763
25136,75,24190,6,10,0,8,0,24,9,4,1,1,4,19,nowin,loss,bust,plbust,0,10,16,191,0.418848168,0.052356021,0.570680628,0,0.029344702
25137,64,24190,4,3,3,3,10,23,9,4,1,1,4,19,nowin,loss,bust,plbust,0,10,7,187,0.363636364,0.048128342,0.631016043,0,0.027594885
25138,44,24190,7,5,0,10,0,22,9,4,1,1,4,19,nowin,loss,bust,plbust,0,10,12,219,0.433789954,0.050228311,0.534246575,1,0.285551035
25139,91,24190,10,7,0,0,0,17,9,4,1,1,4,19,nowin,loss,beat,dlwin,0,10,17,194,0.417525773,0.046391753,0.515463918,1,0.266616552
25140,117,24191,7,8,0,0,0,15,3,5,10,0,0,18,nowin,loss,beat,dlwin,0,10,15,173,0.410404624,0.069364162,0.606936416,2,0.578610282
25141,66,24191,3,3,10,0,0,16,3,5,10,0,0,18,nowin,loss,beat,dlwin,0,10,6,217,0.456221198,0.064516129,0.626728111,3,0.924304367
25142,19,24191,10,11,0,0,0,21,3,5,10,0,0,18,win,win,plwin,beat,25,0,21,237,0.41350211,0.054852321,0.628691983,2,0.597373826
25143,146,24191,5,5,10,0,0,20,3,5,10,0,0,18,nowin,win,plwin,beat,20,0,10,221,0.43438914,0.040723982,0.542986425,1,0.290190091
25144,100,24191,9,10,0,0,0,19,3,5,10,0,0,18,nowin,win,plwin,beat,20,0,19,190,0.452631579,0.036842105,0.594736842,3,0.888671154
25145,75,24191,8,10,0,0,0,18,3,5,10,0,0,18,nowin,push,push,push,10,0,18,191,0.418848168,0.052356021,0.570680628,0,0.029344702
25146,89,24192,9,10,0,0,0,19,9,8,0,0,0,17,nowin,win,plwin,beat,20,0,19,212,0.537735849,0.047169811,0.594339623,3,0.990167191
25147,81,24192,3,10,0,5,0,18,9,8,0,0,0,17,nowin,win,plwin,beat,20,0,13,182,0.395604396,0.043956044,0.60989011,2,0.567491261
25148,76,24192,3,10,0,8,0,21,9,8,0,0,0,17,nowin,win,plwin,beat,20,0,13,189,0.534391534,0.079365079,0.608465608,3,1
25149,150,24192,2,6,7,9,0,24,9,8,0,0,0,17,nowin,loss,bust,plbust,0,10,8,192,0.401041667,0.036458333,0.567708333,0,0.023287458
25150,99,24192,10,10,0,0,0,20,9,8,0,0,0,17,nowin,win,plwin,beat,20,0,20,207,0.47826087,0.062801932,0.637681159,3,0.961418446
25151,137,24192,4,7,10,0,0,21,9,8,0,0,0,17,nowin,win,plwin,beat,20,0,11,194,0.417525773,0.046391753,0.536082474,1,0.276714602
25152,50,24193,9,10,0,0,0,19,11,6,0,0,0,17,nowin,win,plwin,beat,20,0,19,202,0.405940594,0.04950495,0.54950495,0,0.020296079
25153,29,24193,4,1,9,10,0,24,11,6,0,0,0,17,nowin,loss,bust,plbust,0,10,5,189,0.44973545,0.058201058,0.544973545,1,0.300349439
25154,45,24193,8,10,0,0,0,18,11,6,0,0,0,17,nowin,win,plwin,beat,20,0,18,196,0.428571429,0.051020408,0.612244898,2,0.598821767
25155,67,24193,10,10,0,0,0,20,11,6,0,0,0,17,nowin,win,plwin,beat,20,0,20,195,0.369230769,0.041025641,0.569230769,0,0.014139427
25156,148,24193,10,8,0,0,0,18,11,6,0,0,0,17,nowin,win,plwin,beat,20,0,18,204,0.401960784,0.078431373,0.593137255,0,0.029789521
25157,6,24193,1,4,9,3,0,17,11,6,0,0,0,17,nowin,push,push,push,10,0,5,191,0.439790576,0.047120419,0.581151832,1,0.31211505
25158,24,24194,10,10,0,0,0,20,7,9,3,0,0,19,nowin,win,plwin,beat,20,0,20,207,0.458937198,0.048309179,0.570048309,1,0.318138014
25159,47,24194,4,10,0,1,3,18,7,9,3,0,0,19,nowin,loss,beat,dlwin,0,10,14,210,0.438095238,0.057142857,0.623809524,2,0.615868808
25160,84,24194,10,6,0,5,0,21,7,9,3,0,0,19,nowin,win,plwin,beat,20,0,16,195,0.379487179,0.056410256,0.569230769,0,0.017209119
25161,34,24194,10,10,0,0,0,20,7,9,3,0,0,19,nowin,win,plwin,beat,20,0,20,202,0.5,0.079207921,0.618811881,3,0.968961434
25162,29,24194,10,5,0,5,0,20,7,9,3,0,0,19,nowin,win,plwin,beat,20,0,15,189,0.44973545,0.058201058,0.544973545,1,0.300349439
25163,13,24194,8,4,0,7,0,19,7,9,3,0,0,19,nowin,push,push,push,10,0,12,206,0.417475728,0.063106796,0.621359223,2,0.59555479
25164,13,24195,8,5,0,5,0,18,7,10,0,0,0,17,nowin,win,plwin,beat,20,0,13,206,0.417475728,0.063106796,0.621359223,2,0.59555479
25165,74,24195,10,3,0,7,0,20,7,10,0,0,0,17,nowin,win,plwin,beat,20,0,13,209,0.411483254,0.04784689,0.531100478,0,0.017448125
25166,120,24195,6,10,0,10,0,26,7,10,0,0,0,17,nowin,loss,bust,plbust,0,10,16,202,0.440594059,0.034653465,0.618811881,2,0.614441029
25167,102,24195,10,7,0,0,0,17,7,10,0,0,0,17,nowin,push,push,push,10,0,17,192,0.338541667,0.046875,0.5625,0,0.003306118
25168,27,24195,2,9,10,0,0,21,7,10,0,0,0,17,nowin,win,plwin,beat,20,0,11,178,0.370786517,0.016853933,0.573033708,0,0.015536309
25169,150,24195,6,4,3,3,6,22,7,10,0,0,0,17,nowin,loss,bust,plbust,0,10,10,192,0.401041667,0.036458333,0.567708333,0,0.023287458
25170,96,24196,10,10,0,0,0,20,8,6,4,0,0,18,nowin,win,plwin,beat,20,0,20,190,0.468421053,0.057894737,0.584210526,3,0.897263354
25171,91,24196,5,2,10,0,0,17,8,6,4,0,0,18,nowin,loss,beat,dlwin,0,10,7,194,0.417525773,0.046391753,0.515463918,1,0.266616552
25172,38,24196,10,7,0,0,0,17,8,6,4,0,0,18,nowin,loss,beat,dlwin,0,10,17,202,0.361386139,0.03960396,0.564356436,0,0.010597953
25173,127,24196,9,10,0,0,0,19,8,6,4,0,0,18,nowin,win,plwin,beat,20,0,19,201,0.402985075,0.029850746,0.60199005,0,0.032263937
25174,60,24196,10,2,0,5,0,17,8,6,4,0,0,18,nowin,loss,beat,dlwin,0,10,12,227,0.418502203,0.022026432,0.559471366,0,0.026496258
25175,98,24196,10,2,0,4,10,26,8,6,4,0,0,18,nowin,loss,bust,plbust,0,10,12,220,0.422727273,0.054545455,0.55,1,0.28664435
25176,84,24197,6,5,7,0,0,18,2,10,6,0,0,18,nowin,push,push,push,10,0,11,195,0.379487179,0.056410256,0.569230769,0,0.017209119
25177,108,24197,4,3,8,0,0,15,2,10,6,0,0,18,nowin,loss,beat,dlwin,0,10,7,193,0.435233161,0.056994819,0.559585492,1,0.298824795
25178,23,24197,11,10,0,0,0,21,2,10,6,0,0,18,win,win,plwin,beat,25,0,21,208,0.427884615,0.0625,0.552884615,1,0.29114424
25179,109,24197,10,11,0,0,0,21,2,10,6,0,0,18,win,win,plwin,beat,25,0,21,221,0.461538462,0.058823529,0.597285068,3,0.901830309
25180,137,24197,7,6,0,0,0,13,2,10,6,0,0,18,nowin,loss,beat,dlwin,0,10,13,194,0.417525773,0.046391753,0.536082474,1,0.276714602
25181,120,24197,10,10,0,0,0,20,2,10,6,0,0,18,nowin,win,plwin,beat,20,0,20,202,0.440594059,0.034653465,0.618811881,2,0.614441029
25182,53,24198,10,10,0,0,0,20,7,10,0,0,0,17,nowin,win,plwin,beat,20,0,20,250,0.372,0.064,0.564,0,0.013687345
25183,149,24198,10,7,0,0,0,17,7,10,0,0,0,17,nowin,push,push,push,10,0,17,225,0.457777778,0.057777778,0.648888889,2,0.651965595
25184,109,24198,7,10,0,0,0,17,7,10,0,0,0,17,nowin,push,push,push,10,0,17,221,0.461538462,0.058823529,0.597285068,3,0.901830309
25185,28,24198,10,5,0,6,0,21,7,10,0,0,0,17,nowin,win,plwin,beat,20,0,15,199,0.422110553,0.045226131,0.542713568,1,0.282706618
25186,68,24198,10,11,0,0,0,21,7,10,0,0,0,17,win,win,plwin,beat,25,0,21,205,0.434146341,0.029268293,0.6,2,0.59483189
25187,96,24198,10,8,0,0,0,18,7,10,0,0,0,17,nowin,win,plwin,beat,20,0,18,190,0.468421053,0.057894737,0.584210526,3,0.897263354
25188,124,24199,2,10,0,0,0,12,4,4,5,9,0,22,nowin,win,dlbust,bust,20,0,12,202,0.47029703,0.064356436,0.584158416,3,0.899458193
25189,109,24199,3,10,0,0,0,13,4,4,5,9,0,22,nowin,win,dlbust,bust,20,0,13,221,0.461538462,0.058823529,0.597285068,3,0.901830309
25190,100,24199,10,10,0,0,0,20,4,4,5,9,0,22,nowin,win,dlbust,bust,20,0,20,190,0.452631579,0.036842105,0.594736842,3,0.888671154
25191,116,24199,10,6,0,0,0,16,4,4,5,9,0,22,nowin,win,dlbust,bust,20,0,16,195,0.425641026,0.056410256,0.538461538,1,0.28273747
25192,70,24199,6,10,0,0,0,16,4,4,5,9,0,22,nowin,win,dlbust,bust,20,0,16,228,0.385964912,0.039473684,0.557017544,0,0.016157125
25193,107,24199,10,10,0,0,0,20,4,4,5,9,0,22,nowin,win,dlbust,bust,20,0,20,218,0.444954128,0.073394495,0.600917431,2,0.605210014
25194,117,24200,10,9,0,0,0,19,10,11,0,0,0,21,nowin,loss,beat,dlwin,0,10,19,173,0.410404624,0.069364162,0.606936416,2,0.578610282
25195,112,24200,10,10,0,0,0,20,10,11,0,0,0,21,nowin,loss,beat,dlwin,0,10,20,203,0.448275862,0.054187192,0.600985222,3,0.889576933
25196,149,24200,10,6,0,5,0,21,10,11,0,0,0,21,nowin,push,push,push,10,0,16,225,0.457777778,0.057777778,0.648888889,2,0.651965595
25197,85,24200,10,11,0,0,0,21,10,11,0,0,0,21,win,push,push,push,10,0,21,195,0.41025641,0.066666667,0.594871795,0,0.03269711
25198,97,24200,4,6,5,10,0,25,10,11,0,0,0,21,nowin,loss,bust,plbust,0,10,10,182,0.450549451,0.06043956,0.692307692,2,0.677372279
25199,90,24200,4,3,10,0,0,17,10,11,0,0,0,21,nowin,loss,beat,dlwin,0,10,7,201,0.447761194,0.049751244,0.60199005,3,0.889945023
25200,50,24201,10,3,0,0,0,13,2,5,4,10,0,21,nowin,loss,beat,dlwin,0,10,13,202,0.405940594,0.04950495,0.54950495,0,0.020296079
25201,143,24201,7,8,0,0,0,15,2,5,4,10,0,21,nowin,loss,beat,dlwin,0,10,15,203,0.463054187,0.044334975,0.57635468,3,0.883143365
25202,144,24201,8,10,0,0,0,18,2,5,4,10,0,21,nowin,loss,beat,dlwin,0,10,18,202,0.386138614,0.054455446,0.564356436,0,0.018006244
25203,59,24201,3,6,5,0,0,14,2,5,4,10,0,21,nowin,loss,beat,dlwin,0,10,9,228,0.429824561,0.048245614,0.543859649,1,0.287885446
25204,28,24201,2,10,0,1,0,13,2,5,4,10,0,21,nowin,loss,beat,dlwin,0,10,12,199,0.422110553,0.045226131,0.542713568,1,0.282706618
25205,15,24201,10,9,0,0,0,19,2,5,4,10,0,21,nowin,loss,beat,dlwin,0,10,19,212,0.410377358,0.051886792,0.561320755,0,0.024517408
25206,122,24202,10,10,0,0,0,20,10,2,6,0,0,18,nowin,win,plwin,beat,20,0,20,210,0.347619048,0.052380952,0.59047619,0,0.012873677
25207,115,24202,2,10,0,1,8,21,10,2,6,0,0,18,nowin,win,plwin,beat,20,0,12,194,0.427835052,0.041237113,0.592783505,2,0.583863602
25208,53,24202,8,8,0,3,0,19,10,2,6,0,0,18,nowin,win,plwin,beat,20,0,16,250,0.372,0.064,0.564,0,0.013687345
25209,103,24202,4,10,0,10,0,24,10,2,6,0,0,18,nowin,loss,bust,plbust,0,10,14,203,0.379310345,0.064039409,0.551724138,0,0.012869209
25210,137,24202,10,10,0,0,0,20,10,2,6,0,0,18,nowin,win,plwin,beat,20,0,20,194,0.417525773,0.046391753,0.536082474,1,0.276714602
25211,93,24202,8,9,0,0,0,17,10,2,6,0,0,18,nowin,loss,beat,dlwin,0,10,17,175,0.485714286,0.051428571,0.548571429,1,0.323648091
25212,19,24203,9,10,0,0,0,19,5,7,8,0,0,20,nowin,loss,beat,dlwin,0,10,19,237,0.41350211,0.054852321,0.628691983,2,0.597373826
25213,75,24203,8,10,0,0,0,18,5,7,8,0,0,20,nowin,loss,beat,dlwin,0,10,18,191,0.418848168,0.052356021,0.570680628,0,0.029344702
25214,50,24203,2,2,10,0,0,14,5,7,8,0,0,20,nowin,loss,beat,dlwin,0,10,4,202,0.405940594,0.04950495,0.54950495,0,0.020296079
25215,44,24203,8,10,0,0,0,18,5,7,8,0,0,20,nowin,loss,beat,dlwin,0,10,18,219,0.433789954,0.050228311,0.534246575,1,0.285551035
25216,97,24203,2,4,10,0,0,16,5,7,8,0,0,20,nowin,loss,beat,dlwin,0,10,6,182,0.450549451,0.06043956,0.692307692,2,0.677372279
25217,119,24203,6,10,0,0,0,16,5,7,8,0,0,20,nowin,loss,beat,dlwin,0,10,16,190,0.405263158,0.068421053,0.515789474,0,0.011837158
25218,90,24204,4,5,10,0,0,19,8,10,0,0,0,18,nowin,win,plwin,beat,20,0,9,201,0.447761194,0.049751244,0.60199005,3,0.889945023
25219,91,24204,10,10,0,0,0,20,8,10,0,0,0,18,nowin,win,plwin,beat,20,0,20,194,0.417525773,0.046391753,0.515463918,1,0.266616552
25220,29,24204,6,5,4,2,0,17,8,10,0,0,0,18,nowin,loss,beat,dlwin,0,10,11,189,0.44973545,0.058201058,0.544973545,1,0.300349439
25221,109,24204,5,2,4,1,1,13,8,10,0,0,0,18,nowin,loss,beat,dlwin,0,10,7,221,0.461538462,0.058823529,0.597285068,3,0.901830309
25222,110,24204,10,7,0,0,0,17,8,10,0,0,0,18,nowin,loss,beat,dlwin,0,10,17,192,0.416666667,0.046875,0.557291667,0,0.025413132
25223,35,24204,6,9,0,2,0,17,8,10,0,0,0,18,nowin,loss,beat,dlwin,0,10,15,202,0.410891089,0.044554455,0.633663366,2,0.598681573
25224,77,24205,3,10,0,0,0,13,2,5,8,10,0,25,nowin,win,dlbust,bust,20,0,13,200,0.455,0.04,0.62,3,0.916252116
25225,138,24205,2,8,2,10,0,22,2,5,8,10,0,25,nowin,loss,bust,plbust,0,10,10,190,0.442105263,0.047368421,0.610526316,2,0.609711065
25226,95,24205,7,10,0,0,0,17,2,5,8,10,0,25,nowin,win,dlbust,bust,20,0,17,218,0.412844037,0.04587156,0.559633028,0,0.024842385
25227,87,24205,5,2,9,0,0,16,2,5,8,10,0,25,nowin,win,dlbust,bust,20,0,7,202,0.405940594,0.054455446,0.628712871,2,0.590599801
25228,71,24205,6,3,11,0,0,20,2,5,8,10,0,25,nowin,win,dlbust,bust,20,0,9,193,0.352331606,0.046632124,0.585492228,0,0.013063661
25229,98,24205,11,1,4,0,0,16,2,5,8,10,0,25,nowin,win,dlbust,bust,20,0,12,220,0.422727273,0.054545455,0.55,1,0.28664435
25230,138,24206,6,10,0,7,0,23,1,5,7,10,0,23,nowin,loss,bust,plbust,0,10,16,190,0.442105263,0.047368421,0.610526316,2,0.609711065
25231,31,24206,2,3,11,3,0,19,1,5,7,10,0,23,nowin,win,dlbust,bust,20,0,5,188,0.473404255,0.058510638,0.515957447,1,0.300306557
25232,59,24206,8,3,5,4,0,20,1,5,7,10,0,23,nowin,win,dlbust,bust,20,0,11,228,0.429824561,0.048245614,0.543859649,1,0.287885446
25233,22,24206,10,10,0,0,0,20,1,5,7,10,0,23,nowin,win,dlbust,bust,20,0,20,187,0.481283422,0.042780749,0.577540107,3,0.906128176
25234,142,24206,4,8,0,8,0,20,1,5,7,10,0,23,nowin,win,dlbust,bust,20,0,12,211,0.417061611,0.047393365,0.526066351,1,0.271531309
25235,86,24206,10,2,0,10,0,22,1,5,7,10,0,23,nowin,loss,bust,plbust,0,10,12,196,0.454081633,0.040816327,0.591836735,3,0.887566443
25236,98,24207,8,8,0,0,0,16,6,10,10,0,0,26,nowin,win,dlbust,bust,20,0,16,220,0.422727273,0.054545455,0.55,1,0.28664435
25237,147,24207,9,10,0,0,0,19,6,10,10,0,0,26,nowin,win,dlbust,bust,20,0,19,205,0.380487805,0.014634146,0.536585366,0,0.00951447
25238,86,24207,2,5,9,0,0,16,6,10,10,0,0,26,nowin,win,dlbust,bust,20,0,7,196,0.454081633,0.040816327,0.591836735,3,0.887566443
25239,134,24207,6,10,0,0,0,16,6,10,10,0,0,26,nowin,win,dlbust,bust,20,0,16,185,0.443243243,0.021621622,0.545945946,1,0.296939509
25240,65,24207,6,9,0,0,0,15,6,10,10,0,0,26,nowin,win,dlbust,bust,20,0,15,203,0.492610837,0.054187192,0.571428571,3,0.913702814
25241,100,24207,2,10,0,0,0,12,6,10,10,0,0,26,nowin,win,dlbust,bust,20,0,12,190,0.452631579,0.036842105,0.594736842,3,0.888671154
25242,59,24208,8,4,0,1,10,23,8,11,0,0,0,19,nowin,loss,bust,plbust,0,10,12,228,0.429824561,0.048245614,0.543859649,1,0.287885446
25243,104,24208,10,10,0,0,0,20,8,11,0,0,0,19,nowin,win,plwin,beat,20,0,20,209,0.363636364,0.052631579,0.593301435,0,0.018359419
25244,94,24208,10,2,0,4,3,19,8,11,0,0,0,19,nowin,push,push,push,10,0,12,183,0.43715847,0.043715847,0.540983607,1,0.290866892
25245,139,24208,10,11,0,0,0,21,8,11,0,0,0,19,win,win,plwin,beat,25,0,21,192,0.380208333,0.036458333,0.59375,0,0.023429169
25246,60,24208,5,10,0,10,0,25,8,11,0,0,0,19,nowin,loss,bust,plbust,0,10,15,227,0.418502203,0.022026432,0.559471366,0,0.026496258
25247,8,24208,10,10,0,0,0,20,8,11,0,0,0,19,nowin,win,plwin,beat,20,0,20,181,0.44198895,0.071823204,0.596685083,2,0.599438402
25248,13,24209,10,10,0,0,0,20,11,10,0,0,0,21,nowin,loss,beat,dlwin,0,10,20,206,0.417475728,0.063106796,0.621359223,2,0.59555479
25249,124,24209,10,4,0,6,0,20,11,10,0,0,0,21,nowin,loss,beat,dlwin,0,10,14,202,0.47029703,0.064356436,0.584158416,3,0.899458193
25250,67,24209,7,3,8,0,0,18,11,10,0,0,0,21,nowin,loss,beat,dlwin,0,10,10,195,0.369230769,0.041025641,0.569230769,0,0.014139427
25251,55,24209,8,10,0,0,0,18,11,10,0,0,0,21,nowin,loss,beat,dlwin,0,10,18,191,0.371727749,0.057591623,0.54973822,0,0.01011347
25252,130,24209,9,7,0,10,0,26,11,10,0,0,0,21,nowin,loss,bust,plbust,0,10,16,219,0.410958904,0.03652968,0.566210046,0,0.025888739
25253,96,24209,6,10,0,5,0,21,11,10,0,0,0,21,nowin,push,push,push,10,0,16,190,0.468421053,0.057894737,0.584210526,3,0.897263354
25254,29,24210,10,4,0,2,10,26,7,11,0,0,0,18,nowin,loss,bust,plbust,0,10,14,189,0.44973545,0.058201058,0.544973545,1,0.300349439
25255,146,24210,4,4,7,6,0,21,7,11,0,0,0,18,nowin,win,plwin,beat,20,0,8,221,0.43438914,0.040723982,0.542986425,1,0.290190091
25256,75,24210,9,10,0,0,0,19,7,11,0,0,0,18,nowin,win,plwin,beat,20,0,19,191,0.418848168,0.052356021,0.570680628,0,0.029344702
25257,31,24210,4,11,1,5,0,21,7,11,0,0,0,18,nowin,win,plwin,beat,20,0,15,188,0.473404255,0.058510638,0.515957447,1,0.300306557
25258,95,24210,7,4,8,0,0,19,7,11,0,0,0,18,nowin,win,plwin,beat,20,0,11,218,0.412844037,0.04587156,0.559633028,0,0.024842385
25259,48,24210,5,1,6,8,0,20,7,11,0,0,0,18,nowin,win,plwin,beat,20,0,6,203,0.413793103,0.019704433,0.600985222,2,0.577280801
25260,112,24211,6,4,10,0,0,20,11,10,0,0,0,21,nowin,loss,beat,dlwin,0,10,10,203,0.448275862,0.054187192,0.600985222,3,0.889576933
25261,91,24211,11,10,0,0,0,21,11,10,0,0,0,21,win,push,push,push,10,0,21,194,0.417525773,0.046391753,0.515463918,1,0.266616552
25262,66,24211,7,2,7,10,0,26,11,10,0,0,0,21,nowin,loss,bust,plbust,0,10,9,217,0.456221198,0.064516129,0.626728111,3,0.924304367
25263,24,24211,8,2,4,10,0,24,11,10,0,0,0,21,nowin,loss,bust,plbust,0,10,10,207,0.458937198,0.048309179,0.570048309,1,0.318138014
25264,150,24211,9,5,0,7,0,21,11,10,0,0,0,21,nowin,push,push,push,10,0,14,192,0.401041667,0.036458333,0.567708333,0,0.023287458
25265,7,24211,3,9,0,6,0,18,11,10,0,0,0,21,nowin,loss,beat,dlwin,0,10,12,183,0.442622951,0.06010929,0.62295082,2,0.619303341
25266,21,24212,10,10,0,0,0,20,2,5,4,4,10,25,nowin,win,dlbust,bust,20,0,20,214,0.359813084,0.042056075,0.626168224,0,0.025263474
25267,13,24212,8,8,0,0,0,16,2,5,4,4,10,25,nowin,win,dlbust,bust,20,0,16,206,0.417475728,0.063106796,0.621359223,2,0.59555479
25268,115,24212,10,9,0,0,0,19,2,5,4,4,10,25,nowin,win,dlbust,bust,20,0,19,194,0.427835052,0.041237113,0.592783505,2,0.583863602
25269,14,24212,7,10,0,0,0,17,2,5,4,4,10,25,nowin,win,dlbust,bust,20,0,17,202,0.391089109,0.01980198,0.628712871,2,0.577264877
25270,47,24212,10,10,0,0,0,20,2,5,4,4,10,25,nowin,win,dlbust,bust,20,0,20,210,0.438095238,0.057142857,0.623809524,2,0.615868808
25271,8,24212,6,1,7,0,0,14,2,5,4,4,10,25,nowin,win,dlbust,bust,20,0,7,181,0.44198895,0.071823204,0.596685083,2,0.599438402
25272,67,24213,10,10,0,0,0,20,10,5,2,0,0,17,nowin,win,plwin,beat,20,0,20,195,0.369230769,0.041025641,0.569230769,0,0.014139427
25273,19,24213,10,11,0,0,0,21,10,5,2,0,0,17,win,win,plwin,beat,25,0,21,237,0.41350211,0.054852321,0.628691983,2,0.597373826
25274,61,24213,4,2,4,10,0,20,10,5,2,0,0,17,nowin,win,plwin,beat,20,0,6,194,0.427835052,0.077319588,0.603092784,2,0.591437139
25275,77,24213,8,3,2,3,2,18,10,5,2,0,0,17,nowin,win,plwin,beat,20,0,11,200,0.455,0.04,0.62,3,0.916252116
25276,45,24213,10,7,0,0,0,17,10,5,2,0,0,17,nowin,push,push,push,10,0,17,196,0.428571429,0.051020408,0.612244898,2,0.598821767
25277,110,24213,8,10,0,0,0,18,10,5,2,0,0,17,nowin,win,plwin,beat,20,0,18,192,0.416666667,0.046875,0.557291667,0,0.025413132
25278,35,24214,10,10,0,0,0,20,10,10,0,0,0,20,nowin,push,push,push,10,0,20,202,0.410891089,0.044554455,0.633663366,2,0.598681573
25279,39,24214,10,10,0,0,0,20,10,10,0,0,0,20,nowin,push,push,push,10,0,20,191,0.429319372,0.062827225,0.57591623,0,0.033760763
25280,131,24214,6,10,0,10,0,26,10,10,0,0,0,20,nowin,loss,bust,plbust,0,10,16,217,0.410138249,0.069124424,0.543778802,0,0.02015021
25281,117,24214,9,3,0,10,0,22,10,10,0,0,0,20,nowin,loss,bust,plbust,0,10,12,173,0.410404624,0.069364162,0.606936416,2,0.578610282
25282,21,24214,7,10,0,0,0,17,10,10,0,0,0,20,nowin,loss,beat,dlwin,0,10,17,214,0.359813084,0.042056075,0.626168224,0,0.025263474
25283,70,24214,10,6,0,3,0,19,10,10,0,0,0,20,nowin,loss,beat,dlwin,0,10,16,228,0.385964912,0.039473684,0.557017544,0,0.016157125
25284,33,24215,8,10,0,0,0,18,5,10,10,0,0,25,nowin,win,dlbust,bust,20,0,18,192,0.4375,0.057291667,0.625,2,0.616208916
25285,85,24215,2,10,0,0,0,12,5,10,10,0,0,25,nowin,win,dlbust,bust,20,0,12,195,0.41025641,0.066666667,0.594871795,0,0.03269711
25286,82,24215,10,4,0,0,0,14,5,10,10,0,0,25,nowin,win,dlbust,bust,20,0,14,225,0.408888889,0.075555556,0.577777778,0,0.028101874
25287,101,24215,8,10,0,0,0,18,5,10,10,0,0,25,nowin,win,dlbust,bust,20,0,18,205,0.424390244,0.068292683,0.63902439,2,0.614740646
25288,111,24215,2,8,9,0,0,19,5,10,10,0,0,25,nowin,win,dlbust,bust,20,0,10,180,0.433333333,0.055555556,0.611111111,2,0.602264492
25289,25,24215,11,10,0,0,0,21,5,10,10,0,0,25,win,win,dlbust,bust,25,0,21,190,0.463157895,0.063157895,0.536842105,1,0.304401563
25290,34,24216,10,10,0,0,0,20,10,9,0,0,0,19,nowin,win,plwin,beat,20,0,20,202,0.5,0.079207921,0.618811881,3,0.968961434
25291,78,24216,3,10,0,5,0,18,10,9,0,0,0,19,nowin,loss,beat,dlwin,0,10,13,201,0.517412935,0.034825871,0.587064677,3,0.95871112
25292,17,24216,8,10,0,0,0,18,10,9,0,0,0,19,nowin,loss,beat,dlwin,0,10,18,171,0.444444444,0.070175439,0.555555556,1,0.302364894
25293,119,24216,6,10,0,5,0,21,10,9,0,0,0,19,nowin,win,plwin,beat,20,0,16,190,0.405263158,0.068421053,0.515789474,0,0.011837158
25294,1,24216,8,10,0,0,0,18,10,9,0,0,0,19,nowin,loss,beat,dlwin,0,10,18,197,0.406091371,0.025380711,0.649746193,2,0.606186955
25295,61,24216,9,2,5,10,0,26,10,9,0,0,0,19,nowin,loss,bust,plbust,0,10,11,194,0.427835052,0.077319588,0.603092784,2,0.591437139
25296,82,24217,6,9,0,9,0,24,11,10,0,0,0,21,nowin,loss,bust,plbust,0,10,15,225,0.408888889,0.075555556,0.577777778,0,0.028101874
25297,68,24217,2,10,0,6,0,18,11,10,0,0,0,21,nowin,loss,beat,dlwin,0,10,12,205,0.434146341,0.029268293,0.6,2,0.59483189
25298,25,24217,8,8,0,5,0,21,11,10,0,0,0,21,nowin,push,push,push,10,0,16,190,0.463157895,0.063157895,0.536842105,1,0.304401563
25299,43,24217,2,10,0,7,0,19,11,10,0,0,0,21,nowin,loss,beat,dlwin,0,10,12,192,0.40625,0.041666667,0.609375,2,0.576671372
25300,8,24217,2,5,9,1,0,17,11,10,0,0,0,21,nowin,loss,beat,dlwin,0,10,7,181,0.44198895,0.071823204,0.596685083,2,0.599438402
25301,48,24217,10,10,0,0,0,20,11,10,0,0,0,21,nowin,loss,beat,dlwin,0,10,20,203,0.413793103,0.019704433,0.600985222,2,0.577280801
25302,64,24218,6,3,10,0,0,19,10,5,4,0,0,19,nowin,push,push,push,10,0,9,187,0.363636364,0.048128342,0.631016043,0,0.027594885
25303,68,24218,10,5,0,2,0,17,10,5,4,0,0,19,nowin,loss,beat,dlwin,0,10,15,205,0.434146341,0.029268293,0.6,2,0.59483189
25304,73,24218,2,10,0,10,0,22,10,5,4,0,0,19,nowin,loss,bust,plbust,0,10,12,181,0.375690608,0.011049724,0.596685083,0,0.022795773
25305,144,24218,7,5,0,2,1,15,10,5,4,0,0,19,nowin,loss,beat,dlwin,0,10,12,202,0.386138614,0.054455446,0.564356436,0,0.018006244
25306,108,24218,10,9,0,0,0,19,10,5,4,0,0,19,nowin,push,push,push,10,0,19,193,0.435233161,0.056994819,0.559585492,1,0.298824795
25307,87,24218,8,5,0,10,0,23,10,5,4,0,0,19,nowin,loss,bust,plbust,0,10,13,202,0.405940594,0.054455446,0.628712871,2,0.590599801
25308,110,24219,10,8,0,0,0,18,11,7,0,0,0,18,nowin,push,push,push,10,0,18,192,0.416666667,0.046875,0.557291667,0,0.025413132
25309,75,24219,10,10,0,0,0,20,11,7,0,0,0,18,nowin,win,plwin,beat,20,0,20,191,0.418848168,0.052356021,0.570680628,0,0.029344702
25310,118,24219,2,2,9,9,0,22,11,7,0,0,0,18,nowin,loss,bust,plbust,0,10,4,216,0.393518519,0.037037037,0.555555556,0,0.018059873
25311,77,24219,2,10,0,10,0,22,11,7,0,0,0,18,nowin,loss,bust,plbust,0,10,12,200,0.455,0.04,0.62,3,0.916252116
25312,41,24219,5,3,9,0,0,17,11,7,0,0,0,18,nowin,loss,beat,dlwin,0,10,8,192,0.364583333,0.036458333,0.520833333,0,0.00089702
25313,24,24219,3,1,10,1,7,22,11,7,0,0,0,18,nowin,loss,bust,plbust,0,10,4,207,0.458937198,0.048309179,0.570048309,1,0.318138014
25314,57,24220,2,10,0,4,5,21,7,7,5,0,0,19,nowin,win,plwin,beat,20,0,12,192,0.46875,0.052083333,0.59375,3,0.907001181
25315,19,24220,10,10,0,0,0,20,7,7,5,0,0,19,nowin,win,plwin,beat,20,0,20,237,0.41350211,0.054852321,0.628691983,2,0.597373826
25316,111,24220,10,9,0,0,0,19,7,7,5,0,0,19,nowin,push,push,push,10,0,19,180,0.433333333,0.055555556,0.611111111,2,0.602264492
25317,23,24220,10,11,0,0,0,21,7,7,5,0,0,19,win,win,plwin,beat,25,0,21,208,0.427884615,0.0625,0.552884615,1,0.29114424
25318,9,24220,10,10,0,0,0,20,7,7,5,0,0,19,nowin,win,plwin,beat,20,0,20,194,0.37628866,0.015463918,0.541237113,0,0.009396796
25319,24,24220,5,3,10,0,0,18,7,7,5,0,0,19,nowin,loss,beat,dlwin,0,10,8,207,0.458937198,0.048309179,0.570048309,1,0.318138014
25320,58,24221,7,11,0,0,0,18,10,10,0,0,0,20,nowin,loss,beat,dlwin,0,10,18,195,0.430769231,0.041025641,0.584615385,2,0.580497586
25321,115,24221,10,2,0,9,0,21,10,10,0,0,0,20,nowin,win,plwin,beat,20,0,12,194,0.427835052,0.041237113,0.592783505,2,0.583863602
25322,26,24221,10,8,0,0,0,18,10,10,0,0,0,20,nowin,loss,beat,dlwin,0,10,18,203,0.463054187,0.0591133,0.541871921,1,0.306802864
25323,100,24221,2,9,10,0,0,21,10,10,0,0,0,20,nowin,win,plwin,beat,20,0,11,190,0.452631579,0.036842105,0.594736842,3,0.888671154
25324,14,24221,8,5,0,10,0,23,10,10,0,0,0,20,nowin,loss,bust,plbust,0,10,13,202,0.391089109,0.01980198,0.628712871,2,0.577264877
25325,143,24221,10,3,0,9,0,22,10,10,0,0,0,20,nowin,loss,bust,plbust,0,10,13,203,0.463054187,0.044334975,0.57635468,3,0.883143365
25326,125,24222,9,10,0,0,0,19,2,11,6,0,0,19,nowin,push,push,push,10,0,19,219,0.438356164,0.050228311,0.575342466,1,0.308411257
25327,98,24222,6,9,0,0,0,15,2,11,6,0,0,19,nowin,loss,beat,dlwin,0,10,15,220,0.422727273,0.054545455,0.55,1,0.28664435
25328,27,24222,8,11,0,0,0,19,2,11,6,0,0,19,nowin,push,push,push,10,0,19,178,0.370786517,0.016853933,0.573033708,0,0.015536309
25329,22,24222,2,5,6,0,0,13,2,11,6,0,0,19,nowin,loss,beat,dlwin,0,10,7,187,0.481283422,0.042780749,0.577540107,3,0.906128176
25330,71,24222,1,2,10,0,0,13,2,11,6,0,0,19,nowin,loss,beat,dlwin,0,10,3,193,0.352331606,0.046632124,0.585492228,0,0.013063661
25331,38,24222,8,10,0,0,0,18,2,11,6,0,0,19,nowin,loss,beat,dlwin,0,10,18,202,0.361386139,0.03960396,0.564356436,0,0.010597953
25332,7,24223,8,9,0,0,0,17,6,7,7,0,0,20,nowin,loss,beat,dlwin,0,10,17,183,0.442622951,0.06010929,0.62295082,2,0.619303341
25333,54,24223,8,5,0,0,0,13,6,7,7,0,0,20,nowin,loss,beat,dlwin,0,10,13,185,0.437837838,0.032432432,0.556756757,1,0.29899854
25334,3,24223,10,2,0,0,0,12,6,7,7,0,0,20,nowin,loss,beat,dlwin,0,10,12,190,0.431578947,0.026315789,0.542105263,1,0.288076384
25335,85,24223,10,3,0,0,0,13,6,7,7,0,0,20,nowin,loss,beat,dlwin,0,10,13,195,0.41025641,0.066666667,0.594871795,0,0.03269711
25336,75,24223,3,10,0,0,0,13,6,7,7,0,0,20,nowin,loss,beat,dlwin,0,10,13,191,0.418848168,0.052356021,0.570680628,0,0.029344702
25337,144,24223,3,6,11,0,0,20,6,7,7,0,0,20,nowin,push,push,push,10,0,9,202,0.386138614,0.054455446,0.564356436,0,0.018006244
25338,77,24224,10,9,0,0,0,19,10,5,8,0,0,23,nowin,win,dlbust,bust,20,0,19,200,0.455,0.04,0.62,3,0.916252116
25339,95,24224,7,8,0,10,0,25,10,5,8,0,0,23,nowin,loss,bust,plbust,0,10,15,218,0.412844037,0.04587156,0.559633028,0,0.024842385
25340,80,24224,10,10,0,0,0,20,10,5,8,0,0,23,nowin,win,dlbust,bust,20,0,20,186,0.419354839,0.059139785,0.623655914,2,0.59892924
25341,27,24224,7,4,5,4,0,20,10,5,8,0,0,23,nowin,win,dlbust,bust,20,0,11,178,0.370786517,0.016853933,0.573033708,0,0.015536309
25342,87,24224,5,7,0,8,0,20,10,5,8,0,0,23,nowin,win,dlbust,bust,20,0,12,202,0.405940594,0.054455446,0.628712871,2,0.590599801
25343,99,24224,10,6,0,6,0,22,10,5,8,0,0,23,nowin,loss,bust,plbust,0,10,16,207,0.47826087,0.062801932,0.637681159,3,0.961418446
25344,82,24225,11,7,0,0,0,18,6,8,2,10,0,26,nowin,win,dlbust,bust,20,0,18,225,0.408888889,0.075555556,0.577777778,0,0.028101874
25345,87,24225,9,11,0,0,0,20,6,8,2,10,0,26,nowin,win,dlbust,bust,20,0,20,202,0.405940594,0.054455446,0.628712871,2,0.590599801
25346,135,24225,5,3,11,0,0,19,6,8,2,10,0,26,nowin,win,dlbust,bust,20,0,8,179,0.391061453,0.067039106,0.586592179,0,0.024924662
25347,128,24225,7,3,10,0,0,20,6,8,2,10,0,26,nowin,win,dlbust,bust,20,0,10,227,0.356828194,0.052863436,0.577092511,0,0.012352564
25348,68,24225,2,10,0,0,0,12,6,8,2,10,0,26,nowin,win,dlbust,bust,20,0,12,205,0.434146341,0.029268293,0.6,2,0.59483189
25349,147,24225,10,5,0,0,0,15,6,8,2,10,0,26,nowin,win,dlbust,bust,20,0,15,205,0.380487805,0.014634146,0.536585366,0,0.00951447
25350,92,24226,10,8,0,0,0,18,6,9,10,0,0,25,nowin,win,dlbust,bust,20,0,18,186,0.446236559,0.059139785,0.564516129,1,0.307826125
25351,27,24226,9,10,0,0,0,19,6,9,10,0,0,25,nowin,win,dlbust,bust,20,0,19,178,0.370786517,0.016853933,0.573033708,0,0.015536309
25352,111,24226,5,4,6,0,0,15,6,9,10,0,0,25,nowin,win,dlbust,bust,20,0,9,180,0.433333333,0.055555556,0.611111111,2,0.602264492
25353,128,24226,10,10,0,0,0,20,6,9,10,0,0,25,nowin,win,dlbust,bust,20,0,20,227,0.356828194,0.052863436,0.577092511,0,0.012352564
25354,29,24226,2,10,0,0,0,12,6,9,10,0,0,25,nowin,win,dlbust,bust,20,0,12,189,0.44973545,0.058201058,0.544973545,1,0.300349439
25355,108,24226,3,4,10,0,0,17,6,9,10,0,0,25,nowin,win,dlbust,bust,20,0,7,193,0.435233161,0.056994819,0.559585492,1,0.298824795
25356,88,24227,10,11,0,0,0,21,10,7,0,0,0,17,win,win,plwin,beat,25,0,21,206,0.466019417,0.033980583,0.54368932,1,0.309467903
25357,99,24227,10,9,0,0,0,19,10,7,0,0,0,17,nowin,win,plwin,beat,20,0,19,207,0.47826087,0.062801932,0.637681159,3,0.961418446
25358,118,24227,10,10,0,0,0,20,10,7,0,0,0,17,nowin,win,plwin,beat,20,0,20,216,0.393518519,0.037037037,0.555555556,0,0.018059873
25359,137,24227,10,10,0,0,0,20,10,7,0,0,0,17,nowin,win,plwin,beat,20,0,20,194,0.417525773,0.046391753,0.536082474,1,0.276714602
25360,80,24227,10,10,0,0,0,20,10,7,0,0,0,17,nowin,win,plwin,beat,20,0,20,186,0.419354839,0.059139785,0.623655914,2,0.59892924
25361,9,24227,10,6,0,2,0,18,10,7,0,0,0,17,nowin,win,plwin,beat,20,0,16,194,0.37628866,0.015463918,0.541237113,0,0.009396796
25362,140,24228,6,10,0,3,0,19,11,10,0,0,0,21,nowin,loss,beat,dlwin,0,10,16,210,0.466666667,0.023809524,0.604761905,3,0.915293335
25363,145,24228,8,2,3,4,0,17,11,10,0,0,0,21,nowin,loss,beat,dlwin,0,10,10,188,0.441489362,0.031914894,0.622340426,2,0.617837093
25364,139,24228,10,3,0,7,0,20,11,10,0,0,0,21,nowin,loss,beat,dlwin,0,10,13,192,0.380208333,0.036458333,0.59375,0,0.023429169
25365,80,24228,10,10,0,0,0,20,11,10,0,0,0,21,nowin,loss,beat,dlwin,0,10,20,186,0.419354839,0.059139785,0.623655914,2,0.59892924
25366,81,24228,11,10,0,0,0,21,11,10,0,0,0,21,win,push,push,push,10,0,21,182,0.395604396,0.043956044,0.60989011,2,0.567491261
25367,57,24228,10,10,0,0,0,20,11,10,0,0,0,21,nowin,loss,beat,dlwin,0,10,20,192,0.46875,0.052083333,0.59375,3,0.907001181
25368,49,24229,5,10,0,3,0,18,10,10,0,0,0,20,nowin,loss,beat,dlwin,0,10,15,207,0.396135266,0.053140097,0.594202899,0,0.028306925
25369,5,24229,10,2,0,7,0,19,10,10,0,0,0,20,nowin,loss,beat,dlwin,0,10,12,203,0.42364532,0.02955665,0.596059113,2,0.582508076
25370,50,24229,10,10,0,0,0,20,10,10,0,0,0,20,nowin,push,push,push,10,0,20,202,0.405940594,0.04950495,0.54950495,0,0.020296079
25371,74,24229,10,11,0,0,0,21,10,10,0,0,0,20,win,win,plwin,beat,25,0,21,209,0.411483254,0.04784689,0.531100478,0,0.017448125
25372,130,24229,10,8,0,0,0,18,10,10,0,0,0,20,nowin,loss,beat,dlwin,0,10,18,219,0.410958904,0.03652968,0.566210046,0,0.025888739
25373,63,24229,10,2,0,1,10,23,10,10,0,0,0,20,nowin,loss,bust,plbust,0,10,12,216,0.467592593,0.037037037,0.62037037,3,0.931690496
25374,59,24230,3,6,10,0,0,19,2,8,10,0,0,20,nowin,loss,beat,dlwin,0,10,9,228,0.429824561,0.048245614,0.543859649,1,0.287885446
25375,130,24230,3,5,10,0,0,18,2,8,10,0,0,20,nowin,loss,beat,dlwin,0,10,8,219,0.410958904,0.03652968,0.566210046,0,0.025888739
25376,127,24230,8,10,0,0,0,18,2,8,10,0,0,20,nowin,loss,beat,dlwin,0,10,18,201,0.402985075,0.029850746,0.60199005,0,0.032263937
25377,25,24230,3,6,11,0,0,20,2,8,10,0,0,20,nowin,push,push,push,10,0,9,190,0.463157895,0.063157895,0.536842105,1,0.304401563
25378,15,24230,10,9,0,0,0,19,2,8,10,0,0,20,nowin,loss,beat,dlwin,0,10,19,212,0.410377358,0.051886792,0.561320755,0,0.024517408
25379,48,24230,9,10,0,0,0,19,2,8,10,0,0,20,nowin,loss,beat,dlwin,0,10,19,203,0.413793103,0.019704433,0.600985222,2,0.577280801
25380,17,24231,10,5,0,0,0,15,6,2,9,0,0,17,nowin,loss,beat,dlwin,0,10,15,171,0.444444444,0.070175439,0.555555556,1,0.302364894
25381,48,24231,4,8,0,0,0,12,6,2,9,0,0,17,nowin,loss,beat,dlwin,0,10,12,203,0.413793103,0.019704433,0.600985222,2,0.577280801
25382,126,24231,10,10,0,0,0,20,6,2,9,0,0,17,nowin,win,plwin,beat,20,0,20,188,0.457446809,0.074468085,0.60106383,3,0.900633203
25383,64,24231,10,11,0,0,0,21,6,2,9,0,0,17,win,win,plwin,beat,25,0,21,187,0.363636364,0.048128342,0.631016043,0,0.027594885
25384,80,24231,9,8,0,0,0,17,6,2,9,0,0,17,nowin,push,push,push,10,0,17,186,0.419354839,0.059139785,0.623655914,2,0.59892924
25385,48,24231,10,10,0,0,0,20,6,2,9,0,0,17,nowin,win,plwin,beat,20,0,20,203,0.413793103,0.019704433,0.600985222,2,0.577280801
25386,50,24232,3,10,0,5,0,18,10,10,0,0,0,20,nowin,loss,beat,dlwin,0,10,13,202,0.405940594,0.04950495,0.54950495,0,0.020296079
25387,61,24232,10,4,0,10,0,24,10,10,0,0,0,20,nowin,loss,bust,plbust,0,10,14,194,0.427835052,0.077319588,0.603092784,2,0.591437139
25388,108,24232,11,9,0,0,0,20,10,10,0,0,0,20,nowin,push,push,push,10,0,20,193,0.435233161,0.056994819,0.559585492,1,0.298824795
25389,39,24232,9,8,0,0,0,17,10,10,0,0,0,20,nowin,loss,beat,dlwin,0,10,17,191,0.429319372,0.062827225,0.57591623,0,0.033760763
25390,61,24232,5,5,9,0,0,19,10,10,0,0,0,20,nowin,loss,beat,dlwin,0,10,10,194,0.427835052,0.077319588,0.603092784,2,0.591437139
25391,119,24232,3,5,3,7,0,18,10,10,0,0,0,20,nowin,loss,beat,dlwin,0,10,8,190,0.405263158,0.068421053,0.515789474,0,0.011837158
25392,17,24233,10,8,0,0,0,18,8,10,0,0,0,18,nowin,push,push,push,10,0,18,171,0.444444444,0.070175439,0.555555556,1,0.302364894
25393,125,24233,6,6,0,6,0,18,8,10,0,0,0,18,nowin,push,push,push,10,0,12,219,0.438356164,0.050228311,0.575342466,1,0.308411257
25394,56,24233,10,10,0,0,0,20,8,10,0,0,0,18,nowin,win,plwin,beat,20,0,20,175,0.4,0.057142857,0.582857143,0,0.026685297
25395,70,24233,10,9,0,0,0,19,8,10,0,0,0,18,nowin,win,plwin,beat,20,0,19,228,0.385964912,0.039473684,0.557017544,0,0.016157125
25396,107,24233,10,2,0,9,0,21,8,10,0,0,0,18,nowin,win,plwin,beat,20,0,12,218,0.444954128,0.073394495,0.600917431,2,0.605210014
25397,109,24233,10,10,0,0,0,20,8,10,0,0,0,18,nowin,win,plwin,beat,20,0,20,221,0.461538462,0.058823529,0.597285068,3,0.901830309
25398,98,24234,10,7,0,0,0,17,6,4,6,4,0,20,nowin,loss,beat,dlwin,0,10,17,220,0.422727273,0.054545455,0.55,1,0.28664435
25399,88,24234,9,10,0,0,0,19,6,4,6,4,0,20,nowin,loss,beat,dlwin,0,10,19,206,0.466019417,0.033980583,0.54368932,1,0.309467903
25400,126,24234,8,9,0,0,0,17,6,4,6,4,0,20,nowin,loss,beat,dlwin,0,10,17,188,0.457446809,0.074468085,0.60106383,3,0.900633203
25401,63,24234,10,6,0,0,0,16,6,4,6,4,0,20,nowin,loss,beat,dlwin,0,10,16,216,0.467592593,0.037037037,0.62037037,3,0.931690496
25402,46,24234,8,6,0,0,0,14,6,4,6,4,0,20,nowin,loss,beat,dlwin,0,10,14,186,0.403225806,0.048387097,0.591397849,0,0.029742194
25403,28,24234,9,5,0,0,0,14,6,4,6,4,0,20,nowin,loss,beat,dlwin,0,10,14,199,0.422110553,0.045226131,0.542713568,1,0.282706618
25404,1,24235,3,7,7,0,0,17,4,5,10,0,0,19,nowin,loss,beat,dlwin,0,10,10,197,0.406091371,0.025380711,0.649746193,2,0.606186955
25405,47,24235,9,8,0,0,0,17,4,5,10,0,0,19,nowin,loss,beat,dlwin,0,10,17,210,0.438095238,0.057142857,0.623809524,2,0.615868808
25406,57,24235,11,1,9,0,0,21,4,5,10,0,0,19,nowin,win,plwin,beat,20,0,12,192,0.46875,0.052083333,0.59375,3,0.907001181
25407,100,24235,11,8,0,0,0,19,4,5,10,0,0,19,nowin,push,push,push,10,0,19,190,0.452631579,0.036842105,0.594736842,3,0.888671154
25408,15,24235,8,7,0,0,0,15,4,5,10,0,0,19,nowin,loss,beat,dlwin,0,10,15,212,0.410377358,0.051886792,0.561320755,0,0.024517408
25409,133,24235,10,8,0,0,0,18,4,5,10,0,0,19,nowin,loss,beat,dlwin,0,10,18,201,0.47761194,0.064676617,0.611940299,3,0.935428111
25410,62,24236,3,10,0,0,0,13,2,10,10,0,0,22,nowin,win,dlbust,bust,20,0,13,178,0.370786517,0.028089888,0.54494382,0,0.008657722
25411,149,24236,11,10,0,0,0,21,2,10,10,0,0,22,win,win,dlbust,bust,25,0,21,225,0.457777778,0.057777778,0.648888889,2,0.651965595
25412,93,24236,10,10,0,0,0,20,2,10,10,0,0,22,nowin,win,dlbust,bust,20,0,20,175,0.485714286,0.051428571,0.548571429,1,0.323648091
25413,12,24236,10,2,0,8,0,20,2,10,10,0,0,22,nowin,win,dlbust,bust,20,0,12,189,0.470899471,0.015873016,0.613756614,3,0.929171178
25414,44,24236,8,3,2,0,0,13,2,10,10,0,0,22,nowin,win,dlbust,bust,20,0,11,219,0.433789954,0.050228311,0.534246575,1,0.285551035
25415,139,24236,10,7,0,0,0,17,2,10,10,0,0,22,nowin,win,dlbust,bust,20,0,17,192,0.380208333,0.036458333,0.59375,0,0.023429169
25416,33,24237,1,6,10,0,0,17,10,7,0,0,0,17,nowin,push,push,push,10,0,7,192,0.4375,0.057291667,0.625,2,0.616208916
25417,27,24237,9,5,0,10,0,24,10,7,0,0,0,17,nowin,loss,bust,plbust,0,10,14,178,0.370786517,0.016853933,0.573033708,0,0.015536309
25418,105,24237,11,5,4,0,0,20,10,7,0,0,0,17,nowin,win,plwin,beat,20,0,16,198,0.414141414,0.070707071,0.590909091,0,0.032889494
25419,5,24237,10,2,0,4,8,24,10,7,0,0,0,17,nowin,loss,bust,plbust,0,10,12,203,0.42364532,0.02955665,0.596059113,2,0.582508076
25420,30,24237,8,7,0,7,0,22,10,7,0,0,0,17,nowin,loss,bust,plbust,0,10,15,206,0.393203883,0.033980583,0.601941748,0,0.029324648
25421,64,24237,8,5,0,9,0,22,10,7,0,0,0,17,nowin,loss,bust,plbust,0,10,13,187,0.363636364,0.048128342,0.631016043,0,0.027594885
25422,127,24238,4,2,4,5,0,15,6,2,7,10,0,25,nowin,win,dlbust,bust,20,0,6,201,0.402985075,0.029850746,0.60199005,0,0.032263937
25423,43,24238,10,6,0,0,0,16,6,2,7,10,0,25,nowin,win,dlbust,bust,20,0,16,192,0.40625,0.041666667,0.609375,2,0.576671372
25424,4,24238,3,7,11,0,0,21,6,2,7,10,0,25,nowin,win,dlbust,bust,20,0,10,217,0.460829493,0.036866359,0.562211982,1,0.315432839
25425,47,24238,8,4,0,0,0,12,6,2,7,10,0,25,nowin,win,dlbust,bust,20,0,12,210,0.438095238,0.057142857,0.623809524,2,0.615868808
25426,88,24238,10,10,0,0,0,20,6,2,7,10,0,25,nowin,win,dlbust,bust,20,0,20,206,0.466019417,0.033980583,0.54368932,1,0.309467903
25427,98,24238,6,3,11,0,0,20,6,2,7,10,0,25,nowin,win,dlbust,bust,20,0,9,220,0.422727273,0.054545455,0.55,1,0.28664435
25428,81,24239,10,5,0,4,0,19,10,8,0,0,0,18,nowin,win,plwin,beat,20,0,15,182,0.395604396,0.043956044,0.60989011,2,0.567491261
25429,123,24239,4,10,0,4,0,18,10,8,0,0,0,18,nowin,push,push,push,10,0,14,205,0.43902439,0.034146341,0.614634146,2,0.609962544
25430,141,24239,10,2,0,5,0,17,10,8,0,0,0,18,nowin,loss,beat,dlwin,0,10,12,202,0.420792079,0.074257426,0.564356436,0,0.028377851
25431,100,24239,9,3,0,10,0,22,10,8,0,0,0,18,nowin,loss,bust,plbust,0,10,12,190,0.452631579,0.036842105,0.594736842,3,0.888671154
25432,103,24239,10,4,0,9,0,23,10,8,0,0,0,18,nowin,loss,bust,plbust,0,10,14,203,0.379310345,0.064039409,0.551724138,0,0.012869209
25433,19,24239,9,4,0,7,0,20,10,8,0,0,0,18,nowin,win,plwin,beat,20,0,13,237,0.41350211,0.054852321,0.628691983,2,0.597373826
25434,14,24240,8,11,0,0,0,19,2,10,6,0,0,18,nowin,win,plwin,beat,20,0,19,202,0.391089109,0.01980198,0.628712871,2,0.577264877
25435,35,24240,8,10,0,0,0,18,2,10,6,0,0,18,nowin,push,push,push,10,0,18,202,0.410891089,0.044554455,0.633663366,2,0.598681573
25436,96,24240,9,8,0,0,0,17,2,10,6,0,0,18,nowin,loss,beat,dlwin,0,10,17,190,0.468421053,0.057894737,0.584210526,3,0.897263354
25437,112,24240,10,8,0,0,0,18,2,10,6,0,0,18,nowin,push,push,push,10,0,18,203,0.448275862,0.054187192,0.600985222,3,0.889576933
25438,5,24240,3,4,10,0,0,17,2,10,6,0,0,18,nowin,loss,beat,dlwin,0,10,7,203,0.42364532,0.02955665,0.596059113,2,0.582508076
25439,130,24240,4,8,0,4,0,16,2,10,6,0,0,18,nowin,loss,beat,dlwin,0,10,12,219,0.410958904,0.03652968,0.566210046,0,0.025888739
25440,75,24241,10,3,0,10,0,23,7,10,0,0,0,17,nowin,loss,bust,plbust,0,10,13,191,0.418848168,0.052356021,0.570680628,0,0.029344702
25441,2,24241,3,8,10,0,0,21,7,10,0,0,0,17,nowin,win,plwin,beat,20,0,11,200,0.445,0.035,0.64,2,0.633962549
25442,96,24241,10,3,0,9,0,22,7,10,0,0,0,17,nowin,loss,bust,plbust,0,10,13,190,0.468421053,0.057894737,0.584210526,3,0.897263354
25443,66,24241,7,2,9,0,0,18,7,10,0,0,0,17,nowin,win,plwin,beat,20,0,9,217,0.456221198,0.064516129,0.626728111,3,0.924304367
25444,89,24241,10,6,0,10,0,26,7,10,0,0,0,17,nowin,loss,bust,plbust,0,10,16,212,0.537735849,0.047169811,0.594339623,3,0.990167191
25445,92,24241,6,7,0,6,0,19,7,10,0,0,0,17,nowin,win,plwin,beat,20,0,13,186,0.446236559,0.059139785,0.564516129,1,0.307826125
25446,127,24242,10,5,0,10,0,25,10,4,6,0,0,20,nowin,loss,bust,plbust,0,10,15,201,0.402985075,0.029850746,0.60199005,0,0.032263937
25447,125,24242,5,10,0,2,0,17,10,4,6,0,0,20,nowin,loss,beat,dlwin,0,10,15,219,0.438356164,0.050228311,0.575342466,1,0.308411257
25448,121,24242,4,10,0,10,0,24,10,4,6,0,0,20,nowin,loss,bust,plbust,0,10,14,195,0.456410256,0.025641026,0.512820513,1,0.288597791
25449,121,24242,10,10,0,0,0,20,10,4,6,0,0,20,nowin,push,push,push,10,0,20,195,0.456410256,0.025641026,0.512820513,1,0.288597791
25450,84,24242,5,10,0,10,0,25,10,4,6,0,0,20,nowin,loss,bust,plbust,0,10,15,195,0.379487179,0.056410256,0.569230769,0,0.017209119
25451,138,24242,3,4,10,0,0,17,10,4,6,0,0,20,nowin,loss,beat,dlwin,0,10,7,190,0.442105263,0.047368421,0.610526316,2,0.609711065
25452,120,24243,10,8,0,0,0,18,10,11,0,0,0,21,nowin,loss,beat,dlwin,0,10,18,202,0.440594059,0.034653465,0.618811881,2,0.614441029
25453,58,24243,11,10,0,0,0,21,10,11,0,0,0,21,win,push,push,push,10,0,21,195,0.430769231,0.041025641,0.584615385,2,0.580497586
25454,71,24243,10,11,0,0,0,21,10,11,0,0,0,21,win,push,push,push,10,0,21,193,0.352331606,0.046632124,0.585492228,0,0.013063661
25455,127,24243,5,5,10,0,0,20,10,11,0,0,0,21,nowin,loss,beat,dlwin,0,10,10,201,0.402985075,0.029850746,0.60199005,0,0.032263937
25456,127,24243,9,9,0,0,0,18,10,11,0,0,0,21,nowin,loss,beat,dlwin,0,10,18,201,0.402985075,0.029850746,0.60199005,0,0.032263937
25457,68,24243,5,5,8,0,0,18,10,11,0,0,0,21,nowin,loss,beat,dlwin,0,10,10,205,0.434146341,0.029268293,0.6,2,0.59483189
25458,21,24244,10,10,0,0,0,20,10,11,0,0,0,21,nowin,loss,beat,dlwin,0,10,20,214,0.359813084,0.042056075,0.626168224,0,0.025263474
25459,14,24244,10,10,0,0,0,20,10,11,0,0,0,21,nowin,loss,beat,dlwin,0,10,20,202,0.391089109,0.01980198,0.628712871,2,0.577264877
25460,98,24244,6,3,9,0,0,18,10,11,0,0,0,21,nowin,loss,beat,dlwin,0,10,9,220,0.422727273,0.054545455,0.55,1,0.28664435
25461,86,24244,9,10,0,0,0,19,10,11,0,0,0,21,nowin,loss,beat,dlwin,0,10,19,196,0.454081633,0.040816327,0.591836735,3,0.887566443
25462,20,24244,9,2,10,0,0,21,10,11,0,0,0,21,nowin,push,push,push,10,0,11,186,0.456989247,0.037634409,0.537634409,1,0.301097108
25463,29,24244,5,9,0,10,0,24,10,11,0,0,0,21,nowin,loss,bust,plbust,0,10,14,189,0.44973545,0.058201058,0.544973545,1,0.300349439
25464,145,24245,10,9,0,0,0,19,7,6,2,9,0,24,nowin,win,dlbust,bust,20,0,19,188,0.441489362,0.031914894,0.622340426,2,0.617837093
25465,37,24245,10,9,0,0,0,19,7,6,2,9,0,24,nowin,win,dlbust,bust,20,0,19,208,0.394230769,0.038461538,0.581730769,0,0.024682772
25466,15,24245,11,7,0,0,0,18,7,6,2,9,0,24,nowin,win,dlbust,bust,20,0,18,212,0.410377358,0.051886792,0.561320755,0,0.024517408
25467,89,24245,10,7,0,0,0,17,7,6,2,9,0,24,nowin,win,dlbust,bust,20,0,17,212,0.537735849,0.047169811,0.594339623,3,0.990167191
25468,113,24245,10,8,0,0,0,18,7,6,2,9,0,24,nowin,win,dlbust,bust,20,0,18,199,0.407035176,0.055276382,0.668341709,2,0.620695264
25469,43,24245,10,5,0,3,0,18,7,6,2,9,0,24,nowin,win,dlbust,bust,20,0,15,192,0.40625,0.041666667,0.609375,2,0.576671372
25470,54,24246,3,10,0,7,0,20,10,6,9,0,0,25,nowin,win,dlbust,bust,20,0,13,185,0.437837838,0.032432432,0.556756757,1,0.29899854
25471,106,24246,6,11,4,0,0,21,10,6,9,0,0,25,nowin,win,dlbust,bust,20,0,17,192,0.411458333,0.026041667,0.557291667,0,0.023854304
25472,130,24246,9,4,0,2,3,18,10,6,9,0,0,25,nowin,win,dlbust,bust,20,0,13,219,0.410958904,0.03652968,0.566210046,0,0.025888739
25473,87,24246,11,9,0,0,0,20,10,6,9,0,0,25,nowin,win,dlbust,bust,20,0,20,202,0.405940594,0.054455446,0.628712871,2,0.590599801
25474,29,24246,9,10,0,0,0,19,10,6,9,0,0,25,nowin,win,dlbust,bust,20,0,19,189,0.44973545,0.058201058,0.544973545,1,0.300349439
25475,53,24246,4,10,0,4,0,18,10,6,9,0,0,25,nowin,win,dlbust,bust,20,0,14,250,0.372,0.064,0.564,0,0.013687345
25476,35,24247,7,10,0,0,0,17,9,4,8,0,0,21,nowin,loss,beat,dlwin,0,10,17,202,0.410891089,0.044554455,0.633663366,2,0.598681573
25477,39,24247,10,9,0,0,0,19,9,4,8,0,0,21,nowin,loss,beat,dlwin,0,10,19,191,0.429319372,0.062827225,0.57591623,0,0.033760763
25478,47,24247,6,8,0,1,1,16,9,4,8,0,0,21,nowin,loss,beat,dlwin,0,10,14,210,0.438095238,0.057142857,0.623809524,2,0.615868808
25479,47,24247,6,2,11,0,0,19,9,4,8,0,0,21,nowin,loss,beat,dlwin,0,10,8,210,0.438095238,0.057142857,0.623809524,2,0.615868808
25480,146,24247,6,2,4,10,0,22,9,4,8,0,0,21,nowin,loss,bust,plbust,0,10,8,221,0.43438914,0.040723982,0.542986425,1,0.290190091
25481,67,24247,10,4,0,9,0,23,9,4,8,0,0,21,nowin,loss,bust,plbust,0,10,14,195,0.369230769,0.041025641,0.569230769,0,0.014139427
25482,76,24248,8,2,10,0,0,20,7,10,0,0,0,17,nowin,win,plwin,beat,20,0,10,189,0.534391534,0.079365079,0.608465608,3,1
25483,67,24248,4,1,9,10,0,24,7,10,0,0,0,17,nowin,loss,bust,plbust,0,10,5,195,0.369230769,0.041025641,0.569230769,0,0.014139427
25484,12,24248,7,2,5,7,0,21,7,10,0,0,0,17,nowin,win,plwin,beat,20,0,9,189,0.470899471,0.015873016,0.613756614,3,0.929171178
25485,24,24248,7,6,0,1,6,20,7,10,0,0,0,17,nowin,win,plwin,beat,20,0,13,207,0.458937198,0.048309179,0.570048309,1,0.318138014
25486,29,24248,3,10,0,8,0,21,7,10,0,0,0,17,nowin,win,plwin,beat,20,0,13,189,0.44973545,0.058201058,0.544973545,1,0.300349439
25487,133,24248,9,6,0,6,0,21,7,10,0,0,0,17,nowin,win,plwin,beat,20,0,15,201,0.47761194,0.064676617,0.611940299,3,0.935428111
25488,134,24249,9,10,0,0,0,19,10,7,0,0,0,17,nowin,win,plwin,beat,20,0,19,185,0.443243243,0.021621622,0.545945946,1,0.296939509
25489,146,24249,10,5,0,8,0,23,10,7,0,0,0,17,nowin,loss,bust,plbust,0,10,15,221,0.43438914,0.040723982,0.542986425,1,0.290190091
25490,139,24249,10,3,0,3,8,24,10,7,0,0,0,17,nowin,loss,bust,plbust,0,10,13,192,0.380208333,0.036458333,0.59375,0,0.023429169
25491,54,24249,8,11,0,0,0,19,10,7,0,0,0,17,nowin,win,plwin,beat,20,0,19,185,0.437837838,0.032432432,0.556756757,1,0.29899854
25492,55,24249,7,4,10,0,0,21,10,7,0,0,0,17,nowin,win,plwin,beat,20,0,11,191,0.371727749,0.057591623,0.54973822,0,0.01011347
25493,29,24249,9,9,0,0,0,18,10,7,0,0,0,17,nowin,win,plwin,beat,20,0,18,189,0.44973545,0.058201058,0.544973545,1,0.300349439
25494,41,24250,9,5,0,4,0,18,10,2,7,0,0,19,nowin,loss,beat,dlwin,0,10,14,192,0.364583333,0.036458333,0.520833333,0,0.00089702
25495,90,24250,10,10,0,0,0,20,10,2,7,0,0,19,nowin,win,plwin,beat,20,0,20,201,0.447761194,0.049751244,0.60199005,3,0.889945023
25496,62,24250,11,5,2,0,0,18,10,2,7,0,0,19,nowin,loss,beat,dlwin,0,10,16,178,0.370786517,0.028089888,0.54494382,0,0.008657722
25497,25,24250,10,6,0,5,0,21,10,2,7,0,0,19,nowin,win,plwin,beat,20,0,16,190,0.463157895,0.063157895,0.536842105,1,0.304401563
25498,55,24250,9,10,0,0,0,19,10,2,7,0,0,19,nowin,push,push,push,10,0,19,191,0.371727749,0.057591623,0.54973822,0,0.01011347
25499,38,24250,2,10,0,4,4,20,10,2,7,0,0,19,nowin,win,plwin,beat,20,0,12,202,0.361386139,0.03960396,0.564356436,0,0.010597953
25500,67,24251,10,9,0,0,0,19,10,9,0,0,0,19,nowin,push,push,push,10,0,19,195,0.369230769,0.041025641,0.569230769,0,0.014139427
25501,71,24251,2,8,10,0,0,20,10,9,0,0,0,19,nowin,win,plwin,beat,20,0,10,193,0.352331606,0.046632124,0.585492228,0,0.013063661
25502,86,24251,4,10,0,4,0,18,10,9,0,0,0,19,nowin,loss,beat,dlwin,0,10,14,196,0.454081633,0.040816327,0.591836735,3,0.887566443
25503,109,24251,9,11,0,0,0,20,10,9,0,0,0,19,nowin,win,plwin,beat,20,0,20,221,0.461538462,0.058823529,0.597285068,3,0.901830309
25504,5,24251,9,10,0,0,0,19,10,9,0,0,0,19,nowin,push,push,push,10,0,19,203,0.42364532,0.02955665,0.596059113,2,0.582508076
25505,136,24251,5,10,0,9,0,24,10,9,0,0,0,19,nowin,loss,bust,plbust,0,10,15,194,0.396907216,0.025773196,0.597938144,0,0.029452644
25506,149,24252,10,9,0,0,0,19,2,10,7,0,0,19,nowin,push,push,push,10,0,19,225,0.457777778,0.057777778,0.648888889,2,0.651965595
25507,26,24252,10,7,0,0,0,17,2,10,7,0,0,19,nowin,loss,beat,dlwin,0,10,17,203,0.463054187,0.0591133,0.541871921,1,0.306802864
25508,108,24252,4,11,5,0,0,20,2,10,7,0,0,19,nowin,win,plwin,beat,20,0,15,193,0.435233161,0.056994819,0.559585492,1,0.298824795
25509,52,24252,10,6,0,0,0,16,2,10,7,0,0,19,nowin,loss,beat,dlwin,0,10,16,217,0.414746544,0.02764977,0.599078341,2,0.576736024
25510,51,24252,10,10,0,0,0,20,2,10,7,0,0,19,nowin,win,plwin,beat,20,0,20,189,0.529100529,0.068783069,0.608465608,3,0.993665715
25511,26,24252,11,10,0,0,0,21,2,10,7,0,0,19,win,win,plwin,beat,25,0,21,203,0.463054187,0.0591133,0.541871921,1,0.306802864
25512,144,24253,5,6,1,0,0,12,5,10,7,0,0,22,nowin,win,dlbust,bust,20,0,11,202,0.386138614,0.054455446,0.564356436,0,0.018006244
25513,9,24253,9,3,0,0,0,12,5,10,7,0,0,22,nowin,win,dlbust,bust,20,0,12,194,0.37628866,0.015463918,0.541237113,0,0.009396796
25514,115,24253,4,10,0,0,0,14,5,10,7,0,0,22,nowin,win,dlbust,bust,20,0,14,194,0.427835052,0.041237113,0.592783505,2,0.583863602
25515,97,24253,7,5,0,0,0,12,5,10,7,0,0,22,nowin,win,dlbust,bust,20,0,12,182,0.450549451,0.06043956,0.692307692,2,0.677372279
25516,46,24253,4,6,10,0,0,20,5,10,7,0,0,22,nowin,win,dlbust,bust,20,0,10,186,0.403225806,0.048387097,0.591397849,0,0.029742194
25517,21,24253,3,8,4,0,0,15,5,10,7,0,0,22,nowin,win,dlbust,bust,20,0,11,214,0.359813084,0.042056075,0.626168224,0,0.025263474
25518,61,24254,10,10,0,0,0,20,7,10,0,0,0,17,nowin,win,plwin,beat,20,0,20,194,0.427835052,0.077319588,0.603092784,2,0.591437139
25519,41,24254,4,10,0,8,0,22,7,10,0,0,0,17,nowin,loss,bust,plbust,0,10,14,192,0.364583333,0.036458333,0.520833333,0,0.00089702
25520,144,24254,6,2,3,6,0,17,7,10,0,0,0,17,nowin,push,push,push,10,0,8,202,0.386138614,0.054455446,0.564356436,0,0.018006244
25521,30,24254,10,10,0,0,0,20,7,10,0,0,0,17,nowin,win,plwin,beat,20,0,20,206,0.393203883,0.033980583,0.601941748,0,0.029324648
25522,69,24254,10,11,0,0,0,21,7,10,0,0,0,17,win,win,plwin,beat,25,0,21,194,0.365979381,0.030927835,0.515463918,0,0
25523,135,24254,4,6,10,0,0,20,7,10,0,0,0,17,nowin,win,plwin,beat,20,0,10,179,0.391061453,0.067039106,0.586592179,0,0.024924662
25524,6,24255,10,9,0,0,0,19,10,9,0,0,0,19,nowin,push,push,push,10,0,19,191,0.439790576,0.047120419,0.581151832,1,0.31211505
25525,136,24255,10,8,0,0,0,18,10,9,0,0,0,19,nowin,loss,beat,dlwin,0,10,18,194,0.396907216,0.025773196,0.597938144,0,0.029452644
25526,128,24255,5,8,0,1,2,16,10,9,0,0,0,19,nowin,loss,beat,dlwin,0,10,13,227,0.356828194,0.052863436,0.577092511,0,0.012352564
25527,62,24255,2,4,5,6,0,17,10,9,0,0,0,19,nowin,loss,beat,dlwin,0,10,6,178,0.370786517,0.028089888,0.54494382,0,0.008657722
25528,123,24255,9,6,0,5,0,20,10,9,0,0,0,19,nowin,win,plwin,beat,20,0,15,205,0.43902439,0.034146341,0.614634146,2,0.609962544
25529,17,24255,8,6,0,4,0,18,10,9,0,0,0,19,nowin,loss,beat,dlwin,0,10,14,171,0.444444444,0.070175439,0.555555556,1,0.302364894
25530,134,24256,2,10,0,9,0,21,10,10,0,0,0,20,nowin,win,plwin,beat,20,0,12,185,0.443243243,0.021621622,0.545945946,1,0.296939509
25531,52,24256,5,11,1,0,0,17,10,10,0,0,0,20,nowin,loss,beat,dlwin,0,10,16,217,0.414746544,0.02764977,0.599078341,2,0.576736024
25532,36,24256,10,11,0,0,0,21,10,10,0,0,0,20,win,win,plwin,beat,25,0,21,229,0.445414847,0.056768559,0.655021834,2,0.645370571
25533,104,24256,8,10,0,0,0,18,10,10,0,0,0,20,nowin,loss,beat,dlwin,0,10,18,209,0.363636364,0.052631579,0.593301435,0,0.018359419
25534,134,24256,6,10,0,3,0,19,10,10,0,0,0,20,nowin,loss,beat,dlwin,0,10,16,185,0.443243243,0.021621622,0.545945946,1,0.296939509
25535,42,24256,10,2,0,10,0,22,10,10,0,0,0,20,nowin,loss,bust,plbust,0,10,12,212,0.443396226,0.051886792,0.570754717,1,0.309181312
25536,51,24257,10,4,0,10,0,24,10,7,0,0,0,17,nowin,loss,bust,plbust,0,10,14,189,0.529100529,0.068783069,0.608465608,3,0.993665715
25537,14,24257,10,10,0,0,0,20,10,7,0,0,0,17,nowin,win,plwin,beat,20,0,20,202,0.391089109,0.01980198,0.628712871,2,0.577264877
25538,9,24257,2,8,10,0,0,20,10,7,0,0,0,17,nowin,win,plwin,beat,20,0,10,194,0.37628866,0.015463918,0.541237113,0,0.009396796
25539,72,24257,10,10,0,0,0,20,10,7,0,0,0,17,nowin,win,plwin,beat,20,0,20,185,0.394594595,0.032432432,0.508108108,0,0.006763115
25540,79,24257,2,8,8,0,0,18,10,7,0,0,0,17,nowin,win,plwin,beat,20,0,10,211,0.436018957,0.028436019,0.672985782,2,0.650131054
25541,131,24257,6,4,8,0,0,18,10,7,0,0,0,17,nowin,win,plwin,beat,20,0,10,217,0.410138249,0.069124424,0.543778802,0,0.02015021
25542,4,24258,8,2,3,0,0,13,2,10,10,0,0,22,nowin,win,dlbust,bust,20,0,10,217,0.460829493,0.036866359,0.562211982,1,0.315432839
25543,76,24258,10,10,0,0,0,20,2,10,10,0,0,22,nowin,win,dlbust,bust,20,0,20,189,0.534391534,0.079365079,0.608465608,3,1
25544,91,24258,6,1,10,0,0,17,2,10,10,0,0,22,nowin,win,dlbust,bust,20,0,7,194,0.417525773,0.046391753,0.515463918,1,0.266616552
25545,35,24258,10,5,0,0,0,15,2,10,10,0,0,22,nowin,win,dlbust,bust,20,0,15,202,0.410891089,0.044554455,0.633663366,2,0.598681573
25546,109,24258,10,10,0,0,0,20,2,10,10,0,0,22,nowin,win,dlbust,bust,20,0,20,221,0.461538462,0.058823529,0.597285068,3,0.901830309
25547,20,24258,9,10,0,0,0,19,2,10,10,0,0,22,nowin,win,dlbust,bust,20,0,19,186,0.456989247,0.037634409,0.537634409,1,0.301097108
25548,88,24259,4,10,0,5,0,19,8,10,0,0,0,18,nowin,win,plwin,beat,20,0,14,206,0.466019417,0.033980583,0.54368932,1,0.309467903
25549,79,24259,8,10,0,0,0,18,8,10,0,0,0,18,nowin,push,push,push,10,0,18,211,0.436018957,0.028436019,0.672985782,2,0.650131054
25550,74,24259,7,11,0,0,0,18,8,10,0,0,0,18,nowin,push,push,push,10,0,18,209,0.411483254,0.04784689,0.531100478,0,0.017448125
25551,149,24259,5,10,0,10,0,25,8,10,0,0,0,18,nowin,loss,bust,plbust,0,10,15,225,0.457777778,0.057777778,0.648888889,2,0.651965595
25552,11,24259,5,10,0,1,10,26,8,10,0,0,0,18,nowin,loss,bust,plbust,0,10,15,236,0.457627119,0.016949153,0.588983051,3,0.889015813
25553,145,24259,4,3,2,1,9,19,8,10,0,0,0,18,nowin,win,plwin,beat,20,0,7,188,0.441489362,0.031914894,0.622340426,2,0.617837093
25554,131,24260,10,4,0,0,0,14,2,10,5,0,0,17,nowin,loss,beat,dlwin,0,10,14,217,0.410138249,0.069124424,0.543778802,0,0.02015021
25555,36,24260,4,10,0,0,0,14,2,10,5,0,0,17,nowin,loss,beat,dlwin,0,10,14,229,0.445414847,0.056768559,0.655021834,2,0.645370571
25556,143,24260,5,10,0,0,0,15,2,10,5,0,0,17,nowin,loss,beat,dlwin,0,10,15,203,0.463054187,0.044334975,0.57635468,3,0.883143365
25557,6,24260,3,10,0,0,0,13,2,10,5,0,0,17,nowin,loss,beat,dlwin,0,10,13,191,0.439790576,0.047120419,0.581151832,1,0.31211505
25558,82,24260,6,4,7,0,0,17,2,10,5,0,0,17,nowin,push,push,push,10,0,10,225,0.408888889,0.075555556,0.577777778,0,0.028101874
25559,54,24260,10,9,0,0,0,19,2,10,5,0,0,17,nowin,win,plwin,beat,20,0,19,185,0.437837838,0.032432432,0.556756757,1,0.29899854
25560,2,24261,7,3,2,2,9,23,11,10,0,0,0,21,nowin,loss,bust,plbust,0,10,10,200,0.445,0.035,0.64,2,0.633962549
25561,62,24261,8,11,0,0,0,19,11,10,0,0,0,21,nowin,loss,beat,dlwin,0,10,19,178,0.370786517,0.028089888,0.54494382,0,0.008657722
25562,87,24261,6,5,4,5,0,20,11,10,0,0,0,21,nowin,loss,beat,dlwin,0,10,11,202,0.405940594,0.054455446,0.628712871,2,0.590599801
25563,35,24261,10,6,0,8,0,24,11,10,0,0,0,21,nowin,loss,bust,plbust,0,10,16,202,0.410891089,0.044554455,0.633663366,2,0.598681573
25564,54,24261,3,10,0,4,0,17,11,10,0,0,0,21,nowin,loss,beat,dlwin,0,10,13,185,0.437837838,0.032432432,0.556756757,1,0.29899854
25565,22,24261,6,1,10,0,0,17,11,10,0,0,0,21,nowin,loss,beat,dlwin,0,10,7,187,0.481283422,0.042780749,0.577540107,3,0.906128176
25566,91,24262,1,3,10,5,0,19,8,6,7,0,0,21,nowin,loss,beat,dlwin,0,10,4,194,0.417525773,0.046391753,0.515463918,1,0.266616552
25567,144,24262,11,7,0,0,0,18,8,6,7,0,0,21,nowin,loss,beat,dlwin,0,10,18,202,0.386138614,0.054455446,0.564356436,0,0.018006244
25568,113,24262,7,10,0,0,0,17,8,6,7,0,0,21,nowin,loss,beat,dlwin,0,10,17,199,0.407035176,0.055276382,0.668341709,2,0.620695264
25569,127,24262,3,10,0,7,0,20,8,6,7,0,0,21,nowin,loss,beat,dlwin,0,10,13,201,0.402985075,0.029850746,0.60199005,0,0.032263937
25570,12,24262,6,2,10,0,0,18,8,6,7,0,0,21,nowin,loss,beat,dlwin,0,10,8,189,0.470899471,0.015873016,0.613756614,3,0.929171178
25571,24,24262,10,6,0,5,0,21,8,6,7,0,0,21,nowin,push,push,push,10,0,16,207,0.458937198,0.048309179,0.570048309,1,0.318138014
25572,2,24263,9,10,0,0,0,19,3,2,5,10,0,20,nowin,loss,beat,dlwin,0,10,19,200,0.445,0.035,0.64,2,0.633962549
25573,16,24263,9,6,0,0,0,15,3,2,5,10,0,20,nowin,loss,beat,dlwin,0,10,15,220,0.427272727,0.081818182,0.6,2,0.588660176
25574,120,24263,10,10,0,0,0,20,3,2,5,10,0,20,nowin,push,push,push,10,0,20,202,0.440594059,0.034653465,0.618811881,2,0.614441029
25575,14,24263,5,4,10,0,0,19,3,2,5,10,0,20,nowin,loss,beat,dlwin,0,10,9,202,0.391089109,0.01980198,0.628712871,2,0.577264877
25576,47,24263,8,10,0,0,0,18,3,2,5,10,0,20,nowin,loss,beat,dlwin,0,10,18,210,0.438095238,0.057142857,0.623809524,2,0.615868808
25577,130,24263,3,3,6,7,0,19,3,2,5,10,0,20,nowin,loss,beat,dlwin,0,10,6,219,0.410958904,0.03652968,0.566210046,0,0.025888739
25578,31,24264,8,8,0,0,0,16,5,6,4,10,0,25,nowin,win,dlbust,bust,20,0,16,188,0.473404255,0.058510638,0.515957447,1,0.300306557
25579,47,24264,10,2,0,0,0,12,5,6,4,10,0,25,nowin,win,dlbust,bust,20,0,12,210,0.438095238,0.057142857,0.623809524,2,0.615868808
25580,113,24264,10,10,0,0,0,20,5,6,4,10,0,25,nowin,win,dlbust,bust,20,0,20,199,0.407035176,0.055276382,0.668341709,2,0.620695264
25581,31,24264,10,9,0,0,0,19,5,6,4,10,0,25,nowin,win,dlbust,bust,20,0,19,188,0.473404255,0.058510638,0.515957447,1,0.300306557
25582,118,24264,6,9,0,0,0,15,5,6,4,10,0,25,nowin,win,dlbust,bust,20,0,15,216,0.393518519,0.037037037,0.555555556,0,0.018059873
25583,14,24264,5,4,5,0,0,14,5,6,4,10,0,25,nowin,win,dlbust,bust,20,0,9,202,0.391089109,0.01980198,0.628712871,2,0.577264877
25584,63,24265,3,2,7,0,0,12,6,6,4,10,0,26,nowin,win,dlbust,bust,20,0,5,216,0.467592593,0.037037037,0.62037037,3,0.931690496
25585,78,24265,10,10,0,0,0,20,6,6,4,10,0,26,nowin,win,dlbust,bust,20,0,20,201,0.517412935,0.034825871,0.587064677,3,0.95871112
25586,85,24265,9,10,0,0,0,19,6,6,4,10,0,26,nowin,win,dlbust,bust,20,0,19,195,0.41025641,0.066666667,0.594871795,0,0.03269711
25587,131,24265,3,3,11,0,0,17,6,6,4,10,0,26,nowin,win,dlbust,bust,20,0,6,217,0.410138249,0.069124424,0.543778802,0,0.02015021
25588,73,24265,2,1,10,0,0,13,6,6,4,10,0,26,nowin,win,dlbust,bust,20,0,3,181,0.375690608,0.011049724,0.596685083,0,0.022795773
25589,19,24265,8,10,0,0,0,18,6,6,4,10,0,26,nowin,win,dlbust,bust,20,0,18,237,0.41350211,0.054852321,0.628691983,2,0.597373826
25590,114,24266,2,1,10,0,0,13,2,10,1,9,0,22,nowin,win,dlbust,bust,20,0,3,198,0.47979798,0.025252525,0.611111111,3,0.937232995
25591,19,24266,2,7,8,0,0,17,2,10,1,9,0,22,nowin,win,dlbust,bust,20,0,9,237,0.41350211,0.054852321,0.628691983,2,0.597373826
25592,38,24266,9,6,0,0,0,15,2,10,1,9,0,22,nowin,win,dlbust,bust,20,0,15,202,0.361386139,0.03960396,0.564356436,0,0.010597953
25593,58,24266,2,7,3,1,0,13,2,10,1,9,0,22,nowin,win,dlbust,bust,20,0,9,195,0.430769231,0.041025641,0.584615385,2,0.580497586
25594,15,24266,9,8,0,0,0,17,2,10,1,9,0,22,nowin,win,dlbust,bust,20,0,17,212,0.410377358,0.051886792,0.561320755,0,0.024517408
25595,8,24266,9,11,0,0,0,20,2,10,1,9,0,22,nowin,win,dlbust,bust,20,0,20,181,0.44198895,0.071823204,0.596685083,2,0.599438402
25596,43,24267,10,5,0,8,0,23,8,2,7,0,0,17,nowin,loss,bust,plbust,0,10,15,192,0.40625,0.041666667,0.609375,2,0.576671372
25597,77,24267,10,8,0,0,0,18,8,2,7,0,0,17,nowin,win,plwin,beat,20,0,18,200,0.455,0.04,0.62,3,0.916252116
25598,58,24267,1,6,10,0,0,17,8,2,7,0,0,17,nowin,push,push,push,10,0,7,195,0.430769231,0.041025641,0.584615385,2,0.580497586
25599,127,24267,8,10,0,0,0,18,8,2,7,0,0,17,nowin,win,plwin,beat,20,0,18,201,0.402985075,0.029850746,0.60199005,0,0.032263937
25600,147,24267,6,5,10,0,0,21,8,2,7,0,0,17,nowin,win,plwin,beat,20,0,11,205,0.380487805,0.014634146,0.536585366,0,0.00951447
25601,59,24267,10,3,0,3,8,24,8,2,7,0,0,17,nowin,loss,bust,plbust,0,10,13,228,0.429824561,0.048245614,0.543859649,1,0.287885446
25602,38,24268,10,5,0,5,0,20,10,6,4,0,0,20,nowin,push,push,push,10,0,15,202,0.361386139,0.03960396,0.564356436,0,0.010597953
25603,92,24268,10,10,0,0,0,20,10,6,4,0,0,20,nowin,push,push,push,10,0,20,186,0.446236559,0.059139785,0.564516129,1,0.307826125
25604,49,24268,9,9,0,0,0,18,10,6,4,0,0,20,nowin,loss,beat,dlwin,0,10,18,207,0.396135266,0.053140097,0.594202899,0,0.028306925
25605,127,24268,5,10,0,7,0,22,10,6,4,0,0,20,nowin,loss,bust,plbust,0,10,15,201,0.402985075,0.029850746,0.60199005,0,0.032263937
25606,23,24268,6,8,0,4,0,18,10,6,4,0,0,20,nowin,loss,beat,dlwin,0,10,14,208,0.427884615,0.0625,0.552884615,1,0.29114424
25607,97,24268,8,10,0,0,0,18,10,6,4,0,0,20,nowin,loss,beat,dlwin,0,10,18,182,0.450549451,0.06043956,0.692307692,2,0.677372279
25608,123,24269,2,10,0,4,5,21,8,5,6,0,0,19,nowin,win,plwin,beat,20,0,12,205,0.43902439,0.034146341,0.614634146,2,0.609962544
25609,67,24269,10,7,0,0,0,17,8,5,6,0,0,19,nowin,loss,beat,dlwin,0,10,17,195,0.369230769,0.041025641,0.569230769,0,0.014139427
25610,24,24269,8,4,0,9,0,21,8,5,6,0,0,19,nowin,win,plwin,beat,20,0,12,207,0.458937198,0.048309179,0.570048309,1,0.318138014
25611,10,24269,6,6,0,5,0,17,8,5,6,0,0,19,nowin,loss,beat,dlwin,0,10,12,191,0.413612565,0.057591623,0.596858639,2,0.574087175
25612,10,24269,10,7,0,0,0,17,8,5,6,0,0,19,nowin,loss,beat,dlwin,0,10,17,191,0.413612565,0.057591623,0.596858639,2,0.574087175
25613,1,24269,10,7,0,0,0,17,8,5,6,0,0,19,nowin,loss,beat,dlwin,0,10,17,197,0.406091371,0.025380711,0.649746193,2,0.606186955
25614,64,24270,10,10,0,0,0,20,6,5,10,0,0,21,nowin,loss,beat,dlwin,0,10,20,187,0.363636364,0.048128342,0.631016043,0,0.027594885
25615,88,24270,6,3,6,0,0,15,6,5,10,0,0,21,nowin,loss,beat,dlwin,0,10,9,206,0.466019417,0.033980583,0.54368932,1,0.309467903
25616,103,24270,7,10,0,0,0,17,6,5,10,0,0,21,nowin,loss,beat,dlwin,0,10,17,203,0.379310345,0.064039409,0.551724138,0,0.012869209
25617,78,24270,10,10,0,0,0,20,6,5,10,0,0,21,nowin,loss,beat,dlwin,0,10,20,201,0.517412935,0.034825871,0.587064677,3,0.95871112
25618,61,24270,10,9,0,0,0,19,6,5,10,0,0,21,nowin,loss,beat,dlwin,0,10,19,194,0.427835052,0.077319588,0.603092784,2,0.591437139
25619,92,24270,9,10,0,0,0,19,6,5,10,0,0,21,nowin,loss,beat,dlwin,0,10,19,186,0.446236559,0.059139785,0.564516129,1,0.307826125
25620,21,24271,4,9,0,2,10,25,10,10,0,0,0,20,nowin,loss,bust,plbust,0,10,13,214,0.359813084,0.042056075,0.626168224,0,0.025263474
25621,126,24271,9,3,0,5,0,17,10,10,0,0,0,20,nowin,loss,beat,dlwin,0,10,12,188,0.457446809,0.074468085,0.60106383,3,0.900633203
25622,114,24271,1,5,6,9,0,21,10,10,0,0,0,20,nowin,win,plwin,beat,20,0,6,198,0.47979798,0.025252525,0.611111111,3,0.937232995
25623,7,24271,10,9,0,0,0,19,10,10,0,0,0,20,nowin,loss,beat,dlwin,0,10,19,183,0.442622951,0.06010929,0.62295082,2,0.619303341
25624,6,24271,10,10,0,0,0,20,10,10,0,0,0,20,nowin,push,push,push,10,0,20,191,0.439790576,0.047120419,0.581151832,1,0.31211505
25625,132,24271,6,10,0,2,0,18,10,10,0,0,0,20,nowin,loss,beat,dlwin,0,10,16,194,0.412371134,0.036082474,0.649484536,2,0.611633238
25626,103,24272,5,2,9,4,0,20,10,9,0,0,0,19,nowin,win,plwin,beat,20,0,7,203,0.379310345,0.064039409,0.551724138,0,0.012869209
25627,63,24272,10,8,0,0,0,18,10,9,0,0,0,19,nowin,loss,beat,dlwin,0,10,18,216,0.467592593,0.037037037,0.62037037,3,0.931690496
25628,97,24272,3,10,0,10,0,23,10,9,0,0,0,19,nowin,loss,bust,plbust,0,10,13,182,0.450549451,0.06043956,0.692307692,2,0.677372279
25629,97,24272,10,11,0,0,0,21,10,9,0,0,0,19,win,win,plwin,beat,25,0,21,182,0.450549451,0.06043956,0.692307692,2,0.677372279
25630,43,24272,10,3,0,7,0,20,10,9,0,0,0,19,nowin,win,plwin,beat,20,0,13,192,0.40625,0.041666667,0.609375,2,0.576671372
25631,20,24272,6,7,0,5,0,18,10,9,0,0,0,19,nowin,loss,beat,dlwin,0,10,13,186,0.456989247,0.037634409,0.537634409,1,0.301097108
25632,51,24273,10,8,0,0,0,18,1,4,7,10,0,22,nowin,win,dlbust,bust,20,0,18,189,0.529100529,0.068783069,0.608465608,3,0.993665715
25633,17,24273,6,10,0,6,0,22,1,4,7,10,0,22,nowin,loss,bust,plbust,0,10,16,171,0.444444444,0.070175439,0.555555556,1,0.302364894
25634,86,24273,9,7,0,8,0,24,1,4,7,10,0,22,nowin,loss,bust,plbust,0,10,16,196,0.454081633,0.040816327,0.591836735,3,0.887566443
25635,137,24273,3,11,4,0,0,18,1,4,7,10,0,22,nowin,win,dlbust,bust,20,0,14,194,0.417525773,0.046391753,0.536082474,1,0.276714602
25636,144,24273,4,9,0,10,0,23,1,4,7,10,0,22,nowin,loss,bust,plbust,0,10,13,202,0.386138614,0.054455446,0.564356436,0,0.018006244
25637,60,24273,6,3,10,0,0,19,1,4,7,10,0,22,nowin,win,dlbust,bust,20,0,9,227,0.418502203,0.022026432,0.559471366,0,0.026496258
25638,95,24274,4,10,0,0,0,14,6,8,10,0,0,24,nowin,win,dlbust,bust,20,0,14,218,0.412844037,0.04587156,0.559633028,0,0.024842385
25639,14,24274,5,8,0,0,0,13,6,8,10,0,0,24,nowin,win,dlbust,bust,20,0,13,202,0.391089109,0.01980198,0.628712871,2,0.577264877
25640,148,24274,10,2,0,0,0,12,6,8,10,0,0,24,nowin,win,dlbust,bust,20,0,12,204,0.401960784,0.078431373,0.593137255,0,0.029789521
25641,105,24274,11,10,0,0,0,21,6,8,10,0,0,24,win,win,dlbust,bust,25,0,21,198,0.414141414,0.070707071,0.590909091,0,0.032889494
25642,27,24274,6,3,10,0,0,19,6,8,10,0,0,24,nowin,win,dlbust,bust,20,0,9,178,0.370786517,0.016853933,0.573033708,0,0.015536309
25643,118,24274,5,10,0,0,0,15,6,8,10,0,0,24,nowin,win,dlbust,bust,20,0,15,216,0.393518519,0.037037037,0.555555556,0,0.018059873
25644,21,24275,8,4,0,10,0,22,10,10,0,0,0,20,nowin,loss,bust,plbust,0,10,12,214,0.359813084,0.042056075,0.626168224,0,0.025263474
25645,98,24275,10,5,0,6,0,21,10,10,0,0,0,20,nowin,win,plwin,beat,20,0,15,220,0.422727273,0.054545455,0.55,1,0.28664435
25646,77,24275,10,11,0,0,0,21,10,10,0,0,0,20,win,win,plwin,beat,25,0,21,200,0.455,0.04,0.62,3,0.916252116
25647,145,24275,1,6,10,0,0,17,10,10,0,0,0,20,nowin,loss,beat,dlwin,0,10,7,188,0.441489362,0.031914894,0.622340426,2,0.617837093
25648,144,24275,9,10,0,0,0,19,10,10,0,0,0,20,nowin,loss,beat,dlwin,0,10,19,202,0.386138614,0.054455446,0.564356436,0,0.018006244
25649,69,24275,11,9,0,0,0,20,10,10,0,0,0,20,nowin,push,push,push,10,0,20,194,0.365979381,0.030927835,0.515463918,0,0
25650,53,24276,4,4,11,0,0,19,5,5,11,0,0,21,nowin,loss,beat,dlwin,0,10,8,250,0.372,0.064,0.564,0,0.013687345
25651,62,24276,10,9,0,0,0,19,5,5,11,0,0,21,nowin,loss,beat,dlwin,0,10,19,178,0.370786517,0.028089888,0.54494382,0,0.008657722
25652,100,24276,1,2,10,0,0,13,5,5,11,0,0,21,nowin,loss,beat,dlwin,0,10,3,190,0.452631579,0.036842105,0.594736842,3,0.888671154
25653,148,24276,10,8,0,0,0,18,5,5,11,0,0,21,nowin,loss,beat,dlwin,0,10,18,204,0.401960784,0.078431373,0.593137255,0,0.029789521
25654,132,24276,10,10,0,0,0,20,5,5,11,0,0,21,nowin,loss,beat,dlwin,0,10,20,194,0.412371134,0.036082474,0.649484536,2,0.611633238
25655,146,24276,11,10,0,0,0,21,5,5,11,0,0,21,win,push,push,push,10,0,21,221,0.43438914,0.040723982,0.542986425,1,0.290190091
25656,28,24277,10,7,0,0,0,17,11,8,0,0,0,19,nowin,loss,beat,dlwin,0,10,17,199,0.422110553,0.045226131,0.542713568,1,0.282706618
25657,104,24277,10,10,0,0,0,20,11,8,0,0,0,19,nowin,win,plwin,beat,20,0,20,209,0.363636364,0.052631579,0.593301435,0,0.018359419
25658,43,24277,3,9,0,2,2,16,11,8,0,0,0,19,nowin,loss,beat,dlwin,0,10,12,192,0.40625,0.041666667,0.609375,2,0.576671372
25659,6,24277,10,11,0,0,0,21,11,8,0,0,0,19,win,win,plwin,beat,25,0,21,191,0.439790576,0.047120419,0.581151832,1,0.31211505
25660,17,24277,8,6,0,1,10,25,11,8,0,0,0,19,nowin,loss,bust,plbust,0,10,14,171,0.444444444,0.070175439,0.555555556,1,0.302364894
25661,67,24277,5,10,0,10,0,25,11,8,0,0,0,19,nowin,loss,bust,plbust,0,10,15,195,0.369230769,0.041025641,0.569230769,0,0.014139427
25662,2,24278,2,4,8,10,0,24,7,6,5,0,0,18,nowin,loss,bust,plbust,0,10,6,200,0.445,0.035,0.64,2,0.633962549
25663,24,24278,9,5,0,10,0,24,7,6,5,0,0,18,nowin,loss,bust,plbust,0,10,14,207,0.458937198,0.048309179,0.570048309,1,0.318138014
25664,27,24278,2,1,10,4,0,17,7,6,5,0,0,18,nowin,loss,beat,dlwin,0,10,3,178,0.370786517,0.016853933,0.573033708,0,0.015536309
25665,70,24278,7,2,10,0,0,19,7,6,5,0,0,18,nowin,win,plwin,beat,20,0,9,228,0.385964912,0.039473684,0.557017544,0,0.016157125
25666,79,24278,10,10,0,0,0,20,7,6,5,0,0,18,nowin,win,plwin,beat,20,0,20,211,0.436018957,0.028436019,0.672985782,2,0.650131054
25667,101,24278,7,4,7,0,0,18,7,6,5,0,0,18,nowin,push,push,push,10,0,11,205,0.424390244,0.068292683,0.63902439,2,0.614740646
25668,22,24279,10,8,0,0,0,18,8,4,10,0,0,22,nowin,win,dlbust,bust,20,0,18,187,0.481283422,0.042780749,0.577540107,3,0.906128176
25669,4,24279,10,5,0,5,0,20,8,4,10,0,0,22,nowin,win,dlbust,bust,20,0,15,217,0.460829493,0.036866359,0.562211982,1,0.315432839
25670,2,24279,7,10,0,0,0,17,8,4,10,0,0,22,nowin,win,dlbust,bust,20,0,17,200,0.445,0.035,0.64,2,0.633962549
25671,102,24279,5,3,9,0,0,17,8,4,10,0,0,22,nowin,win,dlbust,bust,20,0,8,192,0.338541667,0.046875,0.5625,0,0.003306118
25672,71,24279,10,4,0,10,0,24,8,4,10,0,0,22,nowin,loss,bust,plbust,0,10,14,193,0.352331606,0.046632124,0.585492228,0,0.013063661
25673,27,24279,10,3,0,3,4,20,8,4,10,0,0,22,nowin,win,dlbust,bust,20,0,13,178,0.370786517,0.016853933,0.573033708,0,0.015536309
25674,71,24280,3,6,3,10,0,22,9,5,3,0,0,17,nowin,loss,bust,plbust,0,10,9,193,0.352331606,0.046632124,0.585492228,0,0.013063661
25675,52,24280,11,9,0,0,0,20,9,5,3,0,0,17,nowin,win,plwin,beat,20,0,20,217,0.414746544,0.02764977,0.599078341,2,0.576736024
25676,140,24280,4,7,1,4,4,20,9,5,3,0,0,17,nowin,win,plwin,beat,20,0,11,210,0.466666667,0.023809524,0.604761905,3,0.915293335
25677,142,24280,6,10,0,1,0,17,9,5,3,0,0,17,nowin,push,push,push,10,0,16,211,0.417061611,0.047393365,0.526066351,1,0.271531309
25678,63,24280,9,10,0,0,0,19,9,5,3,0,0,17,nowin,win,plwin,beat,20,0,19,216,0.467592593,0.037037037,0.62037037,3,0.931690496
25679,70,24280,10,5,0,6,0,21,9,5,3,0,0,17,nowin,win,plwin,beat,20,0,15,228,0.385964912,0.039473684,0.557017544,0,0.016157125
25680,132,24281,10,10,0,0,0,20,2,1,10,5,0,18,nowin,win,plwin,beat,20,0,20,194,0.412371134,0.036082474,0.649484536,2,0.611633238
25681,129,24281,10,5,0,0,0,15,2,1,10,5,0,18,nowin,loss,beat,dlwin,0,10,15,201,0.422885572,0.064676617,0.55721393,0,0.027255383
25682,118,24281,7,10,0,0,0,17,2,1,10,5,0,18,nowin,loss,beat,dlwin,0,10,17,216,0.393518519,0.037037037,0.555555556,0,0.018059873
25683,100,24281,10,11,0,0,0,21,2,1,10,5,0,18,win,win,plwin,beat,25,0,21,190,0.452631579,0.036842105,0.594736842,3,0.888671154
25684,24,24281,3,5,4,7,0,19,2,1,10,5,0,18,nowin,win,plwin,beat,20,0,8,207,0.458937198,0.048309179,0.570048309,1,0.318138014
25685,45,24281,10,2,0,10,0,22,2,1,10,5,0,18,nowin,loss,bust,plbust,0,10,12,196,0.428571429,0.051020408,0.612244898,2,0.598821767
25686,82,24282,8,11,0,0,0,19,7,10,0,0,0,17,nowin,win,plwin,beat,20,0,19,225,0.408888889,0.075555556,0.577777778,0,0.028101874
25687,97,24282,6,5,9,0,0,20,7,10,0,0,0,17,nowin,win,plwin,beat,20,0,11,182,0.450549451,0.06043956,0.692307692,2,0.677372279
25688,30,24282,10,10,0,0,0,20,7,10,0,0,0,17,nowin,win,plwin,beat,20,0,20,206,0.393203883,0.033980583,0.601941748,0,0.029324648
25689,65,24282,8,4,0,7,0,19,7,10,0,0,0,17,nowin,win,plwin,beat,20,0,12,203,0.492610837,0.054187192,0.571428571,3,0.913702814
25690,145,24282,3,11,7,0,0,21,7,10,0,0,0,17,nowin,win,plwin,beat,20,0,14,188,0.441489362,0.031914894,0.622340426,2,0.617837093
25691,100,24282,10,7,0,0,0,17,7,10,0,0,0,17,nowin,push,push,push,10,0,17,190,0.452631579,0.036842105,0.594736842,3,0.888671154
25692,64,24283,4,10,0,0,0,14,5,10,4,0,0,19,nowin,loss,beat,dlwin,0,10,14,187,0.363636364,0.048128342,0.631016043,0,0.027594885
25693,17,24283,3,6,7,0,0,16,5,10,4,0,0,19,nowin,loss,beat,dlwin,0,10,9,171,0.444444444,0.070175439,0.555555556,1,0.302364894
25694,60,24283,2,7,9,0,0,18,5,10,4,0,0,19,nowin,loss,beat,dlwin,0,10,9,227,0.418502203,0.022026432,0.559471366,0,0.026496258
25695,114,24283,1,2,9,0,0,12,5,10,4,0,0,19,nowin,loss,beat,dlwin,0,10,3,198,0.47979798,0.025252525,0.611111111,3,0.937232995
25696,2,24283,10,8,0,0,0,18,5,10,4,0,0,19,nowin,loss,beat,dlwin,0,10,18,200,0.445,0.035,0.64,2,0.633962549
25697,124,24283,3,10,0,0,0,13,5,10,4,0,0,19,nowin,loss,beat,dlwin,0,10,13,202,0.47029703,0.064356436,0.584158416,3,0.899458193
25698,43,24284,10,6,0,10,0,26,9,10,0,0,0,19,nowin,loss,bust,plbust,0,10,16,192,0.40625,0.041666667,0.609375,2,0.576671372
25699,72,24284,10,9,0,0,0,19,9,10,0,0,0,19,nowin,push,push,push,10,0,19,185,0.394594595,0.032432432,0.508108108,0,0.006763115
25700,107,24284,9,9,0,0,0,18,9,10,0,0,0,19,nowin,loss,beat,dlwin,0,10,18,218,0.444954128,0.073394495,0.600917431,2,0.605210014
25701,74,24284,10,7,0,0,0,17,9,10,0,0,0,19,nowin,loss,beat,dlwin,0,10,17,209,0.411483254,0.04784689,0.531100478,0,0.017448125
25702,105,24284,10,10,0,0,0,20,9,10,0,0,0,19,nowin,win,plwin,beat,20,0,20,198,0.414141414,0.070707071,0.590909091,0,0.032889494
25703,8,24284,8,4,0,3,5,20,9,10,0,0,0,19,nowin,win,plwin,beat,20,0,12,181,0.44198895,0.071823204,0.596685083,2,0.599438402
25704,32,24285,9,8,0,0,0,17,1,3,9,10,0,23,nowin,win,dlbust,bust,20,0,17,189,0.391534392,0.037037037,0.53968254,0,0.013579086
25705,36,24285,5,11,5,0,0,21,1,3,9,10,0,23,nowin,win,dlbust,bust,20,0,16,229,0.445414847,0.056768559,0.655021834,2,0.645370571
25706,20,24285,3,2,7,8,0,20,1,3,9,10,0,23,nowin,win,dlbust,bust,20,0,5,186,0.456989247,0.037634409,0.537634409,1,0.301097108
25707,31,24285,2,10,0,1,10,23,1,3,9,10,0,23,nowin,loss,bust,plbust,0,10,12,188,0.473404255,0.058510638,0.515957447,1,0.300306557
25708,143,24285,10,3,0,4,0,17,1,3,9,10,0,23,nowin,win,dlbust,bust,20,0,13,203,0.463054187,0.044334975,0.57635468,3,0.883143365
25709,143,24285,4,10,0,2,10,26,1,3,9,10,0,23,nowin,loss,bust,plbust,0,10,14,203,0.463054187,0.044334975,0.57635468,3,0.883143365
25710,30,24286,3,4,3,10,0,20,10,8,0,0,0,18,nowin,win,plwin,beat,20,0,7,206,0.393203883,0.033980583,0.601941748,0,0.029324648
25711,48,24286,10,5,0,3,0,18,10,8,0,0,0,18,nowin,push,push,push,10,0,15,203,0.413793103,0.019704433,0.600985222,2,0.577280801
25712,80,24286,7,3,6,10,0,26,10,8,0,0,0,18,nowin,loss,bust,plbust,0,10,10,186,0.419354839,0.059139785,0.623655914,2,0.59892924
25713,16,24286,8,4,0,9,0,21,10,8,0,0,0,18,nowin,win,plwin,beat,20,0,12,220,0.427272727,0.081818182,0.6,2,0.588660176
25714,132,24286,6,11,2,0,0,19,10,8,0,0,0,18,nowin,win,plwin,beat,20,0,17,194,0.412371134,0.036082474,0.649484536,2,0.611633238
25715,53,24286,6,10,0,1,0,17,10,8,0,0,0,18,nowin,loss,beat,dlwin,0,10,16,250,0.372,0.064,0.564,0,0.013687345
25716,143,24287,11,8,0,0,0,19,10,9,0,0,0,19,nowin,push,push,push,10,0,19,203,0.463054187,0.044334975,0.57635468,3,0.883143365
25717,68,24287,5,2,2,7,10,26,10,9,0,0,0,19,nowin,loss,bust,plbust,0,10,7,205,0.434146341,0.029268293,0.6,2,0.59483189
25718,82,24287,10,4,0,10,0,24,10,9,0,0,0,19,nowin,loss,bust,plbust,0,10,14,225,0.408888889,0.075555556,0.577777778,0,0.028101874
25719,125,24287,11,4,5,0,0,20,10,9,0,0,0,19,nowin,win,plwin,beat,20,0,15,219,0.438356164,0.050228311,0.575342466,1,0.308411257
25720,11,24287,10,8,0,0,0,18,10,9,0,0,0,19,nowin,loss,beat,dlwin,0,10,18,236,0.457627119,0.016949153,0.588983051,3,0.889015813
25721,13,24287,10,6,0,10,0,26,10,9,0,0,0,19,nowin,loss,bust,plbust,0,10,16,206,0.417475728,0.063106796,0.621359223,2,0.59555479
25722,7,24288,10,8,0,0,0,18,10,7,0,0,0,17,nowin,win,plwin,beat,20,0,18,183,0.442622951,0.06010929,0.62295082,2,0.619303341
25723,59,24288,10,9,0,0,0,19,10,7,0,0,0,17,nowin,win,plwin,beat,20,0,19,228,0.429824561,0.048245614,0.543859649,1,0.287885446
25724,15,24288,10,11,0,0,0,21,10,7,0,0,0,17,win,win,plwin,beat,25,0,21,212,0.410377358,0.051886792,0.561320755,0,0.024517408
25725,107,24288,10,7,0,0,0,17,10,7,0,0,0,17,nowin,push,push,push,10,0,17,218,0.444954128,0.073394495,0.600917431,2,0.605210014
25726,74,24288,8,10,0,0,0,18,10,7,0,0,0,17,nowin,win,plwin,beat,20,0,18,209,0.411483254,0.04784689,0.531100478,0,0.017448125
25727,104,24288,4,6,10,0,0,20,10,7,0,0,0,17,nowin,win,plwin,beat,20,0,10,209,0.363636364,0.052631579,0.593301435,0,0.018359419
25728,77,24289,11,10,0,0,0,21,10,10,0,0,0,20,win,win,plwin,beat,25,0,21,200,0.455,0.04,0.62,3,0.916252116
25729,77,24289,3,5,9,0,0,17,10,10,0,0,0,20,nowin,loss,beat,dlwin,0,10,8,200,0.455,0.04,0.62,3,0.916252116
25730,1,24289,10,10,0,0,0,20,10,10,0,0,0,20,nowin,push,push,push,10,0,20,197,0.406091371,0.025380711,0.649746193,2,0.606186955
25731,91,24289,2,10,0,9,0,21,10,10,0,0,0,20,nowin,win,plwin,beat,20,0,12,194,0.417525773,0.046391753,0.515463918,1,0.266616552
25732,92,24289,8,5,0,10,0,23,10,10,0,0,0,20,nowin,loss,bust,plbust,0,10,13,186,0.446236559,0.059139785,0.564516129,1,0.307826125
25733,149,24289,8,10,0,0,0,18,10,10,0,0,0,20,nowin,loss,beat,dlwin,0,10,18,225,0.457777778,0.057777778,0.648888889,2,0.651965595
25734,134,24290,10,6,0,0,0,16,6,6,8,0,0,20,nowin,loss,beat,dlwin,0,10,16,185,0.443243243,0.021621622,0.545945946,1,0.296939509
25735,60,24290,1,4,9,0,0,14,6,6,8,0,0,20,nowin,loss,beat,dlwin,0,10,5,227,0.418502203,0.022026432,0.559471366,0,0.026496258
25736,4,24290,10,5,0,0,0,15,6,6,8,0,0,20,nowin,loss,beat,dlwin,0,10,15,217,0.460829493,0.036866359,0.562211982,1,0.315432839
25737,59,24290,5,6,8,0,0,19,6,6,8,0,0,20,nowin,loss,beat,dlwin,0,10,11,228,0.429824561,0.048245614,0.543859649,1,0.287885446
25738,106,24290,4,10,0,0,0,14,6,6,8,0,0,20,nowin,loss,beat,dlwin,0,10,14,192,0.411458333,0.026041667,0.557291667,0,0.023854304
25739,53,24290,4,8,0,0,0,12,6,6,8,0,0,20,nowin,loss,beat,dlwin,0,10,12,250,0.372,0.064,0.564,0,0.013687345
25740,86,24291,6,9,0,0,0,15,2,6,3,6,0,17,nowin,loss,beat,dlwin,0,10,15,196,0.454081633,0.040816327,0.591836735,3,0.887566443
25741,115,24291,10,10,0,0,0,20,2,6,3,6,0,17,nowin,win,plwin,beat,20,0,20,194,0.427835052,0.041237113,0.592783505,2,0.583863602
25742,122,24291,6,10,0,0,0,16,2,6,3,6,0,17,nowin,loss,beat,dlwin,0,10,16,210,0.347619048,0.052380952,0.59047619,0,0.012873677
25743,59,24291,7,4,6,0,0,17,2,6,3,6,0,17,nowin,push,push,push,10,0,11,228,0.429824561,0.048245614,0.543859649,1,0.287885446
25744,139,24291,6,10,0,0,0,16,2,6,3,6,0,17,nowin,loss,beat,dlwin,0,10,16,192,0.380208333,0.036458333,0.59375,0,0.023429169
25745,99,24291,2,8,4,0,0,14,2,6,3,6,0,17,nowin,loss,beat,dlwin,0,10,10,207,0.47826087,0.062801932,0.637681159,3,0.961418446
25746,43,24292,10,10,0,0,0,20,6,11,0,0,0,17,nowin,win,plwin,beat,20,0,20,192,0.40625,0.041666667,0.609375,2,0.576671372
25747,20,24292,11,10,0,0,0,21,6,11,0,0,0,17,win,win,plwin,beat,25,0,21,186,0.456989247,0.037634409,0.537634409,1,0.301097108
25748,47,24292,3,10,0,0,0,13,6,11,0,0,0,17,nowin,loss,beat,dlwin,0,10,13,210,0.438095238,0.057142857,0.623809524,2,0.615868808
25749,108,24292,10,8,0,0,0,18,6,11,0,0,0,17,nowin,win,plwin,beat,20,0,18,193,0.435233161,0.056994819,0.559585492,1,0.298824795
25750,63,24292,7,8,0,0,0,15,6,11,0,0,0,17,nowin,loss,beat,dlwin,0,10,15,216,0.467592593,0.037037037,0.62037037,3,0.931690496
25751,31,24292,10,10,0,0,0,20,6,11,0,0,0,17,nowin,win,plwin,beat,20,0,20,188,0.473404255,0.058510638,0.515957447,1,0.300306557
25752,92,24293,11,10,0,0,0,21,11,10,0,0,0,21,win,push,push,push,10,0,21,186,0.446236559,0.059139785,0.564516129,1,0.307826125
25753,34,24293,11,5,2,0,0,18,11,10,0,0,0,21,nowin,loss,beat,dlwin,0,10,16,202,0.5,0.079207921,0.618811881,3,0.968961434
25754,107,24293,8,9,0,0,0,17,11,10,0,0,0,21,nowin,loss,beat,dlwin,0,10,17,218,0.444954128,0.073394495,0.600917431,2,0.605210014
25755,101,24293,3,4,10,0,0,17,11,10,0,0,0,21,nowin,loss,beat,dlwin,0,10,7,205,0.424390244,0.068292683,0.63902439,2,0.614740646
25756,92,24293,10,8,0,0,0,18,11,10,0,0,0,21,nowin,loss,beat,dlwin,0,10,18,186,0.446236559,0.059139785,0.564516129,1,0.307826125
25757,57,24293,8,3,3,10,0,24,11,10,0,0,0,21,nowin,loss,bust,plbust,0,10,11,192,0.46875,0.052083333,0.59375,3,0.907001181
25758,133,24294,11,10,0,0,0,21,7,3,9,0,0,19,win,win,plwin,beat,25,0,21,201,0.47761194,0.064676617,0.611940299,3,0.935428111
25759,147,24294,9,10,0,0,0,19,7,3,9,0,0,19,nowin,push,push,push,10,0,19,205,0.380487805,0.014634146,0.536585366,0,0.00951447
25760,52,24294,2,9,2,1,10,24,7,3,9,0,0,19,nowin,loss,bust,plbust,0,10,11,217,0.414746544,0.02764977,0.599078341,2,0.576736024
25761,1,24294,10,7,0,0,0,17,7,3,9,0,0,19,nowin,loss,beat,dlwin,0,10,17,197,0.406091371,0.025380711,0.649746193,2,0.606186955
25762,115,24294,10,10,0,0,0,20,7,3,9,0,0,19,nowin,win,plwin,beat,20,0,20,194,0.427835052,0.041237113,0.592783505,2,0.583863602
25763,79,24294,11,9,0,0,0,20,7,3,9,0,0,19,nowin,win,plwin,beat,20,0,20,211,0.436018957,0.028436019,0.672985782,2,0.650131054
25764,6,24295,3,4,5,1,7,20,7,10,0,0,0,17,nowin,win,plwin,beat,20,0,7,191,0.439790576,0.047120419,0.581151832,1,0.31211505
25765,50,24295,1,2,10,5,0,18,7,10,0,0,0,17,nowin,win,plwin,beat,20,0,3,202,0.405940594,0.04950495,0.54950495,0,0.020296079
25766,145,24295,10,6,0,5,0,21,7,10,0,0,0,17,nowin,win,plwin,beat,20,0,16,188,0.441489362,0.031914894,0.622340426,2,0.617837093
25767,129,24295,3,10,0,9,0,22,7,10,0,0,0,17,nowin,loss,bust,plbust,0,10,13,201,0.422885572,0.064676617,0.55721393,0,0.027255383
25768,142,24295,10,10,0,0,0,20,7,10,0,0,0,17,nowin,win,plwin,beat,20,0,20,211,0.417061611,0.047393365,0.526066351,1,0.271531309
25769,19,24295,2,8,5,10,0,25,7,10,0,0,0,17,nowin,loss,bust,plbust,0,10,10,237,0.41350211,0.054852321,0.628691983,2,0.597373826
25770,41,24296,5,8,0,10,0,23,10,4,4,0,0,18,nowin,loss,bust,plbust,0,10,13,192,0.364583333,0.036458333,0.520833333,0,0.00089702
25771,95,24296,5,7,0,7,0,19,10,4,4,0,0,18,nowin,win,plwin,beat,20,0,12,218,0.412844037,0.04587156,0.559633028,0,0.024842385
25772,67,24296,6,4,2,3,10,25,10,4,4,0,0,18,nowin,loss,bust,plbust,0,10,10,195,0.369230769,0.041025641,0.569230769,0,0.014139427
25773,109,24296,10,9,0,0,0,19,10,4,4,0,0,18,nowin,win,plwin,beat,20,0,19,221,0.461538462,0.058823529,0.597285068,3,0.901830309
25774,106,24296,10,5,0,9,0,24,10,4,4,0,0,18,nowin,loss,bust,plbust,0,10,15,192,0.411458333,0.026041667,0.557291667,0,0.023854304
25775,23,24296,10,8,0,0,0,18,10,4,4,0,0,18,nowin,push,push,push,10,0,18,208,0.427884615,0.0625,0.552884615,1,0.29114424
25776,46,24297,4,10,0,0,0,14,2,7,10,0,0,19,nowin,loss,beat,dlwin,0,10,14,186,0.403225806,0.048387097,0.591397849,0,0.029742194
25777,109,24297,10,10,0,0,0,20,2,7,10,0,0,19,nowin,win,plwin,beat,20,0,20,221,0.461538462,0.058823529,0.597285068,3,0.901830309
25778,85,24297,2,7,6,0,0,15,2,7,10,0,0,19,nowin,loss,beat,dlwin,0,10,9,195,0.41025641,0.066666667,0.594871795,0,0.03269711
25779,132,24297,7,11,0,0,0,18,2,7,10,0,0,19,nowin,loss,beat,dlwin,0,10,18,194,0.412371134,0.036082474,0.649484536,2,0.611633238
25780,129,24297,2,10,0,2,0,14,2,7,10,0,0,19,nowin,loss,beat,dlwin,0,10,12,201,0.422885572,0.064676617,0.55721393,0,0.027255383
25781,21,24297,9,10,0,0,0,19,2,7,10,0,0,19,nowin,push,push,push,10,0,19,214,0.359813084,0.042056075,0.626168224,0,0.025263474
25782,44,24298,3,4,10,0,0,17,9,5,5,0,0,19,nowin,loss,beat,dlwin,0,10,7,219,0.433789954,0.050228311,0.534246575,1,0.285551035
25783,110,24298,10,8,0,0,0,18,9,5,5,0,0,19,nowin,loss,beat,dlwin,0,10,18,192,0.416666667,0.046875,0.557291667,0,0.025413132
25784,29,24298,6,7,0,7,0,20,9,5,5,0,0,19,nowin,win,plwin,beat,20,0,13,189,0.44973545,0.058201058,0.544973545,1,0.300349439
25785,5,24298,10,10,0,0,0,20,9,5,5,0,0,19,nowin,win,plwin,beat,20,0,20,203,0.42364532,0.02955665,0.596059113,2,0.582508076
25786,44,24298,5,2,11,0,0,18,9,5,5,0,0,19,nowin,loss,beat,dlwin,0,10,7,219,0.433789954,0.050228311,0.534246575,1,0.285551035
25787,19,24298,10,4,0,10,0,24,9,5,5,0,0,19,nowin,loss,bust,plbust,0,10,14,237,0.41350211,0.054852321,0.628691983,2,0.597373826
25788,122,24299,10,9,0,0,0,19,9,10,0,0,0,19,nowin,push,push,push,10,0,19,210,0.347619048,0.052380952,0.59047619,0,0.012873677
25789,60,24299,6,10,0,10,0,26,9,10,0,0,0,19,nowin,loss,bust,plbust,0,10,16,227,0.418502203,0.022026432,0.559471366,0,0.026496258
25790,33,24299,10,10,0,0,0,20,9,10,0,0,0,19,nowin,win,plwin,beat,20,0,20,192,0.4375,0.057291667,0.625,2,0.616208916
25791,112,24299,8,9,0,0,0,17,9,10,0,0,0,19,nowin,loss,beat,dlwin,0,10,17,203,0.448275862,0.054187192,0.600985222,3,0.889576933
25792,120,24299,10,9,0,0,0,19,9,10,0,0,0,19,nowin,push,push,push,10,0,19,202,0.440594059,0.034653465,0.618811881,2,0.614441029
25793,85,24299,10,8,0,0,0,18,9,10,0,0,0,19,nowin,loss,beat,dlwin,0,10,18,195,0.41025641,0.066666667,0.594871795,0,0.03269711
25794,110,24300,10,4,0,9,0,23,10,9,0,0,0,19,nowin,loss,bust,plbust,0,10,14,192,0.416666667,0.046875,0.557291667,0,0.025413132
25795,135,24300,2,6,7,7,0,22,10,9,0,0,0,19,nowin,loss,bust,plbust,0,10,8,179,0.391061453,0.067039106,0.586592179,0,0.024924662
25796,81,24300,10,7,0,0,0,17,10,9,0,0,0,19,nowin,loss,beat,dlwin,0,10,17,182,0.395604396,0.043956044,0.60989011,2,0.567491261
25797,85,24300,11,10,0,0,0,21,10,9,0,0,0,19,win,win,plwin,beat,25,0,21,195,0.41025641,0.066666667,0.594871795,0,0.03269711
25798,6,24300,6,10,0,3,0,19,10,9,0,0,0,19,nowin,push,push,push,10,0,16,191,0.439790576,0.047120419,0.581151832,1,0.31211505
25799,136,24300,10,6,0,10,0,26,10,9,0,0,0,19,nowin,loss,bust,plbust,0,10,16,194,0.396907216,0.025773196,0.597938144,0,0.029452644
25800,1,24301,2,4,10,5,0,21,10,10,0,0,0,20,nowin,win,plwin,beat,20,0,6,197,0.406091371,0.025380711,0.649746193,2,0.606186955
25801,2,24301,11,8,0,0,0,19,10,10,0,0,0,20,nowin,loss,beat,dlwin,0,10,19,200,0.445,0.035,0.64,2,0.633962549
25802,58,24301,8,10,0,0,0,18,10,10,0,0,0,20,nowin,loss,beat,dlwin,0,10,18,195,0.430769231,0.041025641,0.584615385,2,0.580497586
25803,51,24301,11,10,0,0,0,21,10,10,0,0,0,20,win,win,plwin,beat,25,0,21,189,0.529100529,0.068783069,0.608465608,3,0.993665715
25804,43,24301,10,10,0,0,0,20,10,10,0,0,0,20,nowin,push,push,push,10,0,20,192,0.40625,0.041666667,0.609375,2,0.576671372
25805,23,24301,4,8,0,7,0,19,10,10,0,0,0,20,nowin,loss,beat,dlwin,0,10,12,208,0.427884615,0.0625,0.552884615,1,0.29114424
25806,64,24302,5,10,0,0,0,15,3,10,8,0,0,21,nowin,loss,beat,dlwin,0,10,15,187,0.363636364,0.048128342,0.631016043,0,0.027594885
25807,92,24302,4,10,0,0,0,14,3,10,8,0,0,21,nowin,loss,beat,dlwin,0,10,14,186,0.446236559,0.059139785,0.564516129,1,0.307826125
25808,103,24302,11,10,0,0,0,21,3,10,8,0,0,21,win,push,push,push,10,0,21,203,0.379310345,0.064039409,0.551724138,0,0.012869209
25809,93,24302,5,2,3,2,10,22,3,10,8,0,0,21,nowin,loss,bust,plbust,0,10,7,175,0.485714286,0.051428571,0.548571429,1,0.323648091
25810,34,24302,4,10,0,0,0,14,3,10,8,0,0,21,nowin,loss,beat,dlwin,0,10,14,202,0.5,0.079207921,0.618811881,3,0.968961434
25811,13,24302,10,10,0,0,0,20,3,10,8,0,0,21,nowin,loss,beat,dlwin,0,10,20,206,0.417475728,0.063106796,0.621359223,2,0.59555479
25812,36,24303,8,9,0,0,0,17,1,2,10,1,4,18,nowin,loss,beat,dlwin,0,10,17,229,0.445414847,0.056768559,0.655021834,2,0.645370571
25813,105,24303,7,8,0,1,3,19,1,2,10,1,4,18,nowin,win,plwin,beat,20,0,15,198,0.414141414,0.070707071,0.590909091,0,0.032889494
25814,101,24303,10,8,0,0,0,18,1,2,10,1,4,18,nowin,push,push,push,10,0,18,205,0.424390244,0.068292683,0.63902439,2,0.614740646
25815,30,24303,10,4,0,2,1,17,1,2,10,1,4,18,nowin,loss,beat,dlwin,0,10,14,206,0.393203883,0.033980583,0.601941748,0,0.029324648
25816,84,24303,7,6,0,10,0,23,1,2,10,1,4,18,nowin,loss,bust,plbust,0,10,13,195,0.379487179,0.056410256,0.569230769,0,0.017209119
25817,64,24303,8,5,0,10,0,23,1,2,10,1,4,18,nowin,loss,bust,plbust,0,10,13,187,0.363636364,0.048128342,0.631016043,0,0.027594885
25818,68,24304,8,10,0,0,0,18,3,9,10,0,0,22,nowin,win,dlbust,bust,20,0,18,205,0.434146341,0.029268293,0.6,2,0.59483189
25819,57,24304,11,10,0,0,0,21,3,9,10,0,0,22,win,win,dlbust,bust,25,0,21,192,0.46875,0.052083333,0.59375,3,0.907001181
25820,79,24304,10,5,0,0,0,15,3,9,10,0,0,22,nowin,win,dlbust,bust,20,0,15,211,0.436018957,0.028436019,0.672985782,2,0.650131054
25821,101,24304,9,8,0,0,0,17,3,9,10,0,0,22,nowin,win,dlbust,bust,20,0,17,205,0.424390244,0.068292683,0.63902439,2,0.614740646
25822,42,24304,7,2,3,10,0,22,3,9,10,0,0,22,nowin,loss,bust,plbust,0,10,9,212,0.443396226,0.051886792,0.570754717,1,0.309181312
25823,40,24304,10,4,0,0,0,14,3,9,10,0,0,22,nowin,win,dlbust,bust,20,0,14,196,0.367346939,0.030612245,0.617346939,0,0.025358183
25824,99,24305,9,2,3,0,0,14,6,11,0,0,0,17,nowin,loss,beat,dlwin,0,10,11,207,0.47826087,0.062801932,0.637681159,3,0.961418446
25825,18,24305,5,10,0,0,0,15,6,11,0,0,0,17,nowin,loss,beat,dlwin,0,10,15,182,0.461538462,0.043956044,0.587912088,3,0.892649374
25826,76,24305,9,7,0,0,0,16,6,11,0,0,0,17,nowin,loss,beat,dlwin,0,10,16,189,0.534391534,0.079365079,0.608465608,3,1
25827,13,24305,10,4,0,0,0,14,6,11,0,0,0,17,nowin,loss,beat,dlwin,0,10,14,206,0.417475728,0.063106796,0.621359223,2,0.59555479
25828,141,24305,10,8,0,0,0,18,6,11,0,0,0,17,nowin,win,plwin,beat,20,0,18,202,0.420792079,0.074257426,0.564356436,0,0.028377851
25829,134,24305,10,10,0,0,0,20,6,11,0,0,0,17,nowin,win,plwin,beat,20,0,20,185,0.443243243,0.021621622,0.545945946,1,0.296939509
25830,31,24306,10,5,0,10,0,25,10,10,0,0,0,20,nowin,loss,bust,plbust,0,10,15,188,0.473404255,0.058510638,0.515957447,1,0.300306557
25831,74,24306,9,5,0,8,0,22,10,10,0,0,0,20,nowin,loss,bust,plbust,0,10,14,209,0.411483254,0.04784689,0.531100478,0,0.017448125
25832,27,24306,10,10,0,0,0,20,10,10,0,0,0,20,nowin,push,push,push,10,0,20,178,0.370786517,0.016853933,0.573033708,0,0.015536309
25833,49,24306,5,7,0,6,0,18,10,10,0,0,0,20,nowin,loss,beat,dlwin,0,10,12,207,0.396135266,0.053140097,0.594202899,0,0.028306925
25834,127,24306,7,10,0,0,0,17,10,10,0,0,0,20,nowin,loss,beat,dlwin,0,10,17,201,0.402985075,0.029850746,0.60199005,0,0.032263937
25835,81,24306,10,10,0,0,0,20,10,10,0,0,0,20,nowin,push,push,push,10,0,20,182,0.395604396,0.043956044,0.60989011,2,0.567491261
25836,98,24307,11,4,6,0,0,21,10,7,0,0,0,17,nowin,win,plwin,beat,20,0,15,220,0.422727273,0.054545455,0.55,1,0.28664435
25837,87,24307,11,7,0,0,0,18,10,7,0,0,0,17,nowin,win,plwin,beat,20,0,18,202,0.405940594,0.054455446,0.628712871,2,0.590599801
25838,9,24307,8,10,0,0,0,18,10,7,0,0,0,17,nowin,win,plwin,beat,20,0,18,194,0.37628866,0.015463918,0.541237113,0,0.009396796
25839,115,24307,10,8,0,0,0,18,10,7,0,0,0,17,nowin,win,plwin,beat,20,0,18,194,0.427835052,0.041237113,0.592783505,2,0.583863602
25840,61,24307,7,9,0,10,0,26,10,7,0,0,0,17,nowin,loss,bust,plbust,0,10,16,194,0.427835052,0.077319588,0.603092784,2,0.591437139
25841,146,24307,8,5,0,4,0,17,10,7,0,0,0,17,nowin,push,push,push,10,0,13,221,0.43438914,0.040723982,0.542986425,1,0.290190091
25842,16,24308,7,10,0,0,0,17,5,3,10,0,0,18,nowin,loss,beat,dlwin,0,10,17,220,0.427272727,0.081818182,0.6,2,0.588660176
25843,38,24308,8,5,0,0,0,13,5,3,10,0,0,18,nowin,loss,beat,dlwin,0,10,13,202,0.361386139,0.03960396,0.564356436,0,0.010597953
25844,136,24308,4,1,10,0,0,15,5,3,10,0,0,18,nowin,loss,beat,dlwin,0,10,5,194,0.396907216,0.025773196,0.597938144,0,0.029452644
25845,23,24308,6,9,0,0,0,15,5,3,10,0,0,18,nowin,loss,beat,dlwin,0,10,15,208,0.427884615,0.0625,0.552884615,1,0.29114424
25846,146,24308,10,10,0,0,0,20,5,3,10,0,0,18,nowin,win,plwin,beat,20,0,20,221,0.43438914,0.040723982,0.542986425,1,0.290190091
25847,122,24308,2,10,0,0,0,12,5,3,10,0,0,18,nowin,loss,beat,dlwin,0,10,12,210,0.347619048,0.052380952,0.59047619,0,0.012873677
25848,108,24309,5,6,10,0,0,21,2,10,6,0,0,18,nowin,win,plwin,beat,20,0,11,193,0.435233161,0.056994819,0.559585492,1,0.298824795
25849,50,24309,2,10,0,4,0,16,2,10,6,0,0,18,nowin,loss,beat,dlwin,0,10,12,202,0.405940594,0.04950495,0.54950495,0,0.020296079
25850,28,24309,11,7,0,0,0,18,2,10,6,0,0,18,nowin,push,push,push,10,0,18,199,0.422110553,0.045226131,0.542713568,1,0.282706618
25851,45,24309,4,1,7,10,0,22,2,10,6,0,0,18,nowin,loss,bust,plbust,0,10,5,196,0.428571429,0.051020408,0.612244898,2,0.598821767
25852,40,24309,10,10,0,0,0,20,2,10,6,0,0,18,nowin,win,plwin,beat,20,0,20,196,0.367346939,0.030612245,0.617346939,0,0.025358183
25853,128,24309,10,2,0,10,0,22,2,10,6,0,0,18,nowin,loss,bust,plbust,0,10,12,227,0.356828194,0.052863436,0.577092511,0,0.012352564
25854,131,24310,10,4,0,10,0,24,10,6,4,0,0,20,nowin,loss,bust,plbust,0,10,14,217,0.410138249,0.069124424,0.543778802,0,0.02015021
25855,87,24310,6,9,0,3,0,18,10,6,4,0,0,20,nowin,loss,beat,dlwin,0,10,15,202,0.405940594,0.054455446,0.628712871,2,0.590599801
25856,11,24310,8,4,0,10,0,22,10,6,4,0,0,20,nowin,loss,bust,plbust,0,10,12,236,0.457627119,0.016949153,0.588983051,3,0.889015813
25857,113,24310,3,7,5,2,0,17,10,6,4,0,0,20,nowin,loss,beat,dlwin,0,10,10,199,0.407035176,0.055276382,0.668341709,2,0.620695264
25858,94,24310,6,10,0,9,0,25,10,6,4,0,0,20,nowin,loss,bust,plbust,0,10,16,183,0.43715847,0.043715847,0.540983607,1,0.290866892
25859,57,24310,6,3,11,0,0,20,10,6,4,0,0,20,nowin,push,push,push,10,0,9,192,0.46875,0.052083333,0.59375,3,0.907001181
25860,46,24311,2,10,0,2,2,16,7,9,5,0,0,21,nowin,loss,beat,dlwin,0,10,12,186,0.403225806,0.048387097,0.591397849,0,0.029742194
25861,52,24311,8,10,0,0,0,18,7,9,5,0,0,21,nowin,loss,beat,dlwin,0,10,18,217,0.414746544,0.02764977,0.599078341,2,0.576736024
25862,15,24311,6,10,0,10,0,26,7,9,5,0,0,21,nowin,loss,bust,plbust,0,10,16,212,0.410377358,0.051886792,0.561320755,0,0.024517408
25863,109,24311,11,10,0,0,0,21,7,9,5,0,0,21,win,push,push,push,10,0,21,221,0.461538462,0.058823529,0.597285068,3,0.901830309
25864,140,24311,3,5,5,10,0,23,7,9,5,0,0,21,nowin,loss,bust,plbust,0,10,8,210,0.466666667,0.023809524,0.604761905,3,0.915293335
25865,56,24311,10,8,0,0,0,18,7,9,5,0,0,21,nowin,loss,beat,dlwin,0,10,18,175,0.4,0.057142857,0.582857143,0,0.026685297
25866,73,24312,10,10,0,0,0,20,6,2,10,0,0,18,nowin,win,plwin,beat,20,0,20,181,0.375690608,0.011049724,0.596685083,0,0.022795773
25867,72,24312,10,10,0,0,0,20,6,2,10,0,0,18,nowin,win,plwin,beat,20,0,20,185,0.394594595,0.032432432,0.508108108,0,0.006763115
25868,34,24312,6,6,0,0,0,12,6,2,10,0,0,18,nowin,loss,beat,dlwin,0,10,12,202,0.5,0.079207921,0.618811881,3,0.968961434
25869,147,24312,10,2,0,0,0,12,6,2,10,0,0,18,nowin,loss,beat,dlwin,0,10,12,205,0.380487805,0.014634146,0.536585366,0,0.00951447
25870,107,24312,8,10,0,0,0,18,6,2,10,0,0,18,nowin,push,push,push,10,0,18,218,0.444954128,0.073394495,0.600917431,2,0.605210014
25871,115,24312,8,8,0,0,0,16,6,2,10,0,0,18,nowin,loss,beat,dlwin,0,10,16,194,0.427835052,0.041237113,0.592783505,2,0.583863602
25872,69,24313,6,9,0,6,0,21,8,7,6,0,0,21,nowin,push,push,push,10,0,15,194,0.365979381,0.030927835,0.515463918,0,0
25873,123,24313,2,10,0,4,5,21,8,7,6,0,0,21,nowin,push,push,push,10,0,12,205,0.43902439,0.034146341,0.614634146,2,0.609962544
25874,76,24313,6,7,0,10,0,23,8,7,6,0,0,21,nowin,loss,bust,plbust,0,10,13,189,0.534391534,0.079365079,0.608465608,3,1
25875,135,24313,10,2,0,9,0,21,8,7,6,0,0,21,nowin,push,push,push,10,0,12,179,0.391061453,0.067039106,0.586592179,0,0.024924662
25876,114,24313,10,2,0,9,0,21,8,7,6,0,0,21,nowin,push,push,push,10,0,12,198,0.47979798,0.025252525,0.611111111,3,0.937232995
25877,36,24313,2,5,5,8,0,20,8,7,6,0,0,21,nowin,loss,beat,dlwin,0,10,7,229,0.445414847,0.056768559,0.655021834,2,0.645370571
25878,25,24314,7,6,0,7,0,20,10,10,0,0,0,20,nowin,push,push,push,10,0,13,190,0.463157895,0.063157895,0.536842105,1,0.304401563
25879,115,24314,7,10,0,0,0,17,10,10,0,0,0,20,nowin,loss,beat,dlwin,0,10,17,194,0.427835052,0.041237113,0.592783505,2,0.583863602
25880,38,24314,6,7,0,3,9,25,10,10,0,0,0,20,nowin,loss,bust,plbust,0,10,13,202,0.361386139,0.03960396,0.564356436,0,0.010597953
25881,110,24314,10,7,0,0,0,17,10,10,0,0,0,20,nowin,loss,beat,dlwin,0,10,17,192,0.416666667,0.046875,0.557291667,0,0.025413132
25882,30,24314,9,2,8,0,0,19,10,10,0,0,0,20,nowin,loss,beat,dlwin,0,10,11,206,0.393203883,0.033980583,0.601941748,0,0.029324648
25883,24,24314,7,10,0,0,0,17,10,10,0,0,0,20,nowin,loss,beat,dlwin,0,10,17,207,0.458937198,0.048309179,0.570048309,1,0.318138014
25884,1,24315,10,6,0,0,0,16,6,2,8,10,0,26,nowin,win,dlbust,bust,20,0,16,197,0.406091371,0.025380711,0.649746193,2,0.606186955
25885,127,24315,4,10,0,0,0,14,6,2,8,10,0,26,nowin,win,dlbust,bust,20,0,14,201,0.402985075,0.029850746,0.60199005,0,0.032263937
25886,108,24315,11,10,0,0,0,21,6,2,8,10,0,26,win,win,dlbust,bust,25,0,21,193,0.435233161,0.056994819,0.559585492,1,0.298824795
25887,44,24315,7,10,0,0,0,17,6,2,8,10,0,26,nowin,win,dlbust,bust,20,0,17,219,0.433789954,0.050228311,0.534246575,1,0.285551035
25888,118,24315,1,6,9,0,0,16,6,2,8,10,0,26,nowin,win,dlbust,bust,20,0,7,216,0.393518519,0.037037037,0.555555556,0,0.018059873
25889,150,24315,9,3,0,0,0,12,6,2,8,10,0,26,nowin,win,dlbust,bust,20,0,12,192,0.401041667,0.036458333,0.567708333,0,0.023287458
25890,134,24316,2,8,6,0,0,16,3,2,4,2,10,21,nowin,loss,beat,dlwin,0,10,10,185,0.443243243,0.021621622,0.545945946,1,0.296939509
25891,58,24316,5,8,0,0,0,13,3,2,4,2,10,21,nowin,loss,beat,dlwin,0,10,13,195,0.430769231,0.041025641,0.584615385,2,0.580497586
25892,68,24316,11,10,0,0,0,21,3,2,4,2,10,21,win,push,push,push,10,0,21,205,0.434146341,0.029268293,0.6,2,0.59483189
25893,102,24316,10,2,0,2,0,14,3,2,4,2,10,21,nowin,loss,beat,dlwin,0,10,12,192,0.338541667,0.046875,0.5625,0,0.003306118
25894,122,24316,5,10,0,0,0,15,3,2,4,2,10,21,nowin,loss,beat,dlwin,0,10,15,210,0.347619048,0.052380952,0.59047619,0,0.012873677
25895,10,24316,2,5,6,0,0,13,3,2,4,2,10,21,nowin,loss,beat,dlwin,0,10,7,191,0.413612565,0.057591623,0.596858639,2,0.574087175
25896,82,24317,8,8,0,0,0,16,6,5,5,1,0,17,nowin,loss,beat,dlwin,0,10,16,225,0.408888889,0.075555556,0.577777778,0,0.028101874
25897,113,24317,3,10,0,0,0,13,6,5,5,1,0,17,nowin,loss,beat,dlwin,0,10,13,199,0.407035176,0.055276382,0.668341709,2,0.620695264
25898,109,24317,10,10,0,0,0,20,6,5,5,1,0,17,nowin,win,plwin,beat,20,0,20,221,0.461538462,0.058823529,0.597285068,3,0.901830309
25899,26,24317,9,8,0,0,0,17,6,5,5,1,0,17,nowin,push,push,push,10,0,17,203,0.463054187,0.0591133,0.541871921,1,0.306802864
25900,53,24317,10,5,0,0,0,15,6,5,5,1,0,17,nowin,loss,beat,dlwin,0,10,15,250,0.372,0.064,0.564,0,0.013687345
25901,2,24317,10,4,0,0,0,14,6,5,5,1,0,17,nowin,loss,beat,dlwin,0,10,14,200,0.445,0.035,0.64,2,0.633962549
25902,57,24318,10,9,0,0,0,19,10,10,0,0,0,20,nowin,loss,beat,dlwin,0,10,19,192,0.46875,0.052083333,0.59375,3,0.907001181
25903,15,24318,8,3,2,7,0,20,10,10,0,0,0,20,nowin,push,push,push,10,0,11,212,0.410377358,0.051886792,0.561320755,0,0.024517408
25904,32,24318,11,2,1,4,0,18,10,10,0,0,0,20,nowin,loss,beat,dlwin,0,10,13,189,0.391534392,0.037037037,0.53968254,0,0.013579086
25905,125,24318,6,10,0,7,0,23,10,10,0,0,0,20,nowin,loss,bust,plbust,0,10,16,219,0.438356164,0.050228311,0.575342466,1,0.308411257
25906,38,24318,10,7,0,0,0,17,10,10,0,0,0,20,nowin,loss,beat,dlwin,0,10,17,202,0.361386139,0.03960396,0.564356436,0,0.010597953
25907,9,24318,10,10,0,0,0,20,10,10,0,0,0,20,nowin,push,push,push,10,0,20,194,0.37628866,0.015463918,0.541237113,0,0.009396796
25908,32,24319,7,3,3,10,0,23,10,10,0,0,0,20,nowin,loss,bust,plbust,0,10,10,189,0.391534392,0.037037037,0.53968254,0,0.013579086
25909,73,24319,10,10,0,0,0,20,10,10,0,0,0,20,nowin,push,push,push,10,0,20,181,0.375690608,0.011049724,0.596685083,0,0.022795773
25910,15,24319,3,3,7,10,0,23,10,10,0,0,0,20,nowin,loss,bust,plbust,0,10,6,212,0.410377358,0.051886792,0.561320755,0,0.024517408
25911,105,24319,4,4,4,3,10,25,10,10,0,0,0,20,nowin,loss,bust,plbust,0,10,8,198,0.414141414,0.070707071,0.590909091,0,0.032889494
25912,103,24319,6,5,7,0,0,18,10,10,0,0,0,20,nowin,loss,beat,dlwin,0,10,11,203,0.379310345,0.064039409,0.551724138,0,0.012869209
25913,62,24319,10,10,0,0,0,20,10,10,0,0,0,20,nowin,push,push,push,10,0,20,178,0.370786517,0.028089888,0.54494382,0,0.008657722
25914,2,24320,10,3,0,8,0,21,11,10,0,0,0,21,nowin,push,push,push,10,0,13,200,0.445,0.035,0.64,2,0.633962549
25915,34,24320,5,10,0,4,0,19,11,10,0,0,0,21,nowin,loss,beat,dlwin,0,10,15,202,0.5,0.079207921,0.618811881,3,0.968961434
25916,32,24320,7,10,0,0,0,17,11,10,0,0,0,21,nowin,loss,beat,dlwin,0,10,17,189,0.391534392,0.037037037,0.53968254,0,0.013579086
25917,13,24320,4,6,6,5,0,21,11,10,0,0,0,21,nowin,push,push,push,10,0,10,206,0.417475728,0.063106796,0.621359223,2,0.59555479
25918,67,24320,10,8,0,0,0,18,11,10,0,0,0,21,nowin,loss,beat,dlwin,0,10,18,195,0.369230769,0.041025641,0.569230769,0,0.014139427
25919,36,24320,2,7,10,0,0,19,11,10,0,0,0,21,nowin,loss,beat,dlwin,0,10,9,229,0.445414847,0.056768559,0.655021834,2,0.645370571
25920,85,24321,11,7,0,0,0,18,11,10,0,0,0,21,nowin,loss,beat,dlwin,0,10,18,195,0.41025641,0.066666667,0.594871795,0,0.03269711
25921,137,24321,10,8,0,0,0,18,11,10,0,0,0,21,nowin,loss,beat,dlwin,0,10,18,194,0.417525773,0.046391753,0.536082474,1,0.276714602
25922,12,24321,10,7,0,0,0,17,11,10,0,0,0,21,nowin,loss,beat,dlwin,0,10,17,189,0.470899471,0.015873016,0.613756614,3,0.929171178
25923,22,24321,8,8,0,2,0,18,11,10,0,0,0,21,nowin,loss,beat,dlwin,0,10,16,187,0.481283422,0.042780749,0.577540107,3,0.906128176
25924,131,24321,11,1,5,0,0,17,11,10,0,0,0,21,nowin,loss,beat,dlwin,0,10,12,217,0.410138249,0.069124424,0.543778802,0,0.02015021
25925,89,24321,10,6,0,7,0,23,11,10,0,0,0,21,nowin,loss,bust,plbust,0,10,16,212,0.537735849,0.047169811,0.594339623,3,0.990167191
25926,130,24322,10,3,0,2,4,19,9,6,4,0,0,19,nowin,push,push,push,10,0,13,219,0.410958904,0.03652968,0.566210046,0,0.025888739
25927,108,24322,10,2,0,7,0,19,9,6,4,0,0,19,nowin,push,push,push,10,0,12,193,0.435233161,0.056994819,0.559585492,1,0.298824795
25928,47,24322,6,10,0,2,0,18,9,6,4,0,0,19,nowin,loss,beat,dlwin,0,10,16,210,0.438095238,0.057142857,0.623809524,2,0.615868808
25929,19,24322,8,11,0,0,0,19,9,6,4,0,0,19,nowin,push,push,push,10,0,19,237,0.41350211,0.054852321,0.628691983,2,0.597373826
25930,74,24322,1,5,7,5,0,18,9,6,4,0,0,19,nowin,loss,beat,dlwin,0,10,6,209,0.411483254,0.04784689,0.531100478,0,0.017448125
25931,52,24322,6,10,0,7,0,23,9,6,4,0,0,19,nowin,loss,bust,plbust,0,10,16,217,0.414746544,0.02764977,0.599078341,2,0.576736024
25932,131,24323,4,5,10,0,0,19,11,10,0,0,0,21,nowin,loss,beat,dlwin,0,10,9,217,0.410138249,0.069124424,0.543778802,0,0.02015021
25933,2,24323,8,5,0,6,0,19,11,10,0,0,0,21,nowin,loss,beat,dlwin,0,10,13,200,0.445,0.035,0.64,2,0.633962549
25934,16,24323,10,8,0,0,0,18,11,10,0,0,0,21,nowin,loss,beat,dlwin,0,10,18,220,0.427272727,0.081818182,0.6,2,0.588660176
25935,122,24323,8,6,0,10,0,24,11,10,0,0,0,21,nowin,loss,bust,plbust,0,10,14,210,0.347619048,0.052380952,0.59047619,0,0.012873677
25936,44,24323,10,10,0,0,0,20,11,10,0,0,0,21,nowin,loss,beat,dlwin,0,10,20,219,0.433789954,0.050228311,0.534246575,1,0.285551035
25937,50,24323,10,5,0,10,0,25,11,10,0,0,0,21,nowin,loss,bust,plbust,0,10,15,202,0.405940594,0.04950495,0.54950495,0,0.020296079
25938,140,24324,2,4,3,6,10,25,9,9,0,0,0,18,nowin,loss,bust,plbust,0,10,6,210,0.466666667,0.023809524,0.604761905,3,0.915293335
25939,36,24324,7,4,8,0,0,19,9,9,0,0,0,18,nowin,win,plwin,beat,20,0,11,229,0.445414847,0.056768559,0.655021834,2,0.645370571
25940,13,24324,10,10,0,0,0,20,9,9,0,0,0,18,nowin,win,plwin,beat,20,0,20,206,0.417475728,0.063106796,0.621359223,2,0.59555479
25941,11,24324,11,1,6,0,0,18,9,9,0,0,0,18,nowin,push,push,push,10,0,12,236,0.457627119,0.016949153,0.588983051,3,0.889015813
25942,139,24324,10,4,0,6,0,20,9,9,0,0,0,18,nowin,win,plwin,beat,20,0,14,192,0.380208333,0.036458333,0.59375,0,0.023429169
25943,59,24324,10,4,0,3,0,17,9,9,0,0,0,18,nowin,loss,beat,dlwin,0,10,14,228,0.429824561,0.048245614,0.543859649,1,0.287885446
25944,144,24325,9,10,0,0,0,19,8,10,0,0,0,18,nowin,win,plwin,beat,20,0,19,202,0.386138614,0.054455446,0.564356436,0,0.018006244
25945,31,24325,7,8,0,7,0,22,8,10,0,0,0,18,nowin,loss,bust,plbust,0,10,15,188,0.473404255,0.058510638,0.515957447,1,0.300306557
25946,70,24325,6,1,10,0,0,17,8,10,0,0,0,18,nowin,loss,beat,dlwin,0,10,7,228,0.385964912,0.039473684,0.557017544,0,0.016157125
25947,19,24325,5,3,9,0,0,17,8,10,0,0,0,18,nowin,loss,beat,dlwin,0,10,8,237,0.41350211,0.054852321,0.628691983,2,0.597373826
25948,111,24325,10,9,0,0,0,19,8,10,0,0,0,18,nowin,win,plwin,beat,20,0,19,180,0.433333333,0.055555556,0.611111111,2,0.602264492
25949,60,24325,10,10,0,0,0,20,8,10,0,0,0,18,nowin,win,plwin,beat,20,0,20,227,0.418502203,0.022026432,0.559471366,0,0.026496258
25950,25,24326,3,4,5,1,10,23,10,6,3,0,0,19,nowin,loss,bust,plbust,0,10,7,190,0.463157895,0.063157895,0.536842105,1,0.304401563
25951,45,24326,9,5,0,8,0,22,10,6,3,0,0,19,nowin,loss,bust,plbust,0,10,14,196,0.428571429,0.051020408,0.612244898,2,0.598821767
25952,115,24326,10,10,0,0,0,20,10,6,3,0,0,19,nowin,win,plwin,beat,20,0,20,194,0.427835052,0.041237113,0.592783505,2,0.583863602
25953,103,24326,11,10,0,0,0,21,10,6,3,0,0,19,win,win,plwin,beat,25,0,21,203,0.379310345,0.064039409,0.551724138,0,0.012869209
25954,126,24326,10,7,0,0,0,17,10,6,3,0,0,19,nowin,loss,beat,dlwin,0,10,17,188,0.457446809,0.074468085,0.60106383,3,0.900633203
25955,60,24326,5,2,10,0,0,17,10,6,3,0,0,19,nowin,loss,beat,dlwin,0,10,7,227,0.418502203,0.022026432,0.559471366,0,0.026496258
25956,22,24327,10,7,0,0,0,17,10,3,1,1,10,25,nowin,win,dlbust,bust,20,0,17,187,0.481283422,0.042780749,0.577540107,3,0.906128176
25957,47,24327,3,6,3,9,0,21,10,3,1,1,10,25,nowin,win,dlbust,bust,20,0,9,210,0.438095238,0.057142857,0.623809524,2,0.615868808
25958,140,24327,2,10,0,2,10,24,10,3,1,1,10,25,nowin,loss,bust,plbust,0,10,12,210,0.466666667,0.023809524,0.604761905,3,0.915293335
25959,93,24327,4,7,9,0,0,20,10,3,1,1,10,25,nowin,win,dlbust,bust,20,0,11,175,0.485714286,0.051428571,0.548571429,1,0.323648091
25960,118,24327,2,6,8,10,0,26,10,3,1,1,10,25,nowin,loss,bust,plbust,0,10,8,216,0.393518519,0.037037037,0.555555556,0,0.018059873
25961,98,24327,10,10,0,0,0,20,10,3,1,1,10,25,nowin,win,dlbust,bust,20,0,20,220,0.422727273,0.054545455,0.55,1,0.28664435
25962,72,24328,10,10,0,0,0,20,2,4,4,5,8,23,nowin,win,dlbust,bust,20,0,20,185,0.394594595,0.032432432,0.508108108,0,0.006763115
25963,59,24328,8,6,0,0,0,14,2,4,4,5,8,23,nowin,win,dlbust,bust,20,0,14,228,0.429824561,0.048245614,0.543859649,1,0.287885446
25964,119,24328,5,6,6,0,0,17,2,4,4,5,8,23,nowin,win,dlbust,bust,20,0,11,190,0.405263158,0.068421053,0.515789474,0,0.011837158
25965,82,24328,7,11,0,0,0,18,2,4,4,5,8,23,nowin,win,dlbust,bust,20,0,18,225,0.408888889,0.075555556,0.577777778,0,0.028101874
25966,51,24328,4,6,2,7,0,19,2,4,4,5,8,23,nowin,win,dlbust,bust,20,0,10,189,0.529100529,0.068783069,0.608465608,3,0.993665715
25967,22,24328,10,10,0,0,0,20,2,4,4,5,8,23,nowin,win,dlbust,bust,20,0,20,187,0.481283422,0.042780749,0.577540107,3,0.906128176
25968,98,24329,4,10,0,0,0,14,3,8,10,0,0,21,nowin,loss,beat,dlwin,0,10,14,220,0.422727273,0.054545455,0.55,1,0.28664435
25969,93,24329,6,7,0,0,0,13,3,8,10,0,0,21,nowin,loss,beat,dlwin,0,10,13,175,0.485714286,0.051428571,0.548571429,1,0.323648091
25970,31,24329,10,10,0,0,0,20,3,8,10,0,0,21,nowin,loss,beat,dlwin,0,10,20,188,0.473404255,0.058510638,0.515957447,1,0.300306557
25971,142,24329,10,10,0,0,0,20,3,8,10,0,0,21,nowin,loss,beat,dlwin,0,10,20,211,0.417061611,0.047393365,0.526066351,1,0.271531309
25972,4,24329,6,3,10,0,0,19,3,8,10,0,0,21,nowin,loss,beat,dlwin,0,10,9,217,0.460829493,0.036866359,0.562211982,1,0.315432839
25973,45,24329,11,9,0,0,0,20,3,8,10,0,0,21,nowin,loss,beat,dlwin,0,10,20,196,0.428571429,0.051020408,0.612244898,2,0.598821767
25974,7,24330,7,4,6,0,0,17,5,8,10,0,0,23,nowin,win,dlbust,bust,20,0,11,183,0.442622951,0.06010929,0.62295082,2,0.619303341
25975,133,24330,10,5,0,0,0,15,5,8,10,0,0,23,nowin,win,dlbust,bust,20,0,15,201,0.47761194,0.064676617,0.611940299,3,0.935428111
25976,33,24330,5,10,0,0,0,15,5,8,10,0,0,23,nowin,win,dlbust,bust,20,0,15,192,0.4375,0.057291667,0.625,2,0.616208916
25977,87,24330,5,10,0,0,0,15,5,8,10,0,0,23,nowin,win,dlbust,bust,20,0,15,202,0.405940594,0.054455446,0.628712871,2,0.590599801
25978,108,24330,10,7,0,0,0,17,5,8,10,0,0,23,nowin,win,dlbust,bust,20,0,17,193,0.435233161,0.056994819,0.559585492,1,0.298824795
25979,146,24330,9,9,0,0,0,18,5,8,10,0,0,23,nowin,win,dlbust,bust,20,0,18,221,0.43438914,0.040723982,0.542986425,1,0.290190091
25980,144,24331,10,2,0,7,0,19,11,6,0,0,0,17,nowin,win,plwin,beat,20,0,12,202,0.386138614,0.054455446,0.564356436,0,0.018006244
25981,77,24331,10,9,0,0,0,19,11,6,0,0,0,17,nowin,win,plwin,beat,20,0,19,200,0.455,0.04,0.62,3,0.916252116
25982,47,24331,4,5,5,10,0,24,11,6,0,0,0,17,nowin,loss,bust,plbust,0,10,9,210,0.438095238,0.057142857,0.623809524,2,0.615868808
25983,67,24331,6,10,0,8,0,24,11,6,0,0,0,17,nowin,loss,bust,plbust,0,10,16,195,0.369230769,0.041025641,0.569230769,0,0.014139427
25984,98,24331,11,10,0,0,0,21,11,6,0,0,0,17,win,win,plwin,beat,25,0,21,220,0.422727273,0.054545455,0.55,1,0.28664435
25985,126,24331,10,10,0,0,0,20,11,6,0,0,0,17,nowin,win,plwin,beat,20,0,20,188,0.457446809,0.074468085,0.60106383,3,0.900633203
25986,11,24332,10,10,0,0,0,20,2,10,6,0,0,18,nowin,win,plwin,beat,20,0,20,236,0.457627119,0.016949153,0.588983051,3,0.889015813
25987,144,24332,5,10,0,0,0,15,2,10,6,0,0,18,nowin,loss,beat,dlwin,0,10,15,202,0.386138614,0.054455446,0.564356436,0,0.018006244
25988,95,24332,4,9,0,0,0,13,2,10,6,0,0,18,nowin,loss,beat,dlwin,0,10,13,218,0.412844037,0.04587156,0.559633028,0,0.024842385
25989,23,24332,10,8,0,0,0,18,2,10,6,0,0,18,nowin,push,push,push,10,0,18,208,0.427884615,0.0625,0.552884615,1,0.29114424
25990,145,24332,6,8,0,0,0,14,2,10,6,0,0,18,nowin,loss,beat,dlwin,0,10,14,188,0.441489362,0.031914894,0.622340426,2,0.617837093
25991,58,24332,10,8,0,0,0,18,2,10,6,0,0,18,nowin,push,push,push,10,0,18,195,0.430769231,0.041025641,0.584615385,2,0.580497586
25992,96,24333,8,10,0,0,0,18,3,10,9,0,0,22,nowin,win,dlbust,bust,20,0,18,190,0.468421053,0.057894737,0.584210526,3,0.897263354
25993,22,24333,3,7,10,0,0,20,3,10,9,0,0,22,nowin,win,dlbust,bust,20,0,10,187,0.481283422,0.042780749,0.577540107,3,0.906128176
25994,113,24333,7,6,0,0,0,13,3,10,9,0,0,22,nowin,win,dlbust,bust,20,0,13,199,0.407035176,0.055276382,0.668341709,2,0.620695264
25995,24,24333,3,8,10,0,0,21,3,10,9,0,0,22,nowin,win,dlbust,bust,20,0,11,207,0.458937198,0.048309179,0.570048309,1,0.318138014
25996,81,24333,5,7,0,3,0,15,3,10,9,0,0,22,nowin,win,dlbust,bust,20,0,12,182,0.395604396,0.043956044,0.60989011,2,0.567491261
25997,65,24333,8,11,0,0,0,19,3,10,9,0,0,22,nowin,win,dlbust,bust,20,0,19,203,0.492610837,0.054187192,0.571428571,3,0.913702814
25998,133,24334,4,10,0,1,6,21,7,9,10,0,0,26,nowin,win,dlbust,bust,20,0,14,201,0.47761194,0.064676617,0.611940299,3,0.935428111
25999,62,24334,11,8,0,0,0,19,7,9,10,0,0,26,nowin,win,dlbust,bust,20,0,19,178,0.370786517,0.028089888,0.54494382,0,0.008657722
26000,79,24334,10,10,0,0,0,20,7,9,10,0,0,26,nowin,win,dlbust,bust,20,0,20,211,0.436018957,0.028436019,0.672985782,2,0.650131054
26001,54,24334,10,4,0,1,1,16,7,9,10,0,0,26,nowin,win,dlbust,bust,20,0,14,185,0.437837838,0.032432432,0.556756757,1,0.29899854
26002,40,24334,8,9,0,0,0,17,7,9,10,0,0,26,nowin,win,dlbust,bust,20,0,17,196,0.367346939,0.030612245,0.617346939,0,0.025358183
26003,132,24334,4,7,9,0,0,20,7,9,10,0,0,26,nowin,win,dlbust,bust,20,0,11,194,0.412371134,0.036082474,0.649484536,2,0.611633238
26004,8,24335,7,7,0,7,0,21,8,7,10,0,0,25,nowin,win,dlbust,bust,20,0,14,181,0.44198895,0.071823204,0.596685083,2,0.599438402
26005,102,24335,7,11,0,0,0,18,8,7,10,0,0,25,nowin,win,dlbust,bust,20,0,18,192,0.338541667,0.046875,0.5625,0,0.003306118
26006,29,24335,2,10,0,3,8,23,8,7,10,0,0,25,nowin,loss,bust,plbust,0,10,12,189,0.44973545,0.058201058,0.544973545,1,0.300349439
26007,92,24335,6,10,0,9,0,25,8,7,10,0,0,25,nowin,loss,bust,plbust,0,10,16,186,0.446236559,0.059139785,0.564516129,1,0.307826125
26008,38,24335,2,3,10,5,0,20,8,7,10,0,0,25,nowin,win,dlbust,bust,20,0,5,202,0.361386139,0.03960396,0.564356436,0,0.010597953
26009,15,24335,10,6,0,10,0,26,8,7,10,0,0,25,nowin,loss,bust,plbust,0,10,16,212,0.410377358,0.051886792,0.561320755,0,0.024517408
26010,2,24336,2,4,10,8,0,24,10,7,0,0,0,17,nowin,loss,bust,plbust,0,10,6,200,0.445,0.035,0.64,2,0.633962549
26011,31,24336,10,10,0,0,0,20,10,7,0,0,0,17,nowin,win,plwin,beat,20,0,20,188,0.473404255,0.058510638,0.515957447,1,0.300306557
26012,57,24336,10,9,0,0,0,19,10,7,0,0,0,17,nowin,win,plwin,beat,20,0,19,192,0.46875,0.052083333,0.59375,3,0.907001181
26013,90,24336,6,10,0,5,0,21,10,7,0,0,0,17,nowin,win,plwin,beat,20,0,16,201,0.447761194,0.049751244,0.60199005,3,0.889945023
26014,114,24336,7,10,0,0,0,17,10,7,0,0,0,17,nowin,push,push,push,10,0,17,198,0.47979798,0.025252525,0.611111111,3,0.937232995
26015,134,24336,7,11,0,0,0,18,10,7,0,0,0,17,nowin,win,plwin,beat,20,0,18,185,0.443243243,0.021621622,0.545945946,1,0.296939509
26016,51,24337,11,3,7,0,0,21,9,2,1,10,0,22,nowin,win,dlbust,bust,20,0,14,189,0.529100529,0.068783069,0.608465608,3,0.993665715
26017,29,24337,5,10,0,2,0,17,9,2,1,10,0,22,nowin,win,dlbust,bust,20,0,15,189,0.44973545,0.058201058,0.544973545,1,0.300349439
26018,124,24337,6,9,0,9,0,24,9,2,1,10,0,22,nowin,loss,bust,plbust,0,10,15,202,0.47029703,0.064356436,0.584158416,3,0.899458193
26019,26,24337,1,4,7,2,9,23,9,2,1,10,0,22,nowin,loss,bust,plbust,0,10,5,203,0.463054187,0.0591133,0.541871921,1,0.306802864
26020,81,24337,10,5,0,3,0,18,9,2,1,10,0,22,nowin,win,dlbust,bust,20,0,15,182,0.395604396,0.043956044,0.60989011,2,0.567491261
26021,47,24337,10,8,0,0,0,18,9,2,1,10,0,22,nowin,win,dlbust,bust,20,0,18,210,0.438095238,0.057142857,0.623809524,2,0.615868808
26022,53,24338,11,10,0,0,0,21,8,8,5,0,0,21,win,push,push,push,10,0,21,250,0.372,0.064,0.564,0,0.013687345
26023,52,24338,2,8,10,0,0,20,8,8,5,0,0,21,nowin,loss,beat,dlwin,0,10,10,217,0.414746544,0.02764977,0.599078341,2,0.576736024
26024,55,24338,8,10,0,0,0,18,8,8,5,0,0,21,nowin,loss,beat,dlwin,0,10,18,191,0.371727749,0.057591623,0.54973822,0,0.01011347
26025,62,24338,6,5,7,0,0,18,8,8,5,0,0,21,nowin,loss,beat,dlwin,0,10,11,178,0.370786517,0.028089888,0.54494382,0,0.008657722
26026,110,24338,3,10,0,10,0,23,8,8,5,0,0,21,nowin,loss,bust,plbust,0,10,13,192,0.416666667,0.046875,0.557291667,0,0.025413132
26027,10,24338,6,6,0,10,0,22,8,8,5,0,0,21,nowin,loss,bust,plbust,0,10,12,191,0.413612565,0.057591623,0.596858639,2,0.574087175
26028,61,24339,3,7,7,0,0,17,10,3,10,0,0,23,nowin,win,dlbust,bust,20,0,10,194,0.427835052,0.077319588,0.603092784,2,0.591437139
26029,65,24339,10,9,0,0,0,19,10,3,10,0,0,23,nowin,win,dlbust,bust,20,0,19,203,0.492610837,0.054187192,0.571428571,3,0.913702814
26030,5,24339,9,5,0,10,0,24,10,3,10,0,0,23,nowin,loss,bust,plbust,0,10,14,203,0.42364532,0.02955665,0.596059113,2,0.582508076
26031,89,24339,4,10,0,10,0,24,10,3,10,0,0,23,nowin,loss,bust,plbust,0,10,14,212,0.537735849,0.047169811,0.594339623,3,0.990167191
26032,97,24339,2,1,10,1,3,17,10,3,10,0,0,23,nowin,win,dlbust,bust,20,0,3,182,0.450549451,0.06043956,0.692307692,2,0.677372279
26033,57,24339,3,6,9,0,0,18,10,3,10,0,0,23,nowin,win,dlbust,bust,20,0,9,192,0.46875,0.052083333,0.59375,3,0.907001181
26034,149,24340,9,5,0,7,0,21,11,7,0,0,0,18,nowin,win,plwin,beat,20,0,14,225,0.457777778,0.057777778,0.648888889,2,0.651965595
26035,56,24340,11,9,0,0,0,20,11,7,0,0,0,18,nowin,win,plwin,beat,20,0,20,175,0.4,0.057142857,0.582857143,0,0.026685297
26036,144,24340,7,5,0,6,0,18,11,7,0,0,0,18,nowin,push,push,push,10,0,12,202,0.386138614,0.054455446,0.564356436,0,0.018006244
26037,8,24340,10,2,0,4,2,18,11,7,0,0,0,18,nowin,push,push,push,10,0,12,181,0.44198895,0.071823204,0.596685083,2,0.599438402
26038,137,24340,10,4,0,5,0,19,11,7,0,0,0,18,nowin,win,plwin,beat,20,0,14,194,0.417525773,0.046391753,0.536082474,1,0.276714602
26039,143,24340,10,11,0,0,0,21,11,7,0,0,0,18,win,win,plwin,beat,25,0,21,203,0.463054187,0.044334975,0.57635468,3,0.883143365
26040,67,24341,4,10,0,10,0,24,8,10,0,0,0,18,nowin,loss,bust,plbust,0,10,14,195,0.369230769,0.041025641,0.569230769,0,0.014139427
26041,3,24341,10,2,0,10,0,22,8,10,0,0,0,18,nowin,loss,bust,plbust,0,10,12,190,0.431578947,0.026315789,0.542105263,1,0.288076384
26042,125,24341,7,7,0,8,0,22,8,10,0,0,0,18,nowin,loss,bust,plbust,0,10,14,219,0.438356164,0.050228311,0.575342466,1,0.308411257
26043,134,24341,6,10,0,10,0,26,8,10,0,0,0,18,nowin,loss,bust,plbust,0,10,16,185,0.443243243,0.021621622,0.545945946,1,0.296939509
26044,128,24341,10,6,0,10,0,26,8,10,0,0,0,18,nowin,loss,bust,plbust,0,10,16,227,0.356828194,0.052863436,0.577092511,0,0.012352564
26045,42,24341,6,1,10,0,0,17,8,10,0,0,0,18,nowin,loss,beat,dlwin,0,10,7,212,0.443396226,0.051886792,0.570754717,1,0.309181312
26046,122,24342,1,5,8,0,0,14,3,9,4,2,0,18,nowin,loss,beat,dlwin,0,10,6,210,0.347619048,0.052380952,0.59047619,0,0.012873677
26047,12,24342,4,10,0,0,0,14,3,9,4,2,0,18,nowin,loss,beat,dlwin,0,10,14,189,0.470899471,0.015873016,0.613756614,3,0.929171178
26048,133,24342,4,11,1,0,0,16,3,9,4,2,0,18,nowin,loss,beat,dlwin,0,10,15,201,0.47761194,0.064676617,0.611940299,3,0.935428111
26049,51,24342,4,1,7,4,0,16,3,9,4,2,0,18,nowin,loss,beat,dlwin,0,10,5,189,0.529100529,0.068783069,0.608465608,3,0.993665715
26050,90,24342,5,10,0,0,0,15,3,9,4,2,0,18,nowin,loss,beat,dlwin,0,10,15,201,0.447761194,0.049751244,0.60199005,3,0.889945023
26051,143,24342,3,5,2,8,0,18,3,9,4,2,0,18,nowin,push,push,push,10,0,8,203,0.463054187,0.044334975,0.57635468,3,0.883143365
26052,110,24343,5,10,0,0,0,15,5,5,8,0,0,18,nowin,loss,beat,dlwin,0,10,15,192,0.416666667,0.046875,0.557291667,0,0.025413132
26053,67,24343,6,10,0,0,0,16,5,5,8,0,0,18,nowin,loss,beat,dlwin,0,10,16,195,0.369230769,0.041025641,0.569230769,0,0.014139427
26054,86,24343,10,10,0,0,0,20,5,5,8,0,0,18,nowin,win,plwin,beat,20,0,20,196,0.454081633,0.040816327,0.591836735,3,0.887566443
26055,121,24343,7,10,0,0,0,17,5,5,8,0,0,18,nowin,loss,beat,dlwin,0,10,17,195,0.456410256,0.025641026,0.512820513,1,0.288597791
26056,109,24343,2,2,10,0,0,14,5,5,8,0,0,18,nowin,loss,beat,dlwin,0,10,4,221,0.461538462,0.058823529,0.597285068,3,0.901830309
26057,134,24343,3,1,10,0,0,14,5,5,8,0,0,18,nowin,loss,beat,dlwin,0,10,4,185,0.443243243,0.021621622,0.545945946,1,0.296939509
26058,106,24344,11,9,0,0,0,20,4,9,5,0,0,18,nowin,win,plwin,beat,20,0,20,192,0.411458333,0.026041667,0.557291667,0,0.023854304
26059,100,24344,2,8,10,0,0,20,4,9,5,0,0,18,nowin,win,plwin,beat,20,0,10,190,0.452631579,0.036842105,0.594736842,3,0.888671154
26060,49,24344,7,10,0,0,0,17,4,9,5,0,0,18,nowin,loss,beat,dlwin,0,10,17,207,0.396135266,0.053140097,0.594202899,0,0.028306925
26061,89,24344,4,5,4,0,0,13,4,9,5,0,0,18,nowin,loss,beat,dlwin,0,10,9,212,0.537735849,0.047169811,0.594339623,3,0.990167191
26062,99,24344,8,10,0,0,0,18,4,9,5,0,0,18,nowin,push,push,push,10,0,18,207,0.47826087,0.062801932,0.637681159,3,0.961418446
26063,114,24344,5,6,10,0,0,21,4,9,5,0,0,18,nowin,win,plwin,beat,20,0,11,198,0.47979798,0.025252525,0.611111111,3,0.937232995
26064,124,24345,3,6,10,0,0,19,10,10,0,0,0,20,nowin,loss,beat,dlwin,0,10,9,202,0.47029703,0.064356436,0.584158416,3,0.899458193
26065,23,24345,4,11,2,0,0,17,10,10,0,0,0,20,nowin,loss,beat,dlwin,0,10,15,208,0.427884615,0.0625,0.552884615,1,0.29114424
26066,4,24345,10,8,0,0,0,18,10,10,0,0,0,20,nowin,loss,beat,dlwin,0,10,18,217,0.460829493,0.036866359,0.562211982,1,0.315432839
26067,139,24345,10,5,0,10,0,25,10,10,0,0,0,20,nowin,loss,bust,plbust,0,10,15,192,0.380208333,0.036458333,0.59375,0,0.023429169
26068,121,24345,10,5,0,9,0,24,10,10,0,0,0,20,nowin,loss,bust,plbust,0,10,15,195,0.456410256,0.025641026,0.512820513,1,0.288597791
26069,65,24345,10,9,0,0,0,19,10,10,0,0,0,20,nowin,loss,beat,dlwin,0,10,19,203,0.492610837,0.054187192,0.571428571,3,0.913702814
26070,126,24346,7,2,9,0,0,18,2,6,11,0,0,19,nowin,loss,beat,dlwin,0,10,9,188,0.457446809,0.074468085,0.60106383,3,0.900633203
26071,65,24346,10,5,0,0,0,15,2,6,11,0,0,19,nowin,loss,beat,dlwin,0,10,15,203,0.492610837,0.054187192,0.571428571,3,0.913702814
26072,121,24346,10,11,0,0,0,21,2,6,11,0,0,19,win,win,plwin,beat,25,0,21,195,0.456410256,0.025641026,0.512820513,1,0.288597791
26073,112,24346,6,10,0,0,0,16,2,6,11,0,0,19,nowin,loss,beat,dlwin,0,10,16,203,0.448275862,0.054187192,0.600985222,3,0.889576933
26074,145,24346,5,7,0,7,0,19,2,6,11,0,0,19,nowin,push,push,push,10,0,12,188,0.441489362,0.031914894,0.622340426,2,0.617837093
26075,130,24346,10,10,0,0,0,20,2,6,11,0,0,19,nowin,win,plwin,beat,20,0,20,219,0.410958904,0.03652968,0.566210046,0,0.025888739
26076,112,24347,10,4,0,10,0,24,10,10,0,0,0,20,nowin,loss,bust,plbust,0,10,14,203,0.448275862,0.054187192,0.600985222,3,0.889576933
26077,145,24347,8,10,0,0,0,18,10,10,0,0,0,20,nowin,loss,beat,dlwin,0,10,18,188,0.441489362,0.031914894,0.622340426,2,0.617837093
26078,150,24347,7,11,0,0,0,18,10,10,0,0,0,20,nowin,loss,beat,dlwin,0,10,18,192,0.401041667,0.036458333,0.567708333,0,0.023287458
26079,19,24347,10,10,0,0,0,20,10,10,0,0,0,20,nowin,push,push,push,10,0,20,237,0.41350211,0.054852321,0.628691983,2,0.597373826
26080,5,24347,4,1,8,10,0,23,10,10,0,0,0,20,nowin,loss,bust,plbust,0,10,5,203,0.42364532,0.02955665,0.596059113,2,0.582508076
26081,8,24347,10,3,0,7,0,20,10,10,0,0,0,20,nowin,push,push,push,10,0,13,181,0.44198895,0.071823204,0.596685083,2,0.599438402
26082,133,24348,10,11,0,0,0,21,10,3,10,0,0,23,win,win,dlbust,bust,25,0,21,201,0.47761194,0.064676617,0.611940299,3,0.935428111
26083,140,24348,11,4,5,0,0,20,10,3,10,0,0,23,nowin,win,dlbust,bust,20,0,15,210,0.466666667,0.023809524,0.604761905,3,0.915293335
26084,28,24348,10,10,0,0,0,20,10,3,10,0,0,23,nowin,win,dlbust,bust,20,0,20,199,0.422110553,0.045226131,0.542713568,1,0.282706618
26085,111,24348,6,10,0,7,0,23,10,3,10,0,0,23,nowin,loss,bust,plbust,0,10,16,180,0.433333333,0.055555556,0.611111111,2,0.602264492
26086,98,24348,10,3,0,4,0,17,10,3,10,0,0,23,nowin,win,dlbust,bust,20,0,13,220,0.422727273,0.054545455,0.55,1,0.28664435
26087,68,24348,3,10,0,10,0,23,10,3,10,0,0,23,nowin,loss,bust,plbust,0,10,13,205,0.434146341,0.029268293,0.6,2,0.59483189
26088,80,24349,7,5,0,3,4,19,10,2,10,0,0,22,nowin,win,dlbust,bust,20,0,12,186,0.419354839,0.059139785,0.623655914,2,0.59892924
26089,103,24349,7,10,0,0,0,17,10,2,10,0,0,22,nowin,win,dlbust,bust,20,0,17,203,0.379310345,0.064039409,0.551724138,0,0.012869209
26090,126,24349,10,7,0,0,0,17,10,2,10,0,0,22,nowin,win,dlbust,bust,20,0,17,188,0.457446809,0.074468085,0.60106383,3,0.900633203
26091,4,24349,4,8,0,10,0,22,10,2,10,0,0,22,nowin,loss,bust,plbust,0,10,12,217,0.460829493,0.036866359,0.562211982,1,0.315432839
26092,116,24349,7,10,0,0,0,17,10,2,10,0,0,22,nowin,win,dlbust,bust,20,0,17,195,0.425641026,0.056410256,0.538461538,1,0.28273747
26093,24,24349,10,9,0,0,0,19,10,2,10,0,0,22,nowin,win,dlbust,bust,20,0,19,207,0.458937198,0.048309179,0.570048309,1,0.318138014
26094,12,24350,11,9,0,0,0,20,7,8,9,0,0,24,nowin,win,dlbust,bust,20,0,20,189,0.470899471,0.015873016,0.613756614,3,0.929171178
26095,145,24350,4,4,7,5,0,20,7,8,9,0,0,24,nowin,win,dlbust,bust,20,0,8,188,0.441489362,0.031914894,0.622340426,2,0.617837093
26096,109,24350,10,10,0,0,0,20,7,8,9,0,0,24,nowin,win,dlbust,bust,20,0,20,221,0.461538462,0.058823529,0.597285068,3,0.901830309
26097,23,24350,10,10,0,0,0,20,7,8,9,0,0,24,nowin,win,dlbust,bust,20,0,20,208,0.427884615,0.0625,0.552884615,1,0.29114424
26098,84,24350,3,11,4,0,0,18,7,8,9,0,0,24,nowin,win,dlbust,bust,20,0,14,195,0.379487179,0.056410256,0.569230769,0,0.017209119
26099,53,24350,2,5,11,0,0,18,7,8,9,0,0,24,nowin,win,dlbust,bust,20,0,7,250,0.372,0.064,0.564,0,0.013687345
26100,149,24351,11,9,0,0,0,20,6,5,5,2,0,18,nowin,win,plwin,beat,20,0,20,225,0.457777778,0.057777778,0.648888889,2,0.651965595
26101,64,24351,10,6,0,0,0,16,6,5,5,2,0,18,nowin,loss,beat,dlwin,0,10,16,187,0.363636364,0.048128342,0.631016043,0,0.027594885
26102,126,24351,2,6,9,0,0,17,6,5,5,2,0,18,nowin,loss,beat,dlwin,0,10,8,188,0.457446809,0.074468085,0.60106383,3,0.900633203
26103,150,24351,2,6,3,10,0,21,6,5,5,2,0,18,nowin,win,plwin,beat,20,0,8,192,0.401041667,0.036458333,0.567708333,0,0.023287458
26104,91,24351,3,10,0,0,0,13,6,5,5,2,0,18,nowin,loss,beat,dlwin,0,10,13,194,0.417525773,0.046391753,0.515463918,1,0.266616552
26105,18,24351,9,4,0,0,0,13,6,5,5,2,0,18,nowin,loss,beat,dlwin,0,10,13,182,0.461538462,0.043956044,0.587912088,3,0.892649374
26106,48,24352,5,4,8,0,0,17,10,8,0,0,0,18,nowin,loss,beat,dlwin,0,10,9,203,0.413793103,0.019704433,0.600985222,2,0.577280801
26107,57,24352,4,4,3,3,6,20,10,8,0,0,0,18,nowin,win,plwin,beat,20,0,8,192,0.46875,0.052083333,0.59375,3,0.907001181
26108,57,24352,6,4,2,2,3,17,10,8,0,0,0,18,nowin,loss,beat,dlwin,0,10,10,192,0.46875,0.052083333,0.59375,3,0.907001181
26109,96,24352,2,2,10,10,0,24,10,8,0,0,0,18,nowin,loss,bust,plbust,0,10,4,190,0.468421053,0.057894737,0.584210526,3,0.897263354
26110,118,24352,11,10,0,0,0,21,10,8,0,0,0,18,win,win,plwin,beat,25,0,21,216,0.393518519,0.037037037,0.555555556,0,0.018059873
26111,114,24352,8,2,4,1,2,17,10,8,0,0,0,18,nowin,loss,beat,dlwin,0,10,10,198,0.47979798,0.025252525,0.611111111,3,0.937232995
26112,64,24353,5,8,0,0,0,13,3,9,6,0,0,18,nowin,loss,beat,dlwin,0,10,13,187,0.363636364,0.048128342,0.631016043,0,0.027594885
26113,95,24353,10,8,0,0,0,18,3,9,6,0,0,18,nowin,push,push,push,10,0,18,218,0.412844037,0.04587156,0.559633028,0,0.024842385
26114,16,24353,3,7,10,0,0,20,3,9,6,0,0,18,nowin,win,plwin,beat,20,0,10,220,0.427272727,0.081818182,0.6,2,0.588660176
26115,10,24353,7,10,0,0,0,17,3,9,6,0,0,18,nowin,loss,beat,dlwin,0,10,17,191,0.413612565,0.057591623,0.596858639,2,0.574087175
26116,89,24353,10,7,0,0,0,17,3,9,6,0,0,18,nowin,loss,beat,dlwin,0,10,17,212,0.537735849,0.047169811,0.594339623,3,0.990167191
26117,145,24353,10,8,0,0,0,18,3,9,6,0,0,18,nowin,push,push,push,10,0,18,188,0.441489362,0.031914894,0.622340426,2,0.617837093
26118,39,24354,7,7,0,10,0,24,9,11,0,0,0,20,nowin,loss,bust,plbust,0,10,14,191,0.429319372,0.062827225,0.57591623,0,0.033760763
26119,87,24354,7,2,4,9,0,22,9,11,0,0,0,20,nowin,loss,bust,plbust,0,10,9,202,0.405940594,0.054455446,0.628712871,2,0.590599801
26120,112,24354,10,7,0,0,0,17,9,11,0,0,0,20,nowin,loss,beat,dlwin,0,10,17,203,0.448275862,0.054187192,0.600985222,3,0.889576933
26121,3,24354,10,7,0,0,0,17,9,11,0,0,0,20,nowin,loss,beat,dlwin,0,10,17,190,0.431578947,0.026315789,0.542105263,1,0.288076384
26122,55,24354,10,8,0,0,0,18,9,11,0,0,0,20,nowin,loss,beat,dlwin,0,10,18,191,0.371727749,0.057591623,0.54973822,0,0.01011347
26123,118,24354,10,10,0,0,0,20,9,11,0,0,0,20,nowin,push,push,push,10,0,20,216,0.393518519,0.037037037,0.555555556,0,0.018059873
26124,149,24355,4,7,1,7,0,19,10,6,1,0,0,17,nowin,win,plwin,beat,20,0,11,225,0.457777778,0.057777778,0.648888889,2,0.651965595
26125,69,24355,10,10,0,0,0,20,10,6,1,0,0,17,nowin,win,plwin,beat,20,0,20,194,0.365979381,0.030927835,0.515463918,0,0
26126,45,24355,2,6,2,10,0,20,10,6,1,0,0,17,nowin,win,plwin,beat,20,0,8,196,0.428571429,0.051020408,0.612244898,2,0.598821767
26127,132,24355,10,10,0,0,0,20,10,6,1,0,0,17,nowin,win,plwin,beat,20,0,20,194,0.412371134,0.036082474,0.649484536,2,0.611633238
26128,105,24355,4,7,4,4,0,19,10,6,1,0,0,17,nowin,win,plwin,beat,20,0,11,198,0.414141414,0.070707071,0.590909091,0,0.032889494
26129,140,24355,10,11,0,0,0,21,10,6,1,0,0,17,win,win,plwin,beat,25,0,21,210,0.466666667,0.023809524,0.604761905,3,0.915293335
26130,95,24356,5,5,7,0,0,17,10,10,0,0,0,20,nowin,loss,beat,dlwin,0,10,10,218,0.412844037,0.04587156,0.559633028,0,0.024842385
26131,96,24356,1,4,10,9,0,24,10,10,0,0,0,20,nowin,loss,bust,plbust,0,10,5,190,0.468421053,0.057894737,0.584210526,3,0.897263354
26132,102,24356,10,4,0,4,0,18,10,10,0,0,0,20,nowin,loss,beat,dlwin,0,10,14,192,0.338541667,0.046875,0.5625,0,0.003306118
26133,128,24356,8,6,0,4,0,18,10,10,0,0,0,20,nowin,loss,beat,dlwin,0,10,14,227,0.356828194,0.052863436,0.577092511,0,0.012352564
26134,12,24356,8,8,0,10,0,26,10,10,0,0,0,20,nowin,loss,bust,plbust,0,10,16,189,0.470899471,0.015873016,0.613756614,3,0.929171178
26135,56,24356,4,10,0,10,0,24,10,10,0,0,0,20,nowin,loss,bust,plbust,0,10,14,175,0.4,0.057142857,0.582857143,0,0.026685297
26136,21,24357,9,7,0,0,0,16,4,10,10,0,0,24,nowin,win,dlbust,bust,20,0,16,214,0.359813084,0.042056075,0.626168224,0,0.025263474
26137,69,24357,8,5,0,0,0,13,4,10,10,0,0,24,nowin,win,dlbust,bust,20,0,13,194,0.365979381,0.030927835,0.515463918,0,0
26138,60,24357,4,2,10,0,0,16,4,10,10,0,0,24,nowin,win,dlbust,bust,20,0,6,227,0.418502203,0.022026432,0.559471366,0,0.026496258
26139,59,24357,6,10,0,0,0,16,4,10,10,0,0,24,nowin,win,dlbust,bust,20,0,16,228,0.429824561,0.048245614,0.543859649,1,0.287885446
26140,94,24357,3,10,0,0,0,13,4,10,10,0,0,24,nowin,win,dlbust,bust,20,0,13,183,0.43715847,0.043715847,0.540983607,1,0.290866892
26141,89,24357,9,2,10,0,0,21,4,10,10,0,0,24,nowin,win,dlbust,bust,20,0,11,212,0.537735849,0.047169811,0.594339623,3,0.990167191
26142,40,24358,10,9,0,0,0,19,11,2,5,0,0,18,nowin,win,plwin,beat,20,0,19,196,0.367346939,0.030612245,0.617346939,0,0.025358183
26143,71,24358,8,10,0,0,0,18,11,2,5,0,0,18,nowin,push,push,push,10,0,18,193,0.352331606,0.046632124,0.585492228,0,0.013063661
26144,46,24358,6,10,0,10,0,26,11,2,5,0,0,18,nowin,loss,bust,plbust,0,10,16,186,0.403225806,0.048387097,0.591397849,0,0.029742194
26145,62,24358,10,10,0,0,0,20,11,2,5,0,0,18,nowin,win,plwin,beat,20,0,20,178,0.370786517,0.028089888,0.54494382,0,0.008657722
26146,107,24358,9,3,0,7,0,19,11,2,5,0,0,18,nowin,win,plwin,beat,20,0,12,218,0.444954128,0.073394495,0.600917431,2,0.605210014
26147,31,24358,3,4,8,2,0,17,11,2,5,0,0,18,nowin,loss,beat,dlwin,0,10,7,188,0.473404255,0.058510638,0.515957447,1,0.300306557
26148,4,24359,7,8,0,2,0,17,11,8,0,0,0,19,nowin,loss,beat,dlwin,0,10,15,217,0.460829493,0.036866359,0.562211982,1,0.315432839
26149,40,24359,4,10,0,10,0,24,11,8,0,0,0,19,nowin,loss,bust,plbust,0,10,14,196,0.367346939,0.030612245,0.617346939,0,0.025358183
26150,26,24359,8,2,3,8,0,21,11,8,0,0,0,19,nowin,win,plwin,beat,20,0,10,203,0.463054187,0.0591133,0.541871921,1,0.306802864
26151,111,24359,10,3,0,9,0,22,11,8,0,0,0,19,nowin,loss,bust,plbust,0,10,13,180,0.433333333,0.055555556,0.611111111,2,0.602264492
26152,119,24359,8,10,0,0,0,18,11,8,0,0,0,19,nowin,loss,beat,dlwin,0,10,18,190,0.405263158,0.068421053,0.515789474,0,0.011837158
26153,148,24359,8,10,0,0,0,18,11,8,0,0,0,19,nowin,loss,beat,dlwin,0,10,18,204,0.401960784,0.078431373,0.593137255,0,0.029789521
26154,62,24360,9,6,0,10,0,25,10,3,10,0,0,23,nowin,loss,bust,plbust,0,10,15,178,0.370786517,0.028089888,0.54494382,0,0.008657722
26155,19,24360,7,9,0,8,0,24,10,3,10,0,0,23,nowin,loss,bust,plbust,0,10,16,237,0.41350211,0.054852321,0.628691983,2,0.597373826
26156,1,24360,10,10,0,0,0,20,10,3,10,0,0,23,nowin,win,dlbust,bust,20,0,20,197,0.406091371,0.025380711,0.649746193,2,0.606186955
26157,84,24360,2,5,10,0,0,17,10,3,10,0,0,23,nowin,win,dlbust,bust,20,0,7,195,0.379487179,0.056410256,0.569230769,0,0.017209119
26158,39,24360,10,10,0,0,0,20,10,3,10,0,0,23,nowin,win,dlbust,bust,20,0,20,191,0.429319372,0.062827225,0.57591623,0,0.033760763
26159,37,24360,10,8,0,0,0,18,10,3,10,0,0,23,nowin,win,dlbust,bust,20,0,18,208,0.394230769,0.038461538,0.581730769,0,0.024682772
26160,21,24361,9,11,0,0,0,20,10,4,10,0,0,24,nowin,win,dlbust,bust,20,0,20,214,0.359813084,0.042056075,0.626168224,0,0.025263474
26161,125,24361,10,3,0,10,0,23,10,4,10,0,0,24,nowin,loss,bust,plbust,0,10,13,219,0.438356164,0.050228311,0.575342466,1,0.308411257
26162,42,24361,2,7,2,8,0,19,10,4,10,0,0,24,nowin,win,dlbust,bust,20,0,9,212,0.443396226,0.051886792,0.570754717,1,0.309181312
26163,123,24361,4,9,0,10,0,23,10,4,10,0,0,24,nowin,loss,bust,plbust,0,10,13,205,0.43902439,0.034146341,0.614634146,2,0.609962544
26164,103,24361,10,10,0,0,0,20,10,4,10,0,0,24,nowin,win,dlbust,bust,20,0,20,203,0.379310345,0.064039409,0.551724138,0,0.012869209
26165,76,24361,10,11,0,0,0,21,10,4,10,0,0,24,win,win,dlbust,bust,25,0,21,189,0.534391534,0.079365079,0.608465608,3,1
26166,134,24362,10,10,0,0,0,20,10,10,0,0,0,20,nowin,push,push,push,10,0,20,185,0.443243243,0.021621622,0.545945946,1,0.296939509
26167,22,24362,2,4,10,9,0,25,10,10,0,0,0,20,nowin,loss,bust,plbust,0,10,6,187,0.481283422,0.042780749,0.577540107,3,0.906128176
26168,128,24362,4,1,9,10,0,24,10,10,0,0,0,20,nowin,loss,bust,plbust,0,10,5,227,0.356828194,0.052863436,0.577092511,0,0.012352564
26169,143,24362,4,7,9,0,0,20,10,10,0,0,0,20,nowin,push,push,push,10,0,11,203,0.463054187,0.044334975,0.57635468,3,0.883143365
26170,62,24362,10,9,0,0,0,19,10,10,0,0,0,20,nowin,loss,beat,dlwin,0,10,19,178,0.370786517,0.028089888,0.54494382,0,0.008657722
26171,13,24362,10,5,0,5,0,20,10,10,0,0,0,20,nowin,push,push,push,10,0,15,206,0.417475728,0.063106796,0.621359223,2,0.59555479
26172,116,24363,7,7,0,10,0,24,10,3,5,0,0,18,nowin,loss,bust,plbust,0,10,14,195,0.425641026,0.056410256,0.538461538,1,0.28273747
26173,133,24363,10,11,0,0,0,21,10,3,5,0,0,18,win,win,plwin,beat,25,0,21,201,0.47761194,0.064676617,0.611940299,3,0.935428111
26174,83,24363,10,6,0,10,0,26,10,3,5,0,0,18,nowin,loss,bust,plbust,0,10,16,193,0.424870466,0.051813472,0.678756477,2,0.644360335
26175,131,24363,4,10,0,10,0,24,10,3,5,0,0,18,nowin,loss,bust,plbust,0,10,14,217,0.410138249,0.069124424,0.543778802,0,0.02015021
26176,13,24363,5,10,0,10,0,25,10,3,5,0,0,18,nowin,loss,bust,plbust,0,10,15,206,0.417475728,0.063106796,0.621359223,2,0.59555479
26177,112,24363,8,9,0,0,0,17,10,3,5,0,0,18,nowin,loss,beat,dlwin,0,10,17,203,0.448275862,0.054187192,0.600985222,3,0.889576933
26178,145,24364,3,2,5,2,0,12,5,8,10,0,0,23,nowin,win,dlbust,bust,20,0,5,188,0.441489362,0.031914894,0.622340426,2,0.617837093
26179,69,24364,10,8,0,0,0,18,5,8,10,0,0,23,nowin,win,dlbust,bust,20,0,18,194,0.365979381,0.030927835,0.515463918,0,0
26180,8,24364,10,9,0,0,0,19,5,8,10,0,0,23,nowin,win,dlbust,bust,20,0,19,181,0.44198895,0.071823204,0.596685083,2,0.599438402
26181,51,24364,9,4,0,0,0,13,5,8,10,0,0,23,nowin,win,dlbust,bust,20,0,13,189,0.529100529,0.068783069,0.608465608,3,0.993665715
26182,133,24364,1,3,10,0,0,14,5,8,10,0,0,23,nowin,win,dlbust,bust,20,0,4,201,0.47761194,0.064676617,0.611940299,3,0.935428111
26183,149,24364,2,7,11,0,0,20,5,8,10,0,0,23,nowin,win,dlbust,bust,20,0,9,225,0.457777778,0.057777778,0.648888889,2,0.651965595
26184,99,24365,9,8,0,0,0,17,10,5,10,0,0,25,nowin,win,dlbust,bust,20,0,17,207,0.47826087,0.062801932,0.637681159,3,0.961418446
26185,71,24365,2,2,10,6,0,20,10,5,10,0,0,25,nowin,win,dlbust,bust,20,0,4,193,0.352331606,0.046632124,0.585492228,0,0.013063661
26186,3,24365,10,7,0,0,0,17,10,5,10,0,0,25,nowin,win,dlbust,bust,20,0,17,190,0.431578947,0.026315789,0.542105263,1,0.288076384
26187,121,24365,10,10,0,0,0,20,10,5,10,0,0,25,nowin,win,dlbust,bust,20,0,20,195,0.456410256,0.025641026,0.512820513,1,0.288597791
26188,126,24365,10,10,0,0,0,20,10,5,10,0,0,25,nowin,win,dlbust,bust,20,0,20,188,0.457446809,0.074468085,0.60106383,3,0.900633203
26189,78,24365,7,9,0,2,0,18,10,5,10,0,0,25,nowin,win,dlbust,bust,20,0,16,201,0.517412935,0.034825871,0.587064677,3,0.95871112
26190,46,24366,2,9,9,0,0,20,10,10,0,0,0,20,nowin,push,push,push,10,0,11,186,0.403225806,0.048387097,0.591397849,0,0.029742194
26191,19,24366,10,10,0,0,0,20,10,10,0,0,0,20,nowin,push,push,push,10,0,20,237,0.41350211,0.054852321,0.628691983,2,0.597373826
26192,15,24366,6,6,0,1,7,20,10,10,0,0,0,20,nowin,push,push,push,10,0,12,212,0.410377358,0.051886792,0.561320755,0,0.024517408
26193,34,24366,2,10,0,8,0,20,10,10,0,0,0,20,nowin,push,push,push,10,0,12,202,0.5,0.079207921,0.618811881,3,0.968961434
26194,10,24366,8,10,0,0,0,18,10,10,0,0,0,20,nowin,loss,beat,dlwin,0,10,18,191,0.413612565,0.057591623,0.596858639,2,0.574087175
26195,37,24366,2,11,1,1,4,19,10,10,0,0,0,20,nowin,loss,beat,dlwin,0,10,13,208,0.394230769,0.038461538,0.581730769,0,0.024682772
26196,84,24367,6,10,0,0,0,16,3,2,4,8,0,17,nowin,loss,beat,dlwin,0,10,16,195,0.379487179,0.056410256,0.569230769,0,0.017209119
26197,2,24367,7,6,0,0,0,13,3,2,4,8,0,17,nowin,loss,beat,dlwin,0,10,13,200,0.445,0.035,0.64,2,0.633962549
26198,31,24367,8,11,0,0,0,19,3,2,4,8,0,17,nowin,win,plwin,beat,20,0,19,188,0.473404255,0.058510638,0.515957447,1,0.300306557
26199,149,24367,6,2,2,9,0,19,3,2,4,8,0,17,nowin,win,plwin,beat,20,0,8,225,0.457777778,0.057777778,0.648888889,2,0.651965595
26200,122,24367,10,10,0,0,0,20,3,2,4,8,0,17,nowin,win,plwin,beat,20,0,20,210,0.347619048,0.052380952,0.59047619,0,0.012873677
26201,38,24367,10,9,0,0,0,19,3,2,4,8,0,17,nowin,win,plwin,beat,20,0,19,202,0.361386139,0.03960396,0.564356436,0,0.010597953
26202,120,24368,9,7,0,5,0,21,10,10,0,0,0,20,nowin,win,plwin,beat,20,0,16,202,0.440594059,0.034653465,0.618811881,2,0.614441029
26203,98,24368,2,6,2,3,1,14,10,10,0,0,0,20,nowin,loss,beat,dlwin,0,10,8,220,0.422727273,0.054545455,0.55,1,0.28664435
26204,88,24368,10,6,0,10,0,26,10,10,0,0,0,20,nowin,loss,bust,plbust,0,10,16,206,0.466019417,0.033980583,0.54368932,1,0.309467903
26205,113,24368,4,7,10,0,0,21,10,10,0,0,0,20,nowin,win,plwin,beat,20,0,11,199,0.407035176,0.055276382,0.668341709,2,0.620695264
26206,74,24368,9,11,0,0,0,20,10,10,0,0,0,20,nowin,push,push,push,10,0,20,209,0.411483254,0.04784689,0.531100478,0,0.017448125
26207,149,24368,10,4,0,3,0,17,10,10,0,0,0,20,nowin,loss,beat,dlwin,0,10,14,225,0.457777778,0.057777778,0.648888889,2,0.651965595
26208,66,24369,8,7,0,8,0,23,10,3,10,0,0,23,nowin,loss,bust,plbust,0,10,15,217,0.456221198,0.064516129,0.626728111,3,0.924304367
26209,131,24369,6,7,0,10,0,23,10,3,10,0,0,23,nowin,loss,bust,plbust,0,10,13,217,0.410138249,0.069124424,0.543778802,0,0.02015021
26210,115,24369,4,2,10,10,0,26,10,3,10,0,0,23,nowin,loss,bust,plbust,0,10,6,194,0.427835052,0.041237113,0.592783505,2,0.583863602
26211,127,24369,7,10,0,0,0,17,10,3,10,0,0,23,nowin,win,dlbust,bust,20,0,17,201,0.402985075,0.029850746,0.60199005,0,0.032263937
26212,55,24369,3,9,0,8,0,20,10,3,10,0,0,23,nowin,win,dlbust,bust,20,0,12,191,0.371727749,0.057591623,0.54973822,0,0.01011347
26213,23,24369,4,9,0,8,0,21,10,3,10,0,0,23,nowin,win,dlbust,bust,20,0,13,208,0.427884615,0.0625,0.552884615,1,0.29114424
26214,44,24370,11,8,0,0,0,19,5,7,6,0,0,18,nowin,win,plwin,beat,20,0,19,219,0.433789954,0.050228311,0.534246575,1,0.285551035
26215,63,24370,10,10,0,0,0,20,5,7,6,0,0,18,nowin,win,plwin,beat,20,0,20,216,0.467592593,0.037037037,0.62037037,3,0.931690496
26216,83,24370,10,10,0,0,0,20,5,7,6,0,0,18,nowin,win,plwin,beat,20,0,20,193,0.424870466,0.051813472,0.678756477,2,0.644360335
26217,29,24370,3,2,10,0,0,15,5,7,6,0,0,18,nowin,loss,beat,dlwin,0,10,5,189,0.44973545,0.058201058,0.544973545,1,0.300349439
26218,134,24370,5,9,0,0,0,14,5,7,6,0,0,18,nowin,loss,beat,dlwin,0,10,14,185,0.443243243,0.021621622,0.545945946,1,0.296939509
26219,77,24370,9,10,0,0,0,19,5,7,6,0,0,18,nowin,win,plwin,beat,20,0,19,200,0.455,0.04,0.62,3,0.916252116
26220,47,24371,10,4,0,10,0,24,10,8,0,0,0,18,nowin,loss,bust,plbust,0,10,14,210,0.438095238,0.057142857,0.623809524,2,0.615868808
26221,77,24371,10,11,0,0,0,21,10,8,0,0,0,18,win,win,plwin,beat,25,0,21,200,0.455,0.04,0.62,3,0.916252116
26222,62,24371,4,6,2,10,0,22,10,8,0,0,0,18,nowin,loss,bust,plbust,0,10,10,178,0.370786517,0.028089888,0.54494382,0,0.008657722
26223,90,24371,10,11,0,0,0,21,10,8,0,0,0,18,win,win,plwin,beat,25,0,21,201,0.447761194,0.049751244,0.60199005,3,0.889945023
26224,86,24371,10,11,0,0,0,21,10,8,0,0,0,18,win,win,plwin,beat,25,0,21,196,0.454081633,0.040816327,0.591836735,3,0.887566443
26225,32,24371,10,7,0,0,0,17,10,8,0,0,0,18,nowin,loss,beat,dlwin,0,10,17,189,0.391534392,0.037037037,0.53968254,0,0.013579086
26226,124,24372,10,10,0,0,0,20,11,2,2,6,0,21,nowin,loss,beat,dlwin,0,10,20,202,0.47029703,0.064356436,0.584158416,3,0.899458193
26227,72,24372,9,11,0,0,0,20,11,2,2,6,0,21,nowin,loss,beat,dlwin,0,10,20,185,0.394594595,0.032432432,0.508108108,0,0.006763115
26228,109,24372,5,4,10,0,0,19,11,2,2,6,0,21,nowin,loss,beat,dlwin,0,10,9,221,0.461538462,0.058823529,0.597285068,3,0.901830309
26229,28,24372,5,11,1,0,0,17,11,2,2,6,0,21,nowin,loss,beat,dlwin,0,10,16,199,0.422110553,0.045226131,0.542713568,1,0.282706618
26230,128,24372,5,10,0,10,0,25,11,2,2,6,0,21,nowin,loss,bust,plbust,0,10,15,227,0.356828194,0.052863436,0.577092511,0,0.012352564
26231,34,24372,3,8,2,10,0,23,11,2,2,6,0,21,nowin,loss,bust,plbust,0,10,11,202,0.5,0.079207921,0.618811881,3,0.968961434
26232,76,24373,10,4,0,9,0,23,9,10,0,0,0,19,nowin,loss,bust,plbust,0,10,14,189,0.534391534,0.079365079,0.608465608,3,1
26233,51,24373,8,4,0,9,0,21,9,10,0,0,0,19,nowin,win,plwin,beat,20,0,12,189,0.529100529,0.068783069,0.608465608,3,0.993665715
26234,10,24373,10,10,0,0,0,20,9,10,0,0,0,19,nowin,win,plwin,beat,20,0,20,191,0.413612565,0.057591623,0.596858639,2,0.574087175
26235,46,24373,2,10,0,10,0,22,9,10,0,0,0,19,nowin,loss,bust,plbust,0,10,12,186,0.403225806,0.048387097,0.591397849,0,0.029742194
26236,3,24373,9,6,0,9,0,24,9,10,0,0,0,19,nowin,loss,bust,plbust,0,10,15,190,0.431578947,0.026315789,0.542105263,1,0.288076384
26237,93,24373,4,5,5,8,0,22,9,10,0,0,0,19,nowin,loss,bust,plbust,0,10,9,175,0.485714286,0.051428571,0.548571429,1,0.323648091
26238,130,24374,8,8,0,10,0,26,8,11,0,0,0,19,nowin,loss,bust,plbust,0,10,16,219,0.410958904,0.03652968,0.566210046,0,0.025888739
26239,135,24374,4,3,6,3,10,26,8,11,0,0,0,19,nowin,loss,bust,plbust,0,10,7,179,0.391061453,0.067039106,0.586592179,0,0.024924662
26240,148,24374,8,9,0,0,0,17,8,11,0,0,0,19,nowin,loss,beat,dlwin,0,10,17,204,0.401960784,0.078431373,0.593137255,0,0.029789521
26241,31,24374,10,10,0,0,0,20,8,11,0,0,0,19,nowin,win,plwin,beat,20,0,20,188,0.473404255,0.058510638,0.515957447,1,0.300306557
26242,95,24374,4,10,0,7,0,21,8,11,0,0,0,19,nowin,win,plwin,beat,20,0,14,218,0.412844037,0.04587156,0.559633028,0,0.024842385
26243,113,24374,11,10,0,0,0,21,8,11,0,0,0,19,win,win,plwin,beat,25,0,21,199,0.407035176,0.055276382,0.668341709,2,0.620695264
26244,12,24375,9,6,0,5,0,20,9,5,10,0,0,24,nowin,win,dlbust,bust,20,0,15,189,0.470899471,0.015873016,0.613756614,3,0.929171178
26245,71,24375,5,2,4,6,0,17,9,5,10,0,0,24,nowin,win,dlbust,bust,20,0,7,193,0.352331606,0.046632124,0.585492228,0,0.013063661
26246,110,24375,5,5,10,0,0,20,9,5,10,0,0,24,nowin,win,dlbust,bust,20,0,10,192,0.416666667,0.046875,0.557291667,0,0.025413132
26247,53,24375,7,7,0,10,0,24,9,5,10,0,0,24,nowin,loss,bust,plbust,0,10,14,250,0.372,0.064,0.564,0,0.013687345
26248,74,24375,10,11,0,0,0,21,9,5,10,0,0,24,win,win,dlbust,bust,25,0,21,209,0.411483254,0.04784689,0.531100478,0,0.017448125
26249,57,24375,10,2,0,1,10,23,9,5,10,0,0,24,nowin,loss,bust,plbust,0,10,12,192,0.46875,0.052083333,0.59375,3,0.907001181
26250,63,24376,7,6,0,7,0,20,1,1,10,1,10,23,nowin,win,dlbust,bust,20,0,13,216,0.467592593,0.037037037,0.62037037,3,0.931690496
26251,76,24376,6,10,0,10,0,26,1,1,10,1,10,23,nowin,loss,bust,plbust,0,10,16,189,0.534391534,0.079365079,0.608465608,3,1
26252,12,24376,9,4,0,1,10,24,1,1,10,1,10,23,nowin,loss,bust,plbust,0,10,13,189,0.470899471,0.015873016,0.613756614,3,0.929171178
26253,90,24376,9,10,0,0,0,19,1,1,10,1,10,23,nowin,win,dlbust,bust,20,0,19,201,0.447761194,0.049751244,0.60199005,3,0.889945023
26254,26,24376,5,1,6,7,0,19,1,1,10,1,10,23,nowin,win,dlbust,bust,20,0,6,203,0.463054187,0.0591133,0.541871921,1,0.306802864
26255,88,24376,10,11,0,0,0,21,1,1,10,1,10,23,win,win,dlbust,bust,25,0,21,206,0.466019417,0.033980583,0.54368932,1,0.309467903
26256,116,24377,9,10,0,0,0,19,10,7,0,0,0,17,nowin,win,plwin,beat,20,0,19,195,0.425641026,0.056410256,0.538461538,1,0.28273747
26257,95,24377,8,10,0,0,0,18,10,7,0,0,0,17,nowin,win,plwin,beat,20,0,18,218,0.412844037,0.04587156,0.559633028,0,0.024842385
26258,73,24377,9,2,10,0,0,21,10,7,0,0,0,17,nowin,win,plwin,beat,20,0,11,181,0.375690608,0.011049724,0.596685083,0,0.022795773
26259,72,24377,4,5,8,0,0,17,10,7,0,0,0,17,nowin,push,push,push,10,0,9,185,0.394594595,0.032432432,0.508108108,0,0.006763115
26260,77,24377,5,11,3,0,0,19,10,7,0,0,0,17,nowin,win,plwin,beat,20,0,16,200,0.455,0.04,0.62,3,0.916252116
26261,89,24377,10,10,0,0,0,20,10,7,0,0,0,17,nowin,win,plwin,beat,20,0,20,212,0.537735849,0.047169811,0.594339623,3,0.990167191
26262,24,24378,10,5,0,6,0,21,9,10,0,0,0,19,nowin,win,plwin,beat,20,0,15,207,0.458937198,0.048309179,0.570048309,1,0.318138014
26263,29,24378,2,8,8,0,0,18,9,10,0,0,0,19,nowin,loss,beat,dlwin,0,10,10,189,0.44973545,0.058201058,0.544973545,1,0.300349439
26264,45,24378,10,10,0,0,0,20,9,10,0,0,0,19,nowin,win,plwin,beat,20,0,20,196,0.428571429,0.051020408,0.612244898,2,0.598821767
26265,95,24378,7,5,0,3,10,25,9,10,0,0,0,19,nowin,loss,bust,plbust,0,10,12,218,0.412844037,0.04587156,0.559633028,0,0.024842385
26266,134,24378,8,8,0,5,0,21,9,10,0,0,0,19,nowin,win,plwin,beat,20,0,16,185,0.443243243,0.021621622,0.545945946,1,0.296939509
26267,139,24378,4,10,0,5,0,19,9,10,0,0,0,19,nowin,push,push,push,10,0,14,192,0.380208333,0.036458333,0.59375,0,0.023429169
26268,77,24379,10,9,0,0,0,19,1,1,10,10,0,22,nowin,win,dlbust,bust,20,0,19,200,0.455,0.04,0.62,3,0.916252116
26269,63,24379,7,7,0,2,4,20,1,1,10,10,0,22,nowin,win,dlbust,bust,20,0,14,216,0.467592593,0.037037037,0.62037037,3,0.931690496
26270,134,24379,9,6,0,8,0,23,1,1,10,10,0,22,nowin,loss,bust,plbust,0,10,15,185,0.443243243,0.021621622,0.545945946,1,0.296939509
26271,143,24379,9,9,0,0,0,18,1,1,10,10,0,22,nowin,win,dlbust,bust,20,0,18,203,0.463054187,0.044334975,0.57635468,3,0.883143365
26272,68,24379,10,9,0,0,0,19,1,1,10,10,0,22,nowin,win,dlbust,bust,20,0,19,205,0.434146341,0.029268293,0.6,2,0.59483189
26273,13,24379,6,4,9,0,0,19,1,1,10,10,0,22,nowin,win,dlbust,bust,20,0,10,206,0.417475728,0.063106796,0.621359223,2,0.59555479
26274,34,24380,10,3,0,1,10,24,10,10,0,0,0,20,nowin,loss,bust,plbust,0,10,13,202,0.5,0.079207921,0.618811881,3,0.968961434
26275,91,24380,8,5,0,2,8,23,10,10,0,0,0,20,nowin,loss,bust,plbust,0,10,13,194,0.417525773,0.046391753,0.515463918,1,0.266616552
26276,54,24380,3,7,9,0,0,19,10,10,0,0,0,20,nowin,loss,beat,dlwin,0,10,10,185,0.437837838,0.032432432,0.556756757,1,0.29899854
26277,135,24380,7,10,0,0,0,17,10,10,0,0,0,20,nowin,loss,beat,dlwin,0,10,17,179,0.391061453,0.067039106,0.586592179,0,0.024924662
26278,126,24380,7,7,0,10,0,24,10,10,0,0,0,20,nowin,loss,bust,plbust,0,10,14,188,0.457446809,0.074468085,0.60106383,3,0.900633203
26279,147,24380,7,6,0,5,0,18,10,10,0,0,0,20,nowin,loss,beat,dlwin,0,10,13,205,0.380487805,0.014634146,0.536585366,0,0.00951447
26280,77,24381,7,10,0,0,0,17,5,11,4,0,0,20,nowin,loss,beat,dlwin,0,10,17,200,0.455,0.04,0.62,3,0.916252116
26281,42,24381,10,8,0,0,0,18,5,11,4,0,0,20,nowin,loss,beat,dlwin,0,10,18,212,0.443396226,0.051886792,0.570754717,1,0.309181312
26282,116,24381,10,9,0,0,0,19,5,11,4,0,0,20,nowin,loss,beat,dlwin,0,10,19,195,0.425641026,0.056410256,0.538461538,1,0.28273747
26283,43,24381,6,10,0,0,0,16,5,11,4,0,0,20,nowin,loss,beat,dlwin,0,10,16,192,0.40625,0.041666667,0.609375,2,0.576671372
26284,75,24381,8,6,0,0,0,14,5,11,4,0,0,20,nowin,loss,beat,dlwin,0,10,14,191,0.418848168,0.052356021,0.570680628,0,0.029344702
26285,109,24381,9,6,0,0,0,15,5,11,4,0,0,20,nowin,loss,beat,dlwin,0,10,15,221,0.461538462,0.058823529,0.597285068,3,0.901830309
26286,78,24382,6,3,2,9,0,20,8,7,9,0,0,24,nowin,win,dlbust,bust,20,0,9,201,0.517412935,0.034825871,0.587064677,3,0.95871112
26287,50,24382,4,1,8,3,1,17,8,7,9,0,0,24,nowin,win,dlbust,bust,20,0,5,202,0.405940594,0.04950495,0.54950495,0,0.020296079
26288,80,24382,7,10,0,0,0,17,8,7,9,0,0,24,nowin,win,dlbust,bust,20,0,17,186,0.419354839,0.059139785,0.623655914,2,0.59892924
26289,42,24382,11,7,0,0,0,18,8,7,9,0,0,24,nowin,win,dlbust,bust,20,0,18,212,0.443396226,0.051886792,0.570754717,1,0.309181312
26290,65,24382,10,8,0,0,0,18,8,7,9,0,0,24,nowin,win,dlbust,bust,20,0,18,203,0.492610837,0.054187192,0.571428571,3,0.913702814
26291,14,24382,10,5,0,2,0,17,8,7,9,0,0,24,nowin,win,dlbust,bust,20,0,15,202,0.391089109,0.01980198,0.628712871,2,0.577264877
26292,57,24383,2,10,0,10,0,22,3,8,10,0,0,21,nowin,loss,bust,plbust,0,10,12,192,0.46875,0.052083333,0.59375,3,0.907001181
26293,145,24383,7,9,0,0,0,16,3,8,10,0,0,21,nowin,loss,beat,dlwin,0,10,16,188,0.441489362,0.031914894,0.622340426,2,0.617837093
26294,66,24383,3,2,10,0,0,15,3,8,10,0,0,21,nowin,loss,beat,dlwin,0,10,5,217,0.456221198,0.064516129,0.626728111,3,0.924304367
26295,18,24383,7,11,0,0,0,18,3,8,10,0,0,21,nowin,loss,beat,dlwin,0,10,18,182,0.461538462,0.043956044,0.587912088,3,0.892649374
26296,2,24383,9,2,10,0,0,21,3,8,10,0,0,21,nowin,push,push,push,10,0,11,200,0.445,0.035,0.64,2,0.633962549
26297,2,24383,6,10,0,0,0,16,3,8,10,0,0,21,nowin,loss,beat,dlwin,0,10,16,200,0.445,0.035,0.64,2,0.633962549
26298,29,24384,2,10,0,6,0,18,8,3,6,0,0,17,nowin,win,plwin,beat,20,0,12,189,0.44973545,0.058201058,0.544973545,1,0.300349439
26299,143,24384,10,8,0,0,0,18,8,3,6,0,0,17,nowin,win,plwin,beat,20,0,18,203,0.463054187,0.044334975,0.57635468,3,0.883143365
26300,86,24384,2,5,9,10,0,26,8,3,6,0,0,17,nowin,loss,bust,plbust,0,10,7,196,0.454081633,0.040816327,0.591836735,3,0.887566443
26301,16,24384,2,7,4,5,0,18,8,3,6,0,0,17,nowin,win,plwin,beat,20,0,9,220,0.427272727,0.081818182,0.6,2,0.588660176
26302,69,24384,11,7,0,0,0,18,8,3,6,0,0,17,nowin,win,plwin,beat,20,0,18,194,0.365979381,0.030927835,0.515463918,0,0
26303,64,24384,3,2,4,10,0,19,8,3,6,0,0,17,nowin,win,plwin,beat,20,0,5,187,0.363636364,0.048128342,0.631016043,0,0.027594885
26304,87,24385,10,10,0,0,0,20,1,5,9,10,0,25,nowin,win,dlbust,bust,20,0,20,202,0.405940594,0.054455446,0.628712871,2,0.590599801
26305,44,24385,10,5,0,2,0,17,1,5,9,10,0,25,nowin,win,dlbust,bust,20,0,15,219,0.433789954,0.050228311,0.534246575,1,0.285551035
26306,105,24385,11,9,0,0,0,20,1,5,9,10,0,25,nowin,win,dlbust,bust,20,0,20,198,0.414141414,0.070707071,0.590909091,0,0.032889494
26307,32,24385,3,11,5,0,0,19,1,5,9,10,0,25,nowin,win,dlbust,bust,20,0,14,189,0.391534392,0.037037037,0.53968254,0,0.013579086
26308,122,24385,9,9,0,0,0,18,1,5,9,10,0,25,nowin,win,dlbust,bust,20,0,18,210,0.347619048,0.052380952,0.59047619,0,0.012873677
26309,124,24385,10,8,0,0,0,18,1,5,9,10,0,25,nowin,win,dlbust,bust,20,0,18,202,0.47029703,0.064356436,0.584158416,3,0.899458193
26310,91,24386,7,5,0,1,10,23,10,4,3,0,0,17,nowin,loss,bust,plbust,0,10,12,194,0.417525773,0.046391753,0.515463918,1,0.266616552
26311,75,24386,2,10,0,3,2,17,10,4,3,0,0,17,nowin,push,push,push,10,0,12,191,0.418848168,0.052356021,0.570680628,0,0.029344702
26312,119,24386,2,5,10,0,0,17,10,4,3,0,0,17,nowin,push,push,push,10,0,7,190,0.405263158,0.068421053,0.515789474,0,0.011837158
26313,66,24386,7,10,0,0,0,17,10,4,3,0,0,17,nowin,push,push,push,10,0,17,217,0.456221198,0.064516129,0.626728111,3,0.924304367
26314,36,24386,3,10,0,10,0,23,10,4,3,0,0,17,nowin,loss,bust,plbust,0,10,13,229,0.445414847,0.056768559,0.655021834,2,0.645370571
26315,129,24386,3,11,2,10,0,26,10,4,3,0,0,17,nowin,loss,bust,plbust,0,10,14,201,0.422885572,0.064676617,0.55721393,0,0.027255383
26316,142,24387,3,10,0,1,8,22,11,9,0,0,0,20,nowin,loss,bust,plbust,0,10,13,211,0.417061611,0.047393365,0.526066351,1,0.271531309
26317,16,24387,10,3,0,10,0,23,11,9,0,0,0,20,nowin,loss,bust,plbust,0,10,13,220,0.427272727,0.081818182,0.6,2,0.588660176
26318,2,24387,11,7,0,0,0,18,11,9,0,0,0,20,nowin,loss,beat,dlwin,0,10,18,200,0.445,0.035,0.64,2,0.633962549
26319,28,24387,3,5,2,10,0,20,11,9,0,0,0,20,nowin,push,push,push,10,0,8,199,0.422110553,0.045226131,0.542713568,1,0.282706618
26320,24,24387,6,8,0,4,0,18,11,9,0,0,0,20,nowin,loss,beat,dlwin,0,10,14,207,0.458937198,0.048309179,0.570048309,1,0.318138014
26321,128,24387,5,10,0,10,0,25,11,9,0,0,0,20,nowin,loss,bust,plbust,0,10,15,227,0.356828194,0.052863436,0.577092511,0,0.012352564
26322,68,24388,10,10,0,0,0,20,10,2,5,0,0,17,nowin,win,plwin,beat,20,0,20,205,0.434146341,0.029268293,0.6,2,0.59483189
26323,135,24388,11,10,0,0,0,21,10,2,5,0,0,17,win,win,plwin,beat,25,0,21,179,0.391061453,0.067039106,0.586592179,0,0.024924662
26324,54,24388,4,4,10,0,0,18,10,2,5,0,0,17,nowin,win,plwin,beat,20,0,8,185,0.437837838,0.032432432,0.556756757,1,0.29899854
26325,140,24388,7,11,0,0,0,18,10,2,5,0,0,17,nowin,win,plwin,beat,20,0,18,210,0.466666667,0.023809524,0.604761905,3,0.915293335
26326,103,24388,2,7,6,10,0,25,10,2,5,0,0,17,nowin,loss,bust,plbust,0,10,9,203,0.379310345,0.064039409,0.551724138,0,0.012869209
26327,17,24388,5,10,0,5,0,20,10,2,5,0,0,17,nowin,win,plwin,beat,20,0,15,171,0.444444444,0.070175439,0.555555556,1,0.302364894
26328,102,24389,10,5,0,6,0,21,10,8,0,0,0,18,nowin,win,plwin,beat,20,0,15,192,0.338541667,0.046875,0.5625,0,0.003306118
26329,82,24389,10,4,0,8,0,22,10,8,0,0,0,18,nowin,loss,bust,plbust,0,10,14,225,0.408888889,0.075555556,0.577777778,0,0.028101874
26330,123,24389,10,10,0,0,0,20,10,8,0,0,0,18,nowin,win,plwin,beat,20,0,20,205,0.43902439,0.034146341,0.614634146,2,0.609962544
26331,92,24389,5,10,0,4,0,19,10,8,0,0,0,18,nowin,win,plwin,beat,20,0,15,186,0.446236559,0.059139785,0.564516129,1,0.307826125
26332,9,24389,6,3,3,10,0,22,10,8,0,0,0,18,nowin,loss,bust,plbust,0,10,9,194,0.37628866,0.015463918,0.541237113,0,0.009396796
26333,88,24389,4,3,3,8,0,18,10,8,0,0,0,18,nowin,push,push,push,10,0,7,206,0.466019417,0.033980583,0.54368932,1,0.309467903
26334,15,24390,3,6,10,0,0,19,4,9,4,0,0,17,nowin,win,plwin,beat,20,0,9,212,0.410377358,0.051886792,0.561320755,0,0.024517408
26335,48,24390,2,8,4,0,0,14,4,9,4,0,0,17,nowin,loss,beat,dlwin,0,10,10,203,0.413793103,0.019704433,0.600985222,2,0.577280801
26336,133,24390,5,10,0,0,0,15,4,9,4,0,0,17,nowin,loss,beat,dlwin,0,10,15,201,0.47761194,0.064676617,0.611940299,3,0.935428111
26337,150,24390,7,10,0,0,0,17,4,9,4,0,0,17,nowin,push,push,push,10,0,17,192,0.401041667,0.036458333,0.567708333,0,0.023287458
26338,126,24390,10,4,0,0,0,14,4,9,4,0,0,17,nowin,loss,beat,dlwin,0,10,14,188,0.457446809,0.074468085,0.60106383,3,0.900633203
26339,126,24390,11,7,0,0,0,18,4,9,4,0,0,17,nowin,win,plwin,beat,20,0,18,188,0.457446809,0.074468085,0.60106383,3,0.900633203
26340,73,24391,9,2,9,0,0,20,11,3,5,0,0,19,nowin,win,plwin,beat,20,0,11,181,0.375690608,0.011049724,0.596685083,0,0.022795773
26341,122,24391,10,10,0,0,0,20,11,3,5,0,0,19,nowin,win,plwin,beat,20,0,20,210,0.347619048,0.052380952,0.59047619,0,0.012873677
26342,105,24391,8,5,0,10,0,23,11,3,5,0,0,19,nowin,loss,bust,plbust,0,10,13,198,0.414141414,0.070707071,0.590909091,0,0.032889494
26343,22,24391,4,2,10,8,0,24,11,3,5,0,0,19,nowin,loss,bust,plbust,0,10,6,187,0.481283422,0.042780749,0.577540107,3,0.906128176
26344,147,24391,2,6,8,10,0,26,11,3,5,0,0,19,nowin,loss,bust,plbust,0,10,8,205,0.380487805,0.014634146,0.536585366,0,0.00951447
26345,66,24391,11,10,0,0,0,21,11,3,5,0,0,19,win,win,plwin,beat,25,0,21,217,0.456221198,0.064516129,0.626728111,3,0.924304367
26346,111,24392,5,10,0,1,7,23,10,10,0,0,0,20,nowin,loss,bust,plbust,0,10,15,180,0.433333333,0.055555556,0.611111111,2,0.602264492
26347,28,24392,11,7,0,0,0,18,10,10,0,0,0,20,nowin,loss,beat,dlwin,0,10,18,199,0.422110553,0.045226131,0.542713568,1,0.282706618
26348,10,24392,9,10,0,0,0,19,10,10,0,0,0,20,nowin,loss,beat,dlwin,0,10,19,191,0.413612565,0.057591623,0.596858639,2,0.574087175
26349,9,24392,7,8,0,10,0,25,10,10,0,0,0,20,nowin,loss,bust,plbust,0,10,15,194,0.37628866,0.015463918,0.541237113,0,0.009396796
26350,117,24392,10,11,0,0,0,21,10,10,0,0,0,20,win,win,plwin,beat,25,0,21,173,0.410404624,0.069364162,0.606936416,2,0.578610282
26351,143,24392,3,11,5,0,0,19,10,10,0,0,0,20,nowin,loss,beat,dlwin,0,10,14,203,0.463054187,0.044334975,0.57635468,3,0.883143365
26352,138,24393,3,6,6,9,0,24,10,6,6,0,0,22,nowin,loss,bust,plbust,0,10,9,190,0.442105263,0.047368421,0.610526316,2,0.609711065
26353,16,24393,6,1,10,0,0,17,10,6,6,0,0,22,nowin,win,dlbust,bust,20,0,7,220,0.427272727,0.081818182,0.6,2,0.588660176
26354,57,24393,7,10,0,0,0,17,10,6,6,0,0,22,nowin,win,dlbust,bust,20,0,17,192,0.46875,0.052083333,0.59375,3,0.907001181
26355,133,24393,5,6,10,0,0,21,10,6,6,0,0,22,nowin,win,dlbust,bust,20,0,11,201,0.47761194,0.064676617,0.611940299,3,0.935428111
26356,12,24393,7,11,0,0,0,18,10,6,6,0,0,22,nowin,win,dlbust,bust,20,0,18,189,0.470899471,0.015873016,0.613756614,3,0.929171178
26357,65,24393,8,10,0,0,0,18,10,6,6,0,0,22,nowin,win,dlbust,bust,20,0,18,203,0.492610837,0.054187192,0.571428571,3,0.913702814
26358,29,24394,10,11,0,0,0,21,2,10,10,0,0,22,win,win,dlbust,bust,25,0,21,189,0.44973545,0.058201058,0.544973545,1,0.300349439
26359,15,24394,8,10,0,0,0,18,2,10,10,0,0,22,nowin,win,dlbust,bust,20,0,18,212,0.410377358,0.051886792,0.561320755,0,0.024517408
26360,110,24394,8,2,11,0,0,21,2,10,10,0,0,22,nowin,win,dlbust,bust,20,0,10,192,0.416666667,0.046875,0.557291667,0,0.025413132
26361,137,24394,5,9,0,0,0,14,2,10,10,0,0,22,nowin,win,dlbust,bust,20,0,14,194,0.417525773,0.046391753,0.536082474,1,0.276714602
26362,86,24394,5,7,0,2,0,14,2,10,10,0,0,22,nowin,win,dlbust,bust,20,0,12,196,0.454081633,0.040816327,0.591836735,3,0.887566443
26363,40,24394,7,4,10,0,0,21,2,10,10,0,0,22,nowin,win,dlbust,bust,20,0,11,196,0.367346939,0.030612245,0.617346939,0,0.025358183
26364,102,24395,10,9,0,0,0,19,10,2,6,0,0,18,nowin,win,plwin,beat,20,0,19,192,0.338541667,0.046875,0.5625,0,0.003306118
26365,32,24395,4,5,5,2,10,26,10,2,6,0,0,18,nowin,loss,bust,plbust,0,10,9,189,0.391534392,0.037037037,0.53968254,0,0.013579086
26366,18,24395,10,5,0,6,0,21,10,2,6,0,0,18,nowin,win,plwin,beat,20,0,15,182,0.461538462,0.043956044,0.587912088,3,0.892649374
26367,59,24395,11,2,1,6,0,20,10,2,6,0,0,18,nowin,win,plwin,beat,20,0,13,228,0.429824561,0.048245614,0.543859649,1,0.287885446
26368,11,24395,8,10,0,0,0,18,10,2,6,0,0,18,nowin,push,push,push,10,0,18,236,0.457627119,0.016949153,0.588983051,3,0.889015813
26369,96,24395,10,3,0,4,0,17,10,2,6,0,0,18,nowin,loss,beat,dlwin,0,10,13,190,0.468421053,0.057894737,0.584210526,3,0.897263354
26370,73,24396,4,10,0,0,0,14,4,10,10,0,0,24,nowin,win,dlbust,bust,20,0,14,181,0.375690608,0.011049724,0.596685083,0,0.022795773
26371,27,24396,2,5,9,0,0,16,4,10,10,0,0,24,nowin,win,dlbust,bust,20,0,7,178,0.370786517,0.016853933,0.573033708,0,0.015536309
26372,83,24396,4,10,0,0,0,14,4,10,10,0,0,24,nowin,win,dlbust,bust,20,0,14,193,0.424870466,0.051813472,0.678756477,2,0.644360335
26373,38,24396,4,7,10,0,0,21,4,10,10,0,0,24,nowin,win,dlbust,bust,20,0,11,202,0.361386139,0.03960396,0.564356436,0,0.010597953
26374,40,24396,2,2,11,0,0,15,4,10,10,0,0,24,nowin,win,dlbust,bust,20,0,4,196,0.367346939,0.030612245,0.617346939,0,0.025358183
26375,23,24396,10,10,0,0,0,20,4,10,10,0,0,24,nowin,win,dlbust,bust,20,0,20,208,0.427884615,0.0625,0.552884615,1,0.29114424
26376,94,24397,10,11,0,0,0,21,10,11,0,0,0,21,win,push,push,push,10,0,21,183,0.43715847,0.043715847,0.540983607,1,0.290866892
26377,37,24397,3,5,11,0,0,19,10,11,0,0,0,21,nowin,loss,beat,dlwin,0,10,8,208,0.394230769,0.038461538,0.581730769,0,0.024682772
26378,59,24397,1,1,10,8,0,20,10,11,0,0,0,21,nowin,loss,beat,dlwin,0,10,2,228,0.429824561,0.048245614,0.543859649,1,0.287885446
26379,96,24397,6,9,0,9,0,24,10,11,0,0,0,21,nowin,loss,bust,plbust,0,10,15,190,0.468421053,0.057894737,0.584210526,3,0.897263354
26380,112,24397,10,10,0,0,0,20,10,11,0,0,0,21,nowin,loss,beat,dlwin,0,10,20,203,0.448275862,0.054187192,0.600985222,3,0.889576933
26381,119,24397,6,10,0,10,0,26,10,11,0,0,0,21,nowin,loss,bust,plbust,0,10,16,190,0.405263158,0.068421053,0.515789474,0,0.011837158
26382,21,24398,2,6,2,6,10,26,10,5,3,0,0,18,nowin,loss,bust,plbust,0,10,8,214,0.359813084,0.042056075,0.626168224,0,0.025263474
26383,124,24398,11,7,0,0,0,18,10,5,3,0,0,18,nowin,push,push,push,10,0,18,202,0.47029703,0.064356436,0.584158416,3,0.899458193
26384,48,24398,7,10,0,0,0,17,10,5,3,0,0,18,nowin,loss,beat,dlwin,0,10,17,203,0.413793103,0.019704433,0.600985222,2,0.577280801
26385,3,24398,4,11,3,0,0,18,10,5,3,0,0,18,nowin,push,push,push,10,0,15,190,0.431578947,0.026315789,0.542105263,1,0.288076384
26386,59,24398,1,4,9,6,0,20,10,5,3,0,0,18,nowin,win,plwin,beat,20,0,5,228,0.429824561,0.048245614,0.543859649,1,0.287885446
26387,112,24398,6,10,0,10,0,26,10,5,3,0,0,18,nowin,loss,bust,plbust,0,10,16,203,0.448275862,0.054187192,0.600985222,3,0.889576933
26388,97,24399,10,2,0,8,0,20,10,8,0,0,0,18,nowin,win,plwin,beat,20,0,12,182,0.450549451,0.06043956,0.692307692,2,0.677372279
26389,89,24399,3,10,0,10,0,23,10,8,0,0,0,18,nowin,loss,bust,plbust,0,10,13,212,0.537735849,0.047169811,0.594339623,3,0.990167191
26390,95,24399,10,5,0,10,0,25,10,8,0,0,0,18,nowin,loss,bust,plbust,0,10,15,218,0.412844037,0.04587156,0.559633028,0,0.024842385
26391,3,24399,10,10,0,0,0,20,10,8,0,0,0,18,nowin,win,plwin,beat,20,0,20,190,0.431578947,0.026315789,0.542105263,1,0.288076384
26392,50,24399,10,3,0,2,9,24,10,8,0,0,0,18,nowin,loss,bust,plbust,0,10,13,202,0.405940594,0.04950495,0.54950495,0,0.020296079
26393,91,24399,2,10,0,6,0,18,10,8,0,0,0,18,nowin,push,push,push,10,0,12,194,0.417525773,0.046391753,0.515463918,1,0.266616552
26394,21,24400,10,10,0,0,0,20,10,6,10,0,0,26,nowin,win,dlbust,bust,20,0,20,214,0.359813084,0.042056075,0.626168224,0,0.025263474
26395,27,24400,4,8,0,4,7,23,10,6,10,0,0,26,nowin,loss,bust,plbust,0,10,12,178,0.370786517,0.016853933,0.573033708,0,0.015536309
26396,15,24400,8,2,5,10,0,25,10,6,10,0,0,26,nowin,loss,bust,plbust,0,10,10,212,0.410377358,0.051886792,0.561320755,0,0.024517408
26397,107,24400,7,2,9,0,0,18,10,6,10,0,0,26,nowin,win,dlbust,bust,20,0,9,218,0.444954128,0.073394495,0.600917431,2,0.605210014
26398,30,24400,2,10,0,1,10,23,10,6,10,0,0,26,nowin,loss,bust,plbust,0,10,12,206,0.393203883,0.033980583,0.601941748,0,0.029324648
26399,104,24400,6,10,0,8,0,24,10,6,10,0,0,26,nowin,loss,bust,plbust,0,10,16,209,0.363636364,0.052631579,0.593301435,0,0.018359419
26400,18,24401,8,8,0,10,0,26,10,4,10,0,0,24,nowin,loss,bust,plbust,0,10,16,182,0.461538462,0.043956044,0.587912088,3,0.892649374
26401,51,24401,2,4,10,10,0,26,10,4,10,0,0,24,nowin,loss,bust,plbust,0,10,6,189,0.529100529,0.068783069,0.608465608,3,0.993665715
26402,24,24401,5,5,6,2,0,18,10,4,10,0,0,24,nowin,win,dlbust,bust,20,0,10,207,0.458937198,0.048309179,0.570048309,1,0.318138014
26403,57,24401,5,10,0,10,0,25,10,4,10,0,0,24,nowin,loss,bust,plbust,0,10,15,192,0.46875,0.052083333,0.59375,3,0.907001181
26404,106,24401,10,10,0,0,0,20,10,4,10,0,0,24,nowin,win,dlbust,bust,20,0,20,192,0.411458333,0.026041667,0.557291667,0,0.023854304
26405,104,24401,10,2,0,10,0,22,10,4,10,0,0,24,nowin,loss,bust,plbust,0,10,12,209,0.363636364,0.052631579,0.593301435,0,0.018359419
26406,54,24402,6,2,9,0,0,17,4,5,4,5,0,18,nowin,loss,beat,dlwin,0,10,8,185,0.437837838,0.032432432,0.556756757,1,0.29899854
26407,71,24402,4,4,10,0,0,18,4,5,4,5,0,18,nowin,push,push,push,10,0,8,193,0.352331606,0.046632124,0.585492228,0,0.013063661
26408,92,24402,10,10,0,0,0,20,4,5,4,5,0,18,nowin,win,plwin,beat,20,0,20,186,0.446236559,0.059139785,0.564516129,1,0.307826125
26409,104,24402,10,10,0,0,0,20,4,5,4,5,0,18,nowin,win,plwin,beat,20,0,20,209,0.363636364,0.052631579,0.593301435,0,0.018359419
26410,40,24402,8,7,0,0,0,15,4,5,4,5,0,18,nowin,loss,beat,dlwin,0,10,15,196,0.367346939,0.030612245,0.617346939,0,0.025358183
26411,72,24402,10,11,0,0,0,21,4,5,4,5,0,18,win,win,plwin,beat,25,0,21,185,0.394594595,0.032432432,0.508108108,0,0.006763115
26412,44,24403,8,10,0,0,0,18,10,5,4,0,0,19,nowin,loss,beat,dlwin,0,10,18,219,0.433789954,0.050228311,0.534246575,1,0.285551035
26413,11,24403,6,8,0,9,0,23,10,5,4,0,0,19,nowin,loss,bust,plbust,0,10,14,236,0.457627119,0.016949153,0.588983051,3,0.889015813
26414,42,24403,8,7,0,2,0,17,10,5,4,0,0,19,nowin,loss,beat,dlwin,0,10,15,212,0.443396226,0.051886792,0.570754717,1,0.309181312
26415,150,24403,3,10,0,1,10,24,10,5,4,0,0,19,nowin,loss,bust,plbust,0,10,13,192,0.401041667,0.036458333,0.567708333,0,0.023287458
26416,104,24403,3,4,10,0,0,17,10,5,4,0,0,19,nowin,loss,beat,dlwin,0,10,7,209,0.363636364,0.052631579,0.593301435,0,0.018359419
26417,113,24403,10,10,0,0,0,20,10,5,4,0,0,19,nowin,win,plwin,beat,20,0,20,199,0.407035176,0.055276382,0.668341709,2,0.620695264
26418,83,24404,6,8,0,0,0,14,3,10,5,0,0,18,nowin,loss,beat,dlwin,0,10,14,193,0.424870466,0.051813472,0.678756477,2,0.644360335
26419,48,24404,5,6,6,0,0,17,3,10,5,0,0,18,nowin,loss,beat,dlwin,0,10,11,203,0.413793103,0.019704433,0.600985222,2,0.577280801
26420,40,24404,5,10,0,0,0,15,3,10,5,0,0,18,nowin,loss,beat,dlwin,0,10,15,196,0.367346939,0.030612245,0.617346939,0,0.025358183
26421,78,24404,8,10,0,0,0,18,3,10,5,0,0,18,nowin,push,push,push,10,0,18,201,0.517412935,0.034825871,0.587064677,3,0.95871112
26422,18,24404,10,3,0,0,0,13,3,10,5,0,0,18,nowin,loss,beat,dlwin,0,10,13,182,0.461538462,0.043956044,0.587912088,3,0.892649374
26423,18,24404,3,6,10,0,0,19,3,10,5,0,0,18,nowin,win,plwin,beat,20,0,9,182,0.461538462,0.043956044,0.587912088,3,0.892649374
26424,41,24405,10,4,0,10,0,24,10,6,9,0,0,25,nowin,loss,bust,plbust,0,10,14,192,0.364583333,0.036458333,0.520833333,0,0.00089702
26425,47,24405,5,3,6,7,0,21,10,6,9,0,0,25,nowin,win,dlbust,bust,20,0,8,210,0.438095238,0.057142857,0.623809524,2,0.615868808
26426,149,24405,10,10,0,0,0,20,10,6,9,0,0,25,nowin,win,dlbust,bust,20,0,20,225,0.457777778,0.057777778,0.648888889,2,0.651965595
26427,48,24405,10,5,0,8,0,23,10,6,9,0,0,25,nowin,loss,bust,plbust,0,10,15,203,0.413793103,0.019704433,0.600985222,2,0.577280801
26428,34,24405,6,3,6,3,0,18,10,6,9,0,0,25,nowin,win,dlbust,bust,20,0,9,202,0.5,0.079207921,0.618811881,3,0.968961434
26429,142,24405,10,5,0,10,0,25,10,6,9,0,0,25,nowin,loss,bust,plbust,0,10,15,211,0.417061611,0.047393365,0.526066351,1,0.271531309
26430,96,24406,10,5,0,2,0,17,9,5,10,0,0,24,nowin,win,dlbust,bust,20,0,15,190,0.468421053,0.057894737,0.584210526,3,0.897263354
26431,135,24406,10,11,0,0,0,21,9,5,10,0,0,24,win,win,dlbust,bust,25,0,21,179,0.391061453,0.067039106,0.586592179,0,0.024924662
26432,133,24406,10,5,0,5,0,20,9,5,10,0,0,24,nowin,win,dlbust,bust,20,0,15,201,0.47761194,0.064676617,0.611940299,3,0.935428111
26433,13,24406,2,10,0,10,0,22,9,5,10,0,0,24,nowin,loss,bust,plbust,0,10,12,206,0.417475728,0.063106796,0.621359223,2,0.59555479
26434,38,24406,10,6,0,3,0,19,9,5,10,0,0,24,nowin,win,dlbust,bust,20,0,16,202,0.361386139,0.03960396,0.564356436,0,0.010597953
26435,3,24406,8,2,6,10,0,26,9,5,10,0,0,24,nowin,loss,bust,plbust,0,10,10,190,0.431578947,0.026315789,0.542105263,1,0.288076384
26436,81,24407,1,5,8,3,0,17,10,8,0,0,0,18,nowin,loss,beat,dlwin,0,10,6,182,0.395604396,0.043956044,0.60989011,2,0.567491261
26437,138,24407,10,2,0,10,0,22,10,8,0,0,0,18,nowin,loss,bust,plbust,0,10,12,190,0.442105263,0.047368421,0.610526316,2,0.609711065
26438,116,24407,10,5,0,6,0,21,10,8,0,0,0,18,nowin,win,plwin,beat,20,0,15,195,0.425641026,0.056410256,0.538461538,1,0.28273747
26439,24,24407,4,4,10,0,0,18,10,8,0,0,0,18,nowin,push,push,push,10,0,8,207,0.458937198,0.048309179,0.570048309,1,0.318138014
26440,46,24407,10,10,0,0,0,20,10,8,0,0,0,18,nowin,win,plwin,beat,20,0,20,186,0.403225806,0.048387097,0.591397849,0,0.029742194
26441,54,24407,2,9,7,0,0,18,10,8,0,0,0,18,nowin,push,push,push,10,0,11,185,0.437837838,0.032432432,0.556756757,1,0.29899854
26442,31,24408,2,2,10,6,0,20,10,7,0,0,0,17,nowin,win,plwin,beat,20,0,4,188,0.473404255,0.058510638,0.515957447,1,0.300306557
26443,122,24408,4,8,0,6,0,18,10,7,0,0,0,17,nowin,win,plwin,beat,20,0,12,210,0.347619048,0.052380952,0.59047619,0,0.012873677
26444,6,24408,4,10,0,1,3,18,10,7,0,0,0,17,nowin,win,plwin,beat,20,0,14,191,0.439790576,0.047120419,0.581151832,1,0.31211505
26445,15,24408,6,10,0,2,0,18,10,7,0,0,0,17,nowin,win,plwin,beat,20,0,16,212,0.410377358,0.051886792,0.561320755,0,0.024517408
26446,119,24408,2,2,10,6,0,20,10,7,0,0,0,17,nowin,win,plwin,beat,20,0,4,190,0.405263158,0.068421053,0.515789474,0,0.011837158
26447,113,24408,5,1,10,3,0,19,10,7,0,0,0,17,nowin,win,plwin,beat,20,0,6,199,0.407035176,0.055276382,0.668341709,2,0.620695264
26448,30,24409,2,10,0,9,0,21,10,5,4,0,0,19,nowin,win,plwin,beat,20,0,12,206,0.393203883,0.033980583,0.601941748,0,0.029324648
26449,55,24409,10,9,0,0,0,19,10,5,4,0,0,19,nowin,push,push,push,10,0,19,191,0.371727749,0.057591623,0.54973822,0,0.01011347
26450,50,24409,8,6,0,1,1,16,10,5,4,0,0,19,nowin,loss,beat,dlwin,0,10,14,202,0.405940594,0.04950495,0.54950495,0,0.020296079
26451,76,24409,5,1,7,7,0,20,10,5,4,0,0,19,nowin,win,plwin,beat,20,0,6,189,0.534391534,0.079365079,0.608465608,3,1
26452,12,24409,3,10,0,7,0,20,10,5,4,0,0,19,nowin,win,plwin,beat,20,0,13,189,0.470899471,0.015873016,0.613756614,3,0.929171178
26453,148,24409,7,10,0,0,0,17,10,5,4,0,0,19,nowin,loss,beat,dlwin,0,10,17,204,0.401960784,0.078431373,0.593137255,0,0.029789521
26454,58,24410,8,6,0,3,0,17,8,10,0,0,0,18,nowin,loss,beat,dlwin,0,10,14,195,0.430769231,0.041025641,0.584615385,2,0.580497586
26455,37,24410,10,9,0,0,0,19,8,10,0,0,0,18,nowin,win,plwin,beat,20,0,19,208,0.394230769,0.038461538,0.581730769,0,0.024682772
26456,23,24410,4,10,0,5,0,19,8,10,0,0,0,18,nowin,win,plwin,beat,20,0,14,208,0.427884615,0.0625,0.552884615,1,0.29114424
26457,108,24410,10,8,0,0,0,18,8,10,0,0,0,18,nowin,push,push,push,10,0,18,193,0.435233161,0.056994819,0.559585492,1,0.298824795
26458,11,24410,9,5,0,10,0,24,8,10,0,0,0,18,nowin,loss,bust,plbust,0,10,14,236,0.457627119,0.016949153,0.588983051,3,0.889015813
26459,45,24410,9,10,0,0,0,19,8,10,0,0,0,18,nowin,win,plwin,beat,20,0,19,196,0.428571429,0.051020408,0.612244898,2,0.598821767
26460,129,24411,5,1,10,9,0,25,8,3,7,0,0,18,nowin,loss,bust,plbust,0,10,6,201,0.422885572,0.064676617,0.55721393,0,0.027255383
26461,86,24411,2,2,3,8,9,24,8,3,7,0,0,18,nowin,loss,bust,plbust,0,10,4,196,0.454081633,0.040816327,0.591836735,3,0.887566443
26462,88,24411,10,9,0,0,0,19,8,3,7,0,0,18,nowin,win,plwin,beat,20,0,19,206,0.466019417,0.033980583,0.54368932,1,0.309467903
26463,124,24411,10,6,0,7,0,23,8,3,7,0,0,18,nowin,loss,bust,plbust,0,10,16,202,0.47029703,0.064356436,0.584158416,3,0.899458193
26464,7,24411,10,3,0,9,0,22,8,3,7,0,0,18,nowin,loss,bust,plbust,0,10,13,183,0.442622951,0.06010929,0.62295082,2,0.619303341
26465,142,24411,4,4,5,10,0,23,8,3,7,0,0,18,nowin,loss,bust,plbust,0,10,8,211,0.417061611,0.047393365,0.526066351,1,0.271531309
26466,85,24412,2,2,10,0,0,14,2,6,9,0,0,17,nowin,loss,beat,dlwin,0,10,4,195,0.41025641,0.066666667,0.594871795,0,0.03269711
26467,28,24412,6,10,0,0,0,16,2,6,9,0,0,17,nowin,loss,beat,dlwin,0,10,16,199,0.422110553,0.045226131,0.542713568,1,0.282706618
26468,60,24412,11,9,0,0,0,20,2,6,9,0,0,17,nowin,win,plwin,beat,20,0,20,227,0.418502203,0.022026432,0.559471366,0,0.026496258
26469,125,24412,10,6,0,0,0,16,2,6,9,0,0,17,nowin,loss,beat,dlwin,0,10,16,219,0.438356164,0.050228311,0.575342466,1,0.308411257
26470,2,24412,6,10,0,0,0,16,2,6,9,0,0,17,nowin,loss,beat,dlwin,0,10,16,200,0.445,0.035,0.64,2,0.633962549
26471,80,24412,6,10,0,0,0,16,2,6,9,0,0,17,nowin,loss,beat,dlwin,0,10,16,186,0.419354839,0.059139785,0.623655914,2,0.59892924
26472,53,24413,10,11,0,0,0,21,10,7,0,0,0,17,win,win,plwin,beat,25,0,21,250,0.372,0.064,0.564,0,0.013687345
26473,139,24413,11,7,0,0,0,18,10,7,0,0,0,17,nowin,win,plwin,beat,20,0,18,192,0.380208333,0.036458333,0.59375,0,0.023429169
26474,44,24413,6,10,0,8,0,24,10,7,0,0,0,17,nowin,loss,bust,plbust,0,10,16,219,0.433789954,0.050228311,0.534246575,1,0.285551035
26475,6,24413,9,5,0,3,0,17,10,7,0,0,0,17,nowin,push,push,push,10,0,14,191,0.439790576,0.047120419,0.581151832,1,0.31211505
26476,79,24413,3,4,5,6,0,18,10,7,0,0,0,17,nowin,win,plwin,beat,20,0,7,211,0.436018957,0.028436019,0.672985782,2,0.650131054
26477,34,24413,7,8,0,8,0,23,10,7,0,0,0,17,nowin,loss,bust,plbust,0,10,15,202,0.5,0.079207921,0.618811881,3,0.968961434
26478,76,24414,7,9,0,0,0,16,4,9,9,0,0,22,nowin,win,dlbust,bust,20,0,16,189,0.534391534,0.079365079,0.608465608,3,1
26479,39,24414,3,8,6,0,0,17,4,9,9,0,0,22,nowin,win,dlbust,bust,20,0,11,191,0.429319372,0.062827225,0.57591623,0,0.033760763
26480,32,24414,8,10,0,0,0,18,4,9,9,0,0,22,nowin,win,dlbust,bust,20,0,18,189,0.391534392,0.037037037,0.53968254,0,0.013579086
26481,58,24414,10,5,0,0,0,15,4,9,9,0,0,22,nowin,win,dlbust,bust,20,0,15,195,0.430769231,0.041025641,0.584615385,2,0.580497586
26482,133,24414,5,10,0,0,0,15,4,9,9,0,0,22,nowin,win,dlbust,bust,20,0,15,201,0.47761194,0.064676617,0.611940299,3,0.935428111
26483,120,24414,4,1,10,0,0,15,4,9,9,0,0,22,nowin,win,dlbust,bust,20,0,5,202,0.440594059,0.034653465,0.618811881,2,0.614441029
26484,87,24415,10,10,0,0,0,20,9,10,0,0,0,19,nowin,win,plwin,beat,20,0,20,202,0.405940594,0.054455446,0.628712871,2,0.590599801
26485,100,24415,10,11,0,0,0,21,9,10,0,0,0,19,win,win,plwin,beat,25,0,21,190,0.452631579,0.036842105,0.594736842,3,0.888671154
26486,128,24415,10,6,0,10,0,26,9,10,0,0,0,19,nowin,loss,bust,plbust,0,10,16,227,0.356828194,0.052863436,0.577092511,0,0.012352564
26487,98,24415,8,10,0,0,0,18,9,10,0,0,0,19,nowin,loss,beat,dlwin,0,10,18,220,0.422727273,0.054545455,0.55,1,0.28664435
26488,12,24415,2,10,0,8,0,20,9,10,0,0,0,19,nowin,win,plwin,beat,20,0,12,189,0.470899471,0.015873016,0.613756614,3,0.929171178
26489,102,24415,9,4,0,3,8,24,9,10,0,0,0,19,nowin,loss,bust,plbust,0,10,13,192,0.338541667,0.046875,0.5625,0,0.003306118
26490,136,24416,2,5,10,0,0,17,2,11,4,0,0,17,nowin,push,push,push,10,0,7,194,0.396907216,0.025773196,0.597938144,0,0.029452644
26491,79,24416,5,8,0,0,0,13,2,11,4,0,0,17,nowin,loss,beat,dlwin,0,10,13,211,0.436018957,0.028436019,0.672985782,2,0.650131054
26492,97,24416,10,7,0,0,0,17,2,11,4,0,0,17,nowin,push,push,push,10,0,17,182,0.450549451,0.06043956,0.692307692,2,0.677372279
26493,7,24416,10,2,0,1,0,13,2,11,4,0,0,17,nowin,loss,beat,dlwin,0,10,12,183,0.442622951,0.06010929,0.62295082,2,0.619303341
26494,49,24416,7,11,0,0,0,18,2,11,4,0,0,17,nowin,win,plwin,beat,20,0,18,207,0.396135266,0.053140097,0.594202899,0,0.028306925
26495,28,24416,10,10,0,0,0,20,2,11,4,0,0,17,nowin,win,plwin,beat,20,0,20,199,0.422110553,0.045226131,0.542713568,1,0.282706618
26496,139,24417,7,11,0,0,0,18,8,4,6,0,0,18,nowin,push,push,push,10,0,18,192,0.380208333,0.036458333,0.59375,0,0.023429169
26497,70,24417,5,10,0,8,0,23,8,4,6,0,0,18,nowin,loss,bust,plbust,0,10,15,228,0.385964912,0.039473684,0.557017544,0,0.016157125
26498,91,24417,10,5,0,1,8,24,8,4,6,0,0,18,nowin,loss,bust,plbust,0,10,15,194,0.417525773,0.046391753,0.515463918,1,0.266616552
26499,44,24417,5,8,0,7,0,20,8,4,6,0,0,18,nowin,win,plwin,beat,20,0,13,219,0.433789954,0.050228311,0.534246575,1,0.285551035
26500,114,24417,6,10,0,5,0,21,8,4,6,0,0,18,nowin,win,plwin,beat,20,0,16,198,0.47979798,0.025252525,0.611111111,3,0.937232995
26501,48,24417,7,6,0,10,0,23,8,4,6,0,0,18,nowin,loss,bust,plbust,0,10,13,203,0.413793103,0.019704433,0.600985222,2,0.577280801
26502,9,24418,8,10,0,0,0,18,4,10,1,4,0,19,nowin,loss,beat,dlwin,0,10,18,194,0.37628866,0.015463918,0.541237113,0,0.009396796
26503,110,24418,8,2,2,0,0,12,4,10,1,4,0,19,nowin,loss,beat,dlwin,0,10,10,192,0.416666667,0.046875,0.557291667,0,0.025413132
26504,75,24418,8,4,0,0,0,12,4,10,1,4,0,19,nowin,loss,beat,dlwin,0,10,12,191,0.418848168,0.052356021,0.570680628,0,0.029344702
26505,41,24418,10,4,0,0,0,14,4,10,1,4,0,19,nowin,loss,beat,dlwin,0,10,14,192,0.364583333,0.036458333,0.520833333,0,0.00089702
26506,52,24418,1,2,10,0,0,13,4,10,1,4,0,19,nowin,loss,beat,dlwin,0,10,3,217,0.414746544,0.02764977,0.599078341,2,0.576736024
26507,119,24418,11,9,0,0,0,20,4,10,1,4,0,19,nowin,win,plwin,beat,20,0,20,190,0.405263158,0.068421053,0.515789474,0,0.011837158
26508,26,24419,1,2,9,5,0,17,10,9,0,0,0,19,nowin,loss,beat,dlwin,0,10,3,203,0.463054187,0.0591133,0.541871921,1,0.306802864
26509,106,24419,6,5,4,3,0,18,10,9,0,0,0,19,nowin,loss,beat,dlwin,0,10,11,192,0.411458333,0.026041667,0.557291667,0,0.023854304
26510,13,24419,10,10,0,0,0,20,10,9,0,0,0,19,nowin,win,plwin,beat,20,0,20,206,0.417475728,0.063106796,0.621359223,2,0.59555479
26511,54,24419,3,5,6,6,0,20,10,9,0,0,0,19,nowin,win,plwin,beat,20,0,8,185,0.437837838,0.032432432,0.556756757,1,0.29899854
26512,145,24419,5,10,0,10,0,25,10,9,0,0,0,19,nowin,loss,bust,plbust,0,10,15,188,0.441489362,0.031914894,0.622340426,2,0.617837093
26513,56,24419,8,7,0,6,0,21,10,9,0,0,0,19,nowin,win,plwin,beat,20,0,15,175,0.4,0.057142857,0.582857143,0,0.026685297
26514,129,24420,4,1,7,2,4,18,10,5,10,0,0,25,nowin,win,dlbust,bust,20,0,5,201,0.422885572,0.064676617,0.55721393,0,0.027255383
26515,85,24420,10,5,0,5,0,20,10,5,10,0,0,25,nowin,win,dlbust,bust,20,0,15,195,0.41025641,0.066666667,0.594871795,0,0.03269711
26516,35,24420,11,8,0,0,0,19,10,5,10,0,0,25,nowin,win,dlbust,bust,20,0,19,202,0.410891089,0.044554455,0.633663366,2,0.598681573
26517,1,24420,7,8,0,10,0,25,10,5,10,0,0,25,nowin,loss,bust,plbust,0,10,15,197,0.406091371,0.025380711,0.649746193,2,0.606186955
26518,73,24420,8,10,0,0,0,18,10,5,10,0,0,25,nowin,win,dlbust,bust,20,0,18,181,0.375690608,0.011049724,0.596685083,0,0.022795773
26519,39,24420,11,1,2,8,0,22,10,5,10,0,0,25,nowin,loss,bust,plbust,0,10,12,191,0.429319372,0.062827225,0.57591623,0,0.033760763
26520,60,24421,4,10,0,6,0,20,8,9,0,0,0,17,nowin,win,plwin,beat,20,0,14,227,0.418502203,0.022026432,0.559471366,0,0.026496258
26521,130,24421,9,10,0,0,0,19,8,9,0,0,0,17,nowin,win,plwin,beat,20,0,19,219,0.410958904,0.03652968,0.566210046,0,0.025888739
26522,30,24421,8,10,0,0,0,18,8,9,0,0,0,17,nowin,win,plwin,beat,20,0,18,206,0.393203883,0.033980583,0.601941748,0,0.029324648
26523,57,24421,3,10,0,4,0,17,8,9,0,0,0,17,nowin,push,push,push,10,0,13,192,0.46875,0.052083333,0.59375,3,0.907001181
26524,18,24421,10,6,0,10,0,26,8,9,0,0,0,17,nowin,loss,bust,plbust,0,10,16,182,0.461538462,0.043956044,0.587912088,3,0.892649374
26525,144,24421,4,10,0,2,10,26,8,9,0,0,0,17,nowin,loss,bust,plbust,0,10,14,202,0.386138614,0.054455446,0.564356436,0,0.018006244
26526,65,24422,6,10,0,0,0,16,2,7,2,2,1,14,nowin,win,plwin,beat,20,0,16,203,0.492610837,0.054187192,0.571428571,3,0.913702814
26527,8,24422,10,3,0,0,0,13,2,7,2,2,1,14,nowin,loss,beat,dlwin,0,10,13,181,0.44198895,0.071823204,0.596685083,2,0.599438402
26528,122,24422,7,2,10,0,0,19,2,7,2,2,1,14,nowin,win,plwin,beat,20,0,9,210,0.347619048,0.052380952,0.59047619,0,0.012873677
26529,72,24422,11,6,3,0,0,20,2,7,2,2,1,14,nowin,win,plwin,beat,20,0,17,185,0.394594595,0.032432432,0.508108108,0,0.006763115
26530,9,24422,9,10,0,0,0,19,2,7,2,2,1,14,nowin,win,plwin,beat,20,0,19,194,0.37628866,0.015463918,0.541237113,0,0.009396796
26531,128,24422,10,6,0,0,0,16,2,7,2,2,1,14,nowin,win,plwin,beat,20,0,16,227,0.356828194,0.052863436,0.577092511,0,0.012352564
26532,60,24423,5,10,0,0,0,15,4,3,8,6,0,21,nowin,loss,beat,dlwin,0,10,15,227,0.418502203,0.022026432,0.559471366,0,0.026496258
26533,113,24423,11,1,6,0,0,18,4,3,8,6,0,21,nowin,loss,beat,dlwin,0,10,12,199,0.407035176,0.055276382,0.668341709,2,0.620695264
26534,55,24423,5,8,0,0,0,13,4,3,8,6,0,21,nowin,loss,beat,dlwin,0,10,13,191,0.371727749,0.057591623,0.54973822,0,0.01011347
26535,42,24423,10,2,0,0,0,12,4,3,8,6,0,21,nowin,loss,beat,dlwin,0,10,12,212,0.443396226,0.051886792,0.570754717,1,0.309181312
26536,23,24423,9,10,0,0,0,19,4,3,8,6,0,21,nowin,loss,beat,dlwin,0,10,19,208,0.427884615,0.0625,0.552884615,1,0.29114424
26537,99,24423,11,10,0,0,0,21,4,3,8,6,0,21,win,push,push,push,10,0,21,207,0.47826087,0.062801932,0.637681159,3,0.961418446
26538,101,24424,6,10,0,0,0,16,6,10,10,0,0,26,nowin,win,dlbust,bust,20,0,16,205,0.424390244,0.068292683,0.63902439,2,0.614740646
26539,69,24424,4,10,0,0,0,14,6,10,10,0,0,26,nowin,win,dlbust,bust,20,0,14,194,0.365979381,0.030927835,0.515463918,0,0
26540,53,24424,3,4,10,0,0,17,6,10,10,0,0,26,nowin,win,dlbust,bust,20,0,7,250,0.372,0.064,0.564,0,0.013687345
26541,123,24424,7,8,0,0,0,15,6,10,10,0,0,26,nowin,win,dlbust,bust,20,0,15,205,0.43902439,0.034146341,0.614634146,2,0.609962544
26542,2,24424,7,9,0,0,0,16,6,10,10,0,0,26,nowin,win,dlbust,bust,20,0,16,200,0.445,0.035,0.64,2,0.633962549
26543,93,24424,5,10,0,0,0,15,6,10,10,0,0,26,nowin,win,dlbust,bust,20,0,15,175,0.485714286,0.051428571,0.548571429,1,0.323648091
26544,150,24425,6,5,10,0,0,21,11,7,0,0,0,18,nowin,win,plwin,beat,20,0,11,192,0.401041667,0.036458333,0.567708333,0,0.023287458
26545,78,24425,8,6,0,9,0,23,11,7,0,0,0,18,nowin,loss,bust,plbust,0,10,14,201,0.517412935,0.034825871,0.587064677,3,0.95871112
26546,127,24425,10,10,0,0,0,20,11,7,0,0,0,18,nowin,win,plwin,beat,20,0,20,201,0.402985075,0.029850746,0.60199005,0,0.032263937
26547,80,24425,5,9,0,2,2,18,11,7,0,0,0,18,nowin,push,push,push,10,0,14,186,0.419354839,0.059139785,0.623655914,2,0.59892924
26548,18,24425,8,5,0,10,0,23,11,7,0,0,0,18,nowin,loss,bust,plbust,0,10,13,182,0.461538462,0.043956044,0.587912088,3,0.892649374
26549,145,24425,6,3,10,0,0,19,11,7,0,0,0,18,nowin,win,plwin,beat,20,0,9,188,0.441489362,0.031914894,0.622340426,2,0.617837093
26550,41,24426,6,10,0,10,0,26,10,9,0,0,0,19,nowin,loss,bust,plbust,0,10,16,192,0.364583333,0.036458333,0.520833333,0,0.00089702
26551,53,24426,9,3,0,5,0,17,10,9,0,0,0,19,nowin,loss,beat,dlwin,0,10,12,250,0.372,0.064,0.564,0,0.013687345
26552,98,24426,5,1,10,10,0,26,10,9,0,0,0,19,nowin,loss,bust,plbust,0,10,6,220,0.422727273,0.054545455,0.55,1,0.28664435
26553,112,24426,10,8,0,0,0,18,10,9,0,0,0,19,nowin,loss,beat,dlwin,0,10,18,203,0.448275862,0.054187192,0.600985222,3,0.889576933
26554,27,24426,8,3,8,0,0,19,10,9,0,0,0,19,nowin,push,push,push,10,0,11,178,0.370786517,0.016853933,0.573033708,0,0.015536309
26555,35,24426,11,2,4,0,0,17,10,9,0,0,0,19,nowin,loss,beat,dlwin,0,10,13,202,0.410891089,0.044554455,0.633663366,2,0.598681573
26556,50,24427,10,10,0,0,0,20,2,5,3,10,0,20,nowin,push,push,push,10,0,20,202,0.405940594,0.04950495,0.54950495,0,0.020296079
26557,79,24427,8,3,8,0,0,19,2,5,3,10,0,20,nowin,loss,beat,dlwin,0,10,11,211,0.436018957,0.028436019,0.672985782,2,0.650131054
26558,84,24427,4,10,0,0,0,14,2,5,3,10,0,20,nowin,loss,beat,dlwin,0,10,14,195,0.379487179,0.056410256,0.569230769,0,0.017209119
26559,82,24427,6,11,4,0,0,21,2,5,3,10,0,20,nowin,win,plwin,beat,20,0,17,225,0.408888889,0.075555556,0.577777778,0,0.028101874
26560,127,24427,2,5,6,0,0,13,2,5,3,10,0,20,nowin,loss,beat,dlwin,0,10,7,201,0.402985075,0.029850746,0.60199005,0,0.032263937
26561,69,24427,10,10,0,0,0,20,2,5,3,10,0,20,nowin,push,push,push,10,0,20,194,0.365979381,0.030927835,0.515463918,0,0
26562,4,24428,10,5,0,10,0,25,10,10,0,0,0,20,nowin,loss,bust,plbust,0,10,15,217,0.460829493,0.036866359,0.562211982,1,0.315432839
26563,115,24428,10,7,0,0,0,17,10,10,0,0,0,20,nowin,loss,beat,dlwin,0,10,17,194,0.427835052,0.041237113,0.592783505,2,0.583863602
26564,44,24428,10,10,0,0,0,20,10,10,0,0,0,20,nowin,push,push,push,10,0,20,219,0.433789954,0.050228311,0.534246575,1,0.285551035
26565,60,24428,5,3,10,0,0,18,10,10,0,0,0,20,nowin,loss,beat,dlwin,0,10,8,227,0.418502203,0.022026432,0.559471366,0,0.026496258
26566,52,24428,7,2,2,10,0,21,10,10,0,0,0,20,nowin,win,plwin,beat,20,0,9,217,0.414746544,0.02764977,0.599078341,2,0.576736024
26567,16,24428,3,8,8,0,0,19,10,10,0,0,0,20,nowin,loss,beat,dlwin,0,10,11,220,0.427272727,0.081818182,0.6,2,0.588660176
26568,112,24429,2,2,9,10,0,23,10,4,2,10,0,26,nowin,loss,bust,plbust,0,10,4,203,0.448275862,0.054187192,0.600985222,3,0.889576933
26569,47,24429,5,11,2,0,0,18,10,4,2,10,0,26,nowin,win,dlbust,bust,20,0,16,210,0.438095238,0.057142857,0.623809524,2,0.615868808
26570,94,24429,6,4,10,0,0,20,10,4,2,10,0,26,nowin,win,dlbust,bust,20,0,10,183,0.43715847,0.043715847,0.540983607,1,0.290866892
26571,34,24429,3,6,4,6,0,19,10,4,2,10,0,26,nowin,win,dlbust,bust,20,0,9,202,0.5,0.079207921,0.618811881,3,0.968961434
26572,25,24429,10,6,0,10,0,26,10,4,2,10,0,26,nowin,loss,bust,plbust,0,10,16,190,0.463157895,0.063157895,0.536842105,1,0.304401563
26573,53,24429,2,10,0,3,1,16,10,4,2,10,0,26,nowin,win,dlbust,bust,20,0,12,250,0.372,0.064,0.564,0,0.013687345
26574,71,24430,6,4,5,10,0,25,7,10,0,0,0,17,nowin,loss,bust,plbust,0,10,10,193,0.352331606,0.046632124,0.585492228,0,0.013063661
26575,44,24430,7,10,0,0,0,17,7,10,0,0,0,17,nowin,push,push,push,10,0,17,219,0.433789954,0.050228311,0.534246575,1,0.285551035
26576,36,24430,10,8,0,0,0,18,7,10,0,0,0,17,nowin,win,plwin,beat,20,0,18,229,0.445414847,0.056768559,0.655021834,2,0.645370571
26577,123,24430,7,6,0,8,0,21,7,10,0,0,0,17,nowin,win,plwin,beat,20,0,13,205,0.43902439,0.034146341,0.614634146,2,0.609962544
26578,135,24430,11,10,0,0,0,21,7,10,0,0,0,17,win,win,plwin,beat,25,0,21,179,0.391061453,0.067039106,0.586592179,0,0.024924662
26579,129,24430,10,10,0,0,0,20,7,10,0,0,0,17,nowin,win,plwin,beat,20,0,20,201,0.422885572,0.064676617,0.55721393,0,0.027255383
26580,113,24431,10,11,0,0,0,21,2,9,9,0,0,20,win,win,plwin,beat,25,0,21,199,0.407035176,0.055276382,0.668341709,2,0.620695264
26581,86,24431,3,8,8,0,0,19,2,9,9,0,0,20,nowin,loss,beat,dlwin,0,10,11,196,0.454081633,0.040816327,0.591836735,3,0.887566443
26582,40,24431,9,7,0,0,0,16,2,9,9,0,0,20,nowin,loss,beat,dlwin,0,10,16,196,0.367346939,0.030612245,0.617346939,0,0.025358183
26583,30,24431,5,10,0,0,0,15,2,9,9,0,0,20,nowin,loss,beat,dlwin,0,10,15,206,0.393203883,0.033980583,0.601941748,0,0.029324648
26584,38,24431,2,2,10,0,0,14,2,9,9,0,0,20,nowin,loss,beat,dlwin,0,10,4,202,0.361386139,0.03960396,0.564356436,0,0.010597953
26585,30,24431,8,3,7,0,0,18,2,9,9,0,0,20,nowin,loss,beat,dlwin,0,10,11,206,0.393203883,0.033980583,0.601941748,0,0.029324648
26586,37,24432,4,10,0,10,0,24,7,4,6,0,0,17,nowin,loss,bust,plbust,0,10,14,208,0.394230769,0.038461538,0.581730769,0,0.024682772
26587,35,24432,7,9,0,6,0,22,7,4,6,0,0,17,nowin,loss,bust,plbust,0,10,16,202,0.410891089,0.044554455,0.633663366,2,0.598681573
26588,29,24432,9,3,0,9,0,21,7,4,6,0,0,17,nowin,win,plwin,beat,20,0,12,189,0.44973545,0.058201058,0.544973545,1,0.300349439
26589,148,24432,10,9,0,0,0,19,7,4,6,0,0,17,nowin,win,plwin,beat,20,0,19,204,0.401960784,0.078431373,0.593137255,0,0.029789521
26590,88,24432,5,2,3,9,0,19,7,4,6,0,0,17,nowin,win,plwin,beat,20,0,7,206,0.466019417,0.033980583,0.54368932,1,0.309467903
26591,36,24432,10,5,0,8,0,23,7,4,6,0,0,17,nowin,loss,bust,plbust,0,10,15,229,0.445414847,0.056768559,0.655021834,2,0.645370571
26592,9,24433,10,9,0,0,0,19,10,4,9,0,0,23,nowin,win,dlbust,bust,20,0,19,194,0.37628866,0.015463918,0.541237113,0,0.009396796
26593,53,24433,3,2,10,10,0,25,10,4,9,0,0,23,nowin,loss,bust,plbust,0,10,5,250,0.372,0.064,0.564,0,0.013687345
26594,44,24433,4,4,10,0,0,18,10,4,9,0,0,23,nowin,win,dlbust,bust,20,0,8,219,0.433789954,0.050228311,0.534246575,1,0.285551035
26595,104,24433,10,10,0,0,0,20,10,4,9,0,0,23,nowin,win,dlbust,bust,20,0,20,209,0.363636364,0.052631579,0.593301435,0,0.018359419
26596,106,24433,10,5,0,7,0,22,10,4,9,0,0,23,nowin,loss,bust,plbust,0,10,15,192,0.411458333,0.026041667,0.557291667,0,0.023854304
26597,65,24433,10,10,0,0,0,20,10,4,9,0,0,23,nowin,win,dlbust,bust,20,0,20,203,0.492610837,0.054187192,0.571428571,3,0.913702814
26598,34,24434,10,9,0,0,0,19,5,5,4,1,3,18,nowin,win,plwin,beat,20,0,19,202,0.5,0.079207921,0.618811881,3,0.968961434
26599,130,24434,10,7,0,0,0,17,5,5,4,1,3,18,nowin,loss,beat,dlwin,0,10,17,219,0.410958904,0.03652968,0.566210046,0,0.025888739
26600,115,24434,7,2,5,0,0,14,5,5,4,1,3,18,nowin,loss,beat,dlwin,0,10,9,194,0.427835052,0.041237113,0.592783505,2,0.583863602
26601,90,24434,10,7,0,0,0,17,5,5,4,1,3,18,nowin,loss,beat,dlwin,0,10,17,201,0.447761194,0.049751244,0.60199005,3,0.889945023
26602,98,24434,10,8,0,0,0,18,5,5,4,1,3,18,nowin,push,push,push,10,0,18,220,0.422727273,0.054545455,0.55,1,0.28664435
26603,101,24434,5,5,6,0,0,16,5,5,4,1,3,18,nowin,loss,beat,dlwin,0,10,10,205,0.424390244,0.068292683,0.63902439,2,0.614740646
26604,31,24435,3,5,2,2,0,12,4,6,7,0,0,17,nowin,loss,beat,dlwin,0,10,8,188,0.473404255,0.058510638,0.515957447,1,0.300306557
26605,8,24435,10,10,0,0,0,20,4,6,7,0,0,17,nowin,win,plwin,beat,20,0,20,181,0.44198895,0.071823204,0.596685083,2,0.599438402
26606,69,24435,10,5,0,0,0,15,4,6,7,0,0,17,nowin,loss,beat,dlwin,0,10,15,194,0.365979381,0.030927835,0.515463918,0,0
26607,56,24435,6,5,4,0,0,15,4,6,7,0,0,17,nowin,loss,beat,dlwin,0,10,11,175,0.4,0.057142857,0.582857143,0,0.026685297
26608,41,24435,7,9,0,0,0,16,4,6,7,0,0,17,nowin,loss,beat,dlwin,0,10,16,192,0.364583333,0.036458333,0.520833333,0,0.00089702
26609,59,24435,8,3,9,0,0,20,4,6,7,0,0,17,nowin,win,plwin,beat,20,0,11,228,0.429824561,0.048245614,0.543859649,1,0.287885446
26610,142,24436,10,10,0,0,0,20,10,10,0,0,0,20,nowin,push,push,push,10,0,20,211,0.417061611,0.047393365,0.526066351,1,0.271531309
26611,50,24436,10,4,0,10,0,24,10,10,0,0,0,20,nowin,loss,bust,plbust,0,10,14,202,0.405940594,0.04950495,0.54950495,0,0.020296079
26612,69,24436,5,2,10,0,0,17,10,10,0,0,0,20,nowin,loss,beat,dlwin,0,10,7,194,0.365979381,0.030927835,0.515463918,0,0
26613,127,24436,4,5,8,0,0,17,10,10,0,0,0,20,nowin,loss,beat,dlwin,0,10,9,201,0.402985075,0.029850746,0.60199005,0,0.032263937
26614,52,24436,6,8,0,4,0,18,10,10,0,0,0,20,nowin,loss,beat,dlwin,0,10,14,217,0.414746544,0.02764977,0.599078341,2,0.576736024
26615,87,24436,3,4,8,5,0,20,10,10,0,0,0,20,nowin,push,push,push,10,0,7,202,0.405940594,0.054455446,0.628712871,2,0.590599801
26616,2,24437,7,6,0,0,0,13,4,2,6,8,0,20,nowin,loss,beat,dlwin,0,10,13,200,0.445,0.035,0.64,2,0.633962549
26617,54,24437,10,7,0,0,0,17,4,2,6,8,0,20,nowin,loss,beat,dlwin,0,10,17,185,0.437837838,0.032432432,0.556756757,1,0.29899854
26618,72,24437,2,3,8,0,0,13,4,2,6,8,0,20,nowin,loss,beat,dlwin,0,10,5,185,0.394594595,0.032432432,0.508108108,0,0.006763115
26619,74,24437,5,10,0,0,0,15,4,2,6,8,0,20,nowin,loss,beat,dlwin,0,10,15,209,0.411483254,0.04784689,0.531100478,0,0.017448125
26620,124,24437,3,6,10,0,0,19,4,2,6,8,0,20,nowin,loss,beat,dlwin,0,10,9,202,0.47029703,0.064356436,0.584158416,3,0.899458193
26621,116,24437,8,10,0,0,0,18,4,2,6,8,0,20,nowin,loss,beat,dlwin,0,10,18,195,0.425641026,0.056410256,0.538461538,1,0.28273747
26622,7,24438,10,10,0,0,0,20,5,8,8,0,0,21,nowin,loss,beat,dlwin,0,10,20,183,0.442622951,0.06010929,0.62295082,2,0.619303341
26623,23,24438,4,3,5,0,0,12,5,8,8,0,0,21,nowin,loss,beat,dlwin,0,10,7,208,0.427884615,0.0625,0.552884615,1,0.29114424
26624,97,24438,4,3,10,0,0,17,5,8,8,0,0,21,nowin,loss,beat,dlwin,0,10,7,182,0.450549451,0.06043956,0.692307692,2,0.677372279
26625,114,24438,3,5,4,0,0,12,5,8,8,0,0,21,nowin,loss,beat,dlwin,0,10,8,198,0.47979798,0.025252525,0.611111111,3,0.937232995
26626,61,24438,10,10,0,0,0,20,5,8,8,0,0,21,nowin,loss,beat,dlwin,0,10,20,194,0.427835052,0.077319588,0.603092784,2,0.591437139
26627,94,24438,10,6,0,0,0,16,5,8,8,0,0,21,nowin,loss,beat,dlwin,0,10,16,183,0.43715847,0.043715847,0.540983607,1,0.290866892
26628,123,24439,2,9,10,0,0,21,2,5,8,4,0,19,nowin,win,plwin,beat,20,0,11,205,0.43902439,0.034146341,0.614634146,2,0.609962544
26629,136,24439,3,10,0,0,0,13,2,5,8,4,0,19,nowin,loss,beat,dlwin,0,10,13,194,0.396907216,0.025773196,0.597938144,0,0.029452644
26630,37,24439,10,11,0,0,0,21,2,5,8,4,0,19,win,win,plwin,beat,25,0,21,208,0.394230769,0.038461538,0.581730769,0,0.024682772
26631,62,24439,10,10,0,0,0,20,2,5,8,4,0,19,nowin,win,plwin,beat,20,0,20,178,0.370786517,0.028089888,0.54494382,0,0.008657722
26632,84,24439,10,4,0,0,0,14,2,5,8,4,0,19,nowin,loss,beat,dlwin,0,10,14,195,0.379487179,0.056410256,0.569230769,0,0.017209119
26633,146,24439,7,6,0,0,0,13,2,5,8,4,0,19,nowin,loss,beat,dlwin,0,10,13,221,0.43438914,0.040723982,0.542986425,1,0.290190091
26634,94,24440,10,7,0,0,0,17,10,7,0,0,0,17,nowin,push,push,push,10,0,17,183,0.43715847,0.043715847,0.540983607,1,0.290866892
26635,134,24440,6,4,4,8,0,22,10,7,0,0,0,17,nowin,loss,bust,plbust,0,10,10,185,0.443243243,0.021621622,0.545945946,1,0.296939509
26636,147,24440,10,10,0,0,0,20,10,7,0,0,0,17,nowin,win,plwin,beat,20,0,20,205,0.380487805,0.014634146,0.536585366,0,0.00951447
26637,71,24440,5,4,7,4,0,20,10,7,0,0,0,17,nowin,win,plwin,beat,20,0,9,193,0.352331606,0.046632124,0.585492228,0,0.013063661
26638,127,24440,1,6,10,0,0,17,10,7,0,0,0,17,nowin,push,push,push,10,0,7,201,0.402985075,0.029850746,0.60199005,0,0.032263937
26639,124,24440,11,10,0,0,0,21,10,7,0,0,0,17,win,win,plwin,beat,25,0,21,202,0.47029703,0.064356436,0.584158416,3,0.899458193
26640,118,24441,5,10,0,10,0,25,10,5,7,0,0,22,nowin,loss,bust,plbust,0,10,15,216,0.393518519,0.037037037,0.555555556,0,0.018059873
26641,60,24441,10,6,0,6,0,22,10,5,7,0,0,22,nowin,loss,bust,plbust,0,10,16,227,0.418502203,0.022026432,0.559471366,0,0.026496258
26642,91,24441,10,7,0,0,0,17,10,5,7,0,0,22,nowin,win,dlbust,bust,20,0,17,194,0.417525773,0.046391753,0.515463918,1,0.266616552
26643,53,24441,10,10,0,0,0,20,10,5,7,0,0,22,nowin,win,dlbust,bust,20,0,20,250,0.372,0.064,0.564,0,0.013687345
26644,10,24441,10,2,0,1,9,22,10,5,7,0,0,22,nowin,loss,bust,plbust,0,10,12,191,0.413612565,0.057591623,0.596858639,2,0.574087175
26645,39,24441,6,2,10,0,0,18,10,5,7,0,0,22,nowin,win,dlbust,bust,20,0,8,191,0.429319372,0.062827225,0.57591623,0,0.033760763
26646,27,24442,6,7,0,0,0,13,3,9,5,0,0,17,nowin,loss,beat,dlwin,0,10,13,178,0.370786517,0.016853933,0.573033708,0,0.015536309
26647,144,24442,7,4,10,0,0,21,3,9,5,0,0,17,nowin,win,plwin,beat,20,0,11,202,0.386138614,0.054455446,0.564356436,0,0.018006244
26648,28,24442,9,5,0,0,0,14,3,9,5,0,0,17,nowin,loss,beat,dlwin,0,10,14,199,0.422110553,0.045226131,0.542713568,1,0.282706618
26649,40,24442,10,2,0,1,0,13,3,9,5,0,0,17,nowin,loss,beat,dlwin,0,10,12,196,0.367346939,0.030612245,0.617346939,0,0.025358183
26650,93,24442,2,2,5,10,0,19,3,9,5,0,0,17,nowin,win,plwin,beat,20,0,4,175,0.485714286,0.051428571,0.548571429,1,0.323648091
26651,91,24442,5,2,6,0,0,13,3,9,5,0,0,17,nowin,loss,beat,dlwin,0,10,7,194,0.417525773,0.046391753,0.515463918,1,0.266616552
26652,93,24443,4,5,3,9,0,21,10,4,4,0,0,18,nowin,win,plwin,beat,20,0,9,175,0.485714286,0.051428571,0.548571429,1,0.323648091
26653,24,24443,10,6,0,10,0,26,10,4,4,0,0,18,nowin,loss,bust,plbust,0,10,16,207,0.458937198,0.048309179,0.570048309,1,0.318138014
26654,98,24443,10,7,0,0,0,17,10,4,4,0,0,18,nowin,loss,beat,dlwin,0,10,17,220,0.422727273,0.054545455,0.55,1,0.28664435
26655,88,24443,6,4,6,3,0,19,10,4,4,0,0,18,nowin,win,plwin,beat,20,0,10,206,0.466019417,0.033980583,0.54368932,1,0.309467903
26656,37,24443,10,5,0,4,0,19,10,4,4,0,0,18,nowin,win,plwin,beat,20,0,15,208,0.394230769,0.038461538,0.581730769,0,0.024682772
26657,149,24443,10,9,0,0,0,19,10,4,4,0,0,18,nowin,win,plwin,beat,20,0,19,225,0.457777778,0.057777778,0.648888889,2,0.651965595
26658,115,24444,8,6,0,0,0,14,6,11,0,0,0,17,nowin,loss,beat,dlwin,0,10,14,194,0.427835052,0.041237113,0.592783505,2,0.583863602
26659,121,24444,10,10,0,0,0,20,6,11,0,0,0,17,nowin,win,plwin,beat,20,0,20,195,0.456410256,0.025641026,0.512820513,1,0.288597791
26660,71,24444,10,9,0,0,0,19,6,11,0,0,0,17,nowin,win,plwin,beat,20,0,19,193,0.352331606,0.046632124,0.585492228,0,0.013063661
26661,68,24444,9,2,10,0,0,21,6,11,0,0,0,17,nowin,win,plwin,beat,20,0,11,205,0.434146341,0.029268293,0.6,2,0.59483189
26662,18,24444,9,10,0,0,0,19,6,11,0,0,0,17,nowin,win,plwin,beat,20,0,19,182,0.461538462,0.043956044,0.587912088,3,0.892649374
26663,17,24444,8,3,6,0,0,17,6,11,0,0,0,17,nowin,push,push,push,10,0,11,171,0.444444444,0.070175439,0.555555556,1,0.302364894
26664,115,24445,8,6,0,9,0,23,9,6,5,0,0,20,nowin,loss,bust,plbust,0,10,14,194,0.427835052,0.041237113,0.592783505,2,0.583863602
26665,141,24445,7,9,0,1,0,17,9,6,5,0,0,20,nowin,loss,beat,dlwin,0,10,16,202,0.420792079,0.074257426,0.564356436,0,0.028377851
26666,120,24445,6,10,0,10,0,26,9,6,5,0,0,20,nowin,loss,bust,plbust,0,10,16,202,0.440594059,0.034653465,0.618811881,2,0.614441029
26667,86,24445,11,7,0,0,0,18,9,6,5,0,0,20,nowin,loss,beat,dlwin,0,10,18,196,0.454081633,0.040816327,0.591836735,3,0.887566443
26668,2,24445,5,4,10,0,0,19,9,6,5,0,0,20,nowin,loss,beat,dlwin,0,10,9,200,0.445,0.035,0.64,2,0.633962549
26669,106,24445,10,8,0,0,0,18,9,6,5,0,0,20,nowin,loss,beat,dlwin,0,10,18,192,0.411458333,0.026041667,0.557291667,0,0.023854304
26670,73,24446,9,10,0,0,0,19,8,10,0,0,0,18,nowin,win,plwin,beat,20,0,19,181,0.375690608,0.011049724,0.596685083,0,0.022795773
26671,114,24446,5,2,11,0,0,18,8,10,0,0,0,18,nowin,push,push,push,10,0,7,198,0.47979798,0.025252525,0.611111111,3,0.937232995
26672,18,24446,1,3,8,10,0,22,8,10,0,0,0,18,nowin,loss,bust,plbust,0,10,4,182,0.461538462,0.043956044,0.587912088,3,0.892649374
26673,73,24446,10,8,0,0,0,18,8,10,0,0,0,18,nowin,push,push,push,10,0,18,181,0.375690608,0.011049724,0.596685083,0,0.022795773
26674,15,24446,10,6,0,7,0,23,8,10,0,0,0,18,nowin,loss,bust,plbust,0,10,16,212,0.410377358,0.051886792,0.561320755,0,0.024517408
26675,15,24446,2,6,10,0,0,18,8,10,0,0,0,18,nowin,push,push,push,10,0,8,212,0.410377358,0.051886792,0.561320755,0,0.024517408
26676,91,24447,4,8,0,0,0,12,6,10,1,0,0,17,nowin,loss,beat,dlwin,0,10,12,194,0.417525773,0.046391753,0.515463918,1,0.266616552
26677,70,24447,9,10,0,0,0,19,6,10,1,0,0,17,nowin,win,plwin,beat,20,0,19,228,0.385964912,0.039473684,0.557017544,0,0.016157125
26678,129,24447,3,10,0,0,0,13,6,10,1,0,0,17,nowin,loss,beat,dlwin,0,10,13,201,0.422885572,0.064676617,0.55721393,0,0.027255383
26679,31,24447,8,10,0,0,0,18,6,10,1,0,0,17,nowin,win,plwin,beat,20,0,18,188,0.473404255,0.058510638,0.515957447,1,0.300306557
26680,7,24447,4,3,11,0,0,18,6,10,1,0,0,17,nowin,win,plwin,beat,20,0,7,183,0.442622951,0.06010929,0.62295082,2,0.619303341
26681,2,24447,10,10,0,0,0,20,6,10,1,0,0,17,nowin,win,plwin,beat,20,0,20,200,0.445,0.035,0.64,2,0.633962549
26682,14,24448,4,11,2,0,0,17,10,6,4,0,0,20,nowin,loss,beat,dlwin,0,10,15,202,0.391089109,0.01980198,0.628712871,2,0.577264877
26683,60,24448,3,3,9,9,0,24,10,6,4,0,0,20,nowin,loss,bust,plbust,0,10,6,227,0.418502203,0.022026432,0.559471366,0,0.026496258
26684,18,24448,10,9,0,0,0,19,10,6,4,0,0,20,nowin,loss,beat,dlwin,0,10,19,182,0.461538462,0.043956044,0.587912088,3,0.892649374
26685,11,24448,10,3,0,10,0,23,10,6,4,0,0,20,nowin,loss,bust,plbust,0,10,13,236,0.457627119,0.016949153,0.588983051,3,0.889015813
26686,86,24448,11,9,0,0,0,20,10,6,4,0,0,20,nowin,push,push,push,10,0,20,196,0.454081633,0.040816327,0.591836735,3,0.887566443
26687,132,24448,3,8,8,0,0,19,10,6,4,0,0,20,nowin,loss,beat,dlwin,0,10,11,194,0.412371134,0.036082474,0.649484536,2,0.611633238
26688,104,24449,9,10,0,0,0,19,10,7,0,0,0,17,nowin,win,plwin,beat,20,0,19,209,0.363636364,0.052631579,0.593301435,0,0.018359419
26689,41,24449,7,10,0,0,0,17,10,7,0,0,0,17,nowin,push,push,push,10,0,17,192,0.364583333,0.036458333,0.520833333,0,0.00089702
26690,142,24449,10,10,0,0,0,20,10,7,0,0,0,17,nowin,win,plwin,beat,20,0,20,211,0.417061611,0.047393365,0.526066351,1,0.271531309
26691,122,24449,10,10,0,0,0,20,10,7,0,0,0,17,nowin,win,plwin,beat,20,0,20,210,0.347619048,0.052380952,0.59047619,0,0.012873677
26692,149,24449,10,11,0,0,0,21,10,7,0,0,0,17,win,win,plwin,beat,25,0,21,225,0.457777778,0.057777778,0.648888889,2,0.651965595
26693,72,24449,10,3,0,10,0,23,10,7,0,0,0,17,nowin,loss,bust,plbust,0,10,13,185,0.394594595,0.032432432,0.508108108,0,0.006763115
26694,27,24450,7,5,0,10,0,22,10,10,0,0,0,20,nowin,loss,bust,plbust,0,10,12,178,0.370786517,0.016853933,0.573033708,0,0.015536309
26695,84,24450,9,10,0,0,0,19,10,10,0,0,0,20,nowin,loss,beat,dlwin,0,10,19,195,0.379487179,0.056410256,0.569230769,0,0.017209119
26696,128,24450,5,3,6,7,0,21,10,10,0,0,0,20,nowin,win,plwin,beat,20,0,8,227,0.356828194,0.052863436,0.577092511,0,0.012352564
26697,136,24450,10,10,0,0,0,20,10,10,0,0,0,20,nowin,push,push,push,10,0,20,194,0.396907216,0.025773196,0.597938144,0,0.029452644
26698,74,24450,9,10,0,0,0,19,10,10,0,0,0,20,nowin,loss,beat,dlwin,0,10,19,209,0.411483254,0.04784689,0.531100478,0,0.017448125
26699,62,24450,6,4,10,0,0,20,10,10,0,0,0,20,nowin,push,push,push,10,0,10,178,0.370786517,0.028089888,0.54494382,0,0.008657722
26700,10,24451,10,8,0,0,0,18,4,8,10,0,0,22,nowin,win,dlbust,bust,20,0,18,191,0.413612565,0.057591623,0.596858639,2,0.574087175
26701,66,24451,10,5,0,0,0,15,4,8,10,0,0,22,nowin,win,dlbust,bust,20,0,15,217,0.456221198,0.064516129,0.626728111,3,0.924304367
26702,101,24451,2,10,0,0,0,12,4,8,10,0,0,22,nowin,win,dlbust,bust,20,0,12,205,0.424390244,0.068292683,0.63902439,2,0.614740646
26703,51,24451,10,10,0,0,0,20,4,8,10,0,0,22,nowin,win,dlbust,bust,20,0,20,189,0.529100529,0.068783069,0.608465608,3,0.993665715
26704,96,24451,6,10,0,0,0,16,4,8,10,0,0,22,nowin,win,dlbust,bust,20,0,16,190,0.468421053,0.057894737,0.584210526,3,0.897263354
26705,82,24451,4,10,0,0,0,14,4,8,10,0,0,22,nowin,win,dlbust,bust,20,0,14,225,0.408888889,0.075555556,0.577777778,0,0.028101874
26706,84,24452,8,5,0,0,0,13,2,10,8,0,0,20,nowin,loss,beat,dlwin,0,10,13,195,0.379487179,0.056410256,0.569230769,0,0.017209119
26707,15,24452,6,3,3,10,0,22,2,10,8,0,0,20,nowin,loss,bust,plbust,0,10,9,212,0.410377358,0.051886792,0.561320755,0,0.024517408
26708,86,24452,7,6,0,0,0,13,2,10,8,0,0,20,nowin,loss,beat,dlwin,0,10,13,196,0.454081633,0.040816327,0.591836735,3,0.887566443
26709,64,24452,2,5,3,10,0,20,2,10,8,0,0,20,nowin,push,push,push,10,0,7,187,0.363636364,0.048128342,0.631016043,0,0.027594885
26710,40,24452,2,1,10,0,0,13,2,10,8,0,0,20,nowin,loss,beat,dlwin,0,10,3,196,0.367346939,0.030612245,0.617346939,0,0.025358183
26711,81,24452,3,4,3,10,0,20,2,10,8,0,0,20,nowin,push,push,push,10,0,7,182,0.395604396,0.043956044,0.60989011,2,0.567491261
26712,135,24453,3,10,0,10,0,23,8,3,10,0,0,21,nowin,loss,bust,plbust,0,10,13,179,0.391061453,0.067039106,0.586592179,0,0.024924662
26713,6,24453,1,6,7,2,9,25,8,3,10,0,0,21,nowin,loss,bust,plbust,0,10,7,191,0.439790576,0.047120419,0.581151832,1,0.31211505
26714,142,24453,7,2,10,0,0,19,8,3,10,0,0,21,nowin,loss,beat,dlwin,0,10,9,211,0.417061611,0.047393365,0.526066351,1,0.271531309
26715,4,24453,7,5,0,6,0,18,8,3,10,0,0,21,nowin,loss,beat,dlwin,0,10,12,217,0.460829493,0.036866359,0.562211982,1,0.315432839
26716,104,24453,2,11,7,0,0,20,8,3,10,0,0,21,nowin,loss,beat,dlwin,0,10,13,209,0.363636364,0.052631579,0.593301435,0,0.018359419
26717,5,24453,10,4,0,10,0,24,8,3,10,0,0,21,nowin,loss,bust,plbust,0,10,14,203,0.42364532,0.02955665,0.596059113,2,0.582508076
26718,136,24454,9,10,0,0,0,19,3,7,10,0,0,20,nowin,loss,beat,dlwin,0,10,19,194,0.396907216,0.025773196,0.597938144,0,0.029452644
26719,135,24454,10,3,0,0,0,13,3,7,10,0,0,20,nowin,loss,beat,dlwin,0,10,13,179,0.391061453,0.067039106,0.586592179,0,0.024924662
26720,111,24454,7,3,5,0,0,15,3,7,10,0,0,20,nowin,loss,beat,dlwin,0,10,10,180,0.433333333,0.055555556,0.611111111,2,0.602264492
26721,144,24454,11,10,0,0,0,21,3,7,10,0,0,20,win,win,plwin,beat,25,0,21,202,0.386138614,0.054455446,0.564356436,0,0.018006244
26722,103,24454,4,10,0,0,0,14,3,7,10,0,0,20,nowin,loss,beat,dlwin,0,10,14,203,0.379310345,0.064039409,0.551724138,0,0.012869209
26723,112,24454,2,3,2,1,4,12,3,7,10,0,0,20,nowin,loss,beat,dlwin,0,10,5,203,0.448275862,0.054187192,0.600985222,3,0.889576933
26724,41,24455,10,11,0,0,0,21,6,8,8,0,0,22,win,win,dlbust,bust,25,0,21,192,0.364583333,0.036458333,0.520833333,0,0.00089702
26725,109,24455,7,8,0,0,0,15,6,8,8,0,0,22,nowin,win,dlbust,bust,20,0,15,221,0.461538462,0.058823529,0.597285068,3,0.901830309
26726,44,24455,3,5,10,0,0,18,6,8,8,0,0,22,nowin,win,dlbust,bust,20,0,8,219,0.433789954,0.050228311,0.534246575,1,0.285551035
26727,129,24455,11,4,2,0,0,17,6,8,8,0,0,22,nowin,win,dlbust,bust,20,0,15,201,0.422885572,0.064676617,0.55721393,0,0.027255383
26728,28,24455,10,11,0,0,0,21,6,8,8,0,0,22,win,win,dlbust,bust,25,0,21,199,0.422110553,0.045226131,0.542713568,1,0.282706618
26729,12,24455,2,2,6,10,0,20,6,8,8,0,0,22,nowin,win,dlbust,bust,20,0,4,189,0.470899471,0.015873016,0.613756614,3,0.929171178
26730,105,24456,10,10,0,0,0,20,10,10,0,0,0,20,nowin,push,push,push,10,0,20,198,0.414141414,0.070707071,0.590909091,0,0.032889494
26731,139,24456,10,6,0,6,0,22,10,10,0,0,0,20,nowin,loss,bust,plbust,0,10,16,192,0.380208333,0.036458333,0.59375,0,0.023429169
26732,147,24456,9,4,0,1,7,21,10,10,0,0,0,20,nowin,win,plwin,beat,20,0,13,205,0.380487805,0.014634146,0.536585366,0,0.00951447
26733,98,24456,5,7,0,9,0,21,10,10,0,0,0,20,nowin,win,plwin,beat,20,0,12,220,0.422727273,0.054545455,0.55,1,0.28664435
26734,28,24456,10,7,0,0,0,17,10,10,0,0,0,20,nowin,loss,beat,dlwin,0,10,17,199,0.422110553,0.045226131,0.542713568,1,0.282706618
26735,44,24456,3,5,3,6,0,17,10,10,0,0,0,20,nowin,loss,beat,dlwin,0,10,8,219,0.433789954,0.050228311,0.534246575,1,0.285551035
26736,125,24457,8,5,0,10,0,23,8,10,0,0,0,18,nowin,loss,bust,plbust,0,10,13,219,0.438356164,0.050228311,0.575342466,1,0.308411257
26737,103,24457,9,9,0,0,0,18,8,10,0,0,0,18,nowin,push,push,push,10,0,18,203,0.379310345,0.064039409,0.551724138,0,0.012869209
26738,100,24457,10,9,0,0,0,19,8,10,0,0,0,18,nowin,win,plwin,beat,20,0,19,190,0.452631579,0.036842105,0.594736842,3,0.888671154
26739,119,24457,4,10,0,8,0,22,8,10,0,0,0,18,nowin,loss,bust,plbust,0,10,14,190,0.405263158,0.068421053,0.515789474,0,0.011837158
26740,6,24457,2,6,3,10,0,21,8,10,0,0,0,18,nowin,win,plwin,beat,20,0,8,191,0.439790576,0.047120419,0.581151832,1,0.31211505
26741,147,24457,9,11,0,0,0,20,8,10,0,0,0,18,nowin,win,plwin,beat,20,0,20,205,0.380487805,0.014634146,0.536585366,0,0.00951447
26742,27,24458,10,8,0,0,0,18,10,5,9,0,0,24,nowin,win,dlbust,bust,20,0,18,178,0.370786517,0.016853933,0.573033708,0,0.015536309
26743,16,24458,7,10,0,0,0,17,10,5,9,0,0,24,nowin,win,dlbust,bust,20,0,17,220,0.427272727,0.081818182,0.6,2,0.588660176
26744,53,24458,7,5,0,10,0,22,10,5,9,0,0,24,nowin,loss,bust,plbust,0,10,12,250,0.372,0.064,0.564,0,0.013687345
26745,106,24458,3,10,0,9,0,22,10,5,9,0,0,24,nowin,loss,bust,plbust,0,10,13,192,0.411458333,0.026041667,0.557291667,0,0.023854304
26746,125,24458,10,10,0,0,0,20,10,5,9,0,0,24,nowin,win,dlbust,bust,20,0,20,219,0.438356164,0.050228311,0.575342466,1,0.308411257
26747,11,24458,3,7,3,10,0,23,10,5,9,0,0,24,nowin,loss,bust,plbust,0,10,10,236,0.457627119,0.016949153,0.588983051,3,0.889015813
26748,134,24459,5,2,10,0,0,17,7,6,3,10,0,26,nowin,win,dlbust,bust,20,0,7,185,0.443243243,0.021621622,0.545945946,1,0.296939509
26749,95,24459,8,10,0,0,0,18,7,6,3,10,0,26,nowin,win,dlbust,bust,20,0,18,218,0.412844037,0.04587156,0.559633028,0,0.024842385
26750,15,24459,7,9,0,10,0,26,7,6,3,10,0,26,nowin,loss,bust,plbust,0,10,16,212,0.410377358,0.051886792,0.561320755,0,0.024517408
26751,68,24459,10,3,0,10,0,23,7,6,3,10,0,26,nowin,loss,bust,plbust,0,10,13,205,0.434146341,0.029268293,0.6,2,0.59483189
26752,132,24459,10,8,0,0,0,18,7,6,3,10,0,26,nowin,win,dlbust,bust,20,0,18,194,0.412371134,0.036082474,0.649484536,2,0.611633238
26753,48,24459,10,10,0,0,0,20,7,6,3,10,0,26,nowin,win,dlbust,bust,20,0,20,203,0.413793103,0.019704433,0.600985222,2,0.577280801
26754,96,24460,7,7,0,0,0,14,6,7,3,3,0,19,nowin,loss,beat,dlwin,0,10,14,190,0.468421053,0.057894737,0.584210526,3,0.897263354
26755,96,24460,3,2,3,10,0,18,6,7,3,3,0,19,nowin,loss,beat,dlwin,0,10,5,190,0.468421053,0.057894737,0.584210526,3,0.897263354
26756,26,24460,5,2,7,0,0,14,6,7,3,3,0,19,nowin,loss,beat,dlwin,0,10,7,203,0.463054187,0.0591133,0.541871921,1,0.306802864
26757,51,24460,11,10,0,0,0,21,6,7,3,3,0,19,win,win,plwin,beat,25,0,21,189,0.529100529,0.068783069,0.608465608,3,0.993665715
26758,40,24460,9,10,0,0,0,19,6,7,3,3,0,19,nowin,push,push,push,10,0,19,196,0.367346939,0.030612245,0.617346939,0,0.025358183
26759,94,24460,8,3,10,0,0,21,6,7,3,3,0,19,nowin,win,plwin,beat,20,0,11,183,0.43715847,0.043715847,0.540983607,1,0.290866892
26760,1,24461,10,6,0,0,0,16,4,3,4,1,10,22,nowin,win,dlbust,bust,20,0,16,197,0.406091371,0.025380711,0.649746193,2,0.606186955
26761,131,24461,9,9,0,0,0,18,4,3,4,1,10,22,nowin,win,dlbust,bust,20,0,18,217,0.410138249,0.069124424,0.543778802,0,0.02015021
26762,48,24461,4,7,3,0,0,14,4,3,4,1,10,22,nowin,win,dlbust,bust,20,0,11,203,0.413793103,0.019704433,0.600985222,2,0.577280801
26763,92,24461,6,3,10,0,0,19,4,3,4,1,10,22,nowin,win,dlbust,bust,20,0,9,186,0.446236559,0.059139785,0.564516129,1,0.307826125
26764,135,24461,10,9,0,0,0,19,4,3,4,1,10,22,nowin,win,dlbust,bust,20,0,19,179,0.391061453,0.067039106,0.586592179,0,0.024924662
26765,26,24461,4,9,0,0,0,13,4,3,4,1,10,22,nowin,win,dlbust,bust,20,0,13,203,0.463054187,0.0591133,0.541871921,1,0.306802864
26766,71,24462,9,10,0,0,0,19,10,9,0,0,0,19,nowin,push,push,push,10,0,19,193,0.352331606,0.046632124,0.585492228,0,0.013063661
26767,42,24462,10,10,0,0,0,20,10,9,0,0,0,19,nowin,win,plwin,beat,20,0,20,212,0.443396226,0.051886792,0.570754717,1,0.309181312
26768,5,24462,2,4,2,1,10,19,10,9,0,0,0,19,nowin,push,push,push,10,0,6,203,0.42364532,0.02955665,0.596059113,2,0.582508076
26769,87,24462,7,10,0,0,0,17,10,9,0,0,0,19,nowin,loss,beat,dlwin,0,10,17,202,0.405940594,0.054455446,0.628712871,2,0.590599801
26770,114,24462,3,11,1,7,0,22,10,9,0,0,0,19,nowin,loss,bust,plbust,0,10,14,198,0.47979798,0.025252525,0.611111111,3,0.937232995
26771,147,24462,3,10,0,6,0,19,10,9,0,0,0,19,nowin,push,push,push,10,0,13,205,0.380487805,0.014634146,0.536585366,0,0.00951447
26772,82,24463,10,10,0,0,0,20,1,3,10,3,0,17,nowin,win,plwin,beat,20,0,20,225,0.408888889,0.075555556,0.577777778,0,0.028101874
26773,40,24463,7,7,0,10,0,24,1,3,10,3,0,17,nowin,loss,bust,plbust,0,10,14,196,0.367346939,0.030612245,0.617346939,0,0.025358183
26774,141,24463,5,1,10,10,0,26,1,3,10,3,0,17,nowin,loss,bust,plbust,0,10,6,202,0.420792079,0.074257426,0.564356436,0,0.028377851
26775,139,24463,10,5,0,5,0,20,1,3,10,3,0,17,nowin,win,plwin,beat,20,0,15,192,0.380208333,0.036458333,0.59375,0,0.023429169
26776,30,24463,7,8,0,7,0,22,1,3,10,3,0,17,nowin,loss,bust,plbust,0,10,15,206,0.393203883,0.033980583,0.601941748,0,0.029324648
26777,46,24463,1,4,10,6,0,21,1,3,10,3,0,17,nowin,win,plwin,beat,20,0,5,186,0.403225806,0.048387097,0.591397849,0,0.029742194
26778,15,24464,7,11,0,0,0,18,11,8,0,0,0,19,nowin,loss,beat,dlwin,0,10,18,212,0.410377358,0.051886792,0.561320755,0,0.024517408
26779,34,24464,2,9,10,0,0,21,11,8,0,0,0,19,nowin,win,plwin,beat,20,0,11,202,0.5,0.079207921,0.618811881,3,0.968961434
26780,105,24464,5,3,10,0,0,18,11,8,0,0,0,19,nowin,loss,beat,dlwin,0,10,8,198,0.414141414,0.070707071,0.590909091,0,0.032889494
26781,117,24464,8,11,0,0,0,19,11,8,0,0,0,19,nowin,push,push,push,10,0,19,173,0.410404624,0.069364162,0.606936416,2,0.578610282
26782,26,24464,3,1,10,5,0,19,11,8,0,0,0,19,nowin,push,push,push,10,0,4,203,0.463054187,0.0591133,0.541871921,1,0.306802864
26783,26,24464,10,5,0,10,0,25,11,8,0,0,0,19,nowin,loss,bust,plbust,0,10,15,203,0.463054187,0.0591133,0.541871921,1,0.306802864
26784,101,24465,10,9,0,0,0,19,10,6,9,0,0,25,nowin,win,dlbust,bust,20,0,19,205,0.424390244,0.068292683,0.63902439,2,0.614740646
26785,143,24465,8,6,0,2,10,26,10,6,9,0,0,25,nowin,loss,bust,plbust,0,10,14,203,0.463054187,0.044334975,0.57635468,3,0.883143365
26786,116,24465,10,9,0,0,0,19,10,6,9,0,0,25,nowin,win,dlbust,bust,20,0,19,195,0.425641026,0.056410256,0.538461538,1,0.28273747
26787,52,24465,7,6,0,10,0,23,10,6,9,0,0,25,nowin,loss,bust,plbust,0,10,13,217,0.414746544,0.02764977,0.599078341,2,0.576736024
26788,113,24465,4,10,0,5,0,19,10,6,9,0,0,25,nowin,win,dlbust,bust,20,0,14,199,0.407035176,0.055276382,0.668341709,2,0.620695264
26789,24,24465,5,8,0,10,0,23,10,6,9,0,0,25,nowin,loss,bust,plbust,0,10,13,207,0.458937198,0.048309179,0.570048309,1,0.318138014
26790,40,24466,10,10,0,0,0,20,9,11,0,0,0,20,nowin,push,push,push,10,0,20,196,0.367346939,0.030612245,0.617346939,0,0.025358183
26791,2,24466,2,3,2,8,3,18,9,11,0,0,0,20,nowin,loss,beat,dlwin,0,10,5,200,0.445,0.035,0.64,2,0.633962549
26792,50,24466,7,6,0,10,0,23,9,11,0,0,0,20,nowin,loss,bust,plbust,0,10,13,202,0.405940594,0.04950495,0.54950495,0,0.020296079
26793,81,24466,10,10,0,0,0,20,9,11,0,0,0,20,nowin,push,push,push,10,0,20,182,0.395604396,0.043956044,0.60989011,2,0.567491261
26794,74,24466,6,9,0,6,0,21,9,11,0,0,0,20,nowin,win,plwin,beat,20,0,15,209,0.411483254,0.04784689,0.531100478,0,0.017448125
26795,66,24466,4,2,10,7,0,23,9,11,0,0,0,20,nowin,loss,bust,plbust,0,10,6,217,0.456221198,0.064516129,0.626728111,3,0.924304367
26796,126,24467,10,3,0,6,0,19,9,11,0,0,0,20,nowin,loss,beat,dlwin,0,10,13,188,0.457446809,0.074468085,0.60106383,3,0.900633203
26797,5,24467,5,6,10,0,0,21,9,11,0,0,0,20,nowin,win,plwin,beat,20,0,11,203,0.42364532,0.02955665,0.596059113,2,0.582508076
26798,43,24467,8,10,0,0,0,18,9,11,0,0,0,20,nowin,loss,beat,dlwin,0,10,18,192,0.40625,0.041666667,0.609375,2,0.576671372
26799,74,24467,10,10,0,0,0,20,9,11,0,0,0,20,nowin,push,push,push,10,0,20,209,0.411483254,0.04784689,0.531100478,0,0.017448125
26800,142,24467,10,2,0,5,0,17,9,11,0,0,0,20,nowin,loss,beat,dlwin,0,10,12,211,0.417061611,0.047393365,0.526066351,1,0.271531309
26801,28,24467,9,7,0,5,0,21,9,11,0,0,0,20,nowin,win,plwin,beat,20,0,16,199,0.422110553,0.045226131,0.542713568,1,0.282706618
26802,122,24468,2,10,0,6,0,18,10,2,9,0,0,21,nowin,loss,beat,dlwin,0,10,12,210,0.347619048,0.052380952,0.59047619,0,0.012873677
26803,2,24468,5,11,1,0,0,17,10,2,9,0,0,21,nowin,loss,beat,dlwin,0,10,16,200,0.445,0.035,0.64,2,0.633962549
26804,18,24468,7,5,0,5,0,17,10,2,9,0,0,21,nowin,loss,beat,dlwin,0,10,12,182,0.461538462,0.043956044,0.587912088,3,0.892649374
26805,58,24468,10,8,0,0,0,18,10,2,9,0,0,21,nowin,loss,beat,dlwin,0,10,18,195,0.430769231,0.041025641,0.584615385,2,0.580497586
26806,131,24468,6,4,10,0,0,20,10,2,9,0,0,21,nowin,loss,beat,dlwin,0,10,10,217,0.410138249,0.069124424,0.543778802,0,0.02015021
26807,77,24468,10,10,0,0,0,20,10,2,9,0,0,21,nowin,loss,beat,dlwin,0,10,20,200,0.455,0.04,0.62,3,0.916252116
26808,82,24469,7,3,2,0,0,12,4,3,4,7,0,18,nowin,loss,beat,dlwin,0,10,10,225,0.408888889,0.075555556,0.577777778,0,0.028101874
26809,120,24469,3,5,11,0,0,19,4,3,4,7,0,18,nowin,win,plwin,beat,20,0,8,202,0.440594059,0.034653465,0.618811881,2,0.614441029
26810,133,24469,10,5,0,0,0,15,4,3,4,7,0,18,nowin,loss,beat,dlwin,0,10,15,201,0.47761194,0.064676617,0.611940299,3,0.935428111
26811,131,24469,3,6,8,0,0,17,4,3,4,7,0,18,nowin,loss,beat,dlwin,0,10,9,217,0.410138249,0.069124424,0.543778802,0,0.02015021
26812,81,24469,5,9,0,0,0,14,4,3,4,7,0,18,nowin,loss,beat,dlwin,0,10,14,182,0.395604396,0.043956044,0.60989011,2,0.567491261
26813,17,24469,2,2,8,0,0,12,4,3,4,7,0,18,nowin,loss,beat,dlwin,0,10,4,171,0.444444444,0.070175439,0.555555556,1,0.302364894
26814,101,24470,11,9,0,0,0,20,10,10,0,0,0,20,nowin,push,push,push,10,0,20,205,0.424390244,0.068292683,0.63902439,2,0.614740646
26815,37,24470,10,6,0,5,0,21,10,10,0,0,0,20,nowin,win,plwin,beat,20,0,16,208,0.394230769,0.038461538,0.581730769,0,0.024682772
26816,67,24470,10,4,0,10,0,24,10,10,0,0,0,20,nowin,loss,bust,plbust,0,10,14,195,0.369230769,0.041025641,0.569230769,0,0.014139427
26817,59,24470,11,10,0,0,0,21,10,10,0,0,0,20,win,win,plwin,beat,25,0,21,228,0.429824561,0.048245614,0.543859649,1,0.287885446
26818,113,24470,10,10,0,0,0,20,10,10,0,0,0,20,nowin,push,push,push,10,0,20,199,0.407035176,0.055276382,0.668341709,2,0.620695264
26819,138,24470,7,6,0,7,0,20,10,10,0,0,0,20,nowin,push,push,push,10,0,13,190,0.442105263,0.047368421,0.610526316,2,0.609711065
26820,131,24471,9,10,0,0,0,19,8,5,5,0,0,18,nowin,win,plwin,beat,20,0,19,217,0.410138249,0.069124424,0.543778802,0,0.02015021
26821,57,24471,6,1,10,0,0,17,8,5,5,0,0,18,nowin,loss,beat,dlwin,0,10,7,192,0.46875,0.052083333,0.59375,3,0.907001181
26822,4,24471,10,10,0,0,0,20,8,5,5,0,0,18,nowin,win,plwin,beat,20,0,20,217,0.460829493,0.036866359,0.562211982,1,0.315432839
26823,49,24471,7,7,0,8,0,22,8,5,5,0,0,18,nowin,loss,bust,plbust,0,10,14,207,0.396135266,0.053140097,0.594202899,0,0.028306925
26824,124,24471,8,8,0,10,0,26,8,5,5,0,0,18,nowin,loss,bust,plbust,0,10,16,202,0.47029703,0.064356436,0.584158416,3,0.899458193
26825,63,24471,10,10,0,0,0,20,8,5,5,0,0,18,nowin,win,plwin,beat,20,0,20,216,0.467592593,0.037037037,0.62037037,3,0.931690496
26826,52,24472,3,8,3,0,0,14,3,5,2,9,0,19,nowin,loss,beat,dlwin,0,10,11,217,0.414746544,0.02764977,0.599078341,2,0.576736024
26827,20,24472,11,9,0,0,0,20,3,5,2,9,0,19,nowin,win,plwin,beat,20,0,20,186,0.456989247,0.037634409,0.537634409,1,0.301097108
26828,138,24472,10,5,0,0,0,15,3,5,2,9,0,19,nowin,loss,beat,dlwin,0,10,15,190,0.442105263,0.047368421,0.610526316,2,0.609711065
26829,129,24472,10,7,0,0,0,17,3,5,2,9,0,19,nowin,loss,beat,dlwin,0,10,17,201,0.422885572,0.064676617,0.55721393,0,0.027255383
26830,35,24472,10,10,0,0,0,20,3,5,2,9,0,19,nowin,win,plwin,beat,20,0,20,202,0.410891089,0.044554455,0.633663366,2,0.598681573
26831,51,24472,9,10,0,0,0,19,3,5,2,9,0,19,nowin,push,push,push,10,0,19,189,0.529100529,0.068783069,0.608465608,3,0.993665715
26832,22,24473,11,10,0,0,0,21,10,3,9,0,0,22,win,win,dlbust,bust,25,0,21,187,0.481283422,0.042780749,0.577540107,3,0.906128176
26833,49,24473,7,9,0,3,0,19,10,3,9,0,0,22,nowin,win,dlbust,bust,20,0,16,207,0.396135266,0.053140097,0.594202899,0,0.028306925
26834,114,24473,8,11,0,0,0,19,10,3,9,0,0,22,nowin,win,dlbust,bust,20,0,19,198,0.47979798,0.025252525,0.611111111,3,0.937232995
26835,6,24473,8,10,0,0,0,18,10,3,9,0,0,22,nowin,win,dlbust,bust,20,0,18,191,0.439790576,0.047120419,0.581151832,1,0.31211505
26836,38,24473,10,6,0,8,0,24,10,3,9,0,0,22,nowin,loss,bust,plbust,0,10,16,202,0.361386139,0.03960396,0.564356436,0,0.010597953
26837,25,24473,7,5,0,6,0,18,10,3,9,0,0,22,nowin,win,dlbust,bust,20,0,12,190,0.463157895,0.063157895,0.536842105,1,0.304401563
26838,58,24474,10,10,0,0,0,20,7,10,0,0,0,17,nowin,win,plwin,beat,20,0,20,195,0.430769231,0.041025641,0.584615385,2,0.580497586
26839,113,24474,6,4,4,6,0,20,7,10,0,0,0,17,nowin,win,plwin,beat,20,0,10,199,0.407035176,0.055276382,0.668341709,2,0.620695264
26840,30,24474,10,2,0,8,0,20,7,10,0,0,0,17,nowin,win,plwin,beat,20,0,12,206,0.393203883,0.033980583,0.601941748,0,0.029324648
26841,110,24474,7,8,0,9,0,24,7,10,0,0,0,17,nowin,loss,bust,plbust,0,10,15,192,0.416666667,0.046875,0.557291667,0,0.025413132
26842,82,24474,10,10,0,0,0,20,7,10,0,0,0,17,nowin,win,plwin,beat,20,0,20,225,0.408888889,0.075555556,0.577777778,0,0.028101874
26843,89,24474,3,7,7,0,0,17,7,10,0,0,0,17,nowin,push,push,push,10,0,10,212,0.537735849,0.047169811,0.594339623,3,0.990167191
26844,73,24475,5,2,11,0,0,18,10,8,0,0,0,18,nowin,push,push,push,10,0,7,181,0.375690608,0.011049724,0.596685083,0,0.022795773
26845,80,24475,3,5,7,9,0,24,10,8,0,0,0,18,nowin,loss,bust,plbust,0,10,8,186,0.419354839,0.059139785,0.623655914,2,0.59892924
26846,114,24475,10,6,0,6,0,22,10,8,0,0,0,18,nowin,loss,bust,plbust,0,10,16,198,0.47979798,0.025252525,0.611111111,3,0.937232995
26847,132,24475,8,11,0,0,0,19,10,8,0,0,0,18,nowin,win,plwin,beat,20,0,19,194,0.412371134,0.036082474,0.649484536,2,0.611633238
26848,14,24475,10,10,0,0,0,20,10,8,0,0,0,18,nowin,win,plwin,beat,20,0,20,202,0.391089109,0.01980198,0.628712871,2,0.577264877
26849,5,24475,4,9,0,7,0,20,10,8,0,0,0,18,nowin,win,plwin,beat,20,0,13,203,0.42364532,0.02955665,0.596059113,2,0.582508076
26850,147,24476,8,11,0,0,0,19,9,10,0,0,0,19,nowin,push,push,push,10,0,19,205,0.380487805,0.014634146,0.536585366,0,0.00951447
26851,26,24476,2,10,0,4,7,23,9,10,0,0,0,19,nowin,loss,bust,plbust,0,10,12,203,0.463054187,0.0591133,0.541871921,1,0.306802864
26852,21,24476,8,10,0,0,0,18,9,10,0,0,0,19,nowin,loss,beat,dlwin,0,10,18,214,0.359813084,0.042056075,0.626168224,0,0.025263474
26853,44,24476,10,5,0,7,0,22,9,10,0,0,0,19,nowin,loss,bust,plbust,0,10,15,219,0.433789954,0.050228311,0.534246575,1,0.285551035
26854,53,24476,2,3,9,4,0,18,9,10,0,0,0,19,nowin,loss,beat,dlwin,0,10,5,250,0.372,0.064,0.564,0,0.013687345
26855,110,24476,10,10,0,0,0,20,9,10,0,0,0,19,nowin,win,plwin,beat,20,0,20,192,0.416666667,0.046875,0.557291667,0,0.025413132
26856,72,24477,3,9,0,10,0,22,11,6,0,0,0,17,nowin,loss,bust,plbust,0,10,12,185,0.394594595,0.032432432,0.508108108,0,0.006763115
26857,79,24477,8,9,0,0,0,17,11,6,0,0,0,17,nowin,push,push,push,10,0,17,211,0.436018957,0.028436019,0.672985782,2,0.650131054
26858,15,24477,2,8,6,8,0,24,11,6,0,0,0,17,nowin,loss,bust,plbust,0,10,10,212,0.410377358,0.051886792,0.561320755,0,0.024517408
26859,140,24477,8,10,0,0,0,18,11,6,0,0,0,17,nowin,win,plwin,beat,20,0,18,210,0.466666667,0.023809524,0.604761905,3,0.915293335
26860,87,24477,7,6,0,8,0,21,11,6,0,0,0,17,nowin,win,plwin,beat,20,0,13,202,0.405940594,0.054455446,0.628712871,2,0.590599801
26861,4,24477,6,11,4,0,0,21,11,6,0,0,0,17,nowin,win,plwin,beat,20,0,17,217,0.460829493,0.036866359,0.562211982,1,0.315432839
26862,74,24478,3,10,0,10,0,23,10,11,0,0,0,21,nowin,loss,bust,plbust,0,10,13,209,0.411483254,0.04784689,0.531100478,0,0.017448125
26863,142,24478,8,10,0,0,0,18,10,11,0,0,0,21,nowin,loss,beat,dlwin,0,10,18,211,0.417061611,0.047393365,0.526066351,1,0.271531309
26864,101,24478,7,10,0,0,0,17,10,11,0,0,0,21,nowin,loss,beat,dlwin,0,10,17,205,0.424390244,0.068292683,0.63902439,2,0.614740646
26865,125,24478,5,10,0,10,0,25,10,11,0,0,0,21,nowin,loss,bust,plbust,0,10,15,219,0.438356164,0.050228311,0.575342466,1,0.308411257
26866,129,24478,10,9,0,0,0,19,10,11,0,0,0,21,nowin,loss,beat,dlwin,0,10,19,201,0.422885572,0.064676617,0.55721393,0,0.027255383
26867,56,24478,6,10,0,4,0,20,10,11,0,0,0,21,nowin,loss,beat,dlwin,0,10,16,175,0.4,0.057142857,0.582857143,0,0.026685297
26868,71,24479,7,10,0,0,0,17,10,11,0,0,0,21,nowin,loss,beat,dlwin,0,10,17,193,0.352331606,0.046632124,0.585492228,0,0.013063661
26869,25,24479,5,8,0,10,0,23,10,11,0,0,0,21,nowin,loss,bust,plbust,0,10,13,190,0.463157895,0.063157895,0.536842105,1,0.304401563
26870,25,24479,6,4,9,0,0,19,10,11,0,0,0,21,nowin,loss,beat,dlwin,0,10,10,190,0.463157895,0.063157895,0.536842105,1,0.304401563
26871,95,24479,7,5,0,5,0,17,10,11,0,0,0,21,nowin,loss,beat,dlwin,0,10,12,218,0.412844037,0.04587156,0.559633028,0,0.024842385
26872,122,24479,5,10,0,8,0,23,10,11,0,0,0,21,nowin,loss,bust,plbust,0,10,15,210,0.347619048,0.052380952,0.59047619,0,0.012873677
26873,139,24479,2,3,2,9,9,25,10,11,0,0,0,21,nowin,loss,bust,plbust,0,10,5,192,0.380208333,0.036458333,0.59375,0,0.023429169
26874,4,24480,6,8,0,0,0,14,3,10,10,0,0,23,nowin,win,dlbust,bust,20,0,14,217,0.460829493,0.036866359,0.562211982,1,0.315432839
26875,141,24480,4,4,8,0,0,16,3,10,10,0,0,23,nowin,win,dlbust,bust,20,0,8,202,0.420792079,0.074257426,0.564356436,0,0.028377851
26876,144,24480,2,10,0,2,0,14,3,10,10,0,0,23,nowin,win,dlbust,bust,20,0,12,202,0.386138614,0.054455446,0.564356436,0,0.018006244
26877,116,24480,7,4,7,0,0,18,3,10,10,0,0,23,nowin,win,dlbust,bust,20,0,11,195,0.425641026,0.056410256,0.538461538,1,0.28273747
26878,30,24480,10,3,0,0,0,13,3,10,10,0,0,23,nowin,win,dlbust,bust,20,0,13,206,0.393203883,0.033980583,0.601941748,0,0.029324648
26879,36,24480,2,10,0,3,0,15,3,10,10,0,0,23,nowin,win,dlbust,bust,20,0,12,229,0.445414847,0.056768559,0.655021834,2,0.645370571
26880,54,24481,10,11,0,0,0,21,5,10,9,0,0,24,win,win,dlbust,bust,25,0,21,185,0.437837838,0.032432432,0.556756757,1,0.29899854
26881,26,24481,7,3,2,0,0,12,5,10,9,0,0,24,nowin,win,dlbust,bust,20,0,10,203,0.463054187,0.0591133,0.541871921,1,0.306802864
26882,67,24481,8,10,0,0,0,18,5,10,9,0,0,24,nowin,win,dlbust,bust,20,0,18,195,0.369230769,0.041025641,0.569230769,0,0.014139427
26883,125,24481,10,6,0,0,0,16,5,10,9,0,0,24,nowin,win,dlbust,bust,20,0,16,219,0.438356164,0.050228311,0.575342466,1,0.308411257
26884,81,24481,10,10,0,0,0,20,5,10,9,0,0,24,nowin,win,dlbust,bust,20,0,20,182,0.395604396,0.043956044,0.60989011,2,0.567491261
26885,21,24481,10,10,0,0,0,20,5,10,9,0,0,24,nowin,win,dlbust,bust,20,0,20,214,0.359813084,0.042056075,0.626168224,0,0.025263474
26886,13,24482,6,2,10,0,0,18,10,11,0,0,0,21,nowin,loss,beat,dlwin,0,10,8,206,0.417475728,0.063106796,0.621359223,2,0.59555479
26887,106,24482,10,2,0,10,0,22,10,11,0,0,0,21,nowin,loss,bust,plbust,0,10,12,192,0.411458333,0.026041667,0.557291667,0,0.023854304
26888,116,24482,4,4,10,0,0,18,10,11,0,0,0,21,nowin,loss,beat,dlwin,0,10,8,195,0.425641026,0.056410256,0.538461538,1,0.28273747
26889,92,24482,10,5,0,5,0,20,10,11,0,0,0,21,nowin,loss,beat,dlwin,0,10,15,186,0.446236559,0.059139785,0.564516129,1,0.307826125
26890,68,24482,3,6,4,6,0,19,10,11,0,0,0,21,nowin,loss,beat,dlwin,0,10,9,205,0.434146341,0.029268293,0.6,2,0.59483189
26891,83,24482,9,10,0,0,0,19,10,11,0,0,0,21,nowin,loss,beat,dlwin,0,10,19,193,0.424870466,0.051813472,0.678756477,2,0.644360335
26892,141,24483,2,9,2,3,1,17,9,10,0,0,0,19,nowin,loss,beat,dlwin,0,10,11,202,0.420792079,0.074257426,0.564356436,0,0.028377851
26893,70,24483,7,10,0,0,0,17,9,10,0,0,0,19,nowin,loss,beat,dlwin,0,10,17,228,0.385964912,0.039473684,0.557017544,0,0.016157125
26894,5,24483,10,8,0,0,0,18,9,10,0,0,0,19,nowin,loss,beat,dlwin,0,10,18,203,0.42364532,0.02955665,0.596059113,2,0.582508076
26895,133,24483,5,3,7,10,0,25,9,10,0,0,0,19,nowin,loss,bust,plbust,0,10,8,201,0.47761194,0.064676617,0.611940299,3,0.935428111
26896,136,24483,3,8,3,7,0,21,9,10,0,0,0,19,nowin,win,plwin,beat,20,0,11,194,0.396907216,0.025773196,0.597938144,0,0.029452644
26897,133,24483,5,10,0,5,0,20,9,10,0,0,0,19,nowin,win,plwin,beat,20,0,15,201,0.47761194,0.064676617,0.611940299,3,0.935428111
26898,45,24484,10,2,0,3,0,15,2,10,10,0,0,22,nowin,win,dlbust,bust,20,0,12,196,0.428571429,0.051020408,0.612244898,2,0.598821767
26899,130,24484,11,10,0,0,0,21,2,10,10,0,0,22,win,win,dlbust,bust,25,0,21,219,0.410958904,0.03652968,0.566210046,0,0.025888739
26900,18,24484,9,10,0,0,0,19,2,10,10,0,0,22,nowin,win,dlbust,bust,20,0,19,182,0.461538462,0.043956044,0.587912088,3,0.892649374
26901,91,24484,10,6,0,0,0,16,2,10,10,0,0,22,nowin,win,dlbust,bust,20,0,16,194,0.417525773,0.046391753,0.515463918,1,0.266616552
26902,50,24484,5,10,0,0,0,15,2,10,10,0,0,22,nowin,win,dlbust,bust,20,0,15,202,0.405940594,0.04950495,0.54950495,0,0.020296079
26903,45,24484,4,4,2,4,0,14,2,10,10,0,0,22,nowin,win,dlbust,bust,20,0,8,196,0.428571429,0.051020408,0.612244898,2,0.598821767
26904,110,24485,4,10,0,0,0,14,5,3,8,10,0,26,nowin,win,dlbust,bust,20,0,14,192,0.416666667,0.046875,0.557291667,0,0.025413132
26905,66,24485,10,3,0,0,0,13,5,3,8,10,0,26,nowin,win,dlbust,bust,20,0,13,217,0.456221198,0.064516129,0.626728111,3,0.924304367
26906,16,24485,10,6,0,0,0,16,5,3,8,10,0,26,nowin,win,dlbust,bust,20,0,16,220,0.427272727,0.081818182,0.6,2,0.588660176
26907,4,24485,9,6,0,0,0,15,5,3,8,10,0,26,nowin,win,dlbust,bust,20,0,15,217,0.460829493,0.036866359,0.562211982,1,0.315432839
26908,56,24485,5,1,6,0,0,12,5,3,8,10,0,26,nowin,win,dlbust,bust,20,0,6,175,0.4,0.057142857,0.582857143,0,0.026685297
26909,30,24485,2,11,2,0,0,15,5,3,8,10,0,26,nowin,win,dlbust,bust,20,0,13,206,0.393203883,0.033980583,0.601941748,0,0.029324648
26910,79,24486,10,2,0,5,0,17,2,11,4,0,0,17,nowin,push,push,push,10,0,12,211,0.436018957,0.028436019,0.672985782,2,0.650131054
26911,24,24486,6,7,0,0,0,13,2,11,4,0,0,17,nowin,loss,beat,dlwin,0,10,13,207,0.458937198,0.048309179,0.570048309,1,0.318138014
26912,10,24486,7,5,0,6,0,18,2,11,4,0,0,17,nowin,win,plwin,beat,20,0,12,191,0.413612565,0.057591623,0.596858639,2,0.574087175
26913,91,24486,9,9,0,0,0,18,2,11,4,0,0,17,nowin,win,plwin,beat,20,0,18,194,0.417525773,0.046391753,0.515463918,1,0.266616552
26914,74,24486,6,10,0,0,0,16,2,11,4,0,0,17,nowin,loss,beat,dlwin,0,10,16,209,0.411483254,0.04784689,0.531100478,0,0.017448125
26915,98,24486,10,10,0,0,0,20,2,11,4,0,0,17,nowin,win,plwin,beat,20,0,20,220,0.422727273,0.054545455,0.55,1,0.28664435
26916,131,24487,3,2,3,6,10,24,10,10,0,0,0,20,nowin,loss,bust,plbust,0,10,5,217,0.410138249,0.069124424,0.543778802,0,0.02015021
26917,86,24487,10,10,0,0,0,20,10,10,0,0,0,20,nowin,push,push,push,10,0,20,196,0.454081633,0.040816327,0.591836735,3,0.887566443
26918,97,24487,6,7,0,3,10,26,10,10,0,0,0,20,nowin,loss,bust,plbust,0,10,13,182,0.450549451,0.06043956,0.692307692,2,0.677372279
26919,13,24487,10,3,0,6,0,19,10,10,0,0,0,20,nowin,loss,beat,dlwin,0,10,13,206,0.417475728,0.063106796,0.621359223,2,0.59555479
26920,105,24487,5,4,6,3,0,18,10,10,0,0,0,20,nowin,loss,beat,dlwin,0,10,9,198,0.414141414,0.070707071,0.590909091,0,0.032889494
26921,82,24487,3,5,8,9,0,25,10,10,0,0,0,20,nowin,loss,bust,plbust,0,10,8,225,0.408888889,0.075555556,0.577777778,0,0.028101874
26922,11,24488,10,10,0,0,0,20,11,1,8,0,0,20,nowin,push,push,push,10,0,20,236,0.457627119,0.016949153,0.588983051,3,0.889015813
26923,14,24488,7,8,0,10,0,25,11,1,8,0,0,20,nowin,loss,bust,plbust,0,10,15,202,0.391089109,0.01980198,0.628712871,2,0.577264877
26924,126,24488,3,8,10,0,0,21,11,1,8,0,0,20,nowin,win,plwin,beat,20,0,11,188,0.457446809,0.074468085,0.60106383,3,0.900633203
26925,75,24488,2,10,0,10,0,22,11,1,8,0,0,20,nowin,loss,bust,plbust,0,10,12,191,0.418848168,0.052356021,0.570680628,0,0.029344702
26926,10,24488,3,2,6,4,10,25,11,1,8,0,0,20,nowin,loss,bust,plbust,0,10,5,191,0.413612565,0.057591623,0.596858639,2,0.574087175
26927,42,24488,10,10,0,0,0,20,11,1,8,0,0,20,nowin,push,push,push,10,0,20,212,0.443396226,0.051886792,0.570754717,1,0.309181312
26928,131,24489,7,8,0,0,0,15,6,10,1,0,0,17,nowin,loss,beat,dlwin,0,10,15,217,0.410138249,0.069124424,0.543778802,0,0.02015021
26929,33,24489,10,7,0,0,0,17,6,10,1,0,0,17,nowin,push,push,push,10,0,17,192,0.4375,0.057291667,0.625,2,0.616208916
26930,138,24489,4,7,4,0,0,15,6,10,1,0,0,17,nowin,loss,beat,dlwin,0,10,11,190,0.442105263,0.047368421,0.610526316,2,0.609711065
26931,147,24489,3,8,10,0,0,21,6,10,1,0,0,17,nowin,win,plwin,beat,20,0,11,205,0.380487805,0.014634146,0.536585366,0,0.00951447
26932,131,24489,4,10,0,0,0,14,6,10,1,0,0,17,nowin,loss,beat,dlwin,0,10,14,217,0.410138249,0.069124424,0.543778802,0,0.02015021
26933,35,24489,10,8,0,0,0,18,6,10,1,0,0,17,nowin,win,plwin,beat,20,0,18,202,0.410891089,0.044554455,0.633663366,2,0.598681573
26934,17,24490,8,9,0,0,0,17,2,3,10,1,4,20,nowin,loss,beat,dlwin,0,10,17,171,0.444444444,0.070175439,0.555555556,1,0.302364894
26935,1,24490,3,4,2,10,0,19,2,3,10,1,4,20,nowin,loss,beat,dlwin,0,10,7,197,0.406091371,0.025380711,0.649746193,2,0.606186955
26936,121,24490,4,3,8,0,0,15,2,3,10,1,4,20,nowin,loss,beat,dlwin,0,10,7,195,0.456410256,0.025641026,0.512820513,1,0.288597791
26937,102,24490,7,5,0,1,0,13,2,3,10,1,4,20,nowin,loss,beat,dlwin,0,10,12,192,0.338541667,0.046875,0.5625,0,0.003306118
26938,106,24490,4,2,10,0,0,16,2,3,10,1,4,20,nowin,loss,beat,dlwin,0,10,6,192,0.411458333,0.026041667,0.557291667,0,0.023854304
26939,9,24490,3,10,0,0,0,13,2,3,10,1,4,20,nowin,loss,beat,dlwin,0,10,13,194,0.37628866,0.015463918,0.541237113,0,0.009396796
26940,98,24491,11,8,0,0,0,19,10,2,10,0,0,22,nowin,win,dlbust,bust,20,0,19,220,0.422727273,0.054545455,0.55,1,0.28664435
26941,111,24491,1,5,10,10,0,26,10,2,10,0,0,22,nowin,loss,bust,plbust,0,10,6,180,0.433333333,0.055555556,0.611111111,2,0.602264492
26942,103,24491,7,8,0,7,0,22,10,2,10,0,0,22,nowin,loss,bust,plbust,0,10,15,203,0.379310345,0.064039409,0.551724138,0,0.012869209
26943,34,24491,10,10,0,0,0,20,10,2,10,0,0,22,nowin,win,dlbust,bust,20,0,20,202,0.5,0.079207921,0.618811881,3,0.968961434
26944,36,24491,10,10,0,0,0,20,10,2,10,0,0,22,nowin,win,dlbust,bust,20,0,20,229,0.445414847,0.056768559,0.655021834,2,0.645370571
26945,29,24491,5,10,0,2,0,17,10,2,10,0,0,22,nowin,win,dlbust,bust,20,0,15,189,0.44973545,0.058201058,0.544973545,1,0.300349439
26946,81,24492,10,10,0,0,0,20,10,7,0,0,0,17,nowin,win,plwin,beat,20,0,20,182,0.395604396,0.043956044,0.60989011,2,0.567491261
26947,108,24492,8,9,0,0,0,17,10,7,0,0,0,17,nowin,push,push,push,10,0,17,193,0.435233161,0.056994819,0.559585492,1,0.298824795
26948,95,24492,8,11,0,0,0,19,10,7,0,0,0,17,nowin,win,plwin,beat,20,0,19,218,0.412844037,0.04587156,0.559633028,0,0.024842385
26949,31,24492,8,4,0,1,10,23,10,7,0,0,0,17,nowin,loss,bust,plbust,0,10,12,188,0.473404255,0.058510638,0.515957447,1,0.300306557
26950,119,24492,5,11,1,0,0,17,10,7,0,0,0,17,nowin,push,push,push,10,0,16,190,0.405263158,0.068421053,0.515789474,0,0.011837158
26951,113,24492,3,2,10,5,0,20,10,7,0,0,0,17,nowin,win,plwin,beat,20,0,5,199,0.407035176,0.055276382,0.668341709,2,0.620695264
26952,25,24493,2,10,0,2,10,24,10,11,0,0,0,21,nowin,loss,bust,plbust,0,10,12,190,0.463157895,0.063157895,0.536842105,1,0.304401563
26953,22,24493,10,4,0,8,0,22,10,11,0,0,0,21,nowin,loss,bust,plbust,0,10,14,187,0.481283422,0.042780749,0.577540107,3,0.906128176
26954,139,24493,10,2,0,10,0,22,10,11,0,0,0,21,nowin,loss,bust,plbust,0,10,12,192,0.380208333,0.036458333,0.59375,0,0.023429169
26955,148,24493,7,3,3,8,0,21,10,11,0,0,0,21,nowin,push,push,push,10,0,10,204,0.401960784,0.078431373,0.593137255,0,0.029789521
26956,49,24493,8,10,0,0,0,18,10,11,0,0,0,21,nowin,loss,beat,dlwin,0,10,18,207,0.396135266,0.053140097,0.594202899,0,0.028306925
26957,12,24493,10,8,0,0,0,18,10,11,0,0,0,21,nowin,loss,beat,dlwin,0,10,18,189,0.470899471,0.015873016,0.613756614,3,0.929171178
26958,13,24494,2,10,0,4,10,26,9,4,10,0,0,23,nowin,loss,bust,plbust,0,10,12,206,0.417475728,0.063106796,0.621359223,2,0.59555479
26959,96,24494,10,3,0,9,0,22,9,4,10,0,0,23,nowin,loss,bust,plbust,0,10,13,190,0.468421053,0.057894737,0.584210526,3,0.897263354
26960,44,24494,10,10,0,0,0,20,9,4,10,0,0,23,nowin,win,dlbust,bust,20,0,20,219,0.433789954,0.050228311,0.534246575,1,0.285551035
26961,78,24494,6,1,8,10,0,25,9,4,10,0,0,23,nowin,loss,bust,plbust,0,10,7,201,0.517412935,0.034825871,0.587064677,3,0.95871112
26962,144,24494,7,8,0,10,0,25,9,4,10,0,0,23,nowin,loss,bust,plbust,0,10,15,202,0.386138614,0.054455446,0.564356436,0,0.018006244
26963,79,24494,10,10,0,0,0,20,9,4,10,0,0,23,nowin,win,dlbust,bust,20,0,20,211,0.436018957,0.028436019,0.672985782,2,0.650131054
26964,74,24495,9,10,0,0,0,19,2,6,6,5,0,19,nowin,push,push,push,10,0,19,209,0.411483254,0.04784689,0.531100478,0,0.017448125
26965,102,24495,10,8,0,0,0,18,2,6,6,5,0,19,nowin,loss,beat,dlwin,0,10,18,192,0.338541667,0.046875,0.5625,0,0.003306118
26966,14,24495,4,3,9,0,0,16,2,6,6,5,0,19,nowin,loss,beat,dlwin,0,10,7,202,0.391089109,0.01980198,0.628712871,2,0.577264877
26967,13,24495,10,10,0,0,0,20,2,6,6,5,0,19,nowin,win,plwin,beat,20,0,20,206,0.417475728,0.063106796,0.621359223,2,0.59555479
26968,91,24495,2,10,0,7,0,19,2,6,6,5,0,19,nowin,push,push,push,10,0,12,194,0.417525773,0.046391753,0.515463918,1,0.266616552
26969,2,24495,5,1,8,0,0,14,2,6,6,5,0,19,nowin,loss,beat,dlwin,0,10,6,200,0.445,0.035,0.64,2,0.633962549
26970,128,24496,4,10,0,5,0,19,10,10,0,0,0,20,nowin,loss,beat,dlwin,0,10,14,227,0.356828194,0.052863436,0.577092511,0,0.012352564
26971,44,24496,8,10,0,0,0,18,10,10,0,0,0,20,nowin,loss,beat,dlwin,0,10,18,219,0.433789954,0.050228311,0.534246575,1,0.285551035
26972,63,24496,2,4,6,10,0,22,10,10,0,0,0,20,nowin,loss,bust,plbust,0,10,6,216,0.467592593,0.037037037,0.62037037,3,0.931690496
26973,98,24496,8,3,4,10,0,25,10,10,0,0,0,20,nowin,loss,bust,plbust,0,10,11,220,0.422727273,0.054545455,0.55,1,0.28664435
26974,18,24496,10,3,0,1,4,18,10,10,0,0,0,20,nowin,loss,beat,dlwin,0,10,13,182,0.461538462,0.043956044,0.587912088,3,0.892649374
26975,81,24496,10,10,0,0,0,20,10,10,0,0,0,20,nowin,push,push,push,10,0,20,182,0.395604396,0.043956044,0.60989011,2,0.567491261
26976,80,24497,4,3,9,7,0,23,11,9,0,0,0,20,nowin,loss,bust,plbust,0,10,7,186,0.419354839,0.059139785,0.623655914,2,0.59892924
26977,115,24497,6,10,0,1,0,17,11,9,0,0,0,20,nowin,loss,beat,dlwin,0,10,16,194,0.427835052,0.041237113,0.592783505,2,0.583863602
26978,28,24497,3,3,5,10,0,21,11,9,0,0,0,20,nowin,win,plwin,beat,20,0,6,199,0.422110553,0.045226131,0.542713568,1,0.282706618
26979,15,24497,7,5,0,6,0,18,11,9,0,0,0,20,nowin,loss,beat,dlwin,0,10,12,212,0.410377358,0.051886792,0.561320755,0,0.024517408
26980,48,24497,1,6,5,8,0,20,11,9,0,0,0,20,nowin,push,push,push,10,0,7,203,0.413793103,0.019704433,0.600985222,2,0.577280801
26981,146,24497,10,10,0,0,0,20,11,9,0,0,0,20,nowin,push,push,push,10,0,20,221,0.43438914,0.040723982,0.542986425,1,0.290190091
26982,6,24498,2,2,7,6,0,17,7,7,5,0,0,19,nowin,loss,beat,dlwin,0,10,4,191,0.439790576,0.047120419,0.581151832,1,0.31211505
26983,135,24498,7,10,0,0,0,17,7,7,5,0,0,19,nowin,loss,beat,dlwin,0,10,17,179,0.391061453,0.067039106,0.586592179,0,0.024924662
26984,45,24498,5,7,0,10,0,22,7,7,5,0,0,19,nowin,loss,bust,plbust,0,10,12,196,0.428571429,0.051020408,0.612244898,2,0.598821767
26985,23,24498,5,6,10,0,0,21,7,7,5,0,0,19,nowin,win,plwin,beat,20,0,11,208,0.427884615,0.0625,0.552884615,1,0.29114424
26986,137,24498,6,10,0,1,0,17,7,7,5,0,0,19,nowin,loss,beat,dlwin,0,10,16,194,0.417525773,0.046391753,0.536082474,1,0.276714602
26987,44,24498,8,6,0,10,0,24,7,7,5,0,0,19,nowin,loss,bust,plbust,0,10,14,219,0.433789954,0.050228311,0.534246575,1,0.285551035
26988,64,24499,4,10,0,7,0,21,10,10,0,0,0,20,nowin,win,plwin,beat,20,0,14,187,0.363636364,0.048128342,0.631016043,0,0.027594885
26989,142,24499,5,10,0,10,0,25,10,10,0,0,0,20,nowin,loss,bust,plbust,0,10,15,211,0.417061611,0.047393365,0.526066351,1,0.271531309
26990,57,24499,6,10,0,4,0,20,10,10,0,0,0,20,nowin,push,push,push,10,0,16,192,0.46875,0.052083333,0.59375,3,0.907001181
26991,93,24499,10,6,0,10,0,26,10,10,0,0,0,20,nowin,loss,bust,plbust,0,10,16,175,0.485714286,0.051428571,0.548571429,1,0.323648091
26992,60,24499,1,3,10,10,0,24,10,10,0,0,0,20,nowin,loss,bust,plbust,0,10,4,227,0.418502203,0.022026432,0.559471366,0,0.026496258
26993,139,24499,9,10,0,0,0,19,10,10,0,0,0,20,nowin,loss,beat,dlwin,0,10,19,192,0.380208333,0.036458333,0.59375,0,0.023429169
26994,49,24500,9,2,10,0,0,21,6,4,7,0,0,17,nowin,win,plwin,beat,20,0,11,207,0.396135266,0.053140097,0.594202899,0,0.028306925
26995,41,24500,10,3,0,0,0,13,6,4,7,0,0,17,nowin,loss,beat,dlwin,0,10,13,192,0.364583333,0.036458333,0.520833333,0,0.00089702
26996,140,24500,9,10,0,0,0,19,6,4,7,0,0,17,nowin,win,plwin,beat,20,0,19,210,0.466666667,0.023809524,0.604761905,3,0.915293335
26997,20,24500,8,9,0,0,0,17,6,4,7,0,0,17,nowin,push,push,push,10,0,17,186,0.456989247,0.037634409,0.537634409,1,0.301097108
26998,9,24500,6,10,0,0,0,16,6,4,7,0,0,17,nowin,loss,beat,dlwin,0,10,16,194,0.37628866,0.015463918,0.541237113,0,0.009396796
26999,69,24500,7,10,0,0,0,17,6,4,7,0,0,17,nowin,push,push,push,10,0,17,194,0.365979381,0.030927835,0.515463918,0,0
27000,28,24501,5,2,9,10,0,26,11,3,4,0,0,18,nowin,loss,bust,plbust,0,10,7,199,0.422110553,0.045226131,0.542713568,1,0.282706618
27001,87,24501,11,10,0,0,0,21,11,3,4,0,0,18,win,win,plwin,beat,25,0,21,202,0.405940594,0.054455446,0.628712871,2,0.590599801
27002,10,24501,8,5,0,10,0,23,11,3,4,0,0,18,nowin,loss,bust,plbust,0,10,13,191,0.413612565,0.057591623,0.596858639,2,0.574087175
27003,84,24501,5,10,0,8,0,23,11,3,4,0,0,18,nowin,loss,bust,plbust,0,10,15,195,0.379487179,0.056410256,0.569230769,0,0.017209119
27004,126,24501,7,5,0,9,0,21,11,3,4,0,0,18,nowin,win,plwin,beat,20,0,12,188,0.457446809,0.074468085,0.60106383,3,0.900633203
27005,141,24501,10,10,0,0,0,20,11,3,4,0,0,18,nowin,win,plwin,beat,20,0,20,202,0.420792079,0.074257426,0.564356436,0,0.028377851
27006,36,24502,10,9,0,0,0,19,6,11,0,0,0,17,nowin,win,plwin,beat,20,0,19,229,0.445414847,0.056768559,0.655021834,2,0.645370571
27007,126,24502,10,10,0,0,0,20,6,11,0,0,0,17,nowin,win,plwin,beat,20,0,20,188,0.457446809,0.074468085,0.60106383,3,0.900633203
27008,118,24502,10,10,0,0,0,20,6,11,0,0,0,17,nowin,win,plwin,beat,20,0,20,216,0.393518519,0.037037037,0.555555556,0,0.018059873
27009,68,24502,2,10,0,0,0,12,6,11,0,0,0,17,nowin,loss,beat,dlwin,0,10,12,205,0.434146341,0.029268293,0.6,2,0.59483189
27010,115,24502,3,8,1,0,0,12,6,11,0,0,0,17,nowin,loss,beat,dlwin,0,10,11,194,0.427835052,0.041237113,0.592783505,2,0.583863602
27011,125,24502,10,10,0,0,0,20,6,11,0,0,0,17,nowin,win,plwin,beat,20,0,20,219,0.438356164,0.050228311,0.575342466,1,0.308411257
27012,92,24503,4,10,0,0,0,14,6,6,4,4,0,20,nowin,loss,beat,dlwin,0,10,14,186,0.446236559,0.059139785,0.564516129,1,0.307826125
27013,73,24503,3,8,10,0,0,21,6,6,4,4,0,20,nowin,win,plwin,beat,20,0,11,181,0.375690608,0.011049724,0.596685083,0,0.022795773
27014,114,24503,9,2,10,0,0,21,6,6,4,4,0,20,nowin,win,plwin,beat,20,0,11,198,0.47979798,0.025252525,0.611111111,3,0.937232995
27015,30,24503,5,5,10,0,0,20,6,6,4,4,0,20,nowin,push,push,push,10,0,10,206,0.393203883,0.033980583,0.601941748,0,0.029324648
27016,79,24503,8,8,0,0,0,16,6,6,4,4,0,20,nowin,loss,beat,dlwin,0,10,16,211,0.436018957,0.028436019,0.672985782,2,0.650131054
27017,9,24503,5,7,0,0,0,12,6,6,4,4,0,20,nowin,loss,beat,dlwin,0,10,12,194,0.37628866,0.015463918,0.541237113,0,0.009396796
27018,83,24504,6,10,0,10,0,26,10,10,0,0,0,20,nowin,loss,bust,plbust,0,10,16,193,0.424870466,0.051813472,0.678756477,2,0.644360335
27019,37,24504,5,4,5,10,0,24,10,10,0,0,0,20,nowin,loss,bust,plbust,0,10,9,208,0.394230769,0.038461538,0.581730769,0,0.024682772
27020,129,24504,7,9,0,10,0,26,10,10,0,0,0,20,nowin,loss,bust,plbust,0,10,16,201,0.422885572,0.064676617,0.55721393,0,0.027255383
27021,138,24504,4,11,3,0,0,18,10,10,0,0,0,20,nowin,loss,beat,dlwin,0,10,15,190,0.442105263,0.047368421,0.610526316,2,0.609711065
27022,57,24504,3,3,5,4,10,25,10,10,0,0,0,20,nowin,loss,bust,plbust,0,10,6,192,0.46875,0.052083333,0.59375,3,0.907001181
27023,122,24504,6,3,2,10,0,21,10,10,0,0,0,20,nowin,win,plwin,beat,20,0,9,210,0.347619048,0.052380952,0.59047619,0,0.012873677
27024,95,24505,10,10,0,0,0,20,9,10,0,0,0,19,nowin,win,plwin,beat,20,0,20,218,0.412844037,0.04587156,0.559633028,0,0.024842385
27025,27,24505,6,3,11,0,0,20,9,10,0,0,0,19,nowin,win,plwin,beat,20,0,9,178,0.370786517,0.016853933,0.573033708,0,0.015536309
27026,100,24505,3,4,7,5,0,19,9,10,0,0,0,19,nowin,push,push,push,10,0,7,190,0.452631579,0.036842105,0.594736842,3,0.888671154
27027,64,24505,7,10,0,0,0,17,9,10,0,0,0,19,nowin,loss,beat,dlwin,0,10,17,187,0.363636364,0.048128342,0.631016043,0,0.027594885
27028,148,24505,10,3,0,3,7,23,9,10,0,0,0,19,nowin,loss,bust,plbust,0,10,13,204,0.401960784,0.078431373,0.593137255,0,0.029789521
27029,84,24505,5,10,0,8,0,23,9,10,0,0,0,19,nowin,loss,bust,plbust,0,10,15,195,0.379487179,0.056410256,0.569230769,0,0.017209119
27030,6,24506,4,1,10,3,0,18,8,10,0,0,0,18,nowin,push,push,push,10,0,5,191,0.439790576,0.047120419,0.581151832,1,0.31211505
27031,9,24506,3,7,10,0,0,20,8,10,0,0,0,18,nowin,win,plwin,beat,20,0,10,194,0.37628866,0.015463918,0.541237113,0,0.009396796
27032,37,24506,2,10,0,4,1,17,8,10,0,0,0,18,nowin,loss,beat,dlwin,0,10,12,208,0.394230769,0.038461538,0.581730769,0,0.024682772
27033,45,24506,10,10,0,0,0,20,8,10,0,0,0,18,nowin,win,plwin,beat,20,0,20,196,0.428571429,0.051020408,0.612244898,2,0.598821767
27034,132,24506,8,2,10,0,0,20,8,10,0,0,0,18,nowin,win,plwin,beat,20,0,10,194,0.412371134,0.036082474,0.649484536,2,0.611633238
27035,31,24506,10,3,0,7,0,20,8,10,0,0,0,18,nowin,win,plwin,beat,20,0,13,188,0.473404255,0.058510638,0.515957447,1,0.300306557
27036,125,24507,3,9,0,1,10,23,8,5,10,0,0,23,nowin,loss,bust,plbust,0,10,12,219,0.438356164,0.050228311,0.575342466,1,0.308411257
27037,52,24507,5,4,6,10,0,25,8,5,10,0,0,23,nowin,loss,bust,plbust,0,10,9,217,0.414746544,0.02764977,0.599078341,2,0.576736024
27038,112,24507,10,8,0,0,0,18,8,5,10,0,0,23,nowin,win,dlbust,bust,20,0,18,203,0.448275862,0.054187192,0.600985222,3,0.889576933
27039,146,24507,10,7,0,0,0,17,8,5,10,0,0,23,nowin,win,dlbust,bust,20,0,17,221,0.43438914,0.040723982,0.542986425,1,0.290190091
27040,1,24507,9,6,0,2,0,17,8,5,10,0,0,23,nowin,win,dlbust,bust,20,0,15,197,0.406091371,0.025380711,0.649746193,2,0.606186955
27041,48,24507,11,10,0,0,0,21,8,5,10,0,0,23,win,win,dlbust,bust,25,0,21,203,0.413793103,0.019704433,0.600985222,2,0.577280801
27042,114,24508,4,8,0,8,0,20,3,5,2,10,0,20,nowin,push,push,push,10,0,12,198,0.47979798,0.025252525,0.611111111,3,0.937232995
27043,9,24508,2,9,9,0,0,20,3,5,2,10,0,20,nowin,push,push,push,10,0,11,194,0.37628866,0.015463918,0.541237113,0,0.009396796
27044,26,24508,11,2,3,0,0,16,3,5,2,10,0,20,nowin,loss,beat,dlwin,0,10,13,203,0.463054187,0.0591133,0.541871921,1,0.306802864
27045,144,24508,4,10,0,0,0,14,3,5,2,10,0,20,nowin,loss,beat,dlwin,0,10,14,202,0.386138614,0.054455446,0.564356436,0,0.018006244
27046,94,24508,8,10,0,0,0,18,3,5,2,10,0,20,nowin,loss,beat,dlwin,0,10,18,183,0.43715847,0.043715847,0.540983607,1,0.290866892
27047,26,24508,11,9,0,0,0,20,3,5,2,10,0,20,nowin,push,push,push,10,0,20,203,0.463054187,0.0591133,0.541871921,1,0.306802864
27048,18,24509,10,8,0,0,0,18,4,10,1,7,0,22,nowin,win,dlbust,bust,20,0,18,182,0.461538462,0.043956044,0.587912088,3,0.892649374
27049,145,24509,7,4,5,0,0,16,4,10,1,7,0,22,nowin,win,dlbust,bust,20,0,11,188,0.441489362,0.031914894,0.622340426,2,0.617837093
27050,137,24509,9,8,0,0,0,17,4,10,1,7,0,22,nowin,win,dlbust,bust,20,0,17,194,0.417525773,0.046391753,0.536082474,1,0.276714602
27051,126,24509,5,8,0,0,0,13,4,10,1,7,0,22,nowin,win,dlbust,bust,20,0,13,188,0.457446809,0.074468085,0.60106383,3,0.900633203
27052,39,24509,9,9,0,0,0,18,4,10,1,7,0,22,nowin,win,dlbust,bust,20,0,18,191,0.429319372,0.062827225,0.57591623,0,0.033760763
27053,49,24509,11,10,0,0,0,21,4,10,1,7,0,22,win,win,dlbust,bust,25,0,21,207,0.396135266,0.053140097,0.594202899,0,0.028306925
27054,22,24510,11,8,0,0,0,19,10,10,0,0,0,20,nowin,loss,beat,dlwin,0,10,19,187,0.481283422,0.042780749,0.577540107,3,0.906128176
27055,146,24510,10,11,0,0,0,21,10,10,0,0,0,20,win,win,plwin,beat,25,0,21,221,0.43438914,0.040723982,0.542986425,1,0.290190091
27056,55,24510,3,3,2,10,0,18,10,10,0,0,0,20,nowin,loss,beat,dlwin,0,10,6,191,0.371727749,0.057591623,0.54973822,0,0.01011347
27057,2,24510,3,7,11,0,0,21,10,10,0,0,0,20,nowin,win,plwin,beat,20,0,10,200,0.445,0.035,0.64,2,0.633962549
27058,148,24510,6,4,4,10,0,24,10,10,0,0,0,20,nowin,loss,bust,plbust,0,10,10,204,0.401960784,0.078431373,0.593137255,0,0.029789521
27059,94,24510,11,3,7,0,0,21,10,10,0,0,0,20,nowin,win,plwin,beat,20,0,14,183,0.43715847,0.043715847,0.540983607,1,0.290866892
27060,37,24511,10,8,0,0,0,18,7,7,10,0,0,24,nowin,win,dlbust,bust,20,0,18,208,0.394230769,0.038461538,0.581730769,0,0.024682772
27061,146,24511,3,2,10,4,0,19,7,7,10,0,0,24,nowin,win,dlbust,bust,20,0,5,221,0.43438914,0.040723982,0.542986425,1,0.290190091
27062,9,24511,3,2,9,7,0,21,7,7,10,0,0,24,nowin,win,dlbust,bust,20,0,5,194,0.37628866,0.015463918,0.541237113,0,0.009396796
27063,97,24511,11,10,0,0,0,21,7,7,10,0,0,24,win,win,dlbust,bust,25,0,21,182,0.450549451,0.06043956,0.692307692,2,0.677372279
27064,78,24511,10,10,0,0,0,20,7,7,10,0,0,24,nowin,win,dlbust,bust,20,0,20,201,0.517412935,0.034825871,0.587064677,3,0.95871112
27065,12,24511,5,10,0,5,0,20,7,7,10,0,0,24,nowin,win,dlbust,bust,20,0,15,189,0.470899471,0.015873016,0.613756614,3,0.929171178
27066,58,24512,10,3,0,0,0,13,3,7,10,0,0,20,nowin,loss,beat,dlwin,0,10,13,195,0.430769231,0.041025641,0.584615385,2,0.580497586
27067,134,24512,6,10,0,0,0,16,3,7,10,0,0,20,nowin,loss,beat,dlwin,0,10,16,185,0.443243243,0.021621622,0.545945946,1,0.296939509
27068,83,24512,3,5,6,0,0,14,3,7,10,0,0,20,nowin,loss,beat,dlwin,0,10,8,193,0.424870466,0.051813472,0.678756477,2,0.644360335
27069,64,24512,9,9,0,0,0,18,3,7,10,0,0,20,nowin,loss,beat,dlwin,0,10,18,187,0.363636364,0.048128342,0.631016043,0,0.027594885
27070,71,24512,7,10,0,0,0,17,3,7,10,0,0,20,nowin,loss,beat,dlwin,0,10,17,193,0.352331606,0.046632124,0.585492228,0,0.013063661
27071,138,24512,4,1,10,0,0,15,3,7,10,0,0,20,nowin,loss,beat,dlwin,0,10,5,190,0.442105263,0.047368421,0.610526316,2,0.609711065
27072,72,24513,10,7,0,0,0,17,10,10,0,0,0,20,nowin,loss,beat,dlwin,0,10,17,185,0.394594595,0.032432432,0.508108108,0,0.006763115
27073,146,24513,11,7,0,0,0,18,10,10,0,0,0,20,nowin,loss,beat,dlwin,0,10,18,221,0.43438914,0.040723982,0.542986425,1,0.290190091
27074,45,24513,10,5,0,8,0,23,10,10,0,0,0,20,nowin,loss,bust,plbust,0,10,15,196,0.428571429,0.051020408,0.612244898,2,0.598821767
27075,33,24513,10,3,0,3,10,26,10,10,0,0,0,20,nowin,loss,bust,plbust,0,10,13,192,0.4375,0.057291667,0.625,2,0.616208916
27076,132,24513,10,10,0,0,0,20,10,10,0,0,0,20,nowin,push,push,push,10,0,20,194,0.412371134,0.036082474,0.649484536,2,0.611633238
27077,106,24513,9,4,0,10,0,23,10,10,0,0,0,20,nowin,loss,bust,plbust,0,10,13,192,0.411458333,0.026041667,0.557291667,0,0.023854304
27078,88,24514,3,10,0,0,0,13,4,8,2,3,0,17,nowin,loss,beat,dlwin,0,10,13,206,0.466019417,0.033980583,0.54368932,1,0.309467903
27079,122,24514,3,10,0,0,0,13,4,8,2,3,0,17,nowin,loss,beat,dlwin,0,10,13,210,0.347619048,0.052380952,0.59047619,0,0.012873677
27080,24,24514,9,10,0,0,0,19,4,8,2,3,0,17,nowin,win,plwin,beat,20,0,19,207,0.458937198,0.048309179,0.570048309,1,0.318138014
27081,30,24514,6,6,0,0,0,12,4,8,2,3,0,17,nowin,loss,beat,dlwin,0,10,12,206,0.393203883,0.033980583,0.601941748,0,0.029324648
27082,43,24514,10,4,0,0,0,14,4,8,2,3,0,17,nowin,loss,beat,dlwin,0,10,14,192,0.40625,0.041666667,0.609375,2,0.576671372
27083,67,24514,1,6,9,0,0,16,4,8,2,3,0,17,nowin,loss,beat,dlwin,0,10,7,195,0.369230769,0.041025641,0.569230769,0,0.014139427
27084,113,24515,10,10,0,0,0,20,5,8,3,3,0,19,nowin,win,plwin,beat,20,0,20,199,0.407035176,0.055276382,0.668341709,2,0.620695264
27085,65,24515,10,9,0,0,0,19,5,8,3,3,0,19,nowin,push,push,push,10,0,19,203,0.492610837,0.054187192,0.571428571,3,0.913702814
27086,25,24515,3,1,10,0,0,14,5,8,3,3,0,19,nowin,loss,beat,dlwin,0,10,4,190,0.463157895,0.063157895,0.536842105,1,0.304401563
27087,11,24515,6,6,0,0,0,12,5,8,3,3,0,19,nowin,loss,beat,dlwin,0,10,12,236,0.457627119,0.016949153,0.588983051,3,0.889015813
27088,139,24515,3,2,2,9,0,16,5,8,3,3,0,19,nowin,loss,beat,dlwin,0,10,5,192,0.380208333,0.036458333,0.59375,0,0.023429169
27089,85,24515,8,7,0,0,0,15,5,8,3,3,0,19,nowin,loss,beat,dlwin,0,10,15,195,0.41025641,0.066666667,0.594871795,0,0.03269711
27090,138,24516,6,5,7,0,0,18,4,5,3,7,0,19,nowin,loss,beat,dlwin,0,10,11,190,0.442105263,0.047368421,0.610526316,2,0.609711065
27091,8,24516,7,10,0,0,0,17,4,5,3,7,0,19,nowin,loss,beat,dlwin,0,10,17,181,0.44198895,0.071823204,0.596685083,2,0.599438402
27092,30,24516,10,2,0,0,0,12,4,5,3,7,0,19,nowin,loss,beat,dlwin,0,10,12,206,0.393203883,0.033980583,0.601941748,0,0.029324648
27093,139,24516,10,3,0,0,0,13,4,5,3,7,0,19,nowin,loss,beat,dlwin,0,10,13,192,0.380208333,0.036458333,0.59375,0,0.023429169
27094,91,24516,4,10,0,0,0,14,4,5,3,7,0,19,nowin,loss,beat,dlwin,0,10,14,194,0.417525773,0.046391753,0.515463918,1,0.266616552
27095,128,24516,7,3,10,0,0,20,4,5,3,7,0,19,nowin,win,plwin,beat,20,0,10,227,0.356828194,0.052863436,0.577092511,0,0.012352564
27096,44,24517,10,4,0,1,9,24,9,5,6,0,0,20,nowin,loss,bust,plbust,0,10,14,219,0.433789954,0.050228311,0.534246575,1,0.285551035
27097,121,24517,3,10,0,7,0,20,9,5,6,0,0,20,nowin,push,push,push,10,0,13,195,0.456410256,0.025641026,0.512820513,1,0.288597791
27098,57,24517,10,4,0,10,0,24,9,5,6,0,0,20,nowin,loss,bust,plbust,0,10,14,192,0.46875,0.052083333,0.59375,3,0.907001181
27099,56,24517,10,10,0,0,0,20,9,5,6,0,0,20,nowin,push,push,push,10,0,20,175,0.4,0.057142857,0.582857143,0,0.026685297
27100,105,24517,8,10,0,0,0,18,9,5,6,0,0,20,nowin,loss,beat,dlwin,0,10,18,198,0.414141414,0.070707071,0.590909091,0,0.032889494
27101,107,24517,10,9,0,0,0,19,9,5,6,0,0,20,nowin,loss,beat,dlwin,0,10,19,218,0.444954128,0.073394495,0.600917431,2,0.605210014
27102,74,24518,4,2,3,3,1,13,7,10,0,0,0,17,nowin,loss,beat,dlwin,0,10,6,209,0.411483254,0.04784689,0.531100478,0,0.017448125
27103,103,24518,10,7,0,0,0,17,7,10,0,0,0,17,nowin,push,push,push,10,0,17,203,0.379310345,0.064039409,0.551724138,0,0.012869209
27104,34,24518,8,10,0,0,0,18,7,10,0,0,0,17,nowin,win,plwin,beat,20,0,18,202,0.5,0.079207921,0.618811881,3,0.968961434
27105,45,24518,2,9,6,0,0,17,7,10,0,0,0,17,nowin,push,push,push,10,0,11,196,0.428571429,0.051020408,0.612244898,2,0.598821767
27106,89,24518,10,9,0,0,0,19,7,10,0,0,0,17,nowin,win,plwin,beat,20,0,19,212,0.537735849,0.047169811,0.594339623,3,0.990167191
27107,95,24518,10,8,0,0,0,18,7,10,0,0,0,17,nowin,win,plwin,beat,20,0,18,218,0.412844037,0.04587156,0.559633028,0,0.024842385
27108,121,24519,9,2,9,0,0,20,10,6,10,0,0,26,nowin,win,dlbust,bust,20,0,11,195,0.456410256,0.025641026,0.512820513,1,0.288597791
27109,11,24519,6,4,10,0,0,20,10,6,10,0,0,26,nowin,win,dlbust,bust,20,0,10,236,0.457627119,0.016949153,0.588983051,3,0.889015813
27110,49,24519,10,8,0,0,0,18,10,6,10,0,0,26,nowin,win,dlbust,bust,20,0,18,207,0.396135266,0.053140097,0.594202899,0,0.028306925
27111,35,24519,8,10,0,0,0,18,10,6,10,0,0,26,nowin,win,dlbust,bust,20,0,18,202,0.410891089,0.044554455,0.633663366,2,0.598681573
27112,103,24519,5,6,7,0,0,18,10,6,10,0,0,26,nowin,win,dlbust,bust,20,0,11,203,0.379310345,0.064039409,0.551724138,0,0.012869209
27113,53,24519,4,10,0,10,0,24,10,6,10,0,0,26,nowin,loss,bust,plbust,0,10,14,250,0.372,0.064,0.564,0,0.013687345
27114,101,24520,5,2,10,0,0,17,10,10,0,0,0,20,nowin,loss,beat,dlwin,0,10,7,205,0.424390244,0.068292683,0.63902439,2,0.614740646
27115,48,24520,6,5,6,0,0,17,10,10,0,0,0,20,nowin,loss,beat,dlwin,0,10,11,203,0.413793103,0.019704433,0.600985222,2,0.577280801
27116,128,24520,11,8,0,0,0,19,10,10,0,0,0,20,nowin,loss,beat,dlwin,0,10,19,227,0.356828194,0.052863436,0.577092511,0,0.012352564
27117,84,24520,4,8,0,9,0,21,10,10,0,0,0,20,nowin,win,plwin,beat,20,0,12,195,0.379487179,0.056410256,0.569230769,0,0.017209119
27118,29,24520,9,6,0,5,0,20,10,10,0,0,0,20,nowin,push,push,push,10,0,15,189,0.44973545,0.058201058,0.544973545,1,0.300349439
27119,66,24520,5,9,0,8,0,22,10,10,0,0,0,20,nowin,loss,bust,plbust,0,10,14,217,0.456221198,0.064516129,0.626728111,3,0.924304367
27120,43,24521,10,8,0,0,0,18,5,8,7,0,0,20,nowin,loss,beat,dlwin,0,10,18,192,0.40625,0.041666667,0.609375,2,0.576671372
27121,24,24521,10,7,0,0,0,17,5,8,7,0,0,20,nowin,loss,beat,dlwin,0,10,17,207,0.458937198,0.048309179,0.570048309,1,0.318138014
27122,39,24521,10,10,0,0,0,20,5,8,7,0,0,20,nowin,push,push,push,10,0,20,191,0.429319372,0.062827225,0.57591623,0,0.033760763
27123,90,24521,11,10,0,0,0,21,5,8,7,0,0,20,win,win,plwin,beat,25,0,21,201,0.447761194,0.049751244,0.60199005,3,0.889945023
27124,26,24521,10,10,0,0,0,20,5,8,7,0,0,20,nowin,push,push,push,10,0,20,203,0.463054187,0.0591133,0.541871921,1,0.306802864
27125,37,24521,7,3,4,0,0,14,5,8,7,0,0,20,nowin,loss,beat,dlwin,0,10,10,208,0.394230769,0.038461538,0.581730769,0,0.024682772
27126,116,24522,6,9,0,6,0,21,9,4,10,0,0,23,nowin,win,dlbust,bust,20,0,15,195,0.425641026,0.056410256,0.538461538,1,0.28273747
27127,115,24522,7,6,0,3,1,17,9,4,10,0,0,23,nowin,win,dlbust,bust,20,0,13,194,0.427835052,0.041237113,0.592783505,2,0.583863602
27128,29,24522,10,10,0,0,0,20,9,4,10,0,0,23,nowin,win,dlbust,bust,20,0,20,189,0.44973545,0.058201058,0.544973545,1,0.300349439
27129,53,24522,9,10,0,0,0,19,9,4,10,0,0,23,nowin,win,dlbust,bust,20,0,19,250,0.372,0.064,0.564,0,0.013687345
27130,88,24522,2,9,1,10,0,22,9,4,10,0,0,23,nowin,loss,bust,plbust,0,10,11,206,0.466019417,0.033980583,0.54368932,1,0.309467903
27131,4,24522,10,3,0,2,2,17,9,4,10,0,0,23,nowin,win,dlbust,bust,20,0,13,217,0.460829493,0.036866359,0.562211982,1,0.315432839
27132,37,24523,10,8,0,0,0,18,9,10,0,0,0,19,nowin,loss,beat,dlwin,0,10,18,208,0.394230769,0.038461538,0.581730769,0,0.024682772
27133,70,24523,3,2,10,3,0,18,9,10,0,0,0,19,nowin,loss,beat,dlwin,0,10,5,228,0.385964912,0.039473684,0.557017544,0,0.016157125
27134,119,24523,11,4,5,0,0,20,9,10,0,0,0,19,nowin,win,plwin,beat,20,0,15,190,0.405263158,0.068421053,0.515789474,0,0.011837158
27135,107,24523,6,10,0,6,0,22,9,10,0,0,0,19,nowin,loss,bust,plbust,0,10,16,218,0.444954128,0.073394495,0.600917431,2,0.605210014
27136,31,24523,8,10,0,0,0,18,9,10,0,0,0,19,nowin,loss,beat,dlwin,0,10,18,188,0.473404255,0.058510638,0.515957447,1,0.300306557
27137,95,24523,10,7,0,0,0,17,9,10,0,0,0,19,nowin,loss,beat,dlwin,0,10,17,218,0.412844037,0.04587156,0.559633028,0,0.024842385
27138,113,24524,2,4,9,8,0,23,8,9,0,0,0,17,nowin,loss,bust,plbust,0,10,6,199,0.407035176,0.055276382,0.668341709,2,0.620695264
27139,46,24524,10,3,0,7,0,20,8,9,0,0,0,17,nowin,win,plwin,beat,20,0,13,186,0.403225806,0.048387097,0.591397849,0,0.029742194
27140,138,24524,10,8,0,0,0,18,8,9,0,0,0,17,nowin,win,plwin,beat,20,0,18,190,0.442105263,0.047368421,0.610526316,2,0.609711065
27141,47,24524,10,4,0,8,0,22,8,9,0,0,0,17,nowin,loss,bust,plbust,0,10,14,210,0.438095238,0.057142857,0.623809524,2,0.615868808
27142,11,24524,2,9,10,0,0,21,8,9,0,0,0,17,nowin,win,plwin,beat,20,0,11,236,0.457627119,0.016949153,0.588983051,3,0.889015813
27143,12,24524,10,10,0,0,0,20,8,9,0,0,0,17,nowin,win,plwin,beat,20,0,20,189,0.470899471,0.015873016,0.613756614,3,0.929171178
27144,19,24525,8,9,0,0,0,17,1,3,10,6,0,20,nowin,loss,beat,dlwin,0,10,17,237,0.41350211,0.054852321,0.628691983,2,0.597373826
27145,93,24525,10,9,0,0,0,19,1,3,10,6,0,20,nowin,loss,beat,dlwin,0,10,19,175,0.485714286,0.051428571,0.548571429,1,0.323648091
27146,83,24525,10,11,0,0,0,21,1,3,10,6,0,20,win,win,plwin,beat,25,0,21,193,0.424870466,0.051813472,0.678756477,2,0.644360335
27147,61,24525,10,10,0,0,0,20,1,3,10,6,0,20,nowin,push,push,push,10,0,20,194,0.427835052,0.077319588,0.603092784,2,0.591437139
27148,105,24525,8,5,0,8,0,21,1,3,10,6,0,20,nowin,win,plwin,beat,20,0,13,198,0.414141414,0.070707071,0.590909091,0,0.032889494
27149,132,24525,4,5,10,0,0,19,1,3,10,6,0,20,nowin,loss,beat,dlwin,0,10,9,194,0.412371134,0.036082474,0.649484536,2,0.611633238
27150,55,24526,3,10,0,10,0,23,10,8,0,0,0,18,nowin,loss,bust,plbust,0,10,13,191,0.371727749,0.057591623,0.54973822,0,0.01011347
27151,41,24526,6,7,0,6,0,19,10,8,0,0,0,18,nowin,win,plwin,beat,20,0,13,192,0.364583333,0.036458333,0.520833333,0,0.00089702
27152,136,24526,6,10,0,10,0,26,10,8,0,0,0,18,nowin,loss,bust,plbust,0,10,16,194,0.396907216,0.025773196,0.597938144,0,0.029452644
27153,71,24526,8,9,0,0,0,17,10,8,0,0,0,18,nowin,loss,beat,dlwin,0,10,17,193,0.352331606,0.046632124,0.585492228,0,0.013063661
27154,90,24526,2,9,6,0,0,17,10,8,0,0,0,18,nowin,loss,beat,dlwin,0,10,11,201,0.447761194,0.049751244,0.60199005,3,0.889945023
27155,117,24526,10,5,0,5,0,20,10,8,0,0,0,18,nowin,win,plwin,beat,20,0,15,173,0.410404624,0.069364162,0.606936416,2,0.578610282
27156,72,24527,11,10,0,0,0,21,9,10,0,0,0,19,win,win,plwin,beat,25,0,21,185,0.394594595,0.032432432,0.508108108,0,0.006763115
27157,37,24527,3,8,10,0,0,21,9,10,0,0,0,19,nowin,win,plwin,beat,20,0,11,208,0.394230769,0.038461538,0.581730769,0,0.024682772
27158,128,24527,5,10,0,10,0,25,9,10,0,0,0,19,nowin,loss,bust,plbust,0,10,15,227,0.356828194,0.052863436,0.577092511,0,0.012352564
27159,146,24527,9,4,0,9,0,22,9,10,0,0,0,19,nowin,loss,bust,plbust,0,10,13,221,0.43438914,0.040723982,0.542986425,1,0.290190091
27160,25,24527,10,3,0,4,0,17,9,10,0,0,0,19,nowin,loss,beat,dlwin,0,10,13,190,0.463157895,0.063157895,0.536842105,1,0.304401563
27161,111,24527,8,11,0,0,0,19,9,10,0,0,0,19,nowin,push,push,push,10,0,19,180,0.433333333,0.055555556,0.611111111,2,0.602264492
27162,35,24528,6,10,0,4,0,20,10,5,10,0,0,25,nowin,win,dlbust,bust,20,0,16,202,0.410891089,0.044554455,0.633663366,2,0.598681573
27163,55,24528,10,2,0,3,10,25,10,5,10,0,0,25,nowin,loss,bust,plbust,0,10,12,191,0.371727749,0.057591623,0.54973822,0,0.01011347
27164,77,24528,8,10,0,0,0,18,10,5,10,0,0,25,nowin,win,dlbust,bust,20,0,18,200,0.455,0.04,0.62,3,0.916252116
27165,39,24528,10,5,0,7,0,22,10,5,10,0,0,25,nowin,loss,bust,plbust,0,10,15,191,0.429319372,0.062827225,0.57591623,0,0.033760763
27166,109,24528,10,10,0,0,0,20,10,5,10,0,0,25,nowin,win,dlbust,bust,20,0,20,221,0.461538462,0.058823529,0.597285068,3,0.901830309
27167,59,24528,6,2,10,0,0,18,10,5,10,0,0,25,nowin,win,dlbust,bust,20,0,8,228,0.429824561,0.048245614,0.543859649,1,0.287885446
27168,112,24529,6,6,0,0,0,12,4,6,4,9,0,23,nowin,win,dlbust,bust,20,0,12,203,0.448275862,0.054187192,0.600985222,3,0.889576933
27169,25,24529,4,1,9,0,0,14,4,6,4,9,0,23,nowin,win,dlbust,bust,20,0,5,190,0.463157895,0.063157895,0.536842105,1,0.304401563
27170,32,24529,4,2,11,0,0,17,4,6,4,9,0,23,nowin,win,dlbust,bust,20,0,6,189,0.391534392,0.037037037,0.53968254,0,0.013579086
27171,29,24529,7,6,0,0,0,13,4,6,4,9,0,23,nowin,win,dlbust,bust,20,0,13,189,0.44973545,0.058201058,0.544973545,1,0.300349439
27172,66,24529,5,10,0,0,0,15,4,6,4,9,0,23,nowin,win,dlbust,bust,20,0,15,217,0.456221198,0.064516129,0.626728111,3,0.924304367
27173,47,24529,10,10,0,0,0,20,4,6,4,9,0,23,nowin,win,dlbust,bust,20,0,20,210,0.438095238,0.057142857,0.623809524,2,0.615868808
27174,67,24530,10,3,0,4,0,17,11,2,3,6,0,22,nowin,win,dlbust,bust,20,0,13,195,0.369230769,0.041025641,0.569230769,0,0.014139427
27175,4,24530,10,5,0,2,0,17,11,2,3,6,0,22,nowin,win,dlbust,bust,20,0,15,217,0.460829493,0.036866359,0.562211982,1,0.315432839
27176,82,24530,6,10,0,10,0,26,11,2,3,6,0,22,nowin,loss,bust,plbust,0,10,16,225,0.408888889,0.075555556,0.577777778,0,0.028101874
27177,47,24530,5,8,0,2,5,20,11,2,3,6,0,22,nowin,win,dlbust,bust,20,0,13,210,0.438095238,0.057142857,0.623809524,2,0.615868808
27178,55,24530,9,5,0,6,0,20,11,2,3,6,0,22,nowin,win,dlbust,bust,20,0,14,191,0.371727749,0.057591623,0.54973822,0,0.01011347
27179,103,24530,10,4,0,1,2,17,11,2,3,6,0,22,nowin,win,dlbust,bust,20,0,14,203,0.379310345,0.064039409,0.551724138,0,0.012869209
27180,32,24531,10,6,0,10,0,26,10,11,0,0,0,21,nowin,loss,bust,plbust,0,10,16,189,0.391534392,0.037037037,0.53968254,0,0.013579086
27181,10,24531,5,10,0,5,0,20,10,11,0,0,0,21,nowin,loss,beat,dlwin,0,10,15,191,0.413612565,0.057591623,0.596858639,2,0.574087175
27182,38,24531,11,8,0,0,0,19,10,11,0,0,0,21,nowin,loss,beat,dlwin,0,10,19,202,0.361386139,0.03960396,0.564356436,0,0.010597953
27183,5,24531,10,10,0,0,0,20,10,11,0,0,0,21,nowin,loss,beat,dlwin,0,10,20,203,0.42364532,0.02955665,0.596059113,2,0.582508076
27184,56,24531,9,11,0,0,0,20,10,11,0,0,0,21,nowin,loss,beat,dlwin,0,10,20,175,0.4,0.057142857,0.582857143,0,0.026685297
27185,46,24531,11,10,0,0,0,21,10,11,0,0,0,21,win,push,push,push,10,0,21,186,0.403225806,0.048387097,0.591397849,0,0.029742194
27186,124,24532,10,10,0,0,0,20,10,9,0,0,0,19,nowin,win,plwin,beat,20,0,20,202,0.47029703,0.064356436,0.584158416,3,0.899458193
27187,144,24532,6,5,10,0,0,21,10,9,0,0,0,19,nowin,win,plwin,beat,20,0,11,202,0.386138614,0.054455446,0.564356436,0,0.018006244
27188,48,24532,10,9,0,0,0,19,10,9,0,0,0,19,nowin,push,push,push,10,0,19,203,0.413793103,0.019704433,0.600985222,2,0.577280801
27189,119,24532,10,3,0,4,0,17,10,9,0,0,0,19,nowin,loss,beat,dlwin,0,10,13,190,0.405263158,0.068421053,0.515789474,0,0.011837158
27190,25,24532,9,10,0,0,0,19,10,9,0,0,0,19,nowin,push,push,push,10,0,19,190,0.463157895,0.063157895,0.536842105,1,0.304401563
27191,112,24532,10,10,0,0,0,20,10,9,0,0,0,19,nowin,win,plwin,beat,20,0,20,203,0.448275862,0.054187192,0.600985222,3,0.889576933
27192,54,24533,8,4,0,10,0,22,3,10,6,0,0,19,nowin,loss,bust,plbust,0,10,12,185,0.437837838,0.032432432,0.556756757,1,0.29899854
27193,73,24533,9,8,0,0,0,17,3,10,6,0,0,19,nowin,loss,beat,dlwin,0,10,17,181,0.375690608,0.011049724,0.596685083,0,0.022795773
27194,21,24533,10,5,0,0,0,15,3,10,6,0,0,19,nowin,loss,beat,dlwin,0,10,15,214,0.359813084,0.042056075,0.626168224,0,0.025263474
27195,66,24533,3,6,5,0,0,14,3,10,6,0,0,19,nowin,loss,beat,dlwin,0,10,9,217,0.456221198,0.064516129,0.626728111,3,0.924304367
27196,33,24533,10,9,0,0,0,19,3,10,6,0,0,19,nowin,push,push,push,10,0,19,192,0.4375,0.057291667,0.625,2,0.616208916
27197,41,24533,9,10,0,0,0,19,3,10,6,0,0,19,nowin,push,push,push,10,0,19,192,0.364583333,0.036458333,0.520833333,0,0.00089702
27198,123,24534,10,10,0,0,0,20,11,1,5,0,0,17,nowin,win,plwin,beat,20,0,20,205,0.43902439,0.034146341,0.614634146,2,0.609962544
27199,16,24534,6,10,0,5,0,21,11,1,5,0,0,17,nowin,win,plwin,beat,20,0,16,220,0.427272727,0.081818182,0.6,2,0.588660176
27200,35,24534,3,8,10,0,0,21,11,1,5,0,0,17,nowin,win,plwin,beat,20,0,11,202,0.410891089,0.044554455,0.633663366,2,0.598681573
27201,10,24534,6,8,0,7,0,21,11,1,5,0,0,17,nowin,win,plwin,beat,20,0,14,191,0.413612565,0.057591623,0.596858639,2,0.574087175
27202,93,24534,10,9,0,0,0,19,11,1,5,0,0,17,nowin,win,plwin,beat,20,0,19,175,0.485714286,0.051428571,0.548571429,1,0.323648091
27203,103,24534,6,3,10,0,0,19,11,1,5,0,0,17,nowin,win,plwin,beat,20,0,9,203,0.379310345,0.064039409,0.551724138,0,0.012869209
27204,133,24535,8,10,0,0,0,18,3,10,8,0,0,21,nowin,loss,beat,dlwin,0,10,18,201,0.47761194,0.064676617,0.611940299,3,0.935428111
27205,133,24535,6,6,0,10,0,22,3,10,8,0,0,21,nowin,loss,bust,plbust,0,10,12,201,0.47761194,0.064676617,0.611940299,3,0.935428111
27206,66,24535,10,5,0,0,0,15,3,10,8,0,0,21,nowin,loss,beat,dlwin,0,10,15,217,0.456221198,0.064516129,0.626728111,3,0.924304367
27207,29,24535,10,10,0,0,0,20,3,10,8,0,0,21,nowin,loss,beat,dlwin,0,10,20,189,0.44973545,0.058201058,0.544973545,1,0.300349439
27208,93,24535,10,8,0,0,0,18,3,10,8,0,0,21,nowin,loss,beat,dlwin,0,10,18,175,0.485714286,0.051428571,0.548571429,1,0.323648091
27209,40,24535,5,2,7,0,0,14,3,10,8,0,0,21,nowin,loss,beat,dlwin,0,10,7,196,0.367346939,0.030612245,0.617346939,0,0.025358183
27210,39,24536,5,10,0,4,0,19,10,4,1,6,0,21,nowin,loss,beat,dlwin,0,10,15,191,0.429319372,0.062827225,0.57591623,0,0.033760763
27211,121,24536,10,10,0,0,0,20,10,4,1,6,0,21,nowin,loss,beat,dlwin,0,10,20,195,0.456410256,0.025641026,0.512820513,1,0.288597791
27212,40,24536,8,10,0,0,0,18,10,4,1,6,0,21,nowin,loss,beat,dlwin,0,10,18,196,0.367346939,0.030612245,0.617346939,0,0.025358183
27213,79,24536,8,2,10,0,0,20,10,4,1,6,0,21,nowin,loss,beat,dlwin,0,10,10,211,0.436018957,0.028436019,0.672985782,2,0.650131054
27214,95,24536,6,10,0,1,0,17,10,4,1,6,0,21,nowin,loss,beat,dlwin,0,10,16,218,0.412844037,0.04587156,0.559633028,0,0.024842385
27215,72,24536,9,9,0,0,0,18,10,4,1,6,0,21,nowin,loss,beat,dlwin,0,10,18,185,0.394594595,0.032432432,0.508108108,0,0.006763115
27216,62,24537,3,2,3,7,0,15,6,10,3,0,0,19,nowin,loss,beat,dlwin,0,10,5,178,0.370786517,0.028089888,0.54494382,0,0.008657722
27217,119,24537,8,5,0,0,0,13,6,10,3,0,0,19,nowin,loss,beat,dlwin,0,10,13,190,0.405263158,0.068421053,0.515789474,0,0.011837158
27218,37,24537,4,10,0,0,0,14,6,10,3,0,0,19,nowin,loss,beat,dlwin,0,10,14,208,0.394230769,0.038461538,0.581730769,0,0.024682772
27219,135,24537,10,10,0,0,0,20,6,10,3,0,0,19,nowin,win,plwin,beat,20,0,20,179,0.391061453,0.067039106,0.586592179,0,0.024924662
27220,94,24537,2,10,0,0,0,12,6,10,3,0,0,19,nowin,loss,beat,dlwin,0,10,12,183,0.43715847,0.043715847,0.540983607,1,0.290866892
27221,127,24537,6,4,10,0,0,20,6,10,3,0,0,19,nowin,win,plwin,beat,20,0,10,201,0.402985075,0.029850746,0.60199005,0,0.032263937
27222,27,24538,4,6,6,0,0,16,5,10,5,0,0,20,nowin,loss,beat,dlwin,0,10,10,178,0.370786517,0.016853933,0.573033708,0,0.015536309
27223,141,24538,4,7,10,0,0,21,5,10,5,0,0,20,nowin,win,plwin,beat,20,0,11,202,0.420792079,0.074257426,0.564356436,0,0.028377851
27224,118,24538,10,4,0,0,0,14,5,10,5,0,0,20,nowin,loss,beat,dlwin,0,10,14,216,0.393518519,0.037037037,0.555555556,0,0.018059873
27225,83,24538,10,8,0,0,0,18,5,10,5,0,0,20,nowin,loss,beat,dlwin,0,10,18,193,0.424870466,0.051813472,0.678756477,2,0.644360335
27226,31,24538,3,11,4,0,0,18,5,10,5,0,0,20,nowin,loss,beat,dlwin,0,10,14,188,0.473404255,0.058510638,0.515957447,1,0.300306557
27227,62,24538,8,8,0,0,0,16,5,10,5,0,0,20,nowin,loss,beat,dlwin,0,10,16,178,0.370786517,0.028089888,0.54494382,0,0.008657722
27228,143,24539,11,1,2,8,0,22,10,7,0,0,0,17,nowin,loss,bust,plbust,0,10,12,203,0.463054187,0.044334975,0.57635468,3,0.883143365
27229,15,24539,4,9,0,10,0,23,10,7,0,0,0,17,nowin,loss,bust,plbust,0,10,13,212,0.410377358,0.051886792,0.561320755,0,0.024517408
27230,63,24539,5,6,9,0,0,20,10,7,0,0,0,17,nowin,win,plwin,beat,20,0,11,216,0.467592593,0.037037037,0.62037037,3,0.931690496
27231,104,24539,10,4,0,2,10,26,10,7,0,0,0,17,nowin,loss,bust,plbust,0,10,14,209,0.363636364,0.052631579,0.593301435,0,0.018359419
27232,46,24539,3,10,0,10,0,23,10,7,0,0,0,17,nowin,loss,bust,plbust,0,10,13,186,0.403225806,0.048387097,0.591397849,0,0.029742194
27233,124,24539,5,3,2,10,0,20,10,7,0,0,0,17,nowin,win,plwin,beat,20,0,8,202,0.47029703,0.064356436,0.584158416,3,0.899458193
27234,9,24540,8,10,0,0,0,18,4,2,4,10,0,20,nowin,loss,beat,dlwin,0,10,18,194,0.37628866,0.015463918,0.541237113,0,0.009396796
27235,41,24540,7,2,10,0,0,19,4,2,4,10,0,20,nowin,loss,beat,dlwin,0,10,9,192,0.364583333,0.036458333,0.520833333,0,0.00089702
27236,125,24540,7,5,0,0,0,12,4,2,4,10,0,20,nowin,loss,beat,dlwin,0,10,12,219,0.438356164,0.050228311,0.575342466,1,0.308411257
27237,108,24540,7,5,0,0,0,12,4,2,4,10,0,20,nowin,loss,beat,dlwin,0,10,12,193,0.435233161,0.056994819,0.559585492,1,0.298824795
27238,135,24540,11,10,0,0,0,21,4,2,4,10,0,20,win,win,plwin,beat,25,0,21,179,0.391061453,0.067039106,0.586592179,0,0.024924662
27239,94,24540,10,6,0,0,0,16,4,2,4,10,0,20,nowin,loss,beat,dlwin,0,10,16,183,0.43715847,0.043715847,0.540983607,1,0.290866892
27240,97,24541,9,5,0,10,0,24,9,4,7,0,0,20,nowin,loss,bust,plbust,0,10,14,182,0.450549451,0.06043956,0.692307692,2,0.677372279
27241,11,24541,5,10,0,2,0,17,9,4,7,0,0,20,nowin,loss,beat,dlwin,0,10,15,236,0.457627119,0.016949153,0.588983051,3,0.889015813
27242,1,24541,7,10,0,0,0,17,9,4,7,0,0,20,nowin,loss,beat,dlwin,0,10,17,197,0.406091371,0.025380711,0.649746193,2,0.606186955
27243,143,24541,2,1,10,10,0,23,9,4,7,0,0,20,nowin,loss,bust,plbust,0,10,3,203,0.463054187,0.044334975,0.57635468,3,0.883143365
27244,102,24541,3,2,10,7,0,22,9,4,7,0,0,20,nowin,loss,bust,plbust,0,10,5,192,0.338541667,0.046875,0.5625,0,0.003306118
27245,38,24541,10,8,0,0,0,18,9,4,7,0,0,20,nowin,loss,beat,dlwin,0,10,18,202,0.361386139,0.03960396,0.564356436,0,0.010597953
27246,138,24542,2,7,10,0,0,19,7,7,6,0,0,20,nowin,loss,beat,dlwin,0,10,9,190,0.442105263,0.047368421,0.610526316,2,0.609711065
27247,10,24542,9,10,0,0,0,19,7,7,6,0,0,20,nowin,loss,beat,dlwin,0,10,19,191,0.413612565,0.057591623,0.596858639,2,0.574087175
27248,120,24542,4,3,10,0,0,17,7,7,6,0,0,20,nowin,loss,beat,dlwin,0,10,7,202,0.440594059,0.034653465,0.618811881,2,0.614441029
27249,126,24542,10,10,0,0,0,20,7,7,6,0,0,20,nowin,push,push,push,10,0,20,188,0.457446809,0.074468085,0.60106383,3,0.900633203
27250,59,24542,6,8,0,10,0,24,7,7,6,0,0,20,nowin,loss,bust,plbust,0,10,14,228,0.429824561,0.048245614,0.543859649,1,0.287885446
27251,19,24542,1,3,10,1,10,25,7,7,6,0,0,20,nowin,loss,bust,plbust,0,10,4,237,0.41350211,0.054852321,0.628691983,2,0.597373826
27252,131,24543,4,4,2,7,0,17,10,10,0,0,0,20,nowin,loss,beat,dlwin,0,10,8,217,0.410138249,0.069124424,0.543778802,0,0.02015021
27253,40,24543,8,7,0,8,0,23,10,10,0,0,0,20,nowin,loss,bust,plbust,0,10,15,196,0.367346939,0.030612245,0.617346939,0,0.025358183
27254,126,24543,8,10,0,0,0,18,10,10,0,0,0,20,nowin,loss,beat,dlwin,0,10,18,188,0.457446809,0.074468085,0.60106383,3,0.900633203
27255,55,24543,10,2,0,10,0,22,10,10,0,0,0,20,nowin,loss,bust,plbust,0,10,12,191,0.371727749,0.057591623,0.54973822,0,0.01011347
27256,135,24543,10,11,0,0,0,21,10,10,0,0,0,20,win,win,plwin,beat,25,0,21,179,0.391061453,0.067039106,0.586592179,0,0.024924662
27257,88,24543,10,3,0,10,0,23,10,10,0,0,0,20,nowin,loss,bust,plbust,0,10,13,206,0.466019417,0.033980583,0.54368932,1,0.309467903
27258,2,24544,10,5,0,10,0,25,10,11,0,0,0,21,nowin,loss,bust,plbust,0,10,15,200,0.445,0.035,0.64,2,0.633962549
27259,15,24544,10,11,0,0,0,21,10,11,0,0,0,21,win,push,push,push,10,0,21,212,0.410377358,0.051886792,0.561320755,0,0.024517408
27260,98,24544,8,2,10,0,0,20,10,11,0,0,0,21,nowin,loss,beat,dlwin,0,10,10,220,0.422727273,0.054545455,0.55,1,0.28664435
27261,77,24544,5,10,0,10,0,25,10,11,0,0,0,21,nowin,loss,bust,plbust,0,10,15,200,0.455,0.04,0.62,3,0.916252116
27262,109,24544,7,2,5,3,0,17,10,11,0,0,0,21,nowin,loss,beat,dlwin,0,10,9,221,0.461538462,0.058823529,0.597285068,3,0.901830309
27263,124,24544,10,4,0,4,0,18,10,11,0,0,0,21,nowin,loss,beat,dlwin,0,10,14,202,0.47029703,0.064356436,0.584158416,3,0.899458193
27264,140,24545,8,3,1,3,0,15,2,7,11,0,0,20,nowin,loss,beat,dlwin,0,10,11,210,0.466666667,0.023809524,0.604761905,3,0.915293335
27265,100,24545,8,10,0,0,0,18,2,7,11,0,0,20,nowin,loss,beat,dlwin,0,10,18,190,0.452631579,0.036842105,0.594736842,3,0.888671154
27266,64,24545,8,8,0,0,0,16,2,7,11,0,0,20,nowin,loss,beat,dlwin,0,10,16,187,0.363636364,0.048128342,0.631016043,0,0.027594885
27267,91,24545,10,10,0,0,0,20,2,7,11,0,0,20,nowin,push,push,push,10,0,20,194,0.417525773,0.046391753,0.515463918,1,0.266616552
27268,143,24545,6,5,1,4,0,16,2,7,11,0,0,20,nowin,loss,beat,dlwin,0,10,11,203,0.463054187,0.044334975,0.57635468,3,0.883143365
27269,94,24545,10,10,0,0,0,20,2,7,11,0,0,20,nowin,push,push,push,10,0,20,183,0.43715847,0.043715847,0.540983607,1,0.290866892
27270,51,24546,10,11,0,0,0,21,8,7,9,0,0,24,win,win,dlbust,bust,25,0,21,189,0.529100529,0.068783069,0.608465608,3,0.993665715
27271,126,24546,11,10,0,0,0,21,8,7,9,0,0,24,win,win,dlbust,bust,25,0,21,188,0.457446809,0.074468085,0.60106383,3,0.900633203
27272,6,24546,10,10,0,0,0,20,8,7,9,0,0,24,nowin,win,dlbust,bust,20,0,20,191,0.439790576,0.047120419,0.581151832,1,0.31211505
27273,148,24546,11,10,0,0,0,21,8,7,9,0,0,24,win,win,dlbust,bust,25,0,21,204,0.401960784,0.078431373,0.593137255,0,0.029789521
27274,123,24546,3,6,4,3,3,19,8,7,9,0,0,24,nowin,win,dlbust,bust,20,0,9,205,0.43902439,0.034146341,0.614634146,2,0.609962544
27275,57,24546,1,6,5,5,0,17,8,7,9,0,0,24,nowin,win,dlbust,bust,20,0,7,192,0.46875,0.052083333,0.59375,3,0.907001181
27276,53,24547,5,3,4,0,0,12,4,4,3,8,0,19,nowin,loss,beat,dlwin,0,10,8,250,0.372,0.064,0.564,0,0.013687345
27277,105,24547,7,10,0,0,0,17,4,4,3,8,0,19,nowin,loss,beat,dlwin,0,10,17,198,0.414141414,0.070707071,0.590909091,0,0.032889494
27278,74,24547,11,1,8,0,0,20,4,4,3,8,0,19,nowin,win,plwin,beat,20,0,12,209,0.411483254,0.04784689,0.531100478,0,0.017448125
27279,115,24547,5,2,9,0,0,16,4,4,3,8,0,19,nowin,loss,beat,dlwin,0,10,7,194,0.427835052,0.041237113,0.592783505,2,0.583863602
27280,110,24547,4,10,0,0,0,14,4,4,3,8,0,19,nowin,loss,beat,dlwin,0,10,14,192,0.416666667,0.046875,0.557291667,0,0.025413132
27281,56,24547,5,7,0,0,0,12,4,4,3,8,0,19,nowin,loss,beat,dlwin,0,10,12,175,0.4,0.057142857,0.582857143,0,0.026685297
27282,90,24548,8,10,0,0,0,18,7,8,4,0,0,19,nowin,loss,beat,dlwin,0,10,18,201,0.447761194,0.049751244,0.60199005,3,0.889945023
27283,102,24548,10,8,0,0,0,18,7,8,4,0,0,19,nowin,loss,beat,dlwin,0,10,18,192,0.338541667,0.046875,0.5625,0,0.003306118
27284,22,24548,3,10,0,10,0,23,7,8,4,0,0,19,nowin,loss,bust,plbust,0,10,13,187,0.481283422,0.042780749,0.577540107,3,0.906128176
27285,76,24548,2,10,0,1,4,17,7,8,4,0,0,19,nowin,loss,beat,dlwin,0,10,12,189,0.534391534,0.079365079,0.608465608,3,1
27286,60,24548,9,8,0,0,0,17,7,8,4,0,0,19,nowin,loss,beat,dlwin,0,10,17,227,0.418502203,0.022026432,0.559471366,0,0.026496258
27287,108,24548,5,8,0,2,10,25,7,8,4,0,0,19,nowin,loss,bust,plbust,0,10,13,193,0.435233161,0.056994819,0.559585492,1,0.298824795
27288,61,24549,11,10,0,0,0,21,10,3,5,0,0,18,win,win,plwin,beat,25,0,21,194,0.427835052,0.077319588,0.603092784,2,0.591437139
27289,39,24549,10,11,0,0,0,21,10,3,5,0,0,18,win,win,plwin,beat,25,0,21,191,0.429319372,0.062827225,0.57591623,0,0.033760763
27290,5,24549,6,9,0,10,0,25,10,3,5,0,0,18,nowin,loss,bust,plbust,0,10,15,203,0.42364532,0.02955665,0.596059113,2,0.582508076
27291,100,24549,9,10,0,0,0,19,10,3,5,0,0,18,nowin,win,plwin,beat,20,0,19,190,0.452631579,0.036842105,0.594736842,3,0.888671154
27292,112,24549,2,5,7,4,0,18,10,3,5,0,0,18,nowin,push,push,push,10,0,7,203,0.448275862,0.054187192,0.600985222,3,0.889576933
27293,86,24549,10,2,0,2,5,19,10,3,5,0,0,18,nowin,win,plwin,beat,20,0,12,196,0.454081633,0.040816327,0.591836735,3,0.887566443
27294,115,24550,10,7,0,0,0,17,9,5,3,0,0,17,nowin,push,push,push,10,0,17,194,0.427835052,0.041237113,0.592783505,2,0.583863602
27295,8,24550,6,6,0,10,0,22,9,5,3,0,0,17,nowin,loss,bust,plbust,0,10,12,181,0.44198895,0.071823204,0.596685083,2,0.599438402
27296,69,24550,7,9,0,2,0,18,9,5,3,0,0,17,nowin,win,plwin,beat,20,0,16,194,0.365979381,0.030927835,0.515463918,0,0
27297,32,24550,5,6,8,0,0,19,9,5,3,0,0,17,nowin,win,plwin,beat,20,0,11,189,0.391534392,0.037037037,0.53968254,0,0.013579086
27298,46,24550,10,10,0,0,0,20,9,5,3,0,0,17,nowin,win,plwin,beat,20,0,20,186,0.403225806,0.048387097,0.591397849,0,0.029742194
27299,77,24550,4,2,3,10,0,19,9,5,3,0,0,17,nowin,win,plwin,beat,20,0,6,200,0.455,0.04,0.62,3,0.916252116
27300,49,24551,10,10,0,0,0,20,10,3,6,0,0,19,nowin,win,plwin,beat,20,0,20,207,0.396135266,0.053140097,0.594202899,0,0.028306925
27301,14,24551,10,10,0,0,0,20,10,3,6,0,0,19,nowin,win,plwin,beat,20,0,20,202,0.391089109,0.01980198,0.628712871,2,0.577264877
27302,45,24551,2,7,10,0,0,19,10,3,6,0,0,19,nowin,push,push,push,10,0,9,196,0.428571429,0.051020408,0.612244898,2,0.598821767
27303,50,24551,3,9,0,3,8,23,10,3,6,0,0,19,nowin,loss,bust,plbust,0,10,12,202,0.405940594,0.04950495,0.54950495,0,0.020296079
27304,128,24551,11,10,0,0,0,21,10,3,6,0,0,19,win,win,plwin,beat,25,0,21,227,0.356828194,0.052863436,0.577092511,0,0.012352564
27305,142,24551,10,3,0,1,9,23,10,3,6,0,0,19,nowin,loss,bust,plbust,0,10,13,211,0.417061611,0.047393365,0.526066351,1,0.271531309
27306,74,24552,10,3,0,10,0,23,7,11,0,0,0,18,nowin,loss,bust,plbust,0,10,13,209,0.411483254,0.04784689,0.531100478,0,0.017448125
27307,73,24552,10,10,0,0,0,20,7,11,0,0,0,18,nowin,win,plwin,beat,20,0,20,181,0.375690608,0.011049724,0.596685083,0,0.022795773
27308,11,24552,7,5,0,5,0,17,7,11,0,0,0,18,nowin,loss,beat,dlwin,0,10,12,236,0.457627119,0.016949153,0.588983051,3,0.889015813
27309,5,24552,8,10,0,0,0,18,7,11,0,0,0,18,nowin,push,push,push,10,0,18,203,0.42364532,0.02955665,0.596059113,2,0.582508076
27310,53,24552,5,10,0,9,0,24,7,11,0,0,0,18,nowin,loss,bust,plbust,0,10,15,250,0.372,0.064,0.564,0,0.013687345
27311,3,24552,7,8,0,6,0,21,7,11,0,0,0,18,nowin,win,plwin,beat,20,0,15,190,0.431578947,0.026315789,0.542105263,1,0.288076384
27312,47,24553,4,7,10,0,0,21,11,1,4,10,0,26,nowin,win,dlbust,bust,20,0,11,210,0.438095238,0.057142857,0.623809524,2,0.615868808
27313,49,24553,8,5,0,10,0,23,11,1,4,10,0,26,nowin,loss,bust,plbust,0,10,13,207,0.396135266,0.053140097,0.594202899,0,0.028306925
27314,46,24553,1,6,10,0,0,17,11,1,4,10,0,26,nowin,win,dlbust,bust,20,0,7,186,0.403225806,0.048387097,0.591397849,0,0.029742194
27315,102,24553,10,2,0,10,0,22,11,1,4,10,0,26,nowin,loss,bust,plbust,0,10,12,192,0.338541667,0.046875,0.5625,0,0.003306118
27316,101,24553,10,4,0,1,10,25,11,1,4,10,0,26,nowin,loss,bust,plbust,0,10,14,205,0.424390244,0.068292683,0.63902439,2,0.614740646
27317,100,24553,10,11,0,0,0,21,11,1,4,10,0,26,win,win,dlbust,bust,25,0,21,190,0.452631579,0.036842105,0.594736842,3,0.888671154
27318,95,24554,4,10,0,0,0,14,6,10,4,0,0,20,nowin,loss,beat,dlwin,0,10,14,218,0.412844037,0.04587156,0.559633028,0,0.024842385
27319,39,24554,4,9,0,0,0,13,6,10,4,0,0,20,nowin,loss,beat,dlwin,0,10,13,191,0.429319372,0.062827225,0.57591623,0,0.033760763
27320,39,24554,2,3,4,10,0,19,6,10,4,0,0,20,nowin,loss,beat,dlwin,0,10,5,191,0.429319372,0.062827225,0.57591623,0,0.033760763
27321,121,24554,6,9,0,0,0,15,6,10,4,0,0,20,nowin,loss,beat,dlwin,0,10,15,195,0.456410256,0.025641026,0.512820513,1,0.288597791
27322,70,24554,6,6,0,0,0,12,6,10,4,0,0,20,nowin,loss,beat,dlwin,0,10,12,228,0.385964912,0.039473684,0.557017544,0,0.016157125
27323,37,24554,2,4,10,0,0,16,6,10,4,0,0,20,nowin,loss,beat,dlwin,0,10,6,208,0.394230769,0.038461538,0.581730769,0,0.024682772
27324,4,24555,3,10,0,3,6,22,7,9,8,0,0,24,nowin,loss,bust,plbust,0,10,13,217,0.460829493,0.036866359,0.562211982,1,0.315432839
27325,124,24555,10,10,0,0,0,20,7,9,8,0,0,24,nowin,win,dlbust,bust,20,0,20,202,0.47029703,0.064356436,0.584158416,3,0.899458193
27326,45,24555,7,5,0,9,0,21,7,9,8,0,0,24,nowin,win,dlbust,bust,20,0,12,196,0.428571429,0.051020408,0.612244898,2,0.598821767
27327,70,24555,9,6,0,5,0,20,7,9,8,0,0,24,nowin,win,dlbust,bust,20,0,15,228,0.385964912,0.039473684,0.557017544,0,0.016157125
27328,30,24555,3,10,0,10,0,23,7,9,8,0,0,24,nowin,loss,bust,plbust,0,10,13,206,0.393203883,0.033980583,0.601941748,0,0.029324648
27329,50,24555,6,8,0,8,0,22,7,9,8,0,0,24,nowin,loss,bust,plbust,0,10,14,202,0.405940594,0.04950495,0.54950495,0,0.020296079
27330,67,24556,2,2,6,8,0,18,10,10,0,0,0,20,nowin,loss,beat,dlwin,0,10,4,195,0.369230769,0.041025641,0.569230769,0,0.014139427
27331,41,24556,1,1,10,6,0,18,10,10,0,0,0,20,nowin,loss,beat,dlwin,0,10,2,192,0.364583333,0.036458333,0.520833333,0,0.00089702
27332,55,24556,2,7,3,3,7,22,10,10,0,0,0,20,nowin,loss,bust,plbust,0,10,9,191,0.371727749,0.057591623,0.54973822,0,0.01011347
27333,98,24556,10,8,0,0,0,18,10,10,0,0,0,20,nowin,loss,beat,dlwin,0,10,18,220,0.422727273,0.054545455,0.55,1,0.28664435
27334,40,24556,4,9,0,7,0,20,10,10,0,0,0,20,nowin,push,push,push,10,0,13,196,0.367346939,0.030612245,0.617346939,0,0.025358183
27335,77,24556,10,10,0,0,0,20,10,10,0,0,0,20,nowin,push,push,push,10,0,20,200,0.455,0.04,0.62,3,0.916252116
27336,42,24557,3,10,0,10,0,23,10,10,0,0,0,20,nowin,loss,bust,plbust,0,10,13,212,0.443396226,0.051886792,0.570754717,1,0.309181312
27337,34,24557,10,10,0,0,0,20,10,10,0,0,0,20,nowin,push,push,push,10,0,20,202,0.5,0.079207921,0.618811881,3,0.968961434
27338,16,24557,3,4,2,5,8,22,10,10,0,0,0,20,nowin,loss,bust,plbust,0,10,7,220,0.427272727,0.081818182,0.6,2,0.588660176
27339,8,24557,7,10,0,0,0,17,10,10,0,0,0,20,nowin,loss,beat,dlwin,0,10,17,181,0.44198895,0.071823204,0.596685083,2,0.599438402
27340,64,24557,10,10,0,0,0,20,10,10,0,0,0,20,nowin,push,push,push,10,0,20,187,0.363636364,0.048128342,0.631016043,0,0.027594885
27341,93,24557,11,3,7,0,0,21,10,10,0,0,0,20,nowin,win,plwin,beat,20,0,14,175,0.485714286,0.051428571,0.548571429,1,0.323648091
27342,69,24558,7,10,0,0,0,17,9,8,0,0,0,17,nowin,push,push,push,10,0,17,194,0.365979381,0.030927835,0.515463918,0,0
27343,149,24558,3,10,0,3,8,24,9,8,0,0,0,17,nowin,loss,bust,plbust,0,10,13,225,0.457777778,0.057777778,0.648888889,2,0.651965595
27344,32,24558,4,7,8,0,0,19,9,8,0,0,0,17,nowin,win,plwin,beat,20,0,11,189,0.391534392,0.037037037,0.53968254,0,0.013579086
27345,1,24558,10,4,0,1,7,22,9,8,0,0,0,17,nowin,loss,bust,plbust,0,10,14,197,0.406091371,0.025380711,0.649746193,2,0.606186955
27346,70,24558,10,4,0,10,0,24,9,8,0,0,0,17,nowin,loss,bust,plbust,0,10,14,228,0.385964912,0.039473684,0.557017544,0,0.016157125
27347,117,24558,7,6,0,10,0,23,9,8,0,0,0,17,nowin,loss,bust,plbust,0,10,13,173,0.410404624,0.069364162,0.606936416,2,0.578610282
27348,15,24559,7,10,0,0,0,17,3,2,11,5,0,21,nowin,loss,beat,dlwin,0,10,17,212,0.410377358,0.051886792,0.561320755,0,0.024517408
27349,144,24559,9,10,0,0,0,19,3,2,11,5,0,21,nowin,loss,beat,dlwin,0,10,19,202,0.386138614,0.054455446,0.564356436,0,0.018006244
27350,9,24559,5,10,0,0,0,15,3,2,11,5,0,21,nowin,loss,beat,dlwin,0,10,15,194,0.37628866,0.015463918,0.541237113,0,0.009396796
27351,117,24559,2,2,9,0,0,13,3,2,11,5,0,21,nowin,loss,beat,dlwin,0,10,4,173,0.410404624,0.069364162,0.606936416,2,0.578610282
27352,98,24559,4,11,3,0,0,18,3,2,11,5,0,21,nowin,loss,beat,dlwin,0,10,15,220,0.422727273,0.054545455,0.55,1,0.28664435
27353,62,24559,4,6,5,0,0,15,3,2,11,5,0,21,nowin,loss,beat,dlwin,0,10,10,178,0.370786517,0.028089888,0.54494382,0,0.008657722
27354,17,24560,11,1,6,0,0,18,9,4,10,0,0,23,nowin,win,dlbust,bust,20,0,12,171,0.444444444,0.070175439,0.555555556,1,0.302364894
27355,15,24560,9,8,0,0,0,17,9,4,10,0,0,23,nowin,win,dlbust,bust,20,0,17,212,0.410377358,0.051886792,0.561320755,0,0.024517408
27356,72,24560,10,3,0,7,0,20,9,4,10,0,0,23,nowin,win,dlbust,bust,20,0,13,185,0.394594595,0.032432432,0.508108108,0,0.006763115
27357,6,24560,10,5,0,2,0,17,9,4,10,0,0,23,nowin,win,dlbust,bust,20,0,15,191,0.439790576,0.047120419,0.581151832,1,0.31211505
27358,14,24560,3,5,8,10,0,26,9,4,10,0,0,23,nowin,loss,bust,plbust,0,10,8,202,0.391089109,0.01980198,0.628712871,2,0.577264877
27359,79,24560,5,10,0,10,0,25,9,4,10,0,0,23,nowin,loss,bust,plbust,0,10,15,211,0.436018957,0.028436019,0.672985782,2,0.650131054
27360,23,24561,2,7,9,0,0,18,11,10,0,0,0,21,nowin,loss,beat,dlwin,0,10,9,208,0.427884615,0.0625,0.552884615,1,0.29114424
27361,112,24561,4,5,11,0,0,20,11,10,0,0,0,21,nowin,loss,beat,dlwin,0,10,9,203,0.448275862,0.054187192,0.600985222,3,0.889576933
27362,129,24561,11,3,1,9,0,24,11,10,0,0,0,21,nowin,loss,bust,plbust,0,10,14,201,0.422885572,0.064676617,0.55721393,0,0.027255383
27363,63,24561,10,10,0,0,0,20,11,10,0,0,0,21,nowin,loss,beat,dlwin,0,10,20,216,0.467592593,0.037037037,0.62037037,3,0.931690496
27364,133,24561,9,4,0,10,0,23,11,10,0,0,0,21,nowin,loss,bust,plbust,0,10,13,201,0.47761194,0.064676617,0.611940299,3,0.935428111
27365,1,24561,8,5,0,6,0,19,11,10,0,0,0,21,nowin,loss,beat,dlwin,0,10,13,197,0.406091371,0.025380711,0.649746193,2,0.606186955
27366,127,24562,5,7,0,2,10,24,10,10,0,0,0,20,nowin,loss,bust,plbust,0,10,12,201,0.402985075,0.029850746,0.60199005,0,0.032263937
27367,71,24562,10,5,0,5,0,20,10,10,0,0,0,20,nowin,push,push,push,10,0,15,193,0.352331606,0.046632124,0.585492228,0,0.013063661
27368,67,24562,7,9,0,10,0,26,10,10,0,0,0,20,nowin,loss,bust,plbust,0,10,16,195,0.369230769,0.041025641,0.569230769,0,0.014139427
27369,142,24562,10,6,0,5,0,21,10,10,0,0,0,20,nowin,win,plwin,beat,20,0,16,211,0.417061611,0.047393365,0.526066351,1,0.271531309
27370,70,24562,10,3,0,10,0,23,10,10,0,0,0,20,nowin,loss,bust,plbust,0,10,13,228,0.385964912,0.039473684,0.557017544,0,0.016157125
27371,51,24562,2,6,7,10,0,25,10,10,0,0,0,20,nowin,loss,bust,plbust,0,10,8,189,0.529100529,0.068783069,0.608465608,3,0.993665715
27372,130,24563,10,10,0,0,0,20,10,10,0,0,0,20,nowin,push,push,push,10,0,20,219,0.410958904,0.03652968,0.566210046,0,0.025888739
27373,56,24563,3,10,0,5,0,18,10,10,0,0,0,20,nowin,loss,beat,dlwin,0,10,13,175,0.4,0.057142857,0.582857143,0,0.026685297
27374,44,24563,5,9,0,10,0,24,10,10,0,0,0,20,nowin,loss,bust,plbust,0,10,14,219,0.433789954,0.050228311,0.534246575,1,0.285551035
27375,85,24563,4,8,0,3,10,25,10,10,0,0,0,20,nowin,loss,bust,plbust,0,10,12,195,0.41025641,0.066666667,0.594871795,0,0.03269711
27376,128,24563,11,7,0,0,0,18,10,10,0,0,0,20,nowin,loss,beat,dlwin,0,10,18,227,0.356828194,0.052863436,0.577092511,0,0.012352564
27377,44,24563,8,7,0,10,0,25,10,10,0,0,0,20,nowin,loss,bust,plbust,0,10,15,219,0.433789954,0.050228311,0.534246575,1,0.285551035
27378,91,24564,3,2,10,10,0,25,10,9,0,0,0,19,nowin,loss,bust,plbust,0,10,5,194,0.417525773,0.046391753,0.515463918,1,0.266616552
27379,19,24564,10,10,0,0,0,20,10,9,0,0,0,19,nowin,win,plwin,beat,20,0,20,237,0.41350211,0.054852321,0.628691983,2,0.597373826
27380,125,24564,5,4,4,1,9,23,10,9,0,0,0,19,nowin,loss,bust,plbust,0,10,9,219,0.438356164,0.050228311,0.575342466,1,0.308411257
27381,65,24564,3,10,0,8,0,21,10,9,0,0,0,19,nowin,win,plwin,beat,20,0,13,203,0.492610837,0.054187192,0.571428571,3,0.913702814
27382,126,24564,7,10,0,0,0,17,10,9,0,0,0,19,nowin,loss,beat,dlwin,0,10,17,188,0.457446809,0.074468085,0.60106383,3,0.900633203
27383,68,24564,7,10,0,0,0,17,10,9,0,0,0,19,nowin,loss,beat,dlwin,0,10,17,205,0.434146341,0.029268293,0.6,2,0.59483189
27384,14,24565,10,11,0,0,0,21,3,3,10,6,0,22,win,win,dlbust,bust,25,0,21,202,0.391089109,0.01980198,0.628712871,2,0.577264877
27385,12,24565,8,10,0,0,0,18,3,3,10,6,0,22,nowin,win,dlbust,bust,20,0,18,189,0.470899471,0.015873016,0.613756614,3,0.929171178
27386,129,24565,10,5,0,0,0,15,3,3,10,6,0,22,nowin,win,dlbust,bust,20,0,15,201,0.422885572,0.064676617,0.55721393,0,0.027255383
27387,127,24565,8,5,0,0,0,13,3,3,10,6,0,22,nowin,win,dlbust,bust,20,0,13,201,0.402985075,0.029850746,0.60199005,0,0.032263937
27388,119,24565,6,4,2,1,0,13,3,3,10,6,0,22,nowin,win,dlbust,bust,20,0,10,190,0.405263158,0.068421053,0.515789474,0,0.011837158
27389,2,24565,10,7,0,0,0,17,3,3,10,6,0,22,nowin,win,dlbust,bust,20,0,17,200,0.445,0.035,0.64,2,0.633962549
27390,132,24566,10,3,0,4,0,17,11,10,0,0,0,21,nowin,loss,beat,dlwin,0,10,13,194,0.412371134,0.036082474,0.649484536,2,0.611633238
27391,145,24566,9,8,0,0,0,17,11,10,0,0,0,21,nowin,loss,beat,dlwin,0,10,17,188,0.441489362,0.031914894,0.622340426,2,0.617837093
27392,6,24566,7,4,9,0,0,20,11,10,0,0,0,21,nowin,loss,beat,dlwin,0,10,11,191,0.439790576,0.047120419,0.581151832,1,0.31211505
27393,2,24566,3,10,0,9,0,22,11,10,0,0,0,21,nowin,loss,bust,plbust,0,10,13,200,0.445,0.035,0.64,2,0.633962549
27394,21,24566,5,3,7,7,0,22,11,10,0,0,0,21,nowin,loss,bust,plbust,0,10,8,214,0.359813084,0.042056075,0.626168224,0,0.025263474
27395,111,24566,3,10,0,10,0,23,11,10,0,0,0,21,nowin,loss,bust,plbust,0,10,13,180,0.433333333,0.055555556,0.611111111,2,0.602264492
27396,48,24567,10,10,0,0,0,20,2,10,10,0,0,22,nowin,win,dlbust,bust,20,0,20,203,0.413793103,0.019704433,0.600985222,2,0.577280801
27397,110,24567,11,2,1,0,0,14,2,10,10,0,0,22,nowin,win,dlbust,bust,20,0,13,192,0.416666667,0.046875,0.557291667,0,0.025413132
27398,146,24567,8,5,0,0,0,13,2,10,10,0,0,22,nowin,win,dlbust,bust,20,0,13,221,0.43438914,0.040723982,0.542986425,1,0.290190091
27399,93,24567,2,9,2,0,0,13,2,10,10,0,0,22,nowin,win,dlbust,bust,20,0,11,175,0.485714286,0.051428571,0.548571429,1,0.323648091
27400,141,24567,9,3,0,8,0,20,2,10,10,0,0,22,nowin,win,dlbust,bust,20,0,12,202,0.420792079,0.074257426,0.564356436,0,0.028377851
27401,8,24567,10,6,0,0,0,16,2,10,10,0,0,22,nowin,win,dlbust,bust,20,0,16,181,0.44198895,0.071823204,0.596685083,2,0.599438402
27402,51,24568,4,8,0,1,3,16,10,11,0,0,0,21,nowin,loss,beat,dlwin,0,10,12,189,0.529100529,0.068783069,0.608465608,3,0.993665715
27403,12,24568,10,6,0,7,0,23,10,11,0,0,0,21,nowin,loss,bust,plbust,0,10,16,189,0.470899471,0.015873016,0.613756614,3,0.929171178
27404,8,24568,10,10,0,0,0,20,10,11,0,0,0,21,nowin,loss,beat,dlwin,0,10,20,181,0.44198895,0.071823204,0.596685083,2,0.599438402
27405,133,24568,8,10,0,0,0,18,10,11,0,0,0,21,nowin,loss,beat,dlwin,0,10,18,201,0.47761194,0.064676617,0.611940299,3,0.935428111
27406,118,24568,8,4,0,8,0,20,10,11,0,0,0,21,nowin,loss,beat,dlwin,0,10,12,216,0.393518519,0.037037037,0.555555556,0,0.018059873
27407,75,24568,7,11,0,0,0,18,10,11,0,0,0,21,nowin,loss,beat,dlwin,0,10,18,191,0.418848168,0.052356021,0.570680628,0,0.029344702
27408,139,24569,11,10,0,0,0,21,4,3,11,0,0,18,win,win,plwin,beat,25,0,21,192,0.380208333,0.036458333,0.59375,0,0.023429169
27409,3,24569,10,2,0,0,0,12,4,3,11,0,0,18,nowin,loss,beat,dlwin,0,10,12,190,0.431578947,0.026315789,0.542105263,1,0.288076384
27410,67,24569,1,4,10,0,0,15,4,3,11,0,0,18,nowin,loss,beat,dlwin,0,10,5,195,0.369230769,0.041025641,0.569230769,0,0.014139427
27411,121,24569,10,10,0,0,0,20,4,3,11,0,0,18,nowin,win,plwin,beat,20,0,20,195,0.456410256,0.025641026,0.512820513,1,0.288597791
27412,131,24569,11,10,0,0,0,21,4,3,11,0,0,18,win,win,plwin,beat,25,0,21,217,0.410138249,0.069124424,0.543778802,0,0.02015021
27413,135,24569,10,6,0,0,0,16,4,3,11,0,0,18,nowin,loss,beat,dlwin,0,10,16,179,0.391061453,0.067039106,0.586592179,0,0.024924662
27414,51,24570,3,6,6,10,0,25,7,5,1,4,0,17,nowin,loss,bust,plbust,0,10,9,189,0.529100529,0.068783069,0.608465608,3,0.993665715
27415,61,24570,9,3,0,6,0,18,7,5,1,4,0,17,nowin,win,plwin,beat,20,0,12,194,0.427835052,0.077319588,0.603092784,2,0.591437139
27416,68,24570,11,1,6,0,0,18,7,5,1,4,0,17,nowin,win,plwin,beat,20,0,12,205,0.434146341,0.029268293,0.6,2,0.59483189
27417,79,24570,2,9,2,6,0,19,7,5,1,4,0,17,nowin,win,plwin,beat,20,0,11,211,0.436018957,0.028436019,0.672985782,2,0.650131054
27418,121,24570,4,10,0,3,0,17,7,5,1,4,0,17,nowin,push,push,push,10,0,14,195,0.456410256,0.025641026,0.512820513,1,0.288597791
27419,138,24570,4,3,10,0,0,17,7,5,1,4,0,17,nowin,push,push,push,10,0,7,190,0.442105263,0.047368421,0.610526316,2,0.609711065
27420,53,24571,3,10,0,9,0,22,10,3,2,4,0,19,nowin,loss,bust,plbust,0,10,13,250,0.372,0.064,0.564,0,0.013687345
27421,62,24571,11,10,0,0,0,21,10,3,2,4,0,19,win,win,plwin,beat,25,0,21,178,0.370786517,0.028089888,0.54494382,0,0.008657722
27422,20,24571,10,11,0,0,0,21,10,3,2,4,0,19,win,win,plwin,beat,25,0,21,186,0.456989247,0.037634409,0.537634409,1,0.301097108
27423,11,24571,10,9,0,0,0,19,10,3,2,4,0,19,nowin,push,push,push,10,0,19,236,0.457627119,0.016949153,0.588983051,3,0.889015813
27424,65,24571,10,10,0,0,0,20,10,3,2,4,0,19,nowin,win,plwin,beat,20,0,20,203,0.492610837,0.054187192,0.571428571,3,0.913702814
27425,30,24571,11,7,0,0,0,18,10,3,2,4,0,19,nowin,loss,beat,dlwin,0,10,18,206,0.393203883,0.033980583,0.601941748,0,0.029324648
27426,7,24572,10,6,0,0,0,16,5,3,10,0,0,18,nowin,loss,beat,dlwin,0,10,16,183,0.442622951,0.06010929,0.62295082,2,0.619303341
27427,33,24572,4,10,0,0,0,14,5,3,10,0,0,18,nowin,loss,beat,dlwin,0,10,14,192,0.4375,0.057291667,0.625,2,0.616208916
27428,102,24572,10,10,0,0,0,20,5,3,10,0,0,18,nowin,win,plwin,beat,20,0,20,192,0.338541667,0.046875,0.5625,0,0.003306118
27429,149,24572,10,11,0,0,0,21,5,3,10,0,0,18,win,win,plwin,beat,25,0,21,225,0.457777778,0.057777778,0.648888889,2,0.651965595
27430,24,24572,5,9,0,0,0,14,5,3,10,0,0,18,nowin,loss,beat,dlwin,0,10,14,207,0.458937198,0.048309179,0.570048309,1,0.318138014
27431,71,24572,10,7,0,0,0,17,5,3,10,0,0,18,nowin,loss,beat,dlwin,0,10,17,193,0.352331606,0.046632124,0.585492228,0,0.013063661
27432,41,24573,10,3,0,4,0,17,10,7,0,0,0,17,nowin,push,push,push,10,0,13,192,0.364583333,0.036458333,0.520833333,0,0.00089702
27433,73,24573,10,4,0,2,10,26,10,7,0,0,0,17,nowin,loss,bust,plbust,0,10,14,181,0.375690608,0.011049724,0.596685083,0,0.022795773
27434,109,24573,10,3,0,10,0,23,10,7,0,0,0,17,nowin,loss,bust,plbust,0,10,13,221,0.461538462,0.058823529,0.597285068,3,0.901830309
27435,126,24573,10,10,0,0,0,20,10,7,0,0,0,17,nowin,win,plwin,beat,20,0,20,188,0.457446809,0.074468085,0.60106383,3,0.900633203
27436,75,24573,10,8,0,0,0,18,10,7,0,0,0,17,nowin,win,plwin,beat,20,0,18,191,0.418848168,0.052356021,0.570680628,0,0.029344702
27437,86,24573,6,3,5,1,5,20,10,7,0,0,0,17,nowin,win,plwin,beat,20,0,9,196,0.454081633,0.040816327,0.591836735,3,0.887566443
27438,46,24574,11,1,7,0,0,19,10,8,0,0,0,18,nowin,win,plwin,beat,20,0,12,186,0.403225806,0.048387097,0.591397849,0,0.029742194
27439,53,24574,7,10,0,0,0,17,10,8,0,0,0,18,nowin,loss,beat,dlwin,0,10,17,250,0.372,0.064,0.564,0,0.013687345
27440,115,24574,10,10,0,0,0,20,10,8,0,0,0,18,nowin,win,plwin,beat,20,0,20,194,0.427835052,0.041237113,0.592783505,2,0.583863602
27441,140,24574,3,3,10,5,0,21,10,8,0,0,0,18,nowin,win,plwin,beat,20,0,6,210,0.466666667,0.023809524,0.604761905,3,0.915293335
27442,34,24574,9,10,0,0,0,19,10,8,0,0,0,18,nowin,win,plwin,beat,20,0,19,202,0.5,0.079207921,0.618811881,3,0.968961434
27443,122,24574,6,3,8,0,0,17,10,8,0,0,0,18,nowin,loss,beat,dlwin,0,10,9,210,0.347619048,0.052380952,0.59047619,0,0.012873677
27444,44,24575,9,3,0,0,0,12,6,2,10,0,0,18,nowin,loss,beat,dlwin,0,10,12,219,0.433789954,0.050228311,0.534246575,1,0.285551035
27445,9,24575,11,10,0,0,0,21,6,2,10,0,0,18,win,win,plwin,beat,25,0,21,194,0.37628866,0.015463918,0.541237113,0,0.009396796
27446,145,24575,2,7,4,0,0,13,6,2,10,0,0,18,nowin,loss,beat,dlwin,0,10,9,188,0.441489362,0.031914894,0.622340426,2,0.617837093
27447,16,24575,9,9,0,0,0,18,6,2,10,0,0,18,nowin,push,push,push,10,0,18,220,0.427272727,0.081818182,0.6,2,0.588660176
27448,111,24575,10,10,0,0,0,20,6,2,10,0,0,18,nowin,win,plwin,beat,20,0,20,180,0.433333333,0.055555556,0.611111111,2,0.602264492
27449,121,24575,10,3,0,0,0,13,6,2,10,0,0,18,nowin,loss,beat,dlwin,0,10,13,195,0.456410256,0.025641026,0.512820513,1,0.288597791
27450,113,24576,4,10,0,2,8,24,8,2,5,3,0,18,nowin,loss,bust,plbust,0,10,14,199,0.407035176,0.055276382,0.668341709,2,0.620695264
27451,125,24576,3,5,10,0,0,18,8,2,5,3,0,18,nowin,push,push,push,10,0,8,219,0.438356164,0.050228311,0.575342466,1,0.308411257
27452,73,24576,9,7,0,10,0,26,8,2,5,3,0,18,nowin,loss,bust,plbust,0,10,16,181,0.375690608,0.011049724,0.596685083,0,0.022795773
27453,2,24576,3,10,0,7,0,20,8,2,5,3,0,18,nowin,win,plwin,beat,20,0,13,200,0.445,0.035,0.64,2,0.633962549
27454,80,24576,10,10,0,0,0,20,8,2,5,3,0,18,nowin,win,plwin,beat,20,0,20,186,0.419354839,0.059139785,0.623655914,2,0.59892924
27455,50,24576,9,10,0,0,0,19,8,2,5,3,0,18,nowin,win,plwin,beat,20,0,19,202,0.405940594,0.04950495,0.54950495,0,0.020296079
27456,107,24577,5,9,0,8,0,22,11,10,0,0,0,21,nowin,loss,bust,plbust,0,10,14,218,0.444954128,0.073394495,0.600917431,2,0.605210014
27457,21,24577,3,10,0,8,0,21,11,10,0,0,0,21,nowin,push,push,push,10,0,13,214,0.359813084,0.042056075,0.626168224,0,0.025263474
27458,24,24577,6,8,0,5,0,19,11,10,0,0,0,21,nowin,loss,beat,dlwin,0,10,14,207,0.458937198,0.048309179,0.570048309,1,0.318138014
27459,141,24577,10,2,0,6,0,18,11,10,0,0,0,21,nowin,loss,beat,dlwin,0,10,12,202,0.420792079,0.074257426,0.564356436,0,0.028377851
27460,111,24577,9,10,0,0,0,19,11,10,0,0,0,21,nowin,loss,beat,dlwin,0,10,19,180,0.433333333,0.055555556,0.611111111,2,0.602264492
27461,109,24577,10,10,0,0,0,20,11,10,0,0,0,21,nowin,loss,beat,dlwin,0,10,20,221,0.461538462,0.058823529,0.597285068,3,0.901830309
27462,68,24578,8,3,4,0,0,15,6,3,10,0,0,19,nowin,loss,beat,dlwin,0,10,11,205,0.434146341,0.029268293,0.6,2,0.59483189
27463,140,24578,5,4,9,0,0,18,6,3,10,0,0,19,nowin,loss,beat,dlwin,0,10,9,210,0.466666667,0.023809524,0.604761905,3,0.915293335
27464,23,24578,10,6,0,0,0,16,6,3,10,0,0,19,nowin,loss,beat,dlwin,0,10,16,208,0.427884615,0.0625,0.552884615,1,0.29114424
27465,89,24578,10,10,0,0,0,20,6,3,10,0,0,19,nowin,win,plwin,beat,20,0,20,212,0.537735849,0.047169811,0.594339623,3,0.990167191
27466,21,24578,10,4,0,0,0,14,6,3,10,0,0,19,nowin,loss,beat,dlwin,0,10,14,214,0.359813084,0.042056075,0.626168224,0,0.025263474
27467,25,24578,10,8,0,0,0,18,6,3,10,0,0,19,nowin,loss,beat,dlwin,0,10,18,190,0.463157895,0.063157895,0.536842105,1,0.304401563
27468,135,24579,7,10,0,0,0,17,8,6,10,0,0,24,nowin,win,dlbust,bust,20,0,17,179,0.391061453,0.067039106,0.586592179,0,0.024924662
27469,36,24579,11,10,0,0,0,21,8,6,10,0,0,24,win,win,dlbust,bust,25,0,21,229,0.445414847,0.056768559,0.655021834,2,0.645370571
27470,31,24579,10,10,0,0,0,20,8,6,10,0,0,24,nowin,win,dlbust,bust,20,0,20,188,0.473404255,0.058510638,0.515957447,1,0.300306557
27471,88,24579,2,10,0,8,0,20,8,6,10,0,0,24,nowin,win,dlbust,bust,20,0,12,206,0.466019417,0.033980583,0.54368932,1,0.309467903
27472,86,24579,10,11,0,0,0,21,8,6,10,0,0,24,win,win,dlbust,bust,25,0,21,196,0.454081633,0.040816327,0.591836735,3,0.887566443
27473,43,24579,10,9,0,0,0,19,8,6,10,0,0,24,nowin,win,dlbust,bust,20,0,19,192,0.40625,0.041666667,0.609375,2,0.576671372
27474,126,24580,10,10,0,0,0,20,5,2,10,0,0,17,nowin,win,plwin,beat,20,0,20,188,0.457446809,0.074468085,0.60106383,3,0.900633203
27475,47,24580,9,10,0,0,0,19,5,2,10,0,0,17,nowin,win,plwin,beat,20,0,19,210,0.438095238,0.057142857,0.623809524,2,0.615868808
27476,3,24580,6,10,0,0,0,16,5,2,10,0,0,17,nowin,loss,beat,dlwin,0,10,16,190,0.431578947,0.026315789,0.542105263,1,0.288076384
27477,120,24580,10,4,0,0,0,14,5,2,10,0,0,17,nowin,loss,beat,dlwin,0,10,14,202,0.440594059,0.034653465,0.618811881,2,0.614441029
27478,113,24580,1,6,6,0,0,13,5,2,10,0,0,17,nowin,loss,beat,dlwin,0,10,7,199,0.407035176,0.055276382,0.668341709,2,0.620695264
27479,80,24580,4,2,4,10,0,20,5,2,10,0,0,17,nowin,win,plwin,beat,20,0,6,186,0.419354839,0.059139785,0.623655914,2,0.59892924
27480,134,24581,9,10,0,0,0,19,7,8,1,9,0,25,nowin,win,dlbust,bust,20,0,19,185,0.443243243,0.021621622,0.545945946,1,0.296939509
27481,73,24581,2,10,0,3,8,23,7,8,1,9,0,25,nowin,loss,bust,plbust,0,10,12,181,0.375690608,0.011049724,0.596685083,0,0.022795773
27482,29,24581,10,4,0,9,0,23,7,8,1,9,0,25,nowin,loss,bust,plbust,0,10,14,189,0.44973545,0.058201058,0.544973545,1,0.300349439
27483,3,24581,11,8,0,0,0,19,7,8,1,9,0,25,nowin,win,dlbust,bust,20,0,19,190,0.431578947,0.026315789,0.542105263,1,0.288076384
27484,39,24581,10,11,0,0,0,21,7,8,1,9,0,25,win,win,dlbust,bust,25,0,21,191,0.429319372,0.062827225,0.57591623,0,0.033760763
27485,7,24581,11,9,0,0,0,20,7,8,1,9,0,25,nowin,win,dlbust,bust,20,0,20,183,0.442622951,0.06010929,0.62295082,2,0.619303341
27486,69,24582,4,2,4,10,0,20,10,10,0,0,0,20,nowin,push,push,push,10,0,6,194,0.365979381,0.030927835,0.515463918,0,0
27487,78,24582,5,4,11,0,0,20,10,10,0,0,0,20,nowin,push,push,push,10,0,9,201,0.517412935,0.034825871,0.587064677,3,0.95871112
27488,92,24582,9,4,0,3,5,21,10,10,0,0,0,20,nowin,win,plwin,beat,20,0,13,186,0.446236559,0.059139785,0.564516129,1,0.307826125
27489,25,24582,8,10,0,0,0,18,10,10,0,0,0,20,nowin,loss,beat,dlwin,0,10,18,190,0.463157895,0.063157895,0.536842105,1,0.304401563
27490,8,24582,3,3,10,10,0,26,10,10,0,0,0,20,nowin,loss,bust,plbust,0,10,6,181,0.44198895,0.071823204,0.596685083,2,0.599438402
27491,62,24582,4,9,0,4,0,17,10,10,0,0,0,20,nowin,loss,beat,dlwin,0,10,13,178,0.370786517,0.028089888,0.54494382,0,0.008657722
27492,124,24583,9,10,0,0,0,19,5,10,2,0,0,17,nowin,win,plwin,beat,20,0,19,202,0.47029703,0.064356436,0.584158416,3,0.899458193
27493,80,24583,10,3,0,0,0,13,5,10,2,0,0,17,nowin,loss,beat,dlwin,0,10,13,186,0.419354839,0.059139785,0.623655914,2,0.59892924
27494,59,24583,6,10,0,0,0,16,5,10,2,0,0,17,nowin,loss,beat,dlwin,0,10,16,228,0.429824561,0.048245614,0.543859649,1,0.287885446
27495,20,24583,3,10,0,0,0,13,5,10,2,0,0,17,nowin,loss,beat,dlwin,0,10,13,186,0.456989247,0.037634409,0.537634409,1,0.301097108
27496,84,24583,10,2,0,0,0,12,5,10,2,0,0,17,nowin,loss,beat,dlwin,0,10,12,195,0.379487179,0.056410256,0.569230769,0,0.017209119
27497,79,24583,2,8,10,0,0,20,5,10,2,0,0,17,nowin,win,plwin,beat,20,0,10,211,0.436018957,0.028436019,0.672985782,2,0.650131054
27498,45,24584,10,7,0,0,0,17,9,10,0,0,0,19,nowin,loss,beat,dlwin,0,10,17,196,0.428571429,0.051020408,0.612244898,2,0.598821767
27499,75,24584,10,10,0,0,0,20,9,10,0,0,0,19,nowin,win,plwin,beat,20,0,20,191,0.418848168,0.052356021,0.570680628,0,0.029344702
27500,45,24584,6,8,0,10,0,24,9,10,0,0,0,19,nowin,loss,bust,plbust,0,10,14,196,0.428571429,0.051020408,0.612244898,2,0.598821767
27501,15,24584,3,1,8,5,0,17,9,10,0,0,0,19,nowin,loss,beat,dlwin,0,10,4,212,0.410377358,0.051886792,0.561320755,0,0.024517408
27502,35,24584,9,6,0,3,0,18,9,10,0,0,0,19,nowin,loss,beat,dlwin,0,10,15,202,0.410891089,0.044554455,0.633663366,2,0.598681573
27503,55,24584,6,10,0,7,0,23,9,10,0,0,0,19,nowin,loss,bust,plbust,0,10,16,191,0.371727749,0.057591623,0.54973822,0,0.01011347
27504,138,24585,10,7,0,0,0,17,10,10,0,0,0,20,nowin,loss,beat,dlwin,0,10,17,190,0.442105263,0.047368421,0.610526316,2,0.609711065
27505,95,24585,8,10,0,0,0,18,10,10,0,0,0,20,nowin,loss,beat,dlwin,0,10,18,218,0.412844037,0.04587156,0.559633028,0,0.024842385
27506,93,24585,7,3,10,0,0,20,10,10,0,0,0,20,nowin,push,push,push,10,0,10,175,0.485714286,0.051428571,0.548571429,1,0.323648091
27507,9,24585,8,8,0,9,0,25,10,10,0,0,0,20,nowin,loss,bust,plbust,0,10,16,194,0.37628866,0.015463918,0.541237113,0,0.009396796
27508,35,24585,10,8,0,0,0,18,10,10,0,0,0,20,nowin,loss,beat,dlwin,0,10,18,202,0.410891089,0.044554455,0.633663366,2,0.598681573
27509,144,24585,2,11,8,0,0,21,10,10,0,0,0,20,nowin,win,plwin,beat,20,0,13,202,0.386138614,0.054455446,0.564356436,0,0.018006244
27510,92,24586,4,4,4,10,0,22,8,10,0,0,0,18,nowin,loss,bust,plbust,0,10,8,186,0.446236559,0.059139785,0.564516129,1,0.307826125
27511,104,24586,7,10,0,0,0,17,8,10,0,0,0,18,nowin,loss,beat,dlwin,0,10,17,209,0.363636364,0.052631579,0.593301435,0,0.018359419
27512,148,24586,10,8,0,0,0,18,8,10,0,0,0,18,nowin,push,push,push,10,0,18,204,0.401960784,0.078431373,0.593137255,0,0.029789521
27513,39,24586,6,5,8,0,0,19,8,10,0,0,0,18,nowin,win,plwin,beat,20,0,11,191,0.429319372,0.062827225,0.57591623,0,0.033760763
27514,46,24586,10,10,0,0,0,20,8,10,0,0,0,18,nowin,win,plwin,beat,20,0,20,186,0.403225806,0.048387097,0.591397849,0,0.029742194
27515,103,24586,7,10,0,0,0,17,8,10,0,0,0,18,nowin,loss,beat,dlwin,0,10,17,203,0.379310345,0.064039409,0.551724138,0,0.012869209
27516,51,24587,10,10,0,0,0,20,2,8,7,0,0,17,nowin,win,plwin,beat,20,0,20,189,0.529100529,0.068783069,0.608465608,3,0.993665715
27517,98,24587,9,7,0,0,0,16,2,8,7,0,0,17,nowin,loss,beat,dlwin,0,10,16,220,0.422727273,0.054545455,0.55,1,0.28664435
27518,126,24587,10,10,0,0,0,20,2,8,7,0,0,17,nowin,win,plwin,beat,20,0,20,188,0.457446809,0.074468085,0.60106383,3,0.900633203
27519,44,24587,3,10,0,0,0,13,2,8,7,0,0,17,nowin,loss,beat,dlwin,0,10,13,219,0.433789954,0.050228311,0.534246575,1,0.285551035
27520,103,24587,1,4,8,0,0,13,2,8,7,0,0,17,nowin,loss,beat,dlwin,0,10,5,203,0.379310345,0.064039409,0.551724138,0,0.012869209
27521,91,24587,8,10,0,0,0,18,2,8,7,0,0,17,nowin,win,plwin,beat,20,0,18,194,0.417525773,0.046391753,0.515463918,1,0.266616552
27522,147,24588,10,5,0,6,0,21,9,6,4,0,0,19,nowin,win,plwin,beat,20,0,15,205,0.380487805,0.014634146,0.536585366,0,0.00951447
27523,52,24588,2,7,7,7,0,23,9,6,4,0,0,19,nowin,loss,bust,plbust,0,10,9,217,0.414746544,0.02764977,0.599078341,2,0.576736024
27524,10,24588,4,10,0,5,0,19,9,6,4,0,0,19,nowin,push,push,push,10,0,14,191,0.413612565,0.057591623,0.596858639,2,0.574087175
27525,144,24588,7,3,10,0,0,20,9,6,4,0,0,19,nowin,win,plwin,beat,20,0,10,202,0.386138614,0.054455446,0.564356436,0,0.018006244
27526,99,24588,8,7,0,4,0,19,9,6,4,0,0,19,nowin,push,push,push,10,0,15,207,0.47826087,0.062801932,0.637681159,3,0.961418446
27527,146,24588,10,6,0,6,0,22,9,6,4,0,0,19,nowin,loss,bust,plbust,0,10,16,221,0.43438914,0.040723982,0.542986425,1,0.290190091
27528,18,24589,10,10,0,0,0,20,2,10,1,2,8,23,nowin,win,dlbust,bust,20,0,20,182,0.461538462,0.043956044,0.587912088,3,0.892649374
27529,94,24589,10,3,0,0,0,13,2,10,1,2,8,23,nowin,win,dlbust,bust,20,0,13,183,0.43715847,0.043715847,0.540983607,1,0.290866892
27530,9,24589,10,10,0,0,0,20,2,10,1,2,8,23,nowin,win,dlbust,bust,20,0,20,194,0.37628866,0.015463918,0.541237113,0,0.009396796
27531,133,24589,1,3,10,0,0,14,2,10,1,2,8,23,nowin,win,dlbust,bust,20,0,4,201,0.47761194,0.064676617,0.611940299,3,0.935428111
27532,51,24589,10,10,0,0,0,20,2,10,1,2,8,23,nowin,win,dlbust,bust,20,0,20,189,0.529100529,0.068783069,0.608465608,3,0.993665715
27533,62,24589,10,10,0,0,0,20,2,10,1,2,8,23,nowin,win,dlbust,bust,20,0,20,178,0.370786517,0.028089888,0.54494382,0,0.008657722
27534,40,24590,9,10,0,0,0,19,10,4,7,0,0,21,nowin,loss,beat,dlwin,0,10,19,196,0.367346939,0.030612245,0.617346939,0,0.025358183
27535,137,24590,10,11,0,0,0,21,10,4,7,0,0,21,win,push,push,push,10,0,21,194,0.417525773,0.046391753,0.536082474,1,0.276714602
27536,21,24590,9,4,0,10,0,23,10,4,7,0,0,21,nowin,loss,bust,plbust,0,10,13,214,0.359813084,0.042056075,0.626168224,0,0.025263474
27537,43,24590,8,4,0,6,0,18,10,4,7,0,0,21,nowin,loss,beat,dlwin,0,10,12,192,0.40625,0.041666667,0.609375,2,0.576671372
27538,108,24590,10,5,0,10,0,25,10,4,7,0,0,21,nowin,loss,bust,plbust,0,10,15,193,0.435233161,0.056994819,0.559585492,1,0.298824795
27539,80,24590,9,7,0,10,0,26,10,4,7,0,0,21,nowin,loss,bust,plbust,0,10,16,186,0.419354839,0.059139785,0.623655914,2,0.59892924
27540,83,24591,9,5,0,6,0,20,10,10,0,0,0,20,nowin,push,push,push,10,0,14,193,0.424870466,0.051813472,0.678756477,2,0.644360335
27541,104,24591,9,7,0,9,0,25,10,10,0,0,0,20,nowin,loss,bust,plbust,0,10,16,209,0.363636364,0.052631579,0.593301435,0,0.018359419
27542,125,24591,10,7,0,0,0,17,10,10,0,0,0,20,nowin,loss,beat,dlwin,0,10,17,219,0.438356164,0.050228311,0.575342466,1,0.308411257
27543,144,24591,1,6,8,10,0,25,10,10,0,0,0,20,nowin,loss,bust,plbust,0,10,7,202,0.386138614,0.054455446,0.564356436,0,0.018006244
27544,19,24591,10,2,0,4,2,18,10,10,0,0,0,20,nowin,loss,beat,dlwin,0,10,12,237,0.41350211,0.054852321,0.628691983,2,0.597373826
27545,99,24591,7,6,0,2,9,24,10,10,0,0,0,20,nowin,loss,bust,plbust,0,10,13,207,0.47826087,0.062801932,0.637681159,3,0.961418446
27546,66,24592,4,10,0,1,10,25,10,10,0,0,0,20,nowin,loss,bust,plbust,0,10,14,217,0.456221198,0.064516129,0.626728111,3,0.924304367
27547,127,24592,5,3,3,10,0,21,10,10,0,0,0,20,nowin,win,plwin,beat,20,0,8,201,0.402985075,0.029850746,0.60199005,0,0.032263937
27548,34,24592,11,8,0,0,0,19,10,10,0,0,0,20,nowin,loss,beat,dlwin,0,10,19,202,0.5,0.079207921,0.618811881,3,0.968961434
27549,121,24592,6,5,7,0,0,18,10,10,0,0,0,20,nowin,loss,beat,dlwin,0,10,11,195,0.456410256,0.025641026,0.512820513,1,0.288597791
27550,17,24592,11,10,0,0,0,21,10,10,0,0,0,20,win,win,plwin,beat,25,0,21,171,0.444444444,0.070175439,0.555555556,1,0.302364894
27551,138,24592,10,10,0,0,0,20,10,10,0,0,0,20,nowin,push,push,push,10,0,20,190,0.442105263,0.047368421,0.610526316,2,0.609711065
27552,45,24593,10,2,0,4,0,16,2,10,4,5,0,21,nowin,loss,beat,dlwin,0,10,12,196,0.428571429,0.051020408,0.612244898,2,0.598821767
27553,19,24593,4,2,7,0,0,13,2,10,4,5,0,21,nowin,loss,beat,dlwin,0,10,6,237,0.41350211,0.054852321,0.628691983,2,0.597373826
27554,5,24593,8,10,0,0,0,18,2,10,4,5,0,21,nowin,loss,beat,dlwin,0,10,18,203,0.42364532,0.02955665,0.596059113,2,0.582508076
27555,21,24593,10,10,0,0,0,20,2,10,4,5,0,21,nowin,loss,beat,dlwin,0,10,20,214,0.359813084,0.042056075,0.626168224,0,0.025263474
27556,131,24593,10,5,0,0,0,15,2,10,4,5,0,21,nowin,loss,beat,dlwin,0,10,15,217,0.410138249,0.069124424,0.543778802,0,0.02015021
27557,29,24593,10,10,0,0,0,20,2,10,4,5,0,21,nowin,loss,beat,dlwin,0,10,20,189,0.44973545,0.058201058,0.544973545,1,0.300349439
27558,105,24594,6,10,0,5,0,21,10,10,0,0,0,20,nowin,win,plwin,beat,20,0,16,198,0.414141414,0.070707071,0.590909091,0,0.032889494
27559,24,24594,10,8,0,0,0,18,10,10,0,0,0,20,nowin,loss,beat,dlwin,0,10,18,207,0.458937198,0.048309179,0.570048309,1,0.318138014
27560,37,24594,9,4,0,3,10,26,10,10,0,0,0,20,nowin,loss,bust,plbust,0,10,13,208,0.394230769,0.038461538,0.581730769,0,0.024682772
27561,97,24594,10,10,0,0,0,20,10,10,0,0,0,20,nowin,push,push,push,10,0,20,182,0.450549451,0.06043956,0.692307692,2,0.677372279
27562,88,24594,6,9,0,10,0,25,10,10,0,0,0,20,nowin,loss,bust,plbust,0,10,15,206,0.466019417,0.033980583,0.54368932,1,0.309467903
27563,76,24594,10,10,0,0,0,20,10,10,0,0,0,20,nowin,push,push,push,10,0,20,189,0.534391534,0.079365079,0.608465608,3,1
27564,128,24595,6,1,5,0,0,12,5,4,10,0,0,19,nowin,loss,beat,dlwin,0,10,7,227,0.356828194,0.052863436,0.577092511,0,0.012352564
27565,84,24595,10,4,0,0,0,14,5,4,10,0,0,19,nowin,loss,beat,dlwin,0,10,14,195,0.379487179,0.056410256,0.569230769,0,0.017209119
27566,41,24595,2,2,4,10,0,18,5,4,10,0,0,19,nowin,loss,beat,dlwin,0,10,4,192,0.364583333,0.036458333,0.520833333,0,0.00089702
27567,10,24595,10,11,0,0,0,21,5,4,10,0,0,19,win,win,plwin,beat,25,0,21,191,0.413612565,0.057591623,0.596858639,2,0.574087175
27568,135,24595,3,5,10,0,0,18,5,4,10,0,0,19,nowin,loss,beat,dlwin,0,10,8,179,0.391061453,0.067039106,0.586592179,0,0.024924662
27569,104,24595,5,10,0,0,0,15,5,4,10,0,0,19,nowin,loss,beat,dlwin,0,10,15,209,0.363636364,0.052631579,0.593301435,0,0.018359419
27570,148,24596,5,10,0,5,0,20,7,10,0,0,0,17,nowin,win,plwin,beat,20,0,15,204,0.401960784,0.078431373,0.593137255,0,0.029789521
27571,109,24596,10,9,0,0,0,19,7,10,0,0,0,17,nowin,win,plwin,beat,20,0,19,221,0.461538462,0.058823529,0.597285068,3,0.901830309
27572,49,24596,11,10,0,0,0,21,7,10,0,0,0,17,win,win,plwin,beat,25,0,21,207,0.396135266,0.053140097,0.594202899,0,0.028306925
27573,37,24596,10,7,0,0,0,17,7,10,0,0,0,17,nowin,push,push,push,10,0,17,208,0.394230769,0.038461538,0.581730769,0,0.024682772
27574,145,24596,3,10,0,6,0,19,7,10,0,0,0,17,nowin,win,plwin,beat,20,0,13,188,0.441489362,0.031914894,0.622340426,2,0.617837093
27575,82,24596,9,10,0,0,0,19,7,10,0,0,0,17,nowin,win,plwin,beat,20,0,19,225,0.408888889,0.075555556,0.577777778,0,0.028101874
27576,137,24597,2,3,8,0,0,13,5,4,9,0,0,18,nowin,loss,beat,dlwin,0,10,5,194,0.417525773,0.046391753,0.536082474,1,0.276714602
27577,51,24597,7,3,10,0,0,20,5,4,9,0,0,18,nowin,win,plwin,beat,20,0,10,189,0.529100529,0.068783069,0.608465608,3,0.993665715
27578,97,24597,4,4,10,0,0,18,5,4,9,0,0,18,nowin,push,push,push,10,0,8,182,0.450549451,0.06043956,0.692307692,2,0.677372279
27579,17,24597,9,4,0,0,0,13,5,4,9,0,0,18,nowin,loss,beat,dlwin,0,10,13,171,0.444444444,0.070175439,0.555555556,1,0.302364894
27580,90,24597,5,2,5,0,0,12,5,4,9,0,0,18,nowin,loss,beat,dlwin,0,10,7,201,0.447761194,0.049751244,0.60199005,3,0.889945023
27581,116,24597,6,10,0,0,0,16,5,4,9,0,0,18,nowin,loss,beat,dlwin,0,10,16,195,0.425641026,0.056410256,0.538461538,1,0.28273747
27582,130,24598,8,9,0,0,0,17,11,10,0,0,0,21,nowin,loss,beat,dlwin,0,10,17,219,0.410958904,0.03652968,0.566210046,0,0.025888739
27583,150,24598,6,9,0,1,5,21,11,10,0,0,0,21,nowin,push,push,push,10,0,15,192,0.401041667,0.036458333,0.567708333,0,0.023287458
27584,127,24598,3,1,10,10,0,24,11,10,0,0,0,21,nowin,loss,bust,plbust,0,10,4,201,0.402985075,0.029850746,0.60199005,0,0.032263937
27585,64,24598,10,9,0,0,0,19,11,10,0,0,0,21,nowin,loss,beat,dlwin,0,10,19,187,0.363636364,0.048128342,0.631016043,0,0.027594885
27586,127,24598,3,9,0,7,0,19,11,10,0,0,0,21,nowin,loss,beat,dlwin,0,10,12,201,0.402985075,0.029850746,0.60199005,0,0.032263937
27587,126,24598,3,4,10,0,0,17,11,10,0,0,0,21,nowin,loss,beat,dlwin,0,10,7,188,0.457446809,0.074468085,0.60106383,3,0.900633203
27588,45,24599,2,10,0,3,10,25,10,10,0,0,0,20,nowin,loss,bust,plbust,0,10,12,196,0.428571429,0.051020408,0.612244898,2,0.598821767
27589,112,24599,3,9,0,4,4,20,10,10,0,0,0,20,nowin,push,push,push,10,0,12,203,0.448275862,0.054187192,0.600985222,3,0.889576933
27590,1,24599,11,1,4,8,0,24,10,10,0,0,0,20,nowin,loss,bust,plbust,0,10,12,197,0.406091371,0.025380711,0.649746193,2,0.606186955
27591,6,24599,10,7,0,0,0,17,10,10,0,0,0,20,nowin,loss,beat,dlwin,0,10,17,191,0.439790576,0.047120419,0.581151832,1,0.31211505
27592,107,24599,2,6,8,8,0,24,10,10,0,0,0,20,nowin,loss,bust,plbust,0,10,8,218,0.444954128,0.073394495,0.600917431,2,0.605210014
27593,150,24599,7,2,10,0,0,19,10,10,0,0,0,20,nowin,loss,beat,dlwin,0,10,9,192,0.401041667,0.036458333,0.567708333,0,0.023287458
27594,128,24600,1,3,10,0,0,14,6,7,8,0,0,21,nowin,loss,beat,dlwin,0,10,4,227,0.356828194,0.052863436,0.577092511,0,0.012352564
27595,11,24600,10,10,0,0,0,20,6,7,8,0,0,21,nowin,loss,beat,dlwin,0,10,20,236,0.457627119,0.016949153,0.588983051,3,0.889015813
27596,27,24600,10,10,0,0,0,20,6,7,8,0,0,21,nowin,loss,beat,dlwin,0,10,20,178,0.370786517,0.016853933,0.573033708,0,0.015536309
27597,103,24600,11,10,0,0,0,21,6,7,8,0,0,21,win,push,push,push,10,0,21,203,0.379310345,0.064039409,0.551724138,0,0.012869209
27598,67,24600,11,7,0,0,0,18,6,7,8,0,0,21,nowin,loss,beat,dlwin,0,10,18,195,0.369230769,0.041025641,0.569230769,0,0.014139427
27599,77,24600,11,7,0,0,0,18,6,7,8,0,0,21,nowin,loss,beat,dlwin,0,10,18,200,0.455,0.04,0.62,3,0.916252116
27600,43,24601,8,11,0,0,0,19,1,3,10,10,0,24,nowin,win,dlbust,bust,20,0,19,192,0.40625,0.041666667,0.609375,2,0.576671372
27601,26,24601,3,2,3,2,6,16,1,3,10,10,0,24,nowin,win,dlbust,bust,20,0,5,203,0.463054187,0.0591133,0.541871921,1,0.306802864
27602,109,24601,8,11,0,0,0,19,1,3,10,10,0,24,nowin,win,dlbust,bust,20,0,19,221,0.461538462,0.058823529,0.597285068,3,0.901830309
27603,115,24601,10,4,0,7,0,21,1,3,10,10,0,24,nowin,win,dlbust,bust,20,0,14,194,0.427835052,0.041237113,0.592783505,2,0.583863602
27604,22,24601,10,6,0,10,0,26,1,3,10,10,0,24,nowin,loss,bust,plbust,0,10,16,187,0.481283422,0.042780749,0.577540107,3,0.906128176
27605,55,24601,2,1,9,8,0,20,1,3,10,10,0,24,nowin,win,dlbust,bust,20,0,3,191,0.371727749,0.057591623,0.54973822,0,0.01011347
27606,83,24602,7,10,0,0,0,17,10,9,0,0,0,19,nowin,loss,beat,dlwin,0,10,17,193,0.424870466,0.051813472,0.678756477,2,0.644360335
27607,94,24602,7,7,0,9,0,23,10,9,0,0,0,19,nowin,loss,bust,plbust,0,10,14,183,0.43715847,0.043715847,0.540983607,1,0.290866892
27608,134,24602,10,4,0,1,8,23,10,9,0,0,0,19,nowin,loss,bust,plbust,0,10,14,185,0.443243243,0.021621622,0.545945946,1,0.296939509
27609,63,24602,11,1,9,0,0,21,10,9,0,0,0,19,nowin,win,plwin,beat,20,0,12,216,0.467592593,0.037037037,0.62037037,3,0.931690496
27610,109,24602,6,10,0,7,0,23,10,9,0,0,0,19,nowin,loss,bust,plbust,0,10,16,221,0.461538462,0.058823529,0.597285068,3,0.901830309
27611,41,24602,6,2,8,4,0,20,10,9,0,0,0,19,nowin,win,plwin,beat,20,0,8,192,0.364583333,0.036458333,0.520833333,0,0.00089702
27612,149,24603,6,7,0,0,0,13,2,6,5,6,0,19,nowin,loss,beat,dlwin,0,10,13,225,0.457777778,0.057777778,0.648888889,2,0.651965595
27613,31,24603,9,7,0,0,0,16,2,6,5,6,0,19,nowin,loss,beat,dlwin,0,10,16,188,0.473404255,0.058510638,0.515957447,1,0.300306557
27614,128,24603,2,2,10,0,0,14,2,6,5,6,0,19,nowin,loss,beat,dlwin,0,10,4,227,0.356828194,0.052863436,0.577092511,0,0.012352564
27615,106,24603,9,6,0,0,0,15,2,6,5,6,0,19,nowin,loss,beat,dlwin,0,10,15,192,0.411458333,0.026041667,0.557291667,0,0.023854304
27616,140,24603,4,8,0,7,0,19,2,6,5,6,0,19,nowin,push,push,push,10,0,12,210,0.466666667,0.023809524,0.604761905,3,0.915293335
27617,145,24603,9,5,0,0,0,14,2,6,5,6,0,19,nowin,loss,beat,dlwin,0,10,14,188,0.441489362,0.031914894,0.622340426,2,0.617837093
27618,89,24604,7,7,0,0,0,14,3,10,10,0,0,23,nowin,win,dlbust,bust,20,0,14,212,0.537735849,0.047169811,0.594339623,3,0.990167191
27619,74,24604,11,10,0,0,0,21,3,10,10,0,0,23,win,win,dlbust,bust,25,0,21,209,0.411483254,0.04784689,0.531100478,0,0.017448125
27620,72,24604,10,3,0,0,0,13,3,10,10,0,0,23,nowin,win,dlbust,bust,20,0,13,185,0.394594595,0.032432432,0.508108108,0,0.006763115
27621,107,24604,8,11,0,0,0,19,3,10,10,0,0,23,nowin,win,dlbust,bust,20,0,19,218,0.444954128,0.073394495,0.600917431,2,0.605210014
27622,99,24604,6,8,0,0,0,14,3,10,10,0,0,23,nowin,win,dlbust,bust,20,0,14,207,0.47826087,0.062801932,0.637681159,3,0.961418446
27623,9,24604,2,7,7,0,0,16,3,10,10,0,0,23,nowin,win,dlbust,bust,20,0,9,194,0.37628866,0.015463918,0.541237113,0,0.009396796
27624,16,24605,5,10,0,10,0,25,7,4,5,8,0,24,nowin,loss,bust,plbust,0,10,15,220,0.427272727,0.081818182,0.6,2,0.588660176
27625,124,24605,9,10,0,0,0,19,7,4,5,8,0,24,nowin,win,dlbust,bust,20,0,19,202,0.47029703,0.064356436,0.584158416,3,0.899458193
27626,5,24605,10,9,0,0,0,19,7,4,5,8,0,24,nowin,win,dlbust,bust,20,0,19,203,0.42364532,0.02955665,0.596059113,2,0.582508076
27627,120,24605,8,10,0,0,0,18,7,4,5,8,0,24,nowin,win,dlbust,bust,20,0,18,202,0.440594059,0.034653465,0.618811881,2,0.614441029
27628,66,24605,6,10,0,10,0,26,7,4,5,8,0,24,nowin,loss,bust,plbust,0,10,16,217,0.456221198,0.064516129,0.626728111,3,0.924304367
27629,101,24605,10,10,0,0,0,20,7,4,5,8,0,24,nowin,win,dlbust,bust,20,0,20,205,0.424390244,0.068292683,0.63902439,2,0.614740646
27630,58,24606,8,10,0,0,0,18,6,3,10,0,0,19,nowin,loss,beat,dlwin,0,10,18,195,0.430769231,0.041025641,0.584615385,2,0.580497586
27631,76,24606,11,10,0,0,0,21,6,3,10,0,0,19,win,win,plwin,beat,25,0,21,189,0.534391534,0.079365079,0.608465608,3,1
27632,41,24606,8,6,0,0,0,14,6,3,10,0,0,19,nowin,loss,beat,dlwin,0,10,14,192,0.364583333,0.036458333,0.520833333,0,0.00089702
27633,26,24606,4,10,0,0,0,14,6,3,10,0,0,19,nowin,loss,beat,dlwin,0,10,14,203,0.463054187,0.0591133,0.541871921,1,0.306802864
27634,145,24606,5,7,0,0,0,12,6,3,10,0,0,19,nowin,loss,beat,dlwin,0,10,12,188,0.441489362,0.031914894,0.622340426,2,0.617837093
27635,10,24606,5,1,8,0,0,14,6,3,10,0,0,19,nowin,loss,beat,dlwin,0,10,6,191,0.413612565,0.057591623,0.596858639,2,0.574087175
27636,57,24607,10,9,0,0,0,19,6,3,2,6,0,17,nowin,win,plwin,beat,20,0,19,192,0.46875,0.052083333,0.59375,3,0.907001181
27637,127,24607,6,2,7,0,0,15,6,3,2,6,0,17,nowin,loss,beat,dlwin,0,10,8,201,0.402985075,0.029850746,0.60199005,0,0.032263937
27638,60,24607,3,10,0,0,0,13,6,3,2,6,0,17,nowin,loss,beat,dlwin,0,10,13,227,0.418502203,0.022026432,0.559471366,0,0.026496258
27639,71,24607,9,10,0,0,0,19,6,3,2,6,0,17,nowin,win,plwin,beat,20,0,19,193,0.352331606,0.046632124,0.585492228,0,0.013063661
27640,95,24607,6,10,0,0,0,16,6,3,2,6,0,17,nowin,loss,beat,dlwin,0,10,16,218,0.412844037,0.04587156,0.559633028,0,0.024842385
27641,141,24607,5,10,0,0,0,15,6,3,2,6,0,17,nowin,loss,beat,dlwin,0,10,15,202,0.420792079,0.074257426,0.564356436,0,0.028377851
27642,124,24608,6,7,0,0,0,13,2,3,5,9,0,19,nowin,loss,beat,dlwin,0,10,13,202,0.47029703,0.064356436,0.584158416,3,0.899458193
27643,58,24608,2,3,10,0,0,15,2,3,5,9,0,19,nowin,loss,beat,dlwin,0,10,5,195,0.430769231,0.041025641,0.584615385,2,0.580497586
27644,5,24608,4,8,0,10,0,22,2,3,5,9,0,19,nowin,loss,bust,plbust,0,10,12,203,0.42364532,0.02955665,0.596059113,2,0.582508076
27645,132,24608,10,4,0,0,0,14,2,3,5,9,0,19,nowin,loss,beat,dlwin,0,10,14,194,0.412371134,0.036082474,0.649484536,2,0.611633238
27646,47,24608,6,1,6,0,0,13,2,3,5,9,0,19,nowin,loss,beat,dlwin,0,10,7,210,0.438095238,0.057142857,0.623809524,2,0.615868808
27647,77,24608,10,10,0,0,0,20,2,3,5,9,0,19,nowin,win,plwin,beat,20,0,20,200,0.455,0.04,0.62,3,0.916252116
27648,89,24609,6,5,10,0,0,21,9,10,0,0,0,19,nowin,win,plwin,beat,20,0,11,212,0.537735849,0.047169811,0.594339623,3,0.990167191
27649,125,24609,8,10,0,0,0,18,9,10,0,0,0,19,nowin,loss,beat,dlwin,0,10,18,219,0.438356164,0.050228311,0.575342466,1,0.308411257
27650,142,24609,3,9,0,7,0,19,9,10,0,0,0,19,nowin,push,push,push,10,0,12,211,0.417061611,0.047393365,0.526066351,1,0.271531309
27651,139,24609,5,6,3,6,0,20,9,10,0,0,0,19,nowin,win,plwin,beat,20,0,11,192,0.380208333,0.036458333,0.59375,0,0.023429169
27652,79,24609,10,6,0,1,0,17,9,10,0,0,0,19,nowin,loss,beat,dlwin,0,10,16,211,0.436018957,0.028436019,0.672985782,2,0.650131054
27653,17,24609,10,5,0,4,0,19,9,10,0,0,0,19,nowin,push,push,push,10,0,15,171,0.444444444,0.070175439,0.555555556,1,0.302364894
27654,22,24610,10,4,0,7,0,21,10,2,5,0,0,17,nowin,win,plwin,beat,20,0,14,187,0.481283422,0.042780749,0.577540107,3,0.906128176
27655,100,24610,10,4,0,4,0,18,10,2,5,0,0,17,nowin,win,plwin,beat,20,0,14,190,0.452631579,0.036842105,0.594736842,3,0.888671154
27656,105,24610,10,5,0,8,0,23,10,2,5,0,0,17,nowin,loss,bust,plbust,0,10,15,198,0.414141414,0.070707071,0.590909091,0,0.032889494
27657,71,24610,3,2,8,7,0,20,10,2,5,0,0,17,nowin,win,plwin,beat,20,0,5,193,0.352331606,0.046632124,0.585492228,0,0.013063661
27658,100,24610,11,4,6,0,0,21,10,2,5,0,0,17,nowin,win,plwin,beat,20,0,15,190,0.452631579,0.036842105,0.594736842,3,0.888671154
27659,34,24610,11,7,0,0,0,18,10,2,5,0,0,17,nowin,win,plwin,beat,20,0,18,202,0.5,0.079207921,0.618811881,3,0.968961434
27660,63,24611,11,10,0,0,0,21,7,2,10,0,0,19,win,win,plwin,beat,25,0,21,216,0.467592593,0.037037037,0.62037037,3,0.931690496
27661,101,24611,10,10,0,0,0,20,7,2,10,0,0,19,nowin,win,plwin,beat,20,0,20,205,0.424390244,0.068292683,0.63902439,2,0.614740646
27662,142,24611,2,9,8,0,0,19,7,2,10,0,0,19,nowin,push,push,push,10,0,11,211,0.417061611,0.047393365,0.526066351,1,0.271531309
27663,29,24611,9,2,3,2,6,22,7,2,10,0,0,19,nowin,loss,bust,plbust,0,10,11,189,0.44973545,0.058201058,0.544973545,1,0.300349439
27664,134,24611,10,5,0,6,0,21,7,2,10,0,0,19,nowin,win,plwin,beat,20,0,15,185,0.443243243,0.021621622,0.545945946,1,0.296939509
27665,67,24611,5,9,0,6,0,20,7,2,10,0,0,19,nowin,win,plwin,beat,20,0,14,195,0.369230769,0.041025641,0.569230769,0,0.014139427
27666,3,24612,8,10,0,0,0,18,4,10,6,0,0,20,nowin,loss,beat,dlwin,0,10,18,190,0.431578947,0.026315789,0.542105263,1,0.288076384
27667,34,24612,10,4,0,0,0,14,4,10,6,0,0,20,nowin,loss,beat,dlwin,0,10,14,202,0.5,0.079207921,0.618811881,3,0.968961434
27668,63,24612,10,9,0,0,0,19,4,10,6,0,0,20,nowin,loss,beat,dlwin,0,10,19,216,0.467592593,0.037037037,0.62037037,3,0.931690496
27669,137,24612,6,8,0,0,0,14,4,10,6,0,0,20,nowin,loss,beat,dlwin,0,10,14,194,0.417525773,0.046391753,0.536082474,1,0.276714602
27670,78,24612,5,10,0,0,0,15,4,10,6,0,0,20,nowin,loss,beat,dlwin,0,10,15,201,0.517412935,0.034825871,0.587064677,3,0.95871112
27671,146,24612,4,10,0,0,0,14,4,10,6,0,0,20,nowin,loss,beat,dlwin,0,10,14,221,0.43438914,0.040723982,0.542986425,1,0.290190091
27672,72,24613,4,10,0,7,0,21,7,4,5,10,0,26,nowin,win,dlbust,bust,20,0,14,185,0.394594595,0.032432432,0.508108108,0,0.006763115
27673,32,24613,5,10,0,10,0,25,7,4,5,10,0,26,nowin,loss,bust,plbust,0,10,15,189,0.391534392,0.037037037,0.53968254,0,0.013579086
27674,38,24613,7,10,0,0,0,17,7,4,5,10,0,26,nowin,win,dlbust,bust,20,0,17,202,0.361386139,0.03960396,0.564356436,0,0.010597953
27675,68,24613,6,1,9,10,0,26,7,4,5,10,0,26,nowin,loss,bust,plbust,0,10,7,205,0.434146341,0.029268293,0.6,2,0.59483189
27676,94,24613,6,6,0,10,0,22,7,4,5,10,0,26,nowin,loss,bust,plbust,0,10,12,183,0.43715847,0.043715847,0.540983607,1,0.290866892
27677,95,24613,3,10,0,6,0,19,7,4,5,10,0,26,nowin,win,dlbust,bust,20,0,13,218,0.412844037,0.04587156,0.559633028,0,0.024842385
27678,68,24614,7,3,8,0,0,18,10,6,1,0,0,17,nowin,win,plwin,beat,20,0,10,205,0.434146341,0.029268293,0.6,2,0.59483189
27679,132,24614,10,10,0,0,0,20,10,6,1,0,0,17,nowin,win,plwin,beat,20,0,20,194,0.412371134,0.036082474,0.649484536,2,0.611633238
27680,87,24614,9,6,0,10,0,25,10,6,1,0,0,17,nowin,loss,bust,plbust,0,10,15,202,0.405940594,0.054455446,0.628712871,2,0.590599801
27681,129,24614,10,6,0,8,0,24,10,6,1,0,0,17,nowin,loss,bust,plbust,0,10,16,201,0.422885572,0.064676617,0.55721393,0,0.027255383
27682,146,24614,8,6,0,2,3,19,10,6,1,0,0,17,nowin,win,plwin,beat,20,0,14,221,0.43438914,0.040723982,0.542986425,1,0.290190091
27683,79,24614,3,6,9,0,0,18,10,6,1,0,0,17,nowin,win,plwin,beat,20,0,9,211,0.436018957,0.028436019,0.672985782,2,0.650131054
27684,75,24615,3,10,0,4,0,17,7,9,3,0,0,19,nowin,loss,beat,dlwin,0,10,13,191,0.418848168,0.052356021,0.570680628,0,0.029344702
27685,125,24615,6,9,0,5,0,20,7,9,3,0,0,19,nowin,win,plwin,beat,20,0,15,219,0.438356164,0.050228311,0.575342466,1,0.308411257
27686,117,24615,6,3,10,0,0,19,7,9,3,0,0,19,nowin,push,push,push,10,0,9,173,0.410404624,0.069364162,0.606936416,2,0.578610282
27687,55,24615,6,2,5,6,0,19,7,9,3,0,0,19,nowin,push,push,push,10,0,8,191,0.371727749,0.057591623,0.54973822,0,0.01011347
27688,73,24615,10,10,0,0,0,20,7,9,3,0,0,19,nowin,win,plwin,beat,20,0,20,181,0.375690608,0.011049724,0.596685083,0,0.022795773
27689,29,24615,9,10,0,0,0,19,7,9,3,0,0,19,nowin,push,push,push,10,0,19,189,0.44973545,0.058201058,0.544973545,1,0.300349439
27690,3,24616,11,7,0,0,0,18,9,10,0,0,0,19,nowin,loss,beat,dlwin,0,10,18,190,0.431578947,0.026315789,0.542105263,1,0.288076384
27691,128,24616,5,10,0,10,0,25,9,10,0,0,0,19,nowin,loss,bust,plbust,0,10,15,227,0.356828194,0.052863436,0.577092511,0,0.012352564
27692,19,24616,4,9,0,3,1,17,9,10,0,0,0,19,nowin,loss,beat,dlwin,0,10,13,237,0.41350211,0.054852321,0.628691983,2,0.597373826
27693,36,24616,10,10,0,0,0,20,9,10,0,0,0,19,nowin,win,plwin,beat,20,0,20,229,0.445414847,0.056768559,0.655021834,2,0.645370571
27694,138,24616,10,3,0,10,0,23,9,10,0,0,0,19,nowin,loss,bust,plbust,0,10,13,190,0.442105263,0.047368421,0.610526316,2,0.609711065
27695,60,24616,6,3,10,0,0,19,9,10,0,0,0,19,nowin,push,push,push,10,0,9,227,0.418502203,0.022026432,0.559471366,0,0.026496258
27696,104,24617,5,10,0,10,0,25,1,5,10,10,0,26,nowin,loss,bust,plbust,0,10,15,209,0.363636364,0.052631579,0.593301435,0,0.018359419
27697,32,24617,2,10,0,8,0,20,1,5,10,10,0,26,nowin,win,dlbust,bust,20,0,12,189,0.391534392,0.037037037,0.53968254,0,0.013579086
27698,123,24617,2,2,9,7,0,20,1,5,10,10,0,26,nowin,win,dlbust,bust,20,0,4,205,0.43902439,0.034146341,0.614634146,2,0.609962544
27699,143,24617,9,10,0,0,0,19,1,5,10,10,0,26,nowin,win,dlbust,bust,20,0,19,203,0.463054187,0.044334975,0.57635468,3,0.883143365
27700,127,24617,2,10,0,3,4,19,1,5,10,10,0,26,nowin,win,dlbust,bust,20,0,12,201,0.402985075,0.029850746,0.60199005,0,0.032263937
27701,113,24617,10,4,0,9,0,23,1,5,10,10,0,26,nowin,loss,bust,plbust,0,10,14,199,0.407035176,0.055276382,0.668341709,2,0.620695264
27702,83,24618,10,10,0,0,0,20,10,3,2,10,0,25,nowin,win,dlbust,bust,20,0,20,193,0.424870466,0.051813472,0.678756477,2,0.644360335
27703,148,24618,10,2,0,2,6,20,10,3,2,10,0,25,nowin,win,dlbust,bust,20,0,12,204,0.401960784,0.078431373,0.593137255,0,0.029789521
27704,148,24618,10,6,0,10,0,26,10,3,2,10,0,25,nowin,loss,bust,plbust,0,10,16,204,0.401960784,0.078431373,0.593137255,0,0.029789521
27705,124,24618,6,10,0,8,0,24,10,3,2,10,0,25,nowin,loss,bust,plbust,0,10,16,202,0.47029703,0.064356436,0.584158416,3,0.899458193
27706,59,24618,5,8,0,10,0,23,10,3,2,10,0,25,nowin,loss,bust,plbust,0,10,13,228,0.429824561,0.048245614,0.543859649,1,0.287885446
27707,62,24618,7,8,0,6,0,21,10,3,2,10,0,25,nowin,win,dlbust,bust,20,0,15,178,0.370786517,0.028089888,0.54494382,0,0.008657722
27708,69,24619,10,4,0,10,0,24,8,9,0,0,0,17,nowin,loss,bust,plbust,0,10,14,194,0.365979381,0.030927835,0.515463918,0,0
27709,4,24619,3,7,6,6,0,22,8,9,0,0,0,17,nowin,loss,bust,plbust,0,10,10,217,0.460829493,0.036866359,0.562211982,1,0.315432839
27710,57,24619,10,5,0,2,0,17,8,9,0,0,0,17,nowin,push,push,push,10,0,15,192,0.46875,0.052083333,0.59375,3,0.907001181
27711,102,24619,10,5,0,10,0,25,8,9,0,0,0,17,nowin,loss,bust,plbust,0,10,15,192,0.338541667,0.046875,0.5625,0,0.003306118
27712,130,24619,10,10,0,0,0,20,8,9,0,0,0,17,nowin,win,plwin,beat,20,0,20,219,0.410958904,0.03652968,0.566210046,0,0.025888739
27713,5,24619,7,10,0,0,0,17,8,9,0,0,0,17,nowin,push,push,push,10,0,17,203,0.42364532,0.02955665,0.596059113,2,0.582508076
27714,135,24620,4,6,11,0,0,21,3,6,8,0,0,17,nowin,win,plwin,beat,20,0,10,179,0.391061453,0.067039106,0.586592179,0,0.024924662
27715,40,24620,3,10,0,0,0,13,3,6,8,0,0,17,nowin,loss,beat,dlwin,0,10,13,196,0.367346939,0.030612245,0.617346939,0,0.025358183
27716,101,24620,7,7,0,0,0,14,3,6,8,0,0,17,nowin,loss,beat,dlwin,0,10,14,205,0.424390244,0.068292683,0.63902439,2,0.614740646
27717,4,24620,8,10,0,0,0,18,3,6,8,0,0,17,nowin,win,plwin,beat,20,0,18,217,0.460829493,0.036866359,0.562211982,1,0.315432839
27718,45,24620,10,7,0,0,0,17,3,6,8,0,0,17,nowin,push,push,push,10,0,17,196,0.428571429,0.051020408,0.612244898,2,0.598821767
27719,90,24620,10,3,0,0,0,13,3,6,8,0,0,17,nowin,loss,beat,dlwin,0,10,13,201,0.447761194,0.049751244,0.60199005,3,0.889945023
27720,74,24621,2,3,4,10,0,19,6,10,4,0,0,20,nowin,loss,beat,dlwin,0,10,5,209,0.411483254,0.04784689,0.531100478,0,0.017448125
27721,57,24621,10,6,0,0,0,16,6,10,4,0,0,20,nowin,loss,beat,dlwin,0,10,16,192,0.46875,0.052083333,0.59375,3,0.907001181
27722,128,24621,8,7,0,0,0,15,6,10,4,0,0,20,nowin,loss,beat,dlwin,0,10,15,227,0.356828194,0.052863436,0.577092511,0,0.012352564
27723,80,24621,4,2,10,0,0,16,6,10,4,0,0,20,nowin,loss,beat,dlwin,0,10,6,186,0.419354839,0.059139785,0.623655914,2,0.59892924
27724,97,24621,1,3,8,0,0,12,6,10,4,0,0,20,nowin,loss,beat,dlwin,0,10,4,182,0.450549451,0.06043956,0.692307692,2,0.677372279
27725,12,24621,6,10,0,0,0,16,6,10,4,0,0,20,nowin,loss,beat,dlwin,0,10,16,189,0.470899471,0.015873016,0.613756614,3,0.929171178
27726,104,24622,7,11,0,0,0,18,10,4,8,0,0,22,nowin,win,dlbust,bust,20,0,18,209,0.363636364,0.052631579,0.593301435,0,0.018359419
27727,84,24622,9,8,0,0,0,17,10,4,8,0,0,22,nowin,win,dlbust,bust,20,0,17,195,0.379487179,0.056410256,0.569230769,0,0.017209119
27728,100,24622,5,1,10,7,0,23,10,4,8,0,0,22,nowin,loss,bust,plbust,0,10,6,190,0.452631579,0.036842105,0.594736842,3,0.888671154
27729,11,24622,11,6,4,0,0,21,10,4,8,0,0,22,nowin,win,dlbust,bust,20,0,17,236,0.457627119,0.016949153,0.588983051,3,0.889015813
27730,38,24622,6,8,0,5,0,19,10,4,8,0,0,22,nowin,win,dlbust,bust,20,0,14,202,0.361386139,0.03960396,0.564356436,0,0.010597953
27731,2,24622,7,9,0,4,0,20,10,4,8,0,0,22,nowin,win,dlbust,bust,20,0,16,200,0.445,0.035,0.64,2,0.633962549
27732,103,24623,10,7,0,0,0,17,7,4,8,0,0,19,nowin,loss,beat,dlwin,0,10,17,203,0.379310345,0.064039409,0.551724138,0,0.012869209
27733,86,24623,9,10,0,0,0,19,7,4,8,0,0,19,nowin,push,push,push,10,0,19,196,0.454081633,0.040816327,0.591836735,3,0.887566443
27734,110,24623,6,4,10,0,0,20,7,4,8,0,0,19,nowin,win,plwin,beat,20,0,10,192,0.416666667,0.046875,0.557291667,0,0.025413132
27735,51,24623,9,11,0,0,0,20,7,4,8,0,0,19,nowin,win,plwin,beat,20,0,20,189,0.529100529,0.068783069,0.608465608,3,0.993665715
27736,80,24623,5,6,7,0,0,18,7,4,8,0,0,19,nowin,loss,beat,dlwin,0,10,11,186,0.419354839,0.059139785,0.623655914,2,0.59892924
27737,9,24623,10,10,0,0,0,20,7,4,8,0,0,19,nowin,win,plwin,beat,20,0,20,194,0.37628866,0.015463918,0.541237113,0,0.009396796
27738,125,24624,2,1,10,0,0,13,3,9,10,0,0,22,nowin,win,dlbust,bust,20,0,3,219,0.438356164,0.050228311,0.575342466,1,0.308411257
27739,125,24624,10,6,0,0,0,16,3,9,10,0,0,22,nowin,win,dlbust,bust,20,0,16,219,0.438356164,0.050228311,0.575342466,1,0.308411257
27740,44,24624,3,6,11,0,0,20,3,9,10,0,0,22,nowin,win,dlbust,bust,20,0,9,219,0.433789954,0.050228311,0.534246575,1,0.285551035
27741,133,24624,2,11,4,0,0,17,3,9,10,0,0,22,nowin,win,dlbust,bust,20,0,13,201,0.47761194,0.064676617,0.611940299,3,0.935428111
27742,147,24624,3,10,0,0,0,13,3,9,10,0,0,22,nowin,win,dlbust,bust,20,0,13,205,0.380487805,0.014634146,0.536585366,0,0.00951447
27743,140,24624,9,10,0,0,0,19,3,9,10,0,0,22,nowin,win,dlbust,bust,20,0,19,210,0.466666667,0.023809524,0.604761905,3,0.915293335
27744,119,24625,7,6,0,0,0,13,3,5,10,0,0,18,nowin,loss,beat,dlwin,0,10,13,190,0.405263158,0.068421053,0.515789474,0,0.011837158
27745,94,24625,10,10,0,0,0,20,3,5,10,0,0,18,nowin,win,plwin,beat,20,0,20,183,0.43715847,0.043715847,0.540983607,1,0.290866892
27746,51,24625,7,8,0,0,0,15,3,5,10,0,0,18,nowin,loss,beat,dlwin,0,10,15,189,0.529100529,0.068783069,0.608465608,3,0.993665715
27747,43,24625,7,10,0,0,0,17,3,5,10,0,0,18,nowin,loss,beat,dlwin,0,10,17,192,0.40625,0.041666667,0.609375,2,0.576671372
27748,49,24625,11,5,1,0,0,17,3,5,10,0,0,18,nowin,loss,beat,dlwin,0,10,16,207,0.396135266,0.053140097,0.594202899,0,0.028306925
27749,69,24625,5,2,10,0,0,17,3,5,10,0,0,18,nowin,loss,beat,dlwin,0,10,7,194,0.365979381,0.030927835,0.515463918,0,0
27750,148,24626,10,2,0,0,0,12,4,9,4,0,0,17,nowin,loss,beat,dlwin,0,10,12,204,0.401960784,0.078431373,0.593137255,0,0.029789521
27751,85,24626,2,6,11,0,0,19,4,9,4,0,0,17,nowin,win,plwin,beat,20,0,8,195,0.41025641,0.066666667,0.594871795,0,0.03269711
27752,135,24626,7,10,0,0,0,17,4,9,4,0,0,17,nowin,push,push,push,10,0,17,179,0.391061453,0.067039106,0.586592179,0,0.024924662
27753,66,24626,9,10,0,0,0,19,4,9,4,0,0,17,nowin,win,plwin,beat,20,0,19,217,0.456221198,0.064516129,0.626728111,3,0.924304367
27754,54,24626,10,8,0,0,0,18,4,9,4,0,0,17,nowin,win,plwin,beat,20,0,18,185,0.437837838,0.032432432,0.556756757,1,0.29899854
27755,122,24626,2,10,0,0,0,12,4,9,4,0,0,17,nowin,loss,beat,dlwin,0,10,12,210,0.347619048,0.052380952,0.59047619,0,0.012873677
27756,47,24627,10,11,0,0,0,21,8,6,6,0,0,20,win,win,plwin,beat,25,0,21,210,0.438095238,0.057142857,0.623809524,2,0.615868808
27757,43,24627,2,10,0,7,0,19,8,6,6,0,0,20,nowin,loss,beat,dlwin,0,10,12,192,0.40625,0.041666667,0.609375,2,0.576671372
27758,51,24627,4,10,0,7,0,21,8,6,6,0,0,20,nowin,win,plwin,beat,20,0,14,189,0.529100529,0.068783069,0.608465608,3,0.993665715
27759,140,24627,4,10,0,5,0,19,8,6,6,0,0,20,nowin,loss,beat,dlwin,0,10,14,210,0.466666667,0.023809524,0.604761905,3,0.915293335
27760,17,24627,5,7,0,8,0,20,8,6,6,0,0,20,nowin,push,push,push,10,0,12,171,0.444444444,0.070175439,0.555555556,1,0.302364894
27761,140,24627,2,10,0,7,0,19,8,6,6,0,0,20,nowin,loss,beat,dlwin,0,10,12,210,0.466666667,0.023809524,0.604761905,3,0.915293335
27762,52,24628,10,10,0,0,0,20,10,8,0,0,0,18,nowin,win,plwin,beat,20,0,20,217,0.414746544,0.02764977,0.599078341,2,0.576736024
27763,47,24628,10,10,0,0,0,20,10,8,0,0,0,18,nowin,win,plwin,beat,20,0,20,210,0.438095238,0.057142857,0.623809524,2,0.615868808
27764,91,24628,10,9,0,0,0,19,10,8,0,0,0,18,nowin,win,plwin,beat,20,0,19,194,0.417525773,0.046391753,0.515463918,1,0.266616552
27765,144,24628,11,5,2,0,0,18,10,8,0,0,0,18,nowin,push,push,push,10,0,16,202,0.386138614,0.054455446,0.564356436,0,0.018006244
27766,66,24628,11,3,7,0,0,21,10,8,0,0,0,18,nowin,win,plwin,beat,20,0,14,217,0.456221198,0.064516129,0.626728111,3,0.924304367
27767,118,24628,4,9,0,10,0,23,10,8,0,0,0,18,nowin,loss,bust,plbust,0,10,13,216,0.393518519,0.037037037,0.555555556,0,0.018059873
27768,122,24629,4,10,0,6,0,20,7,6,10,0,0,23,nowin,win,dlbust,bust,20,0,14,210,0.347619048,0.052380952,0.59047619,0,0.012873677
27769,94,24629,2,11,7,0,0,20,7,6,10,0,0,23,nowin,win,dlbust,bust,20,0,13,183,0.43715847,0.043715847,0.540983607,1,0.290866892
27770,97,24629,7,10,0,0,0,17,7,6,10,0,0,23,nowin,win,dlbust,bust,20,0,17,182,0.450549451,0.06043956,0.692307692,2,0.677372279
27771,104,24629,3,2,6,10,0,21,7,6,10,0,0,23,nowin,win,dlbust,bust,20,0,5,209,0.363636364,0.052631579,0.593301435,0,0.018359419
27772,57,24629,7,11,0,0,0,18,7,6,10,0,0,23,nowin,win,dlbust,bust,20,0,18,192,0.46875,0.052083333,0.59375,3,0.907001181
27773,1,24629,8,11,0,0,0,19,7,6,10,0,0,23,nowin,win,dlbust,bust,20,0,19,197,0.406091371,0.025380711,0.649746193,2,0.606186955
27774,71,24630,11,10,0,0,0,21,6,2,3,4,9,24,win,win,dlbust,bust,25,0,21,193,0.352331606,0.046632124,0.585492228,0,0.013063661
27775,64,24630,5,7,0,0,0,12,6,2,3,4,9,24,nowin,win,dlbust,bust,20,0,12,187,0.363636364,0.048128342,0.631016043,0,0.027594885
27776,66,24630,10,10,0,0,0,20,6,2,3,4,9,24,nowin,win,dlbust,bust,20,0,20,217,0.456221198,0.064516129,0.626728111,3,0.924304367
27777,82,24630,9,9,0,0,0,18,6,2,3,4,9,24,nowin,win,dlbust,bust,20,0,18,225,0.408888889,0.075555556,0.577777778,0,0.028101874
27778,110,24630,10,3,0,0,0,13,6,2,3,4,9,24,nowin,win,dlbust,bust,20,0,13,192,0.416666667,0.046875,0.557291667,0,0.025413132
27779,11,24630,10,11,0,0,0,21,6,2,3,4,9,24,win,win,dlbust,bust,25,0,21,236,0.457627119,0.016949153,0.588983051,3,0.889015813
27780,78,24631,8,2,10,0,0,20,9,10,0,0,0,19,nowin,win,plwin,beat,20,0,10,201,0.517412935,0.034825871,0.587064677,3,0.95871112
27781,121,24631,8,3,10,0,0,21,9,10,0,0,0,19,nowin,win,plwin,beat,20,0,11,195,0.456410256,0.025641026,0.512820513,1,0.288597791
27782,112,24631,5,8,0,10,0,23,9,10,0,0,0,19,nowin,loss,bust,plbust,0,10,13,203,0.448275862,0.054187192,0.600985222,3,0.889576933
27783,69,24631,6,2,10,0,0,18,9,10,0,0,0,19,nowin,loss,beat,dlwin,0,10,8,194,0.365979381,0.030927835,0.515463918,0,0
27784,110,24631,10,8,0,0,0,18,9,10,0,0,0,19,nowin,loss,beat,dlwin,0,10,18,192,0.416666667,0.046875,0.557291667,0,0.025413132
27785,31,24631,7,6,0,2,10,25,9,10,0,0,0,19,nowin,loss,bust,plbust,0,10,13,188,0.473404255,0.058510638,0.515957447,1,0.300306557
27786,37,24632,5,5,10,0,0,20,6,10,5,0,0,21,nowin,loss,beat,dlwin,0,10,10,208,0.394230769,0.038461538,0.581730769,0,0.024682772
27787,56,24632,7,7,0,0,0,14,6,10,5,0,0,21,nowin,loss,beat,dlwin,0,10,14,175,0.4,0.057142857,0.582857143,0,0.026685297
27788,82,24632,10,10,0,0,0,20,6,10,5,0,0,21,nowin,loss,beat,dlwin,0,10,20,225,0.408888889,0.075555556,0.577777778,0,0.028101874
27789,13,24632,10,2,0,0,0,12,6,10,5,0,0,21,nowin,loss,beat,dlwin,0,10,12,206,0.417475728,0.063106796,0.621359223,2,0.59555479
27790,127,24632,7,11,0,0,0,18,6,10,5,0,0,21,nowin,loss,beat,dlwin,0,10,18,201,0.402985075,0.029850746,0.60199005,0,0.032263937
27791,24,24632,5,3,11,0,0,19,6,10,5,0,0,21,nowin,loss,beat,dlwin,0,10,8,207,0.458937198,0.048309179,0.570048309,1,0.318138014
27792,57,24633,10,10,0,0,0,20,10,10,0,0,0,20,nowin,push,push,push,10,0,20,192,0.46875,0.052083333,0.59375,3,0.907001181
27793,67,24633,10,10,0,0,0,20,10,10,0,0,0,20,nowin,push,push,push,10,0,20,195,0.369230769,0.041025641,0.569230769,0,0.014139427
27794,124,24633,11,7,0,0,0,18,10,10,0,0,0,20,nowin,loss,beat,dlwin,0,10,18,202,0.47029703,0.064356436,0.584158416,3,0.899458193
27795,68,24633,10,10,0,0,0,20,10,10,0,0,0,20,nowin,push,push,push,10,0,20,205,0.434146341,0.029268293,0.6,2,0.59483189
27796,133,24633,10,2,0,4,7,23,10,10,0,0,0,20,nowin,loss,bust,plbust,0,10,12,201,0.47761194,0.064676617,0.611940299,3,0.935428111
27797,116,24633,10,3,0,5,0,18,10,10,0,0,0,20,nowin,loss,beat,dlwin,0,10,13,195,0.425641026,0.056410256,0.538461538,1,0.28273747
27798,106,24634,8,2,10,0,0,20,3,10,7,0,0,20,nowin,push,push,push,10,0,10,192,0.411458333,0.026041667,0.557291667,0,0.023854304
27799,95,24634,10,8,0,0,0,18,3,10,7,0,0,20,nowin,loss,beat,dlwin,0,10,18,218,0.412844037,0.04587156,0.559633028,0,0.024842385
27800,69,24634,11,1,7,0,0,19,3,10,7,0,0,20,nowin,loss,beat,dlwin,0,10,12,194,0.365979381,0.030927835,0.515463918,0,0
27801,146,24634,2,10,0,5,0,17,3,10,7,0,0,20,nowin,loss,beat,dlwin,0,10,12,221,0.43438914,0.040723982,0.542986425,1,0.290190091
27802,137,24634,10,4,0,0,0,14,3,10,7,0,0,20,nowin,loss,beat,dlwin,0,10,14,194,0.417525773,0.046391753,0.536082474,1,0.276714602
27803,107,24634,5,10,0,0,0,15,3,10,7,0,0,20,nowin,loss,beat,dlwin,0,10,15,218,0.444954128,0.073394495,0.600917431,2,0.605210014
27804,17,24635,7,5,0,10,0,22,10,9,0,0,0,19,nowin,loss,bust,plbust,0,10,12,171,0.444444444,0.070175439,0.555555556,1,0.302364894
27805,20,24635,4,10,0,10,0,24,10,9,0,0,0,19,nowin,loss,bust,plbust,0,10,14,186,0.456989247,0.037634409,0.537634409,1,0.301097108
27806,132,24635,4,2,9,6,0,21,10,9,0,0,0,19,nowin,win,plwin,beat,20,0,6,194,0.412371134,0.036082474,0.649484536,2,0.611633238
27807,45,24635,6,1,9,10,0,26,10,9,0,0,0,19,nowin,loss,bust,plbust,0,10,7,196,0.428571429,0.051020408,0.612244898,2,0.598821767
27808,41,24635,9,8,0,0,0,17,10,9,0,0,0,19,nowin,loss,beat,dlwin,0,10,17,192,0.364583333,0.036458333,0.520833333,0,0.00089702
27809,47,24635,6,5,10,0,0,21,10,9,0,0,0,19,nowin,win,plwin,beat,20,0,11,210,0.438095238,0.057142857,0.623809524,2,0.615868808
27810,15,24636,8,10,0,0,0,18,2,10,4,7,0,23,nowin,win,dlbust,bust,20,0,18,212,0.410377358,0.051886792,0.561320755,0,0.024517408
27811,125,24636,10,5,0,0,0,15,2,10,4,7,0,23,nowin,win,dlbust,bust,20,0,15,219,0.438356164,0.050228311,0.575342466,1,0.308411257
27812,31,24636,3,4,4,10,0,21,2,10,4,7,0,23,nowin,win,dlbust,bust,20,0,7,188,0.473404255,0.058510638,0.515957447,1,0.300306557
27813,19,24636,10,7,0,0,0,17,2,10,4,7,0,23,nowin,win,dlbust,bust,20,0,17,237,0.41350211,0.054852321,0.628691983,2,0.597373826
27814,107,24636,11,3,4,0,0,18,2,10,4,7,0,23,nowin,win,dlbust,bust,20,0,14,218,0.444954128,0.073394495,0.600917431,2,0.605210014
27815,22,24636,10,10,0,0,0,20,2,10,4,7,0,23,nowin,win,dlbust,bust,20,0,20,187,0.481283422,0.042780749,0.577540107,3,0.906128176
27816,95,24637,10,11,0,0,0,21,10,10,0,0,0,20,win,win,plwin,beat,25,0,21,218,0.412844037,0.04587156,0.559633028,0,0.024842385
27817,8,24637,7,10,0,0,0,17,10,10,0,0,0,20,nowin,loss,beat,dlwin,0,10,17,181,0.44198895,0.071823204,0.596685083,2,0.599438402
27818,45,24637,10,3,0,3,7,23,10,10,0,0,0,20,nowin,loss,bust,plbust,0,10,13,196,0.428571429,0.051020408,0.612244898,2,0.598821767
27819,28,24637,3,6,4,9,0,22,10,10,0,0,0,20,nowin,loss,bust,plbust,0,10,9,199,0.422110553,0.045226131,0.542713568,1,0.282706618
27820,9,24637,7,8,0,1,10,26,10,10,0,0,0,20,nowin,loss,bust,plbust,0,10,15,194,0.37628866,0.015463918,0.541237113,0,0.009396796
27821,96,24637,10,10,0,0,0,20,10,10,0,0,0,20,nowin,push,push,push,10,0,20,190,0.468421053,0.057894737,0.584210526,3,0.897263354
27822,47,24638,3,10,0,0,0,13,3,10,5,0,0,18,nowin,loss,beat,dlwin,0,10,13,210,0.438095238,0.057142857,0.623809524,2,0.615868808
27823,42,24638,10,4,0,0,0,14,3,10,5,0,0,18,nowin,loss,beat,dlwin,0,10,14,212,0.443396226,0.051886792,0.570754717,1,0.309181312
27824,111,24638,3,3,2,10,0,18,3,10,5,0,0,18,nowin,push,push,push,10,0,6,180,0.433333333,0.055555556,0.611111111,2,0.602264492
27825,132,24638,6,1,5,10,0,22,3,10,5,0,0,18,nowin,loss,bust,plbust,0,10,7,194,0.412371134,0.036082474,0.649484536,2,0.611633238
27826,143,24638,8,3,10,0,0,21,3,10,5,0,0,18,nowin,win,plwin,beat,20,0,11,203,0.463054187,0.044334975,0.57635468,3,0.883143365
27827,129,24638,5,8,0,0,0,13,3,10,5,0,0,18,nowin,loss,beat,dlwin,0,10,13,201,0.422885572,0.064676617,0.55721393,0,0.027255383
27828,24,24639,5,7,0,8,0,20,9,3,2,10,0,24,nowin,win,dlbust,bust,20,0,12,207,0.458937198,0.048309179,0.570048309,1,0.318138014
27829,79,24639,6,10,0,5,0,21,9,3,2,10,0,24,nowin,win,dlbust,bust,20,0,16,211,0.436018957,0.028436019,0.672985782,2,0.650131054
27830,103,24639,10,2,0,7,0,19,9,3,2,10,0,24,nowin,win,dlbust,bust,20,0,12,203,0.379310345,0.064039409,0.551724138,0,0.012869209
27831,121,24639,2,2,11,3,0,18,9,3,2,10,0,24,nowin,win,dlbust,bust,20,0,4,195,0.456410256,0.025641026,0.512820513,1,0.288597791
27832,65,24639,4,7,10,0,0,21,9,3,2,10,0,24,nowin,win,dlbust,bust,20,0,11,203,0.492610837,0.054187192,0.571428571,3,0.913702814
27833,32,24639,10,8,0,0,0,18,9,3,2,10,0,24,nowin,win,dlbust,bust,20,0,18,189,0.391534392,0.037037037,0.53968254,0,0.013579086
27834,108,24640,10,10,0,0,0,20,4,10,9,0,0,23,nowin,win,dlbust,bust,20,0,20,193,0.435233161,0.056994819,0.559585492,1,0.298824795
27835,31,24640,10,10,0,0,0,20,4,10,9,0,0,23,nowin,win,dlbust,bust,20,0,20,188,0.473404255,0.058510638,0.515957447,1,0.300306557
27836,84,24640,10,8,0,0,0,18,4,10,9,0,0,23,nowin,win,dlbust,bust,20,0,18,195,0.379487179,0.056410256,0.569230769,0,0.017209119
27837,76,24640,4,8,0,0,0,12,4,10,9,0,0,23,nowin,win,dlbust,bust,20,0,12,189,0.534391534,0.079365079,0.608465608,3,1
27838,74,24640,5,1,9,0,0,15,4,10,9,0,0,23,nowin,win,dlbust,bust,20,0,6,209,0.411483254,0.04784689,0.531100478,0,0.017448125
27839,65,24640,10,2,0,0,0,12,4,10,9,0,0,23,nowin,win,dlbust,bust,20,0,12,203,0.492610837,0.054187192,0.571428571,3,0.913702814
27840,19,24641,10,7,0,0,0,17,3,7,10,0,0,20,nowin,loss,beat,dlwin,0,10,17,237,0.41350211,0.054852321,0.628691983,2,0.597373826
27841,46,24641,10,11,0,0,0,21,3,7,10,0,0,20,win,win,plwin,beat,25,0,21,186,0.403225806,0.048387097,0.591397849,0,0.029742194
27842,147,24641,10,2,0,10,0,22,3,7,10,0,0,20,nowin,loss,bust,plbust,0,10,12,205,0.380487805,0.014634146,0.536585366,0,0.00951447
27843,68,24641,9,10,0,0,0,19,3,7,10,0,0,20,nowin,loss,beat,dlwin,0,10,19,205,0.434146341,0.029268293,0.6,2,0.59483189
27844,118,24641,10,10,0,0,0,20,3,7,10,0,0,20,nowin,push,push,push,10,0,20,216,0.393518519,0.037037037,0.555555556,0,0.018059873
27845,67,24641,10,7,0,0,0,17,3,7,10,0,0,20,nowin,loss,beat,dlwin,0,10,17,195,0.369230769,0.041025641,0.569230769,0,0.014139427
27846,58,24642,3,10,0,5,0,18,10,8,0,0,0,18,nowin,push,push,push,10,0,13,195,0.430769231,0.041025641,0.584615385,2,0.580497586
27847,93,24642,10,10,0,0,0,20,10,8,0,0,0,18,nowin,win,plwin,beat,20,0,20,175,0.485714286,0.051428571,0.548571429,1,0.323648091
27848,89,24642,10,11,0,0,0,21,10,8,0,0,0,18,win,win,plwin,beat,25,0,21,212,0.537735849,0.047169811,0.594339623,3,0.990167191
27849,88,24642,10,9,0,0,0,19,10,8,0,0,0,18,nowin,win,plwin,beat,20,0,19,206,0.466019417,0.033980583,0.54368932,1,0.309467903
27850,23,24642,10,8,0,0,0,18,10,8,0,0,0,18,nowin,push,push,push,10,0,18,208,0.427884615,0.0625,0.552884615,1,0.29114424
27851,142,24642,3,3,9,5,0,20,10,8,0,0,0,18,nowin,win,plwin,beat,20,0,6,211,0.417061611,0.047393365,0.526066351,1,0.271531309
27852,30,24643,8,8,0,5,0,21,10,10,0,0,0,20,nowin,win,plwin,beat,20,0,16,206,0.393203883,0.033980583,0.601941748,0,0.029324648
27853,81,24643,10,10,0,0,0,20,10,10,0,0,0,20,nowin,push,push,push,10,0,20,182,0.395604396,0.043956044,0.60989011,2,0.567491261
27854,32,24643,5,10,0,2,0,17,10,10,0,0,0,20,nowin,loss,beat,dlwin,0,10,15,189,0.391534392,0.037037037,0.53968254,0,0.013579086
27855,36,24643,10,3,0,4,0,17,10,10,0,0,0,20,nowin,loss,beat,dlwin,0,10,13,229,0.445414847,0.056768559,0.655021834,2,0.645370571
27856,62,24643,10,10,0,0,0,20,10,10,0,0,0,20,nowin,push,push,push,10,0,20,178,0.370786517,0.028089888,0.54494382,0,0.008657722
27857,81,24643,5,3,7,4,0,19,10,10,0,0,0,20,nowin,loss,beat,dlwin,0,10,8,182,0.395604396,0.043956044,0.60989011,2,0.567491261
27858,18,24644,8,10,0,0,0,18,3,10,1,4,0,18,nowin,push,push,push,10,0,18,182,0.461538462,0.043956044,0.587912088,3,0.892649374
27859,41,24644,4,10,0,0,0,14,3,10,1,4,0,18,nowin,loss,beat,dlwin,0,10,14,192,0.364583333,0.036458333,0.520833333,0,0.00089702
27860,129,24644,9,7,0,0,0,16,3,10,1,4,0,18,nowin,loss,beat,dlwin,0,10,16,201,0.422885572,0.064676617,0.55721393,0,0.027255383
27861,99,24644,11,10,0,0,0,21,3,10,1,4,0,18,win,win,plwin,beat,25,0,21,207,0.47826087,0.062801932,0.637681159,3,0.961418446
27862,86,24644,10,3,0,0,0,13,3,10,1,4,0,18,nowin,loss,beat,dlwin,0,10,13,196,0.454081633,0.040816327,0.591836735,3,0.887566443
27863,89,24644,10,2,0,9,0,21,3,10,1,4,0,18,nowin,win,plwin,beat,20,0,12,212,0.537735849,0.047169811,0.594339623,3,0.990167191
27864,109,24645,10,10,0,0,0,20,9,10,0,0,0,19,nowin,win,plwin,beat,20,0,20,221,0.461538462,0.058823529,0.597285068,3,0.901830309
27865,13,24645,8,10,0,0,0,18,9,10,0,0,0,19,nowin,loss,beat,dlwin,0,10,18,206,0.417475728,0.063106796,0.621359223,2,0.59555479
27866,134,24645,6,10,0,2,0,18,9,10,0,0,0,19,nowin,loss,beat,dlwin,0,10,16,185,0.443243243,0.021621622,0.545945946,1,0.296939509
27867,52,24645,9,6,0,10,0,25,9,10,0,0,0,19,nowin,loss,bust,plbust,0,10,15,217,0.414746544,0.02764977,0.599078341,2,0.576736024
27868,112,24645,3,5,10,0,0,18,9,10,0,0,0,19,nowin,loss,beat,dlwin,0,10,8,203,0.448275862,0.054187192,0.600985222,3,0.889576933
27869,85,24645,7,9,0,2,0,18,9,10,0,0,0,19,nowin,loss,beat,dlwin,0,10,16,195,0.41025641,0.066666667,0.594871795,0,0.03269711
27870,46,24646,7,2,11,0,0,20,2,10,10,0,0,22,nowin,win,dlbust,bust,20,0,9,186,0.403225806,0.048387097,0.591397849,0,0.029742194
27871,19,24646,10,5,0,0,0,15,2,10,10,0,0,22,nowin,win,dlbust,bust,20,0,15,237,0.41350211,0.054852321,0.628691983,2,0.597373826
27872,112,24646,10,9,0,0,0,19,2,10,10,0,0,22,nowin,win,dlbust,bust,20,0,19,203,0.448275862,0.054187192,0.600985222,3,0.889576933
27873,52,24646,10,7,0,0,0,17,2,10,10,0,0,22,nowin,win,dlbust,bust,20,0,17,217,0.414746544,0.02764977,0.599078341,2,0.576736024
27874,134,24646,5,7,0,4,0,16,2,10,10,0,0,22,nowin,win,dlbust,bust,20,0,12,185,0.443243243,0.021621622,0.545945946,1,0.296939509
27875,94,24646,5,10,0,0,0,15,2,10,10,0,0,22,nowin,win,dlbust,bust,20,0,15,183,0.43715847,0.043715847,0.540983607,1,0.290866892
27876,13,24647,5,10,0,0,0,15,6,2,7,10,0,25,nowin,win,dlbust,bust,20,0,15,206,0.417475728,0.063106796,0.621359223,2,0.59555479
27877,71,24647,2,10,0,0,0,12,6,2,7,10,0,25,nowin,win,dlbust,bust,20,0,12,193,0.352331606,0.046632124,0.585492228,0,0.013063661
27878,66,24647,9,5,0,0,0,14,6,2,7,10,0,25,nowin,win,dlbust,bust,20,0,14,217,0.456221198,0.064516129,0.626728111,3,0.924304367
27879,134,24647,3,9,0,0,0,12,6,2,7,10,0,25,nowin,win,dlbust,bust,20,0,12,185,0.443243243,0.021621622,0.545945946,1,0.296939509
27880,74,24647,9,10,0,0,0,19,6,2,7,10,0,25,nowin,win,dlbust,bust,20,0,19,209,0.411483254,0.04784689,0.531100478,0,0.017448125
27881,51,24647,8,9,0,0,0,17,6,2,7,10,0,25,nowin,win,dlbust,bust,20,0,17,189,0.529100529,0.068783069,0.608465608,3,0.993665715
27882,57,24648,7,5,0,1,9,22,10,7,0,0,0,17,nowin,loss,bust,plbust,0,10,12,192,0.46875,0.052083333,0.59375,3,0.907001181
27883,78,24648,10,6,0,10,0,26,10,7,0,0,0,17,nowin,loss,bust,plbust,0,10,16,201,0.517412935,0.034825871,0.587064677,3,0.95871112
27884,25,24648,5,9,0,3,0,17,10,7,0,0,0,17,nowin,push,push,push,10,0,14,190,0.463157895,0.063157895,0.536842105,1,0.304401563
27885,136,24648,10,10,0,0,0,20,10,7,0,0,0,17,nowin,win,plwin,beat,20,0,20,194,0.396907216,0.025773196,0.597938144,0,0.029452644
27886,86,24648,10,6,0,8,0,24,10,7,0,0,0,17,nowin,loss,bust,plbust,0,10,16,196,0.454081633,0.040816327,0.591836735,3,0.887566443
27887,58,24648,10,4,0,10,0,24,10,7,0,0,0,17,nowin,loss,bust,plbust,0,10,14,195,0.430769231,0.041025641,0.584615385,2,0.580497586
27888,48,24649,11,5,3,0,0,19,10,7,0,0,0,17,nowin,win,plwin,beat,20,0,16,203,0.413793103,0.019704433,0.600985222,2,0.577280801
27889,118,24649,10,9,0,0,0,19,10,7,0,0,0,17,nowin,win,plwin,beat,20,0,19,216,0.393518519,0.037037037,0.555555556,0,0.018059873
27890,60,24649,4,10,0,10,0,24,10,7,0,0,0,17,nowin,loss,bust,plbust,0,10,14,227,0.418502203,0.022026432,0.559471366,0,0.026496258
27891,46,24649,4,6,11,0,0,21,10,7,0,0,0,17,nowin,win,plwin,beat,20,0,10,186,0.403225806,0.048387097,0.591397849,0,0.029742194
27892,21,24649,11,10,0,0,0,21,10,7,0,0,0,17,win,win,plwin,beat,25,0,21,214,0.359813084,0.042056075,0.626168224,0,0.025263474
27893,75,24649,5,10,0,3,0,18,10,7,0,0,0,17,nowin,win,plwin,beat,20,0,15,191,0.418848168,0.052356021,0.570680628,0,0.029344702
27894,112,24650,10,10,0,0,0,20,5,6,10,0,0,21,nowin,loss,beat,dlwin,0,10,20,203,0.448275862,0.054187192,0.600985222,3,0.889576933
27895,77,24650,6,10,0,0,0,16,5,6,10,0,0,21,nowin,loss,beat,dlwin,0,10,16,200,0.455,0.04,0.62,3,0.916252116
27896,13,24650,10,3,0,0,0,13,5,6,10,0,0,21,nowin,loss,beat,dlwin,0,10,13,206,0.417475728,0.063106796,0.621359223,2,0.59555479
27897,78,24650,2,10,0,0,0,12,5,6,10,0,0,21,nowin,loss,beat,dlwin,0,10,12,201,0.517412935,0.034825871,0.587064677,3,0.95871112
27898,4,24650,10,10,0,0,0,20,5,6,10,0,0,21,nowin,loss,beat,dlwin,0,10,20,217,0.460829493,0.036866359,0.562211982,1,0.315432839
27899,17,24650,10,5,0,0,0,15,5,6,10,0,0,21,nowin,loss,beat,dlwin,0,10,15,171,0.444444444,0.070175439,0.555555556,1,0.302364894
27900,106,24651,6,9,0,2,0,17,10,6,2,0,0,18,nowin,loss,beat,dlwin,0,10,15,192,0.411458333,0.026041667,0.557291667,0,0.023854304
27901,34,24651,10,10,0,0,0,20,10,6,2,0,0,18,nowin,win,plwin,beat,20,0,20,202,0.5,0.079207921,0.618811881,3,0.968961434
27902,26,24651,9,3,0,3,5,20,10,6,2,0,0,18,nowin,win,plwin,beat,20,0,12,203,0.463054187,0.0591133,0.541871921,1,0.306802864
27903,26,24651,6,7,0,7,0,20,10,6,2,0,0,18,nowin,win,plwin,beat,20,0,13,203,0.463054187,0.0591133,0.541871921,1,0.306802864
27904,90,24651,5,2,10,0,0,17,10,6,2,0,0,18,nowin,loss,beat,dlwin,0,10,7,201,0.447761194,0.049751244,0.60199005,3,0.889945023
27905,10,24651,10,10,0,0,0,20,10,6,2,0,0,18,nowin,win,plwin,beat,20,0,20,191,0.413612565,0.057591623,0.596858639,2,0.574087175
27906,23,24652,4,9,0,0,0,13,4,7,10,0,0,21,nowin,loss,beat,dlwin,0,10,13,208,0.427884615,0.0625,0.552884615,1,0.29114424
27907,4,24652,11,10,0,0,0,21,4,7,10,0,0,21,win,push,push,push,10,0,21,217,0.460829493,0.036866359,0.562211982,1,0.315432839
27908,65,24652,3,10,0,0,0,13,4,7,10,0,0,21,nowin,loss,beat,dlwin,0,10,13,203,0.492610837,0.054187192,0.571428571,3,0.913702814
27909,94,24652,10,11,0,0,0,21,4,7,10,0,0,21,win,push,push,push,10,0,21,183,0.43715847,0.043715847,0.540983607,1,0.290866892
27910,27,24652,8,10,0,0,0,18,4,7,10,0,0,21,nowin,loss,beat,dlwin,0,10,18,178,0.370786517,0.016853933,0.573033708,0,0.015536309
27911,122,24652,10,10,0,0,0,20,4,7,10,0,0,21,nowin,loss,beat,dlwin,0,10,20,210,0.347619048,0.052380952,0.59047619,0,0.012873677
27912,79,24653,9,10,0,0,0,19,3,9,4,3,0,19,nowin,push,push,push,10,0,19,211,0.436018957,0.028436019,0.672985782,2,0.650131054
27913,69,24653,9,10,0,0,0,19,3,9,4,3,0,19,nowin,push,push,push,10,0,19,194,0.365979381,0.030927835,0.515463918,0,0
27914,36,24653,5,10,0,0,0,15,3,9,4,3,0,19,nowin,loss,beat,dlwin,0,10,15,229,0.445414847,0.056768559,0.655021834,2,0.645370571
27915,19,24653,9,9,0,0,0,18,3,9,4,3,0,19,nowin,loss,beat,dlwin,0,10,18,237,0.41350211,0.054852321,0.628691983,2,0.597373826
27916,58,24653,10,7,0,0,0,17,3,9,4,3,0,19,nowin,loss,beat,dlwin,0,10,17,195,0.430769231,0.041025641,0.584615385,2,0.580497586
27917,57,24653,10,5,0,0,0,15,3,9,4,3,0,19,nowin,loss,beat,dlwin,0,10,15,192,0.46875,0.052083333,0.59375,3,0.907001181
27918,124,24654,8,10,0,0,0,18,10,10,0,0,0,20,nowin,loss,beat,dlwin,0,10,18,202,0.47029703,0.064356436,0.584158416,3,0.899458193
27919,133,24654,3,8,8,0,0,19,10,10,0,0,0,20,nowin,loss,beat,dlwin,0,10,11,201,0.47761194,0.064676617,0.611940299,3,0.935428111
27920,69,24654,10,3,0,8,0,21,10,10,0,0,0,20,nowin,win,plwin,beat,20,0,13,194,0.365979381,0.030927835,0.515463918,0,0
27921,140,24654,4,6,5,9,0,24,10,10,0,0,0,20,nowin,loss,bust,plbust,0,10,10,210,0.466666667,0.023809524,0.604761905,3,0.915293335
27922,19,24654,6,4,10,0,0,20,10,10,0,0,0,20,nowin,push,push,push,10,0,10,237,0.41350211,0.054852321,0.628691983,2,0.597373826
27923,117,24654,7,2,6,5,0,20,10,10,0,0,0,20,nowin,push,push,push,10,0,9,173,0.410404624,0.069364162,0.606936416,2,0.578610282
27924,57,24655,9,10,0,0,0,19,10,10,0,0,0,20,nowin,loss,beat,dlwin,0,10,19,192,0.46875,0.052083333,0.59375,3,0.907001181
27925,25,24655,10,6,0,4,0,20,10,10,0,0,0,20,nowin,push,push,push,10,0,16,190,0.463157895,0.063157895,0.536842105,1,0.304401563
27926,130,24655,10,8,0,0,0,18,10,10,0,0,0,20,nowin,loss,beat,dlwin,0,10,18,219,0.410958904,0.03652968,0.566210046,0,0.025888739
27927,149,24655,9,9,0,0,0,18,10,10,0,0,0,20,nowin,loss,beat,dlwin,0,10,18,225,0.457777778,0.057777778,0.648888889,2,0.651965595
27928,38,24655,9,10,0,0,0,19,10,10,0,0,0,20,nowin,loss,beat,dlwin,0,10,19,202,0.361386139,0.03960396,0.564356436,0,0.010597953
27929,106,24655,10,6,0,6,0,22,10,10,0,0,0,20,nowin,loss,bust,plbust,0,10,16,192,0.411458333,0.026041667,0.557291667,0,0.023854304
27930,24,24656,4,10,0,0,0,14,5,7,10,0,0,22,nowin,win,dlbust,bust,20,0,14,207,0.458937198,0.048309179,0.570048309,1,0.318138014
27931,129,24656,10,10,0,0,0,20,5,7,10,0,0,22,nowin,win,dlbust,bust,20,0,20,201,0.422885572,0.064676617,0.55721393,0,0.027255383
27932,43,24656,3,3,5,9,0,20,5,7,10,0,0,22,nowin,win,dlbust,bust,20,0,6,192,0.40625,0.041666667,0.609375,2,0.576671372
27933,51,24656,6,10,0,0,0,16,5,7,10,0,0,22,nowin,win,dlbust,bust,20,0,16,189,0.529100529,0.068783069,0.608465608,3,0.993665715
27934,71,24656,7,10,0,0,0,17,5,7,10,0,0,22,nowin,win,dlbust,bust,20,0,17,193,0.352331606,0.046632124,0.585492228,0,0.013063661
27935,146,24656,5,3,4,0,0,12,5,7,10,0,0,22,nowin,win,dlbust,bust,20,0,8,221,0.43438914,0.040723982,0.542986425,1,0.290190091
27936,111,24657,11,8,0,0,0,19,6,10,10,0,0,26,nowin,win,dlbust,bust,20,0,19,180,0.433333333,0.055555556,0.611111111,2,0.602264492
27937,56,24657,8,3,9,0,0,20,6,10,10,0,0,26,nowin,win,dlbust,bust,20,0,11,175,0.4,0.057142857,0.582857143,0,0.026685297
27938,90,24657,10,6,0,0,0,16,6,10,10,0,0,26,nowin,win,dlbust,bust,20,0,16,201,0.447761194,0.049751244,0.60199005,3,0.889945023
27939,144,24657,7,11,0,0,0,18,6,10,10,0,0,26,nowin,win,dlbust,bust,20,0,18,202,0.386138614,0.054455446,0.564356436,0,0.018006244
27940,146,24657,11,9,0,0,0,20,6,10,10,0,0,26,nowin,win,dlbust,bust,20,0,20,221,0.43438914,0.040723982,0.542986425,1,0.290190091
27941,11,24657,10,9,0,0,0,19,6,10,10,0,0,26,nowin,win,dlbust,bust,20,0,19,236,0.457627119,0.016949153,0.588983051,3,0.889015813
27942,91,24658,9,10,0,0,0,19,5,10,7,0,0,22,nowin,win,dlbust,bust,20,0,19,194,0.417525773,0.046391753,0.515463918,1,0.266616552
27943,82,24658,10,10,0,0,0,20,5,10,7,0,0,22,nowin,win,dlbust,bust,20,0,20,225,0.408888889,0.075555556,0.577777778,0,0.028101874
27944,81,24658,8,10,0,0,0,18,5,10,7,0,0,22,nowin,win,dlbust,bust,20,0,18,182,0.395604396,0.043956044,0.60989011,2,0.567491261
27945,83,24658,7,10,0,0,0,17,5,10,7,0,0,22,nowin,win,dlbust,bust,20,0,17,193,0.424870466,0.051813472,0.678756477,2,0.644360335
27946,42,24658,2,10,0,0,0,12,5,10,7,0,0,22,nowin,win,dlbust,bust,20,0,12,212,0.443396226,0.051886792,0.570754717,1,0.309181312
27947,18,24658,4,9,0,0,0,13,5,10,7,0,0,22,nowin,win,dlbust,bust,20,0,13,182,0.461538462,0.043956044,0.587912088,3,0.892649374
27948,43,24659,10,10,0,0,0,20,10,10,0,0,0,20,nowin,push,push,push,10,0,20,192,0.40625,0.041666667,0.609375,2,0.576671372
27949,49,24659,9,3,0,2,4,18,10,10,0,0,0,20,nowin,loss,beat,dlwin,0,10,12,207,0.396135266,0.053140097,0.594202899,0,0.028306925
27950,141,24659,9,11,0,0,0,20,10,10,0,0,0,20,nowin,push,push,push,10,0,20,202,0.420792079,0.074257426,0.564356436,0,0.028377851
27951,21,24659,5,10,0,3,0,18,10,10,0,0,0,20,nowin,loss,beat,dlwin,0,10,15,214,0.359813084,0.042056075,0.626168224,0,0.025263474
27952,145,24659,5,6,10,0,0,21,10,10,0,0,0,20,nowin,win,plwin,beat,20,0,11,188,0.441489362,0.031914894,0.622340426,2,0.617837093
27953,25,24659,3,5,10,0,0,18,10,10,0,0,0,20,nowin,loss,beat,dlwin,0,10,8,190,0.463157895,0.063157895,0.536842105,1,0.304401563
27954,112,24660,10,10,0,0,0,20,9,8,0,0,0,17,nowin,win,plwin,beat,20,0,20,203,0.448275862,0.054187192,0.600985222,3,0.889576933
27955,97,24660,3,10,0,10,0,23,9,8,0,0,0,17,nowin,loss,bust,plbust,0,10,13,182,0.450549451,0.06043956,0.692307692,2,0.677372279
27956,121,24660,3,11,2,7,0,23,9,8,0,0,0,17,nowin,loss,bust,plbust,0,10,14,195,0.456410256,0.025641026,0.512820513,1,0.288597791
27957,87,24660,10,10,0,0,0,20,9,8,0,0,0,17,nowin,win,plwin,beat,20,0,20,202,0.405940594,0.054455446,0.628712871,2,0.590599801
27958,2,24660,4,10,0,2,10,26,9,8,0,0,0,17,nowin,loss,bust,plbust,0,10,14,200,0.445,0.035,0.64,2,0.633962549
27959,64,24660,3,5,9,0,0,17,9,8,0,0,0,17,nowin,push,push,push,10,0,8,187,0.363636364,0.048128342,0.631016043,0,0.027594885
27960,101,24661,10,6,0,9,0,25,10,11,0,0,0,21,nowin,loss,bust,plbust,0,10,16,205,0.424390244,0.068292683,0.63902439,2,0.614740646
27961,150,24661,10,10,0,0,0,20,10,11,0,0,0,21,nowin,loss,beat,dlwin,0,10,20,192,0.401041667,0.036458333,0.567708333,0,0.023287458
27962,89,24661,5,1,6,3,7,22,10,11,0,0,0,21,nowin,loss,bust,plbust,0,10,6,212,0.537735849,0.047169811,0.594339623,3,0.990167191
27963,117,24661,10,4,0,5,0,19,10,11,0,0,0,21,nowin,loss,beat,dlwin,0,10,14,173,0.410404624,0.069364162,0.606936416,2,0.578610282
27964,15,24661,10,10,0,0,0,20,10,11,0,0,0,21,nowin,loss,beat,dlwin,0,10,20,212,0.410377358,0.051886792,0.561320755,0,0.024517408
27965,44,24661,10,2,0,10,0,22,10,11,0,0,0,21,nowin,loss,bust,plbust,0,10,12,219,0.433789954,0.050228311,0.534246575,1,0.285551035
27966,47,24662,7,4,10,0,0,21,8,10,0,0,0,18,nowin,win,plwin,beat,20,0,11,210,0.438095238,0.057142857,0.623809524,2,0.615868808
27967,47,24662,7,9,0,3,0,19,8,10,0,0,0,18,nowin,win,plwin,beat,20,0,16,210,0.438095238,0.057142857,0.623809524,2,0.615868808
27968,23,24662,3,10,0,3,7,23,8,10,0,0,0,18,nowin,loss,bust,plbust,0,10,13,208,0.427884615,0.0625,0.552884615,1,0.29114424
27969,52,24662,7,10,0,0,0,17,8,10,0,0,0,18,nowin,loss,beat,dlwin,0,10,17,217,0.414746544,0.02764977,0.599078341,2,0.576736024
27970,5,24662,2,10,0,6,0,18,8,10,0,0,0,18,nowin,push,push,push,10,0,12,203,0.42364532,0.02955665,0.596059113,2,0.582508076
27971,111,24662,2,4,8,1,10,25,8,10,0,0,0,18,nowin,loss,bust,plbust,0,10,6,180,0.433333333,0.055555556,0.611111111,2,0.602264492
27972,107,24663,8,4,0,6,0,18,10,10,0,0,0,20,nowin,loss,beat,dlwin,0,10,12,218,0.444954128,0.073394495,0.600917431,2,0.605210014
27973,8,24663,7,8,0,8,0,23,10,10,0,0,0,20,nowin,loss,bust,plbust,0,10,15,181,0.44198895,0.071823204,0.596685083,2,0.599438402
27974,7,24663,1,4,9,10,0,24,10,10,0,0,0,20,nowin,loss,bust,plbust,0,10,5,183,0.442622951,0.06010929,0.62295082,2,0.619303341
27975,43,24663,5,10,0,10,0,25,10,10,0,0,0,20,nowin,loss,bust,plbust,0,10,15,192,0.40625,0.041666667,0.609375,2,0.576671372
27976,74,24663,7,8,0,3,0,18,10,10,0,0,0,20,nowin,loss,beat,dlwin,0,10,15,209,0.411483254,0.04784689,0.531100478,0,0.017448125
27977,22,24663,10,8,0,0,0,18,10,10,0,0,0,20,nowin,loss,beat,dlwin,0,10,18,187,0.481283422,0.042780749,0.577540107,3,0.906128176
27978,128,24664,9,4,0,5,0,18,10,9,0,0,0,19,nowin,loss,beat,dlwin,0,10,13,227,0.356828194,0.052863436,0.577092511,0,0.012352564
27979,113,24664,10,6,0,10,0,26,10,9,0,0,0,19,nowin,loss,bust,plbust,0,10,16,199,0.407035176,0.055276382,0.668341709,2,0.620695264
27980,1,24664,10,7,0,0,0,17,10,9,0,0,0,19,nowin,loss,beat,dlwin,0,10,17,197,0.406091371,0.025380711,0.649746193,2,0.606186955
27981,101,24664,11,7,0,0,0,18,10,9,0,0,0,19,nowin,loss,beat,dlwin,0,10,18,205,0.424390244,0.068292683,0.63902439,2,0.614740646
27982,51,24664,11,4,2,0,0,17,10,9,0,0,0,19,nowin,loss,beat,dlwin,0,10,15,189,0.529100529,0.068783069,0.608465608,3,0.993665715
27983,140,24664,9,5,0,10,0,24,10,9,0,0,0,19,nowin,loss,bust,plbust,0,10,14,210,0.466666667,0.023809524,0.604761905,3,0.915293335
27984,144,24665,7,6,0,0,0,13,4,10,4,0,0,18,nowin,loss,beat,dlwin,0,10,13,202,0.386138614,0.054455446,0.564356436,0,0.018006244
27985,126,24665,4,9,0,0,0,13,4,10,4,0,0,18,nowin,loss,beat,dlwin,0,10,13,188,0.457446809,0.074468085,0.60106383,3,0.900633203
27986,15,24665,6,9,0,0,0,15,4,10,4,0,0,18,nowin,loss,beat,dlwin,0,10,15,212,0.410377358,0.051886792,0.561320755,0,0.024517408
27987,10,24665,4,8,0,0,0,12,4,10,4,0,0,18,nowin,loss,beat,dlwin,0,10,12,191,0.413612565,0.057591623,0.596858639,2,0.574087175
27988,73,24665,5,10,0,0,0,15,4,10,4,0,0,18,nowin,loss,beat,dlwin,0,10,15,181,0.375690608,0.011049724,0.596685083,0,0.022795773
27989,30,24665,10,4,0,0,0,14,4,10,4,0,0,18,nowin,loss,beat,dlwin,0,10,14,206,0.393203883,0.033980583,0.601941748,0,0.029324648
27990,74,24666,11,8,0,0,0,19,9,4,7,0,0,20,nowin,loss,beat,dlwin,0,10,19,209,0.411483254,0.04784689,0.531100478,0,0.017448125
27991,146,24666,10,2,0,3,7,22,9,4,7,0,0,20,nowin,loss,bust,plbust,0,10,12,221,0.43438914,0.040723982,0.542986425,1,0.290190091
27992,142,24666,4,10,0,4,0,18,9,4,7,0,0,20,nowin,loss,beat,dlwin,0,10,14,211,0.417061611,0.047393365,0.526066351,1,0.271531309
27993,149,24666,8,9,0,0,0,17,9,4,7,0,0,20,nowin,loss,beat,dlwin,0,10,17,225,0.457777778,0.057777778,0.648888889,2,0.651965595
27994,37,24666,6,1,5,10,0,22,9,4,7,0,0,20,nowin,loss,bust,plbust,0,10,7,208,0.394230769,0.038461538,0.581730769,0,0.024682772
27995,124,24666,2,11,6,0,0,19,9,4,7,0,0,20,nowin,loss,beat,dlwin,0,10,13,202,0.47029703,0.064356436,0.584158416,3,0.899458193
27996,19,24667,11,10,0,0,0,21,2,4,11,0,0,17,win,win,plwin,beat,25,0,21,237,0.41350211,0.054852321,0.628691983,2,0.597373826
27997,8,24667,10,10,0,0,0,20,2,4,11,0,0,17,nowin,win,plwin,beat,20,0,20,181,0.44198895,0.071823204,0.596685083,2,0.599438402
27998,149,24667,6,4,9,0,0,19,2,4,11,0,0,17,nowin,win,plwin,beat,20,0,10,225,0.457777778,0.057777778,0.648888889,2,0.651965595
27999,148,24667,10,3,0,0,0,13,2,4,11,0,0,17,nowin,loss,beat,dlwin,0,10,13,204,0.401960784,0.078431373,0.593137255,0,0.029789521
28000,50,24667,4,10,0,0,0,14,2,4,11,0,0,17,nowin,loss,beat,dlwin,0,10,14,202,0.405940594,0.04950495,0.54950495,0,0.020296079
28001,50,24667,4,8,0,10,0,22,2,4,11,0,0,17,nowin,loss,bust,plbust,0,10,12,202,0.405940594,0.04950495,0.54950495,0,0.020296079
28002,28,24668,10,5,0,3,0,18,10,5,2,0,0,17,nowin,win,plwin,beat,20,0,15,199,0.422110553,0.045226131,0.542713568,1,0.282706618
28003,91,24668,10,10,0,0,0,20,10,5,2,0,0,17,nowin,win,plwin,beat,20,0,20,194,0.417525773,0.046391753,0.515463918,1,0.266616552
28004,105,24668,10,3,0,3,4,20,10,5,2,0,0,17,nowin,win,plwin,beat,20,0,13,198,0.414141414,0.070707071,0.590909091,0,0.032889494
28005,63,24668,9,6,0,3,0,18,10,5,2,0,0,17,nowin,win,plwin,beat,20,0,15,216,0.467592593,0.037037037,0.62037037,3,0.931690496
28006,117,24668,6,7,0,10,0,23,10,5,2,0,0,17,nowin,loss,bust,plbust,0,10,13,173,0.410404624,0.069364162,0.606936416,2,0.578610282
28007,127,24668,10,11,0,0,0,21,10,5,2,0,0,17,win,win,plwin,beat,25,0,21,201,0.402985075,0.029850746,0.60199005,0,0.032263937
28008,9,24669,10,3,0,0,0,13,2,10,10,0,0,22,nowin,win,dlbust,bust,20,0,13,194,0.37628866,0.015463918,0.541237113,0,0.009396796
28009,124,24669,9,8,0,0,0,17,2,10,10,0,0,22,nowin,win,dlbust,bust,20,0,17,202,0.47029703,0.064356436,0.584158416,3,0.899458193
28010,42,24669,11,10,0,0,0,21,2,10,10,0,0,22,win,win,dlbust,bust,25,0,21,212,0.443396226,0.051886792,0.570754717,1,0.309181312
28011,80,24669,10,2,0,10,0,22,2,10,10,0,0,22,nowin,loss,bust,plbust,0,10,12,186,0.419354839,0.059139785,0.623655914,2,0.59892924
28012,32,24669,10,9,0,0,0,19,2,10,10,0,0,22,nowin,win,dlbust,bust,20,0,19,189,0.391534392,0.037037037,0.53968254,0,0.013579086
28013,7,24669,7,10,0,0,0,17,2,10,10,0,0,22,nowin,win,dlbust,bust,20,0,17,183,0.442622951,0.06010929,0.62295082,2,0.619303341
28014,80,24670,10,10,0,0,0,20,9,10,0,0,0,19,nowin,win,plwin,beat,20,0,20,186,0.419354839,0.059139785,0.623655914,2,0.59892924
28015,50,24670,10,6,0,2,0,18,9,10,0,0,0,19,nowin,loss,beat,dlwin,0,10,16,202,0.405940594,0.04950495,0.54950495,0,0.020296079
28016,123,24670,4,2,7,7,0,20,9,10,0,0,0,19,nowin,win,plwin,beat,20,0,6,205,0.43902439,0.034146341,0.614634146,2,0.609962544
28017,82,24670,1,6,10,0,0,17,9,10,0,0,0,19,nowin,loss,beat,dlwin,0,10,7,225,0.408888889,0.075555556,0.577777778,0,0.028101874
28018,44,24670,5,10,0,10,0,25,9,10,0,0,0,19,nowin,loss,bust,plbust,0,10,15,219,0.433789954,0.050228311,0.534246575,1,0.285551035
28019,49,24670,10,6,0,10,0,26,9,10,0,0,0,19,nowin,loss,bust,plbust,0,10,16,207,0.396135266,0.053140097,0.594202899,0,0.028306925
28020,100,24671,10,10,0,0,0,20,2,9,6,0,0,17,nowin,win,plwin,beat,20,0,20,190,0.452631579,0.036842105,0.594736842,3,0.888671154
28021,34,24671,9,10,0,0,0,19,2,9,6,0,0,17,nowin,win,plwin,beat,20,0,19,202,0.5,0.079207921,0.618811881,3,0.968961434
28022,111,24671,10,5,0,0,0,15,2,9,6,0,0,17,nowin,loss,beat,dlwin,0,10,15,180,0.433333333,0.055555556,0.611111111,2,0.602264492
28023,76,24671,10,10,0,0,0,20,2,9,6,0,0,17,nowin,win,plwin,beat,20,0,20,189,0.534391534,0.079365079,0.608465608,3,1
28024,96,24671,10,9,0,0,0,19,2,9,6,0,0,17,nowin,win,plwin,beat,20,0,19,190,0.468421053,0.057894737,0.584210526,3,0.897263354
28025,136,24671,7,9,0,0,0,16,2,9,6,0,0,17,nowin,loss,beat,dlwin,0,10,16,194,0.396907216,0.025773196,0.597938144,0,0.029452644
28026,139,24672,3,9,0,0,0,12,6,3,10,0,0,19,nowin,loss,beat,dlwin,0,10,12,192,0.380208333,0.036458333,0.59375,0,0.023429169
28027,66,24672,10,3,0,0,0,13,6,3,10,0,0,19,nowin,loss,beat,dlwin,0,10,13,217,0.456221198,0.064516129,0.626728111,3,0.924304367
28028,116,24672,6,11,2,0,0,19,6,3,10,0,0,19,nowin,push,push,push,10,0,17,195,0.425641026,0.056410256,0.538461538,1,0.28273747
28029,71,24672,8,11,0,0,0,19,6,3,10,0,0,19,nowin,push,push,push,10,0,19,193,0.352331606,0.046632124,0.585492228,0,0.013063661
28030,148,24672,5,3,11,0,0,19,6,3,10,0,0,19,nowin,push,push,push,10,0,8,204,0.401960784,0.078431373,0.593137255,0,0.029789521
28031,58,24672,10,10,0,0,0,20,6,3,10,0,0,19,nowin,win,plwin,beat,20,0,20,195,0.430769231,0.041025641,0.584615385,2,0.580497586
28032,45,24673,6,7,0,7,0,20,10,3,10,0,0,23,nowin,win,dlbust,bust,20,0,13,196,0.428571429,0.051020408,0.612244898,2,0.598821767
28033,37,24673,9,11,0,0,0,20,10,3,10,0,0,23,nowin,win,dlbust,bust,20,0,20,208,0.394230769,0.038461538,0.581730769,0,0.024682772
28034,138,24673,4,9,0,3,3,19,10,3,10,0,0,23,nowin,win,dlbust,bust,20,0,13,190,0.442105263,0.047368421,0.610526316,2,0.609711065
28035,1,24673,11,9,0,0,0,20,10,3,10,0,0,23,nowin,win,dlbust,bust,20,0,20,197,0.406091371,0.025380711,0.649746193,2,0.606186955
28036,128,24673,7,4,6,0,0,17,10,3,10,0,0,23,nowin,win,dlbust,bust,20,0,11,227,0.356828194,0.052863436,0.577092511,0,0.012352564
28037,149,24673,10,10,0,0,0,20,10,3,10,0,0,23,nowin,win,dlbust,bust,20,0,20,225,0.457777778,0.057777778,0.648888889,2,0.651965595
28038,124,24674,9,4,0,8,0,21,7,11,0,0,0,18,nowin,win,plwin,beat,20,0,13,202,0.47029703,0.064356436,0.584158416,3,0.899458193
28039,61,24674,10,7,0,0,0,17,7,11,0,0,0,18,nowin,loss,beat,dlwin,0,10,17,194,0.427835052,0.077319588,0.603092784,2,0.591437139
28040,23,24674,1,6,9,10,0,26,7,11,0,0,0,18,nowin,loss,bust,plbust,0,10,7,208,0.427884615,0.0625,0.552884615,1,0.29114424
28041,134,24674,2,9,2,8,0,21,7,11,0,0,0,18,nowin,win,plwin,beat,20,0,11,185,0.443243243,0.021621622,0.545945946,1,0.296939509
28042,34,24674,4,10,0,10,0,24,7,11,0,0,0,18,nowin,loss,bust,plbust,0,10,14,202,0.5,0.079207921,0.618811881,3,0.968961434
28043,147,24674,2,10,0,2,10,24,7,11,0,0,0,18,nowin,loss,bust,plbust,0,10,12,205,0.380487805,0.014634146,0.536585366,0,0.00951447
28044,10,24675,10,9,0,0,0,19,7,10,0,0,0,17,nowin,win,plwin,beat,20,0,19,191,0.413612565,0.057591623,0.596858639,2,0.574087175
28045,133,24675,5,2,8,2,0,17,7,10,0,0,0,17,nowin,push,push,push,10,0,7,201,0.47761194,0.064676617,0.611940299,3,0.935428111
28046,116,24675,11,8,0,0,0,19,7,10,0,0,0,17,nowin,win,plwin,beat,20,0,19,195,0.425641026,0.056410256,0.538461538,1,0.28273747
28047,54,24675,2,10,0,7,0,19,7,10,0,0,0,17,nowin,win,plwin,beat,20,0,12,185,0.437837838,0.032432432,0.556756757,1,0.29899854
28048,102,24675,6,10,0,9,0,25,7,10,0,0,0,17,nowin,loss,bust,plbust,0,10,16,192,0.338541667,0.046875,0.5625,0,0.003306118
28049,124,24675,3,7,10,0,0,20,7,10,0,0,0,17,nowin,win,plwin,beat,20,0,10,202,0.47029703,0.064356436,0.584158416,3,0.899458193
28050,24,24676,2,8,10,0,0,20,10,8,0,0,0,18,nowin,win,plwin,beat,20,0,10,207,0.458937198,0.048309179,0.570048309,1,0.318138014
28051,91,24676,5,8,0,2,7,22,10,8,0,0,0,18,nowin,loss,bust,plbust,0,10,13,194,0.417525773,0.046391753,0.515463918,1,0.266616552
28052,65,24676,10,10,0,0,0,20,10,8,0,0,0,18,nowin,win,plwin,beat,20,0,20,203,0.492610837,0.054187192,0.571428571,3,0.913702814
28053,63,24676,10,11,0,0,0,21,10,8,0,0,0,18,win,win,plwin,beat,25,0,21,216,0.467592593,0.037037037,0.62037037,3,0.931690496
28054,140,24676,9,2,2,6,0,19,10,8,0,0,0,18,nowin,win,plwin,beat,20,0,11,210,0.466666667,0.023809524,0.604761905,3,0.915293335
28055,61,24676,9,5,0,8,0,22,10,8,0,0,0,18,nowin,loss,bust,plbust,0,10,14,194,0.427835052,0.077319588,0.603092784,2,0.591437139
28056,26,24677,8,3,2,10,0,23,11,10,0,0,0,21,nowin,loss,bust,plbust,0,10,11,203,0.463054187,0.0591133,0.541871921,1,0.306802864
28057,149,24677,8,9,0,0,0,17,11,10,0,0,0,21,nowin,loss,beat,dlwin,0,10,17,225,0.457777778,0.057777778,0.648888889,2,0.651965595
28058,93,24677,10,10,0,0,0,20,11,10,0,0,0,21,nowin,loss,beat,dlwin,0,10,20,175,0.485714286,0.051428571,0.548571429,1,0.323648091
28059,47,24677,9,9,0,0,0,18,11,10,0,0,0,21,nowin,loss,beat,dlwin,0,10,18,210,0.438095238,0.057142857,0.623809524,2,0.615868808
28060,90,24677,10,2,0,10,0,22,11,10,0,0,0,21,nowin,loss,bust,plbust,0,10,12,201,0.447761194,0.049751244,0.60199005,3,0.889945023
28061,18,24677,10,2,0,4,10,26,11,10,0,0,0,21,nowin,loss,bust,plbust,0,10,12,182,0.461538462,0.043956044,0.587912088,3,0.892649374
28062,69,24678,10,10,0,0,0,20,9,10,0,0,0,19,nowin,win,plwin,beat,20,0,20,194,0.365979381,0.030927835,0.515463918,0,0
28063,20,24678,4,5,2,10,0,21,9,10,0,0,0,19,nowin,win,plwin,beat,20,0,9,186,0.456989247,0.037634409,0.537634409,1,0.301097108
28064,1,24678,10,10,0,0,0,20,9,10,0,0,0,19,nowin,win,plwin,beat,20,0,20,197,0.406091371,0.025380711,0.649746193,2,0.606186955
28065,11,24678,9,2,10,0,0,21,9,10,0,0,0,19,nowin,win,plwin,beat,20,0,11,236,0.457627119,0.016949153,0.588983051,3,0.889015813
28066,6,24678,10,2,0,5,0,17,9,10,0,0,0,19,nowin,loss,beat,dlwin,0,10,12,191,0.439790576,0.047120419,0.581151832,1,0.31211505
28067,53,24678,11,10,0,0,0,21,9,10,0,0,0,19,win,win,plwin,beat,25,0,21,250,0.372,0.064,0.564,0,0.013687345
28068,143,24679,5,8,0,10,0,23,10,8,0,0,0,18,nowin,loss,bust,plbust,0,10,13,203,0.463054187,0.044334975,0.57635468,3,0.883143365
28069,75,24679,10,10,0,0,0,20,10,8,0,0,0,18,nowin,win,plwin,beat,20,0,20,191,0.418848168,0.052356021,0.570680628,0,0.029344702
28070,72,24679,10,2,0,1,1,14,10,8,0,0,0,18,nowin,loss,beat,dlwin,0,10,12,185,0.394594595,0.032432432,0.508108108,0,0.006763115
28071,75,24679,9,8,0,0,0,17,10,8,0,0,0,18,nowin,loss,beat,dlwin,0,10,17,191,0.418848168,0.052356021,0.570680628,0,0.029344702
28072,118,24679,10,10,0,0,0,20,10,8,0,0,0,18,nowin,win,plwin,beat,20,0,20,216,0.393518519,0.037037037,0.555555556,0,0.018059873
28073,62,24679,3,2,5,1,10,21,10,8,0,0,0,18,nowin,win,plwin,beat,20,0,5,178,0.370786517,0.028089888,0.54494382,0,0.008657722
28074,89,24680,5,3,11,0,0,19,8,7,2,0,0,17,nowin,win,plwin,beat,20,0,8,212,0.537735849,0.047169811,0.594339623,3,0.990167191
28075,105,24680,6,10,0,4,0,20,8,7,2,0,0,17,nowin,win,plwin,beat,20,0,16,198,0.414141414,0.070707071,0.590909091,0,0.032889494
28076,110,24680,10,10,0,0,0,20,8,7,2,0,0,17,nowin,win,plwin,beat,20,0,20,192,0.416666667,0.046875,0.557291667,0,0.025413132
28077,2,24680,3,8,8,0,0,19,8,7,2,0,0,17,nowin,win,plwin,beat,20,0,11,200,0.445,0.035,0.64,2,0.633962549
28078,131,24680,5,11,3,0,0,19,8,7,2,0,0,17,nowin,win,plwin,beat,20,0,16,217,0.410138249,0.069124424,0.543778802,0,0.02015021
28079,88,24680,2,10,0,10,0,22,8,7,2,0,0,17,nowin,loss,bust,plbust,0,10,12,206,0.466019417,0.033980583,0.54368932,1,0.309467903
28080,39,24681,10,10,0,0,0,20,10,3,5,0,0,18,nowin,win,plwin,beat,20,0,20,191,0.429319372,0.062827225,0.57591623,0,0.033760763
28081,58,24681,2,5,10,0,0,17,10,3,5,0,0,18,nowin,loss,beat,dlwin,0,10,7,195,0.430769231,0.041025641,0.584615385,2,0.580497586
28082,137,24681,9,6,0,7,0,22,10,3,5,0,0,18,nowin,loss,bust,plbust,0,10,15,194,0.417525773,0.046391753,0.536082474,1,0.276714602
28083,69,24681,5,3,11,0,0,19,10,3,5,0,0,18,nowin,win,plwin,beat,20,0,8,194,0.365979381,0.030927835,0.515463918,0,0
28084,136,24681,10,7,0,0,0,17,10,3,5,0,0,18,nowin,loss,beat,dlwin,0,10,17,194,0.396907216,0.025773196,0.597938144,0,0.029452644
28085,125,24681,5,10,0,9,0,24,10,3,5,0,0,18,nowin,loss,bust,plbust,0,10,15,219,0.438356164,0.050228311,0.575342466,1,0.308411257
28086,42,24682,6,10,0,0,0,16,5,3,10,0,0,18,nowin,loss,beat,dlwin,0,10,16,212,0.443396226,0.051886792,0.570754717,1,0.309181312
28087,130,24682,2,2,11,0,0,15,5,3,10,0,0,18,nowin,loss,beat,dlwin,0,10,4,219,0.410958904,0.03652968,0.566210046,0,0.025888739
28088,14,24682,10,6,0,0,0,16,5,3,10,0,0,18,nowin,loss,beat,dlwin,0,10,16,202,0.391089109,0.01980198,0.628712871,2,0.577264877
28089,82,24682,5,10,0,0,0,15,5,3,10,0,0,18,nowin,loss,beat,dlwin,0,10,15,225,0.408888889,0.075555556,0.577777778,0,0.028101874
28090,85,24682,8,10,0,0,0,18,5,3,10,0,0,18,nowin,push,push,push,10,0,18,195,0.41025641,0.066666667,0.594871795,0,0.03269711
28091,115,24682,7,10,0,0,0,17,5,3,10,0,0,18,nowin,loss,beat,dlwin,0,10,17,194,0.427835052,0.041237113,0.592783505,2,0.583863602
28092,90,24683,7,10,0,0,0,17,10,10,0,0,0,20,nowin,loss,beat,dlwin,0,10,17,201,0.447761194,0.049751244,0.60199005,3,0.889945023
28093,68,24683,3,10,0,1,1,15,10,10,0,0,0,20,nowin,loss,beat,dlwin,0,10,13,205,0.434146341,0.029268293,0.6,2,0.59483189
28094,148,24683,4,2,8,10,0,24,10,10,0,0,0,20,nowin,loss,bust,plbust,0,10,6,204,0.401960784,0.078431373,0.593137255,0,0.029789521
28095,77,24683,3,10,0,9,0,22,10,10,0,0,0,20,nowin,loss,bust,plbust,0,10,13,200,0.455,0.04,0.62,3,0.916252116
28096,48,24683,2,8,8,0,0,18,10,10,0,0,0,20,nowin,loss,beat,dlwin,0,10,10,203,0.413793103,0.019704433,0.600985222,2,0.577280801
28097,108,24683,10,8,0,0,0,18,10,10,0,0,0,20,nowin,loss,beat,dlwin,0,10,18,193,0.435233161,0.056994819,0.559585492,1,0.298824795
28098,46,24684,10,10,0,0,0,20,7,6,7,0,0,20,nowin,push,push,push,10,0,20,186,0.403225806,0.048387097,0.591397849,0,0.029742194
28099,121,24684,10,9,0,0,0,19,7,6,7,0,0,20,nowin,loss,beat,dlwin,0,10,19,195,0.456410256,0.025641026,0.512820513,1,0.288597791
28100,94,24684,10,9,0,0,0,19,7,6,7,0,0,20,nowin,loss,beat,dlwin,0,10,19,183,0.43715847,0.043715847,0.540983607,1,0.290866892
28101,18,24684,8,11,0,0,0,19,7,6,7,0,0,20,nowin,loss,beat,dlwin,0,10,19,182,0.461538462,0.043956044,0.587912088,3,0.892649374
28102,88,24684,4,9,0,3,1,17,7,6,7,0,0,20,nowin,loss,beat,dlwin,0,10,13,206,0.466019417,0.033980583,0.54368932,1,0.309467903
28103,67,24684,7,8,0,10,0,25,7,6,7,0,0,20,nowin,loss,bust,plbust,0,10,15,195,0.369230769,0.041025641,0.569230769,0,0.014139427
28104,143,24685,10,10,0,0,0,20,10,11,0,0,0,21,nowin,loss,beat,dlwin,0,10,20,203,0.463054187,0.044334975,0.57635468,3,0.883143365
28105,1,24685,3,10,0,6,0,19,10,11,0,0,0,21,nowin,loss,beat,dlwin,0,10,13,197,0.406091371,0.025380711,0.649746193,2,0.606186955
28106,124,24685,2,10,0,10,0,22,10,11,0,0,0,21,nowin,loss,bust,plbust,0,10,12,202,0.47029703,0.064356436,0.584158416,3,0.899458193
28107,120,24685,4,9,0,5,0,18,10,11,0,0,0,21,nowin,loss,beat,dlwin,0,10,13,202,0.440594059,0.034653465,0.618811881,2,0.614441029
28108,101,24685,10,2,0,6,0,18,10,11,0,0,0,21,nowin,loss,beat,dlwin,0,10,12,205,0.424390244,0.068292683,0.63902439,2,0.614740646
28109,117,24685,2,5,2,10,0,19,10,11,0,0,0,21,nowin,loss,beat,dlwin,0,10,7,173,0.410404624,0.069364162,0.606936416,2,0.578610282
28110,107,24686,6,10,0,2,0,18,10,9,0,0,0,19,nowin,loss,beat,dlwin,0,10,16,218,0.444954128,0.073394495,0.600917431,2,0.605210014
28111,11,24686,10,10,0,0,0,20,10,9,0,0,0,19,nowin,win,plwin,beat,20,0,20,236,0.457627119,0.016949153,0.588983051,3,0.889015813
28112,129,24686,10,10,0,0,0,20,10,9,0,0,0,19,nowin,win,plwin,beat,20,0,20,201,0.422885572,0.064676617,0.55721393,0,0.027255383
28113,48,24686,3,4,9,9,0,25,10,9,0,0,0,19,nowin,loss,bust,plbust,0,10,7,203,0.413793103,0.019704433,0.600985222,2,0.577280801
28114,19,24686,10,6,0,5,0,21,10,9,0,0,0,19,nowin,win,plwin,beat,20,0,16,237,0.41350211,0.054852321,0.628691983,2,0.597373826
28115,6,24686,6,6,0,3,3,18,10,9,0,0,0,19,nowin,loss,beat,dlwin,0,10,12,191,0.439790576,0.047120419,0.581151832,1,0.31211505
28116,121,24687,3,5,10,0,0,18,10,5,2,0,0,17,nowin,win,plwin,beat,20,0,8,195,0.456410256,0.025641026,0.512820513,1,0.288597791
28117,83,24687,4,6,9,0,0,19,10,5,2,0,0,17,nowin,win,plwin,beat,20,0,10,193,0.424870466,0.051813472,0.678756477,2,0.644360335
28118,5,24687,1,4,9,3,0,17,10,5,2,0,0,17,nowin,push,push,push,10,0,5,203,0.42364532,0.02955665,0.596059113,2,0.582508076
28119,91,24687,3,10,0,1,10,24,10,5,2,0,0,17,nowin,loss,bust,plbust,0,10,13,194,0.417525773,0.046391753,0.515463918,1,0.266616552
28120,126,24687,9,3,0,4,7,23,10,5,2,0,0,17,nowin,loss,bust,plbust,0,10,12,188,0.457446809,0.074468085,0.60106383,3,0.900633203
28121,31,24687,10,5,0,10,0,25,10,5,2,0,0,17,nowin,loss,bust,plbust,0,10,15,188,0.473404255,0.058510638,0.515957447,1,0.300306557
28122,87,24688,11,4,4,0,0,19,2,10,6,0,0,18,nowin,win,plwin,beat,20,0,15,202,0.405940594,0.054455446,0.628712871,2,0.590599801
28123,109,24688,10,10,0,0,0,20,2,10,6,0,0,18,nowin,win,plwin,beat,20,0,20,221,0.461538462,0.058823529,0.597285068,3,0.901830309
28124,12,24688,10,10,0,0,0,20,2,10,6,0,0,18,nowin,win,plwin,beat,20,0,20,189,0.470899471,0.015873016,0.613756614,3,0.929171178
28125,42,24688,10,10,0,0,0,20,2,10,6,0,0,18,nowin,win,plwin,beat,20,0,20,212,0.443396226,0.051886792,0.570754717,1,0.309181312
28126,20,24688,7,11,0,0,0,18,2,10,6,0,0,18,nowin,push,push,push,10,0,18,186,0.456989247,0.037634409,0.537634409,1,0.301097108
28127,32,24688,10,6,0,0,0,16,2,10,6,0,0,18,nowin,loss,beat,dlwin,0,10,16,189,0.391534392,0.037037037,0.53968254,0,0.013579086
28128,53,24689,3,11,5,0,0,19,4,8,10,0,0,22,nowin,win,dlbust,bust,20,0,14,250,0.372,0.064,0.564,0,0.013687345
28129,81,24689,6,10,0,0,0,16,4,8,10,0,0,22,nowin,win,dlbust,bust,20,0,16,182,0.395604396,0.043956044,0.60989011,2,0.567491261
28130,1,24689,10,5,0,0,0,15,4,8,10,0,0,22,nowin,win,dlbust,bust,20,0,15,197,0.406091371,0.025380711,0.649746193,2,0.606186955
28131,28,24689,7,2,10,0,0,19,4,8,10,0,0,22,nowin,win,dlbust,bust,20,0,9,199,0.422110553,0.045226131,0.542713568,1,0.282706618
28132,35,24689,2,6,6,0,0,14,4,8,10,0,0,22,nowin,win,dlbust,bust,20,0,8,202,0.410891089,0.044554455,0.633663366,2,0.598681573
28133,142,24689,4,7,3,0,0,14,4,8,10,0,0,22,nowin,win,dlbust,bust,20,0,11,211,0.417061611,0.047393365,0.526066351,1,0.271531309
28134,5,24690,10,2,0,1,8,21,10,11,0,0,0,21,nowin,push,push,push,10,0,12,203,0.42364532,0.02955665,0.596059113,2,0.582508076
28135,75,24690,10,7,0,0,0,17,10,11,0,0,0,21,nowin,loss,beat,dlwin,0,10,17,191,0.418848168,0.052356021,0.570680628,0,0.029344702
28136,129,24690,8,10,0,0,0,18,10,11,0,0,0,21,nowin,loss,beat,dlwin,0,10,18,201,0.422885572,0.064676617,0.55721393,0,0.027255383
28137,28,24690,9,11,0,0,0,20,10,11,0,0,0,21,nowin,loss,beat,dlwin,0,10,20,199,0.422110553,0.045226131,0.542713568,1,0.282706618
28138,64,24690,9,5,0,2,10,26,10,11,0,0,0,21,nowin,loss,bust,plbust,0,10,14,187,0.363636364,0.048128342,0.631016043,0,0.027594885
28139,81,24690,2,10,0,10,0,22,10,11,0,0,0,21,nowin,loss,bust,plbust,0,10,12,182,0.395604396,0.043956044,0.60989011,2,0.567491261
28140,43,24691,8,10,0,0,0,18,6,7,1,10,0,24,nowin,win,dlbust,bust,20,0,18,192,0.40625,0.041666667,0.609375,2,0.576671372
28141,40,24691,9,5,0,0,0,14,6,7,1,10,0,24,nowin,win,dlbust,bust,20,0,14,196,0.367346939,0.030612245,0.617346939,0,0.025358183
28142,67,24691,5,10,0,0,0,15,6,7,1,10,0,24,nowin,win,dlbust,bust,20,0,15,195,0.369230769,0.041025641,0.569230769,0,0.014139427
28143,65,24691,10,10,0,0,0,20,6,7,1,10,0,24,nowin,win,dlbust,bust,20,0,20,203,0.492610837,0.054187192,0.571428571,3,0.913702814
28144,16,24691,10,9,0,0,0,19,6,7,1,10,0,24,nowin,win,dlbust,bust,20,0,19,220,0.427272727,0.081818182,0.6,2,0.588660176
28145,63,24691,11,10,0,0,0,21,6,7,1,10,0,24,win,win,dlbust,bust,25,0,21,216,0.467592593,0.037037037,0.62037037,3,0.931690496
28146,85,24692,10,5,0,3,0,18,11,4,6,0,0,21,nowin,loss,beat,dlwin,0,10,15,195,0.41025641,0.066666667,0.594871795,0,0.03269711
28147,103,24692,10,4,0,7,0,21,11,4,6,0,0,21,nowin,push,push,push,10,0,14,203,0.379310345,0.064039409,0.551724138,0,0.012869209
28148,55,24692,2,1,9,7,0,19,11,4,6,0,0,21,nowin,loss,beat,dlwin,0,10,3,191,0.371727749,0.057591623,0.54973822,0,0.01011347
28149,28,24692,8,10,0,0,0,18,11,4,6,0,0,21,nowin,loss,beat,dlwin,0,10,18,199,0.422110553,0.045226131,0.542713568,1,0.282706618
28150,6,24692,7,10,0,0,0,17,11,4,6,0,0,21,nowin,loss,beat,dlwin,0,10,17,191,0.439790576,0.047120419,0.581151832,1,0.31211505
28151,88,24692,3,2,8,1,10,24,11,4,6,0,0,21,nowin,loss,bust,plbust,0,10,5,206,0.466019417,0.033980583,0.54368932,1,0.309467903
28152,147,24693,11,4,1,0,0,16,3,6,11,0,0,20,nowin,loss,beat,dlwin,0,10,15,205,0.380487805,0.014634146,0.536585366,0,0.00951447
28153,82,24693,4,7,8,0,0,19,3,6,11,0,0,20,nowin,loss,beat,dlwin,0,10,11,225,0.408888889,0.075555556,0.577777778,0,0.028101874
28154,109,24693,3,5,8,0,0,16,3,6,11,0,0,20,nowin,loss,beat,dlwin,0,10,8,221,0.461538462,0.058823529,0.597285068,3,0.901830309
28155,52,24693,7,10,0,0,0,17,3,6,11,0,0,20,nowin,loss,beat,dlwin,0,10,17,217,0.414746544,0.02764977,0.599078341,2,0.576736024
28156,102,24693,10,8,0,0,0,18,3,6,11,0,0,20,nowin,loss,beat,dlwin,0,10,18,192,0.338541667,0.046875,0.5625,0,0.003306118
28157,10,24693,8,10,0,0,0,18,3,6,11,0,0,20,nowin,loss,beat,dlwin,0,10,18,191,0.413612565,0.057591623,0.596858639,2,0.574087175
28158,105,24694,10,10,0,0,0,20,10,10,0,0,0,20,nowin,push,push,push,10,0,20,198,0.414141414,0.070707071,0.590909091,0,0.032889494
28159,3,24694,10,10,0,0,0,20,10,10,0,0,0,20,nowin,push,push,push,10,0,20,190,0.431578947,0.026315789,0.542105263,1,0.288076384
28160,29,24694,9,7,0,6,0,22,10,10,0,0,0,20,nowin,loss,bust,plbust,0,10,16,189,0.44973545,0.058201058,0.544973545,1,0.300349439
28161,21,24694,4,7,8,0,0,19,10,10,0,0,0,20,nowin,loss,beat,dlwin,0,10,11,214,0.359813084,0.042056075,0.626168224,0,0.025263474
28162,103,24694,9,11,0,0,0,20,10,10,0,0,0,20,nowin,push,push,push,10,0,20,203,0.379310345,0.064039409,0.551724138,0,0.012869209
28163,23,24694,2,2,6,3,1,14,10,10,0,0,0,20,nowin,loss,beat,dlwin,0,10,4,208,0.427884615,0.0625,0.552884615,1,0.29114424
28164,83,24695,10,8,0,0,0,18,9,10,0,0,0,19,nowin,loss,beat,dlwin,0,10,18,193,0.424870466,0.051813472,0.678756477,2,0.644360335
28165,115,24695,1,5,10,2,0,18,9,10,0,0,0,19,nowin,loss,beat,dlwin,0,10,6,194,0.427835052,0.041237113,0.592783505,2,0.583863602
28166,70,24695,3,5,9,0,0,17,9,10,0,0,0,19,nowin,loss,beat,dlwin,0,10,8,228,0.385964912,0.039473684,0.557017544,0,0.016157125
28167,74,24695,5,9,0,3,0,17,9,10,0,0,0,19,nowin,loss,beat,dlwin,0,10,14,209,0.411483254,0.04784689,0.531100478,0,0.017448125
28168,122,24695,2,2,10,9,0,23,9,10,0,0,0,19,nowin,loss,bust,plbust,0,10,4,210,0.347619048,0.052380952,0.59047619,0,0.012873677
28169,24,24695,10,8,0,0,0,18,9,10,0,0,0,19,nowin,loss,beat,dlwin,0,10,18,207,0.458937198,0.048309179,0.570048309,1,0.318138014
28170,145,24696,10,10,0,0,0,20,3,10,10,0,0,23,nowin,win,dlbust,bust,20,0,20,188,0.441489362,0.031914894,0.622340426,2,0.617837093
28171,28,24696,5,10,0,0,0,15,3,10,10,0,0,23,nowin,win,dlbust,bust,20,0,15,199,0.422110553,0.045226131,0.542713568,1,0.282706618
28172,45,24696,8,3,4,0,0,15,3,10,10,0,0,23,nowin,win,dlbust,bust,20,0,11,196,0.428571429,0.051020408,0.612244898,2,0.598821767
28173,146,24696,10,10,0,0,0,20,3,10,10,0,0,23,nowin,win,dlbust,bust,20,0,20,221,0.43438914,0.040723982,0.542986425,1,0.290190091
28174,120,24696,11,8,0,0,0,19,3,10,10,0,0,23,nowin,win,dlbust,bust,20,0,19,202,0.440594059,0.034653465,0.618811881,2,0.614441029
28175,89,24696,10,6,0,0,0,16,3,10,10,0,0,23,nowin,win,dlbust,bust,20,0,16,212,0.537735849,0.047169811,0.594339623,3,0.990167191
28176,67,24697,6,1,8,7,0,22,7,3,4,6,0,20,nowin,loss,bust,plbust,0,10,7,195,0.369230769,0.041025641,0.569230769,0,0.014139427
28177,140,24697,7,3,8,0,0,18,7,3,4,6,0,20,nowin,loss,beat,dlwin,0,10,10,210,0.466666667,0.023809524,0.604761905,3,0.915293335
28178,43,24697,10,10,0,0,0,20,7,3,4,6,0,20,nowin,push,push,push,10,0,20,192,0.40625,0.041666667,0.609375,2,0.576671372
28179,36,24697,3,6,4,1,9,23,7,3,4,6,0,20,nowin,loss,bust,plbust,0,10,9,229,0.445414847,0.056768559,0.655021834,2,0.645370571
28180,4,24697,10,7,0,0,0,17,7,3,4,6,0,20,nowin,loss,beat,dlwin,0,10,17,217,0.460829493,0.036866359,0.562211982,1,0.315432839
28181,43,24697,10,10,0,0,0,20,7,3,4,6,0,20,nowin,push,push,push,10,0,20,192,0.40625,0.041666667,0.609375,2,0.576671372
28182,15,24698,10,11,0,0,0,21,8,11,0,0,0,19,win,win,plwin,beat,25,0,21,212,0.410377358,0.051886792,0.561320755,0,0.024517408
28183,2,24698,6,4,8,0,0,18,8,11,0,0,0,19,nowin,loss,beat,dlwin,0,10,10,200,0.445,0.035,0.64,2,0.633962549
28184,92,24698,2,10,0,8,0,20,8,11,0,0,0,19,nowin,win,plwin,beat,20,0,12,186,0.446236559,0.059139785,0.564516129,1,0.307826125
28185,63,24698,8,11,0,0,0,19,8,11,0,0,0,19,nowin,push,push,push,10,0,19,216,0.467592593,0.037037037,0.62037037,3,0.931690496
28186,150,24698,10,6,0,10,0,26,8,11,0,0,0,19,nowin,loss,bust,plbust,0,10,16,192,0.401041667,0.036458333,0.567708333,0,0.023287458
28187,25,24698,2,10,0,10,0,22,8,11,0,0,0,19,nowin,loss,bust,plbust,0,10,12,190,0.463157895,0.063157895,0.536842105,1,0.304401563
28188,144,24699,10,9,0,0,0,19,6,10,9,0,0,25,nowin,win,dlbust,bust,20,0,19,202,0.386138614,0.054455446,0.564356436,0,0.018006244
28189,92,24699,10,10,0,0,0,20,6,10,9,0,0,25,nowin,win,dlbust,bust,20,0,20,186,0.446236559,0.059139785,0.564516129,1,0.307826125
28190,1,24699,2,1,10,0,0,13,6,10,9,0,0,25,nowin,win,dlbust,bust,20,0,3,197,0.406091371,0.025380711,0.649746193,2,0.606186955
28191,39,24699,3,7,2,0,0,12,6,10,9,0,0,25,nowin,win,dlbust,bust,20,0,10,191,0.429319372,0.062827225,0.57591623,0,0.033760763
28192,50,24699,11,9,0,0,0,20,6,10,9,0,0,25,nowin,win,dlbust,bust,20,0,20,202,0.405940594,0.04950495,0.54950495,0,0.020296079
28193,37,24699,6,10,0,0,0,16,6,10,9,0,0,25,nowin,win,dlbust,bust,20,0,16,208,0.394230769,0.038461538,0.581730769,0,0.024682772
28194,34,24700,5,5,10,0,0,20,7,3,2,7,0,19,nowin,win,plwin,beat,20,0,10,202,0.5,0.079207921,0.618811881,3,0.968961434
28195,10,24700,9,3,0,10,0,22,7,3,2,7,0,19,nowin,loss,bust,plbust,0,10,12,191,0.413612565,0.057591623,0.596858639,2,0.574087175
28196,114,24700,10,10,0,0,0,20,7,3,2,7,0,19,nowin,win,plwin,beat,20,0,20,198,0.47979798,0.025252525,0.611111111,3,0.937232995
28197,49,24700,2,8,6,3,0,19,7,3,2,7,0,19,nowin,push,push,push,10,0,10,207,0.396135266,0.053140097,0.594202899,0,0.028306925
28198,55,24700,2,10,0,9,0,21,7,3,2,7,0,19,nowin,win,plwin,beat,20,0,12,191,0.371727749,0.057591623,0.54973822,0,0.01011347
28199,80,24700,3,6,7,3,0,19,7,3,2,7,0,19,nowin,push,push,push,10,0,9,186,0.419354839,0.059139785,0.623655914,2,0.59892924
28200,54,24701,2,10,0,2,0,14,3,10,1,2,6,22,nowin,win,dlbust,bust,20,0,12,185,0.437837838,0.032432432,0.556756757,1,0.29899854
28201,19,24701,6,7,0,0,0,13,3,10,1,2,6,22,nowin,win,dlbust,bust,20,0,13,237,0.41350211,0.054852321,0.628691983,2,0.597373826
28202,60,24701,3,10,0,0,0,13,3,10,1,2,6,22,nowin,win,dlbust,bust,20,0,13,227,0.418502203,0.022026432,0.559471366,0,0.026496258
28203,37,24701,7,5,0,8,0,20,3,10,1,2,6,22,nowin,win,dlbust,bust,20,0,12,208,0.394230769,0.038461538,0.581730769,0,0.024682772
28204,107,24701,10,3,0,0,0,13,3,10,1,2,6,22,nowin,win,dlbust,bust,20,0,13,218,0.444954128,0.073394495,0.600917431,2,0.605210014
28205,36,24701,10,2,0,10,0,22,3,10,1,2,6,22,nowin,loss,bust,plbust,0,10,12,229,0.445414847,0.056768559,0.655021834,2,0.645370571
28206,116,24702,10,10,0,0,0,20,7,10,0,0,0,17,nowin,win,plwin,beat,20,0,20,195,0.425641026,0.056410256,0.538461538,1,0.28273747
28207,71,24702,4,7,1,9,0,21,7,10,0,0,0,17,nowin,win,plwin,beat,20,0,11,193,0.352331606,0.046632124,0.585492228,0,0.013063661
28208,123,24702,10,11,0,0,0,21,7,10,0,0,0,17,win,win,plwin,beat,25,0,21,205,0.43902439,0.034146341,0.614634146,2,0.609962544
28209,129,24702,10,10,0,0,0,20,7,10,0,0,0,17,nowin,win,plwin,beat,20,0,20,201,0.422885572,0.064676617,0.55721393,0,0.027255383
28210,22,24702,3,1,10,4,0,18,7,10,0,0,0,17,nowin,win,plwin,beat,20,0,4,187,0.481283422,0.042780749,0.577540107,3,0.906128176
28211,65,24702,7,3,6,10,0,26,7,10,0,0,0,17,nowin,loss,bust,plbust,0,10,10,203,0.492610837,0.054187192,0.571428571,3,0.913702814
28212,61,24703,7,11,0,0,0,18,7,10,0,0,0,17,nowin,win,plwin,beat,20,0,18,194,0.427835052,0.077319588,0.603092784,2,0.591437139
28213,28,24703,6,7,0,2,10,25,7,10,0,0,0,17,nowin,loss,bust,plbust,0,10,13,199,0.422110553,0.045226131,0.542713568,1,0.282706618
28214,74,24703,9,7,0,5,0,21,7,10,0,0,0,17,nowin,win,plwin,beat,20,0,16,209,0.411483254,0.04784689,0.531100478,0,0.017448125
28215,119,24703,4,5,10,0,0,19,7,10,0,0,0,17,nowin,win,plwin,beat,20,0,9,190,0.405263158,0.068421053,0.515789474,0,0.011837158
28216,88,24703,6,8,0,9,0,23,7,10,0,0,0,17,nowin,loss,bust,plbust,0,10,14,206,0.466019417,0.033980583,0.54368932,1,0.309467903
28217,22,24703,10,11,0,0,0,21,7,10,0,0,0,17,win,win,plwin,beat,25,0,21,187,0.481283422,0.042780749,0.577540107,3,0.906128176
28218,125,24704,10,5,0,0,0,15,6,3,9,0,0,18,nowin,loss,beat,dlwin,0,10,15,219,0.438356164,0.050228311,0.575342466,1,0.308411257
28219,122,24704,5,2,3,6,0,16,6,3,9,0,0,18,nowin,loss,beat,dlwin,0,10,7,210,0.347619048,0.052380952,0.59047619,0,0.012873677
28220,128,24704,10,3,0,0,0,13,6,3,9,0,0,18,nowin,loss,beat,dlwin,0,10,13,227,0.356828194,0.052863436,0.577092511,0,0.012352564
28221,4,24704,9,4,0,0,0,13,6,3,9,0,0,18,nowin,loss,beat,dlwin,0,10,13,217,0.460829493,0.036866359,0.562211982,1,0.315432839
28222,58,24704,10,3,0,0,0,13,6,3,9,0,0,18,nowin,loss,beat,dlwin,0,10,13,195,0.430769231,0.041025641,0.584615385,2,0.580497586
28223,90,24704,2,7,8,0,0,17,6,3,9,0,0,18,nowin,loss,beat,dlwin,0,10,9,201,0.447761194,0.049751244,0.60199005,3,0.889945023
28224,58,24705,6,10,0,0,0,16,4,8,5,0,0,17,nowin,loss,beat,dlwin,0,10,16,195,0.430769231,0.041025641,0.584615385,2,0.580497586
28225,66,24705,10,3,0,0,0,13,4,8,5,0,0,17,nowin,loss,beat,dlwin,0,10,13,217,0.456221198,0.064516129,0.626728111,3,0.924304367
28226,143,24705,5,7,0,0,0,12,4,8,5,0,0,17,nowin,loss,beat,dlwin,0,10,12,203,0.463054187,0.044334975,0.57635468,3,0.883143365
28227,12,24705,6,10,0,0,0,16,4,8,5,0,0,17,nowin,loss,beat,dlwin,0,10,16,189,0.470899471,0.015873016,0.613756614,3,0.929171178
28228,139,24705,2,1,10,0,0,13,4,8,5,0,0,17,nowin,loss,beat,dlwin,0,10,3,192,0.380208333,0.036458333,0.59375,0,0.023429169
28229,6,24705,10,6,0,0,0,16,4,8,5,0,0,17,nowin,loss,beat,dlwin,0,10,16,191,0.439790576,0.047120419,0.581151832,1,0.31211505
28230,125,24706,3,11,6,0,0,20,2,10,10,0,0,22,nowin,win,dlbust,bust,20,0,14,219,0.438356164,0.050228311,0.575342466,1,0.308411257
28231,45,24706,10,9,0,0,0,19,2,10,10,0,0,22,nowin,win,dlbust,bust,20,0,19,196,0.428571429,0.051020408,0.612244898,2,0.598821767
28232,105,24706,3,9,0,3,0,15,2,10,10,0,0,22,nowin,win,dlbust,bust,20,0,12,198,0.414141414,0.070707071,0.590909091,0,0.032889494
28233,23,24706,10,7,0,0,0,17,2,10,10,0,0,22,nowin,win,dlbust,bust,20,0,17,208,0.427884615,0.0625,0.552884615,1,0.29114424
28234,127,24706,10,9,0,0,0,19,2,10,10,0,0,22,nowin,win,dlbust,bust,20,0,19,201,0.402985075,0.029850746,0.60199005,0,0.032263937
28235,48,24706,2,10,0,3,0,15,2,10,10,0,0,22,nowin,win,dlbust,bust,20,0,12,203,0.413793103,0.019704433,0.600985222,2,0.577280801
28236,6,24707,6,10,0,3,0,19,11,10,0,0,0,21,nowin,loss,beat,dlwin,0,10,16,191,0.439790576,0.047120419,0.581151832,1,0.31211505
28237,40,24707,10,9,0,0,0,19,11,10,0,0,0,21,nowin,loss,beat,dlwin,0,10,19,196,0.367346939,0.030612245,0.617346939,0,0.025358183
28238,42,24707,4,4,3,8,0,19,11,10,0,0,0,21,nowin,loss,beat,dlwin,0,10,8,212,0.443396226,0.051886792,0.570754717,1,0.309181312
28239,68,24707,10,10,0,0,0,20,11,10,0,0,0,21,nowin,loss,beat,dlwin,0,10,20,205,0.434146341,0.029268293,0.6,2,0.59483189
28240,88,24707,9,8,0,0,0,17,11,10,0,0,0,21,nowin,loss,beat,dlwin,0,10,17,206,0.466019417,0.033980583,0.54368932,1,0.309467903
28241,137,24707,6,8,0,7,0,21,11,10,0,0,0,21,nowin,push,push,push,10,0,14,194,0.417525773,0.046391753,0.536082474,1,0.276714602
28242,22,24708,10,2,0,9,0,21,2,10,10,0,0,22,nowin,win,dlbust,bust,20,0,12,187,0.481283422,0.042780749,0.577540107,3,0.906128176
28243,115,24708,6,3,2,10,0,21,2,10,10,0,0,22,nowin,win,dlbust,bust,20,0,9,194,0.427835052,0.041237113,0.592783505,2,0.583863602
28244,122,24708,5,2,4,3,0,14,2,10,10,0,0,22,nowin,win,dlbust,bust,20,0,7,210,0.347619048,0.052380952,0.59047619,0,0.012873677
28245,53,24708,10,6,0,0,0,16,2,10,10,0,0,22,nowin,win,dlbust,bust,20,0,16,250,0.372,0.064,0.564,0,0.013687345
28246,119,24708,4,9,0,0,0,13,2,10,10,0,0,22,nowin,win,dlbust,bust,20,0,13,190,0.405263158,0.068421053,0.515789474,0,0.011837158
28247,104,24708,11,10,0,0,0,21,2,10,10,0,0,22,win,win,dlbust,bust,25,0,21,209,0.363636364,0.052631579,0.593301435,0,0.018359419
28248,67,24709,9,10,0,0,0,19,5,9,3,0,0,17,nowin,win,plwin,beat,20,0,19,195,0.369230769,0.041025641,0.569230769,0,0.014139427
28249,57,24709,10,10,0,0,0,20,5,9,3,0,0,17,nowin,win,plwin,beat,20,0,20,192,0.46875,0.052083333,0.59375,3,0.907001181
28250,70,24709,3,6,10,0,0,19,5,9,3,0,0,17,nowin,win,plwin,beat,20,0,9,228,0.385964912,0.039473684,0.557017544,0,0.016157125
28251,71,24709,6,8,0,0,0,14,5,9,3,0,0,17,nowin,loss,beat,dlwin,0,10,14,193,0.352331606,0.046632124,0.585492228,0,0.013063661
28252,4,24709,7,11,0,0,0,18,5,9,3,0,0,17,nowin,win,plwin,beat,20,0,18,217,0.460829493,0.036866359,0.562211982,1,0.315432839
28253,129,24709,10,11,0,0,0,21,5,9,3,0,0,17,win,win,plwin,beat,25,0,21,201,0.422885572,0.064676617,0.55721393,0,0.027255383
28254,92,24710,10,2,0,0,0,12,6,11,0,0,0,17,nowin,loss,beat,dlwin,0,10,12,186,0.446236559,0.059139785,0.564516129,1,0.307826125
28255,52,24710,3,8,10,0,0,21,6,11,0,0,0,17,nowin,win,plwin,beat,20,0,11,217,0.414746544,0.02764977,0.599078341,2,0.576736024
28256,48,24710,5,10,0,0,0,15,6,11,0,0,0,17,nowin,loss,beat,dlwin,0,10,15,203,0.413793103,0.019704433,0.600985222,2,0.577280801
28257,19,24710,10,10,0,0,0,20,6,11,0,0,0,17,nowin,win,plwin,beat,20,0,20,237,0.41350211,0.054852321,0.628691983,2,0.597373826
28258,133,24710,10,5,0,0,0,15,6,11,0,0,0,17,nowin,loss,beat,dlwin,0,10,15,201,0.47761194,0.064676617,0.611940299,3,0.935428111
28259,101,24710,10,10,0,0,0,20,6,11,0,0,0,17,nowin,win,plwin,beat,20,0,20,205,0.424390244,0.068292683,0.63902439,2,0.614740646
28260,82,24711,10,10,0,0,0,20,10,3,4,0,0,17,nowin,win,plwin,beat,20,0,20,225,0.408888889,0.075555556,0.577777778,0,0.028101874
28261,4,24711,3,11,6,0,0,20,10,3,4,0,0,17,nowin,win,plwin,beat,20,0,14,217,0.460829493,0.036866359,0.562211982,1,0.315432839
28262,86,24711,4,10,0,8,0,22,10,3,4,0,0,17,nowin,loss,bust,plbust,0,10,14,196,0.454081633,0.040816327,0.591836735,3,0.887566443
28263,131,24711,9,3,0,4,8,24,10,3,4,0,0,17,nowin,loss,bust,plbust,0,10,12,217,0.410138249,0.069124424,0.543778802,0,0.02015021
28264,31,24711,3,10,0,5,0,18,10,3,4,0,0,17,nowin,win,plwin,beat,20,0,13,188,0.473404255,0.058510638,0.515957447,1,0.300306557
28265,42,24711,10,5,0,10,0,25,10,3,4,0,0,17,nowin,loss,bust,plbust,0,10,15,212,0.443396226,0.051886792,0.570754717,1,0.309181312
28266,147,24712,5,9,0,10,0,24,7,6,4,0,0,17,nowin,loss,bust,plbust,0,10,14,205,0.380487805,0.014634146,0.536585366,0,0.00951447
28267,131,24712,3,9,0,4,10,26,7,6,4,0,0,17,nowin,loss,bust,plbust,0,10,12,217,0.410138249,0.069124424,0.543778802,0,0.02015021
28268,45,24712,10,8,0,0,0,18,7,6,4,0,0,17,nowin,win,plwin,beat,20,0,18,196,0.428571429,0.051020408,0.612244898,2,0.598821767
28269,90,24712,2,4,4,10,0,20,7,6,4,0,0,17,nowin,win,plwin,beat,20,0,6,201,0.447761194,0.049751244,0.60199005,3,0.889945023
28270,62,24712,4,4,10,0,0,18,7,6,4,0,0,17,nowin,win,plwin,beat,20,0,8,178,0.370786517,0.028089888,0.54494382,0,0.008657722
28271,117,24712,10,8,0,0,0,18,7,6,4,0,0,17,nowin,win,plwin,beat,20,0,18,173,0.410404624,0.069364162,0.606936416,2,0.578610282
28272,90,24713,10,9,0,0,0,19,10,10,0,0,0,20,nowin,loss,beat,dlwin,0,10,19,201,0.447761194,0.049751244,0.60199005,3,0.889945023
28273,4,24713,5,8,0,10,0,23,10,10,0,0,0,20,nowin,loss,bust,plbust,0,10,13,217,0.460829493,0.036866359,0.562211982,1,0.315432839
28274,12,24713,11,8,0,0,0,19,10,10,0,0,0,20,nowin,loss,beat,dlwin,0,10,19,189,0.470899471,0.015873016,0.613756614,3,0.929171178
28275,122,24713,9,3,0,3,8,23,10,10,0,0,0,20,nowin,loss,bust,plbust,0,10,12,210,0.347619048,0.052380952,0.59047619,0,0.012873677
28276,49,24713,10,2,0,6,0,18,10,10,0,0,0,20,nowin,loss,beat,dlwin,0,10,12,207,0.396135266,0.053140097,0.594202899,0,0.028306925
28277,21,24713,10,10,0,0,0,20,10,10,0,0,0,20,nowin,push,push,push,10,0,20,214,0.359813084,0.042056075,0.626168224,0,0.025263474
28278,41,24714,7,8,0,7,0,22,10,11,0,0,0,21,nowin,loss,bust,plbust,0,10,15,192,0.364583333,0.036458333,0.520833333,0,0.00089702
28279,46,24714,1,6,6,5,0,18,10,11,0,0,0,21,nowin,loss,beat,dlwin,0,10,7,186,0.403225806,0.048387097,0.591397849,0,0.029742194
28280,103,24714,9,5,0,10,0,24,10,11,0,0,0,21,nowin,loss,bust,plbust,0,10,14,203,0.379310345,0.064039409,0.551724138,0,0.012869209
28281,72,24714,2,6,3,4,10,25,10,11,0,0,0,21,nowin,loss,bust,plbust,0,10,8,185,0.394594595,0.032432432,0.508108108,0,0.006763115
28282,141,24714,6,6,0,10,0,22,10,11,0,0,0,21,nowin,loss,bust,plbust,0,10,12,202,0.420792079,0.074257426,0.564356436,0,0.028377851
28283,114,24714,8,10,0,0,0,18,10,11,0,0,0,21,nowin,loss,beat,dlwin,0,10,18,198,0.47979798,0.025252525,0.611111111,3,0.937232995
28284,89,24715,7,10,0,0,0,17,1,5,10,2,0,18,nowin,loss,beat,dlwin,0,10,17,212,0.537735849,0.047169811,0.594339623,3,0.990167191
28285,34,24715,11,10,0,0,0,21,1,5,10,2,0,18,win,win,plwin,beat,25,0,21,202,0.5,0.079207921,0.618811881,3,0.968961434
28286,52,24715,10,10,0,0,0,20,1,5,10,2,0,18,nowin,win,plwin,beat,20,0,20,217,0.414746544,0.02764977,0.599078341,2,0.576736024
28287,64,24715,3,10,0,8,0,21,1,5,10,2,0,18,nowin,win,plwin,beat,20,0,13,187,0.363636364,0.048128342,0.631016043,0,0.027594885
28288,101,24715,11,10,0,0,0,21,1,5,10,2,0,18,win,win,plwin,beat,25,0,21,205,0.424390244,0.068292683,0.63902439,2,0.614740646
28289,63,24715,10,6,0,2,0,18,1,5,10,2,0,18,nowin,push,push,push,10,0,16,216,0.467592593,0.037037037,0.62037037,3,0.931690496
28290,62,24716,1,6,10,0,0,17,10,4,1,10,0,25,nowin,win,dlbust,bust,20,0,7,178,0.370786517,0.028089888,0.54494382,0,0.008657722
28291,5,24716,8,10,0,0,0,18,10,4,1,10,0,25,nowin,win,dlbust,bust,20,0,18,203,0.42364532,0.02955665,0.596059113,2,0.582508076
28292,140,24716,7,3,8,0,0,18,10,4,1,10,0,25,nowin,win,dlbust,bust,20,0,10,210,0.466666667,0.023809524,0.604761905,3,0.915293335
28293,130,24716,6,9,0,10,0,25,10,4,1,10,0,25,nowin,loss,bust,plbust,0,10,15,219,0.410958904,0.03652968,0.566210046,0,0.025888739
28294,21,24716,10,6,0,10,0,26,10,4,1,10,0,25,nowin,loss,bust,plbust,0,10,16,214,0.359813084,0.042056075,0.626168224,0,0.025263474
28295,125,24716,10,4,0,6,0,20,10,4,1,10,0,25,nowin,win,dlbust,bust,20,0,14,219,0.438356164,0.050228311,0.575342466,1,0.308411257
28296,28,24717,10,6,0,7,0,23,11,6,0,0,0,17,nowin,loss,bust,plbust,0,10,16,199,0.422110553,0.045226131,0.542713568,1,0.282706618
28297,132,24717,6,8,0,4,0,18,11,6,0,0,0,17,nowin,win,plwin,beat,20,0,14,194,0.412371134,0.036082474,0.649484536,2,0.611633238
28298,100,24717,7,3,11,0,0,21,11,6,0,0,0,17,nowin,win,plwin,beat,20,0,10,190,0.452631579,0.036842105,0.594736842,3,0.888671154
28299,26,24717,7,5,0,10,0,22,11,6,0,0,0,17,nowin,loss,bust,plbust,0,10,12,203,0.463054187,0.0591133,0.541871921,1,0.306802864
28300,48,24717,10,5,0,7,0,22,11,6,0,0,0,17,nowin,loss,bust,plbust,0,10,15,203,0.413793103,0.019704433,0.600985222,2,0.577280801
28301,82,24717,10,10,0,0,0,20,11,6,0,0,0,17,nowin,win,plwin,beat,20,0,20,225,0.408888889,0.075555556,0.577777778,0,0.028101874
28302,66,24718,10,9,0,0,0,19,7,7,1,2,0,17,nowin,win,plwin,beat,20,0,19,217,0.456221198,0.064516129,0.626728111,3,0.924304367
28303,52,24718,10,7,0,0,0,17,7,7,1,2,0,17,nowin,push,push,push,10,0,17,217,0.414746544,0.02764977,0.599078341,2,0.576736024
28304,128,24718,2,10,0,2,2,16,7,7,1,2,0,17,nowin,loss,beat,dlwin,0,10,12,227,0.356828194,0.052863436,0.577092511,0,0.012352564
28305,15,24718,8,6,0,8,0,22,7,7,1,2,0,17,nowin,loss,bust,plbust,0,10,14,212,0.410377358,0.051886792,0.561320755,0,0.024517408
28306,110,24718,10,9,0,0,0,19,7,7,1,2,0,17,nowin,win,plwin,beat,20,0,19,192,0.416666667,0.046875,0.557291667,0,0.025413132
28307,69,24718,4,6,4,3,0,17,7,7,1,2,0,17,nowin,push,push,push,10,0,10,194,0.365979381,0.030927835,0.515463918,0,0
28308,141,24719,10,10,0,0,0,20,9,9,0,0,0,18,nowin,win,plwin,beat,20,0,20,202,0.420792079,0.074257426,0.564356436,0,0.028377851
28309,58,24719,10,10,0,0,0,20,9,9,0,0,0,18,nowin,win,plwin,beat,20,0,20,195,0.430769231,0.041025641,0.584615385,2,0.580497586
28310,54,24719,11,1,6,0,0,18,9,9,0,0,0,18,nowin,push,push,push,10,0,12,185,0.437837838,0.032432432,0.556756757,1,0.29899854
28311,38,24719,7,6,0,6,0,19,9,9,0,0,0,18,nowin,win,plwin,beat,20,0,13,202,0.361386139,0.03960396,0.564356436,0,0.010597953
28312,76,24719,9,7,0,2,0,18,9,9,0,0,0,18,nowin,push,push,push,10,0,16,189,0.534391534,0.079365079,0.608465608,3,1
28313,10,24719,5,7,0,9,0,21,9,9,0,0,0,18,nowin,win,plwin,beat,20,0,12,191,0.413612565,0.057591623,0.596858639,2,0.574087175
28314,103,24720,2,7,2,10,0,21,8,10,0,0,0,18,nowin,win,plwin,beat,20,0,9,203,0.379310345,0.064039409,0.551724138,0,0.012869209
28315,8,24720,3,9,0,9,0,21,8,10,0,0,0,18,nowin,win,plwin,beat,20,0,12,181,0.44198895,0.071823204,0.596685083,2,0.599438402
28316,94,24720,9,5,0,6,0,20,8,10,0,0,0,18,nowin,win,plwin,beat,20,0,14,183,0.43715847,0.043715847,0.540983607,1,0.290866892
28317,97,24720,11,10,0,0,0,21,8,10,0,0,0,18,win,win,plwin,beat,25,0,21,182,0.450549451,0.06043956,0.692307692,2,0.677372279
28318,122,24720,5,10,0,10,0,25,8,10,0,0,0,18,nowin,loss,bust,plbust,0,10,15,210,0.347619048,0.052380952,0.59047619,0,0.012873677
28319,126,24720,7,6,0,10,0,23,8,10,0,0,0,18,nowin,loss,bust,plbust,0,10,13,188,0.457446809,0.074468085,0.60106383,3,0.900633203
28320,47,24721,6,8,0,0,0,14,5,3,2,10,0,20,nowin,loss,beat,dlwin,0,10,14,210,0.438095238,0.057142857,0.623809524,2,0.615868808
28321,56,24721,2,10,0,0,0,12,5,3,2,10,0,20,nowin,loss,beat,dlwin,0,10,12,175,0.4,0.057142857,0.582857143,0,0.026685297
28322,138,24721,10,5,0,0,0,15,5,3,2,10,0,20,nowin,loss,beat,dlwin,0,10,15,190,0.442105263,0.047368421,0.610526316,2,0.609711065
28323,120,24721,10,8,0,0,0,18,5,3,2,10,0,20,nowin,loss,beat,dlwin,0,10,18,202,0.440594059,0.034653465,0.618811881,2,0.614441029
28324,28,24721,7,6,0,0,0,13,5,3,2,10,0,20,nowin,loss,beat,dlwin,0,10,13,199,0.422110553,0.045226131,0.542713568,1,0.282706618
28325,30,24721,10,10,0,0,0,20,5,3,2,10,0,20,nowin,push,push,push,10,0,20,206,0.393203883,0.033980583,0.601941748,0,0.029324648
28326,47,24722,3,3,10,0,0,16,5,4,8,0,0,17,nowin,loss,beat,dlwin,0,10,6,210,0.438095238,0.057142857,0.623809524,2,0.615868808
28327,125,24722,8,10,0,0,0,18,5,4,8,0,0,17,nowin,win,plwin,beat,20,0,18,219,0.438356164,0.050228311,0.575342466,1,0.308411257
28328,103,24722,7,10,0,0,0,17,5,4,8,0,0,17,nowin,push,push,push,10,0,17,203,0.379310345,0.064039409,0.551724138,0,0.012869209
28329,79,24722,11,1,9,0,0,21,5,4,8,0,0,17,nowin,win,plwin,beat,20,0,12,211,0.436018957,0.028436019,0.672985782,2,0.650131054
28330,107,24722,11,10,0,0,0,21,5,4,8,0,0,17,win,win,plwin,beat,25,0,21,218,0.444954128,0.073394495,0.600917431,2,0.605210014
28331,70,24722,10,3,0,0,0,13,5,4,8,0,0,17,nowin,loss,beat,dlwin,0,10,13,228,0.385964912,0.039473684,0.557017544,0,0.016157125
28332,142,24723,11,10,0,0,0,21,10,10,0,0,0,20,win,win,plwin,beat,25,0,21,211,0.417061611,0.047393365,0.526066351,1,0.271531309
28333,53,24723,5,4,8,0,0,17,10,10,0,0,0,20,nowin,loss,beat,dlwin,0,10,9,250,0.372,0.064,0.564,0,0.013687345
28334,82,24723,7,11,0,0,0,18,10,10,0,0,0,20,nowin,loss,beat,dlwin,0,10,18,225,0.408888889,0.075555556,0.577777778,0,0.028101874
28335,118,24723,10,2,0,6,0,18,10,10,0,0,0,20,nowin,loss,beat,dlwin,0,10,12,216,0.393518519,0.037037037,0.555555556,0,0.018059873
28336,26,24723,8,5,0,5,0,18,10,10,0,0,0,20,nowin,loss,beat,dlwin,0,10,13,203,0.463054187,0.0591133,0.541871921,1,0.306802864
28337,94,24723,10,5,0,8,0,23,10,10,0,0,0,20,nowin,loss,bust,plbust,0,10,15,183,0.43715847,0.043715847,0.540983607,1,0.290866892
28338,53,24724,9,4,0,7,0,20,10,4,6,0,0,20,nowin,push,push,push,10,0,13,250,0.372,0.064,0.564,0,0.013687345
28339,64,24724,4,10,0,10,0,24,10,4,6,0,0,20,nowin,loss,bust,plbust,0,10,14,187,0.363636364,0.048128342,0.631016043,0,0.027594885
28340,28,24724,10,4,0,5,0,19,10,4,6,0,0,20,nowin,loss,beat,dlwin,0,10,14,199,0.422110553,0.045226131,0.542713568,1,0.282706618
28341,125,24724,10,9,0,0,0,19,10,4,6,0,0,20,nowin,loss,beat,dlwin,0,10,19,219,0.438356164,0.050228311,0.575342466,1,0.308411257
28342,138,24724,10,7,0,0,0,17,10,4,6,0,0,20,nowin,loss,beat,dlwin,0,10,17,190,0.442105263,0.047368421,0.610526316,2,0.609711065
28343,43,24724,10,9,0,0,0,19,10,4,6,0,0,20,nowin,loss,beat,dlwin,0,10,19,192,0.40625,0.041666667,0.609375,2,0.576671372
28344,18,24725,2,5,10,0,0,17,5,4,10,0,0,19,nowin,loss,beat,dlwin,0,10,7,182,0.461538462,0.043956044,0.587912088,3,0.892649374
28345,25,24725,3,10,0,0,0,13,5,4,10,0,0,19,nowin,loss,beat,dlwin,0,10,13,190,0.463157895,0.063157895,0.536842105,1,0.304401563
28346,135,24725,4,6,9,0,0,19,5,4,10,0,0,19,nowin,push,push,push,10,0,10,179,0.391061453,0.067039106,0.586592179,0,0.024924662
28347,122,24725,10,4,0,0,0,14,5,4,10,0,0,19,nowin,loss,beat,dlwin,0,10,14,210,0.347619048,0.052380952,0.59047619,0,0.012873677
28348,50,24725,7,10,0,0,0,17,5,4,10,0,0,19,nowin,loss,beat,dlwin,0,10,17,202,0.405940594,0.04950495,0.54950495,0,0.020296079
28349,48,24725,10,10,0,0,0,20,5,4,10,0,0,19,nowin,win,plwin,beat,20,0,20,203,0.413793103,0.019704433,0.600985222,2,0.577280801
28350,96,24726,4,9,0,0,0,13,6,7,10,0,0,23,nowin,win,dlbust,bust,20,0,13,190,0.468421053,0.057894737,0.584210526,3,0.897263354
28351,63,24726,8,4,0,0,0,12,6,7,10,0,0,23,nowin,win,dlbust,bust,20,0,12,216,0.467592593,0.037037037,0.62037037,3,0.931690496
28352,98,24726,2,1,10,0,0,13,6,7,10,0,0,23,nowin,win,dlbust,bust,20,0,3,220,0.422727273,0.054545455,0.55,1,0.28664435
28353,4,24726,10,10,0,0,0,20,6,7,10,0,0,23,nowin,win,dlbust,bust,20,0,20,217,0.460829493,0.036866359,0.562211982,1,0.315432839
28354,13,24726,5,10,0,0,0,15,6,7,10,0,0,23,nowin,win,dlbust,bust,20,0,15,206,0.417475728,0.063106796,0.621359223,2,0.59555479
28355,88,24726,9,10,0,0,0,19,6,7,10,0,0,23,nowin,win,dlbust,bust,20,0,19,206,0.466019417,0.033980583,0.54368932,1,0.309467903
28356,107,24727,5,10,0,3,0,18,10,10,0,0,0,20,nowin,loss,beat,dlwin,0,10,15,218,0.444954128,0.073394495,0.600917431,2,0.605210014
28357,45,24727,5,4,10,0,0,19,10,10,0,0,0,20,nowin,loss,beat,dlwin,0,10,9,196,0.428571429,0.051020408,0.612244898,2,0.598821767
28358,19,24727,6,5,10,0,0,21,10,10,0,0,0,20,nowin,win,plwin,beat,20,0,11,237,0.41350211,0.054852321,0.628691983,2,0.597373826
28359,26,24727,7,6,0,1,9,23,10,10,0,0,0,20,nowin,loss,bust,plbust,0,10,13,203,0.463054187,0.0591133,0.541871921,1,0.306802864
28360,44,24727,10,3,0,5,0,18,10,10,0,0,0,20,nowin,loss,beat,dlwin,0,10,13,219,0.433789954,0.050228311,0.534246575,1,0.285551035
28361,52,24727,1,6,10,0,0,17,10,10,0,0,0,20,nowin,loss,beat,dlwin,0,10,7,217,0.414746544,0.02764977,0.599078341,2,0.576736024
28362,147,24728,4,8,0,6,0,18,9,4,3,5,0,21,nowin,loss,beat,dlwin,0,10,12,205,0.380487805,0.014634146,0.536585366,0,0.00951447
28363,60,24728,5,10,0,10,0,25,9,4,3,5,0,21,nowin,loss,bust,plbust,0,10,15,227,0.418502203,0.022026432,0.559471366,0,0.026496258
28364,13,24728,2,2,9,10,0,23,9,4,3,5,0,21,nowin,loss,bust,plbust,0,10,4,206,0.417475728,0.063106796,0.621359223,2,0.59555479
28365,79,24728,10,7,0,0,0,17,9,4,3,5,0,21,nowin,loss,beat,dlwin,0,10,17,211,0.436018957,0.028436019,0.672985782,2,0.650131054
28366,11,24728,3,3,2,4,6,18,9,4,3,5,0,21,nowin,loss,beat,dlwin,0,10,6,236,0.457627119,0.016949153,0.588983051,3,0.889015813
28367,115,24728,2,9,10,0,0,21,9,4,3,5,0,21,nowin,push,push,push,10,0,11,194,0.427835052,0.041237113,0.592783505,2,0.583863602
28368,63,24729,11,8,0,0,0,19,5,11,1,0,0,17,nowin,win,plwin,beat,20,0,19,216,0.467592593,0.037037037,0.62037037,3,0.931690496
28369,112,24729,3,10,0,0,0,13,5,11,1,0,0,17,nowin,loss,beat,dlwin,0,10,13,203,0.448275862,0.054187192,0.600985222,3,0.889576933
28370,148,24729,9,9,0,0,0,18,5,11,1,0,0,17,nowin,win,plwin,beat,20,0,18,204,0.401960784,0.078431373,0.593137255,0,0.029789521
28371,71,24729,8,9,0,0,0,17,5,11,1,0,0,17,nowin,push,push,push,10,0,17,193,0.352331606,0.046632124,0.585492228,0,0.013063661
28372,105,24729,4,4,10,0,0,18,5,11,1,0,0,17,nowin,win,plwin,beat,20,0,8,198,0.414141414,0.070707071,0.590909091,0,0.032889494
28373,131,24729,3,11,4,0,0,18,5,11,1,0,0,17,nowin,win,plwin,beat,20,0,14,217,0.410138249,0.069124424,0.543778802,0,0.02015021
28374,135,24730,10,10,0,0,0,20,2,8,8,0,0,18,nowin,win,plwin,beat,20,0,20,179,0.391061453,0.067039106,0.586592179,0,0.024924662
28375,150,24730,10,3,0,0,0,13,2,8,8,0,0,18,nowin,loss,beat,dlwin,0,10,13,192,0.401041667,0.036458333,0.567708333,0,0.023287458
28376,127,24730,10,10,0,0,0,20,2,8,8,0,0,18,nowin,win,plwin,beat,20,0,20,201,0.402985075,0.029850746,0.60199005,0,0.032263937
28377,68,24730,3,2,10,0,0,15,2,8,8,0,0,18,nowin,loss,beat,dlwin,0,10,5,205,0.434146341,0.029268293,0.6,2,0.59483189
28378,34,24730,10,11,0,0,0,21,2,8,8,0,0,18,win,win,plwin,beat,25,0,21,202,0.5,0.079207921,0.618811881,3,0.968961434
28379,17,24730,10,4,0,0,0,14,2,8,8,0,0,18,nowin,loss,beat,dlwin,0,10,14,171,0.444444444,0.070175439,0.555555556,1,0.302364894
28380,105,24731,7,6,0,0,0,13,2,10,10,0,0,22,nowin,win,dlbust,bust,20,0,13,198,0.414141414,0.070707071,0.590909091,0,0.032889494
28381,116,24731,7,8,0,0,0,15,2,10,10,0,0,22,nowin,win,dlbust,bust,20,0,15,195,0.425641026,0.056410256,0.538461538,1,0.28273747
28382,12,24731,2,7,10,0,0,19,2,10,10,0,0,22,nowin,win,dlbust,bust,20,0,9,189,0.470899471,0.015873016,0.613756614,3,0.929171178
28383,143,24731,6,4,10,0,0,20,2,10,10,0,0,22,nowin,win,dlbust,bust,20,0,10,203,0.463054187,0.044334975,0.57635468,3,0.883143365
28384,93,24731,10,8,0,0,0,18,2,10,10,0,0,22,nowin,win,dlbust,bust,20,0,18,175,0.485714286,0.051428571,0.548571429,1,0.323648091
28385,150,24731,10,11,0,0,0,21,2,10,10,0,0,22,win,win,dlbust,bust,25,0,21,192,0.401041667,0.036458333,0.567708333,0,0.023287458
28386,149,24732,9,9,0,0,0,18,10,7,0,0,0,17,nowin,win,plwin,beat,20,0,18,225,0.457777778,0.057777778,0.648888889,2,0.651965595
28387,148,24732,6,8,0,10,0,24,10,7,0,0,0,17,nowin,loss,bust,plbust,0,10,14,204,0.401960784,0.078431373,0.593137255,0,0.029789521
28388,48,24732,2,5,5,10,0,22,10,7,0,0,0,17,nowin,loss,bust,plbust,0,10,7,203,0.413793103,0.019704433,0.600985222,2,0.577280801
28389,107,24732,6,3,10,0,0,19,10,7,0,0,0,17,nowin,win,plwin,beat,20,0,9,218,0.444954128,0.073394495,0.600917431,2,0.605210014
28390,89,24732,5,8,0,5,0,18,10,7,0,0,0,17,nowin,win,plwin,beat,20,0,13,212,0.537735849,0.047169811,0.594339623,3,0.990167191
28391,105,24732,10,2,0,5,0,17,10,7,0,0,0,17,nowin,push,push,push,10,0,12,198,0.414141414,0.070707071,0.590909091,0,0.032889494
28392,118,24733,10,8,0,0,0,18,6,5,10,0,0,21,nowin,loss,beat,dlwin,0,10,18,216,0.393518519,0.037037037,0.555555556,0,0.018059873
28393,16,24733,10,10,0,0,0,20,6,5,10,0,0,21,nowin,loss,beat,dlwin,0,10,20,220,0.427272727,0.081818182,0.6,2,0.588660176
28394,110,24733,8,10,0,0,0,18,6,5,10,0,0,21,nowin,loss,beat,dlwin,0,10,18,192,0.416666667,0.046875,0.557291667,0,0.025413132
28395,24,24733,10,6,0,0,0,16,6,5,10,0,0,21,nowin,loss,beat,dlwin,0,10,16,207,0.458937198,0.048309179,0.570048309,1,0.318138014
28396,93,24733,3,10,0,0,0,13,6,5,10,0,0,21,nowin,loss,beat,dlwin,0,10,13,175,0.485714286,0.051428571,0.548571429,1,0.323648091
28397,61,24733,10,10,0,0,0,20,6,5,10,0,0,21,nowin,loss,beat,dlwin,0,10,20,194,0.427835052,0.077319588,0.603092784,2,0.591437139
28398,38,24734,8,10,0,0,0,18,8,10,0,0,0,18,nowin,push,push,push,10,0,18,202,0.361386139,0.03960396,0.564356436,0,0.010597953
28399,99,24734,6,5,10,0,0,21,8,10,0,0,0,18,nowin,win,plwin,beat,20,0,11,207,0.47826087,0.062801932,0.637681159,3,0.961418446
28400,90,24734,6,10,0,7,0,23,8,10,0,0,0,18,nowin,loss,bust,plbust,0,10,16,201,0.447761194,0.049751244,0.60199005,3,0.889945023
28401,92,24734,9,7,0,3,0,19,8,10,0,0,0,18,nowin,win,plwin,beat,20,0,16,186,0.446236559,0.059139785,0.564516129,1,0.307826125
28402,40,24734,10,6,0,10,0,26,8,10,0,0,0,18,nowin,loss,bust,plbust,0,10,16,196,0.367346939,0.030612245,0.617346939,0,0.025358183
28403,107,24734,9,10,0,0,0,19,8,10,0,0,0,18,nowin,win,plwin,beat,20,0,19,218,0.444954128,0.073394495,0.600917431,2,0.605210014
28404,44,24735,3,7,4,10,0,24,7,10,0,0,0,17,nowin,loss,bust,plbust,0,10,10,219,0.433789954,0.050228311,0.534246575,1,0.285551035
28405,28,24735,10,5,0,8,0,23,7,10,0,0,0,17,nowin,loss,bust,plbust,0,10,15,199,0.422110553,0.045226131,0.542713568,1,0.282706618
28406,103,24735,9,3,0,10,0,22,7,10,0,0,0,17,nowin,loss,bust,plbust,0,10,12,203,0.379310345,0.064039409,0.551724138,0,0.012869209
28407,85,24735,11,10,0,0,0,21,7,10,0,0,0,17,win,win,plwin,beat,25,0,21,195,0.41025641,0.066666667,0.594871795,0,0.03269711
28408,79,24735,10,10,0,0,0,20,7,10,0,0,0,17,nowin,win,plwin,beat,20,0,20,211,0.436018957,0.028436019,0.672985782,2,0.650131054
28409,135,24735,5,2,3,10,0,20,7,10,0,0,0,17,nowin,win,plwin,beat,20,0,7,179,0.391061453,0.067039106,0.586592179,0,0.024924662
28410,7,24736,8,2,8,0,0,18,11,10,0,0,0,21,nowin,loss,beat,dlwin,0,10,10,183,0.442622951,0.06010929,0.62295082,2,0.619303341
28411,75,24736,4,7,6,0,0,17,11,10,0,0,0,21,nowin,loss,beat,dlwin,0,10,11,191,0.418848168,0.052356021,0.570680628,0,0.029344702
28412,52,24736,6,7,0,6,0,19,11,10,0,0,0,21,nowin,loss,beat,dlwin,0,10,13,217,0.414746544,0.02764977,0.599078341,2,0.576736024
28413,98,24736,4,10,0,4,0,18,11,10,0,0,0,21,nowin,loss,beat,dlwin,0,10,14,220,0.422727273,0.054545455,0.55,1,0.28664435
28414,44,24736,3,3,2,2,10,20,11,10,0,0,0,21,nowin,loss,beat,dlwin,0,10,6,219,0.433789954,0.050228311,0.534246575,1,0.285551035
28415,144,24736,7,11,0,0,0,18,11,10,0,0,0,21,nowin,loss,beat,dlwin,0,10,18,202,0.386138614,0.054455446,0.564356436,0,0.018006244
28416,67,24737,3,2,5,9,0,19,8,10,0,0,0,18,nowin,win,plwin,beat,20,0,5,195,0.369230769,0.041025641,0.569230769,0,0.014139427
28417,116,24737,10,3,0,2,1,16,8,10,0,0,0,18,nowin,loss,beat,dlwin,0,10,13,195,0.425641026,0.056410256,0.538461538,1,0.28273747
28418,70,24737,4,3,9,10,0,26,8,10,0,0,0,18,nowin,loss,bust,plbust,0,10,7,228,0.385964912,0.039473684,0.557017544,0,0.016157125
28419,120,24737,6,6,0,9,0,21,8,10,0,0,0,18,nowin,win,plwin,beat,20,0,12,202,0.440594059,0.034653465,0.618811881,2,0.614441029
28420,146,24737,6,5,10,0,0,21,8,10,0,0,0,18,nowin,win,plwin,beat,20,0,11,221,0.43438914,0.040723982,0.542986425,1,0.290190091
28421,103,24737,6,10,0,10,0,26,8,10,0,0,0,18,nowin,loss,bust,plbust,0,10,16,203,0.379310345,0.064039409,0.551724138,0,0.012869209
28422,124,24738,8,5,0,10,0,23,10,2,10,0,0,22,nowin,loss,bust,plbust,0,10,13,202,0.47029703,0.064356436,0.584158416,3,0.899458193
28423,14,24738,8,11,0,0,0,19,10,2,10,0,0,22,nowin,win,dlbust,bust,20,0,19,202,0.391089109,0.01980198,0.628712871,2,0.577264877
28424,20,24738,9,6,0,5,0,20,10,2,10,0,0,22,nowin,win,dlbust,bust,20,0,15,186,0.456989247,0.037634409,0.537634409,1,0.301097108
28425,102,24738,7,9,0,2,0,18,10,2,10,0,0,22,nowin,win,dlbust,bust,20,0,16,192,0.338541667,0.046875,0.5625,0,0.003306118
28426,61,24738,9,10,0,0,0,19,10,2,10,0,0,22,nowin,win,dlbust,bust,20,0,19,194,0.427835052,0.077319588,0.603092784,2,0.591437139
28427,69,24738,3,9,0,8,0,20,10,2,10,0,0,22,nowin,win,dlbust,bust,20,0,12,194,0.365979381,0.030927835,0.515463918,0,0
28428,42,24739,9,8,0,0,0,17,5,10,7,0,0,22,nowin,win,dlbust,bust,20,0,17,212,0.443396226,0.051886792,0.570754717,1,0.309181312
28429,59,24739,10,3,0,0,0,13,5,10,7,0,0,22,nowin,win,dlbust,bust,20,0,13,228,0.429824561,0.048245614,0.543859649,1,0.287885446
28430,8,24739,3,4,8,0,0,15,5,10,7,0,0,22,nowin,win,dlbust,bust,20,0,7,181,0.44198895,0.071823204,0.596685083,2,0.599438402
28431,84,24739,8,10,0,0,0,18,5,10,7,0,0,22,nowin,win,dlbust,bust,20,0,18,195,0.379487179,0.056410256,0.569230769,0,0.017209119
28432,119,24739,8,10,0,0,0,18,5,10,7,0,0,22,nowin,win,dlbust,bust,20,0,18,190,0.405263158,0.068421053,0.515789474,0,0.011837158
28433,88,24739,3,3,10,0,0,16,5,10,7,0,0,22,nowin,win,dlbust,bust,20,0,6,206,0.466019417,0.033980583,0.54368932,1,0.309467903
28434,30,24740,10,5,0,0,0,15,6,9,1,10,0,26,nowin,win,dlbust,bust,20,0,15,206,0.393203883,0.033980583,0.601941748,0,0.029324648
28435,146,24740,11,5,2,0,0,18,6,9,1,10,0,26,nowin,win,dlbust,bust,20,0,16,221,0.43438914,0.040723982,0.542986425,1,0.290190091
28436,122,24740,9,5,0,0,0,14,6,9,1,10,0,26,nowin,win,dlbust,bust,20,0,14,210,0.347619048,0.052380952,0.59047619,0,0.012873677
28437,125,24740,10,6,0,0,0,16,6,9,1,10,0,26,nowin,win,dlbust,bust,20,0,16,219,0.438356164,0.050228311,0.575342466,1,0.308411257
28438,144,24740,5,10,0,0,0,15,6,9,1,10,0,26,nowin,win,dlbust,bust,20,0,15,202,0.386138614,0.054455446,0.564356436,0,0.018006244
28439,121,24740,10,10,0,0,0,20,6,9,1,10,0,26,nowin,win,dlbust,bust,20,0,20,195,0.456410256,0.025641026,0.512820513,1,0.288597791
28440,59,24741,6,11,2,0,0,19,10,10,0,0,0,20,nowin,loss,beat,dlwin,0,10,17,228,0.429824561,0.048245614,0.543859649,1,0.287885446
28441,38,24741,5,5,8,0,0,18,10,10,0,0,0,20,nowin,loss,beat,dlwin,0,10,10,202,0.361386139,0.03960396,0.564356436,0,0.010597953
28442,117,24741,9,3,0,5,0,17,10,10,0,0,0,20,nowin,loss,beat,dlwin,0,10,12,173,0.410404624,0.069364162,0.606936416,2,0.578610282
28443,137,24741,5,10,0,10,0,25,10,10,0,0,0,20,nowin,loss,bust,plbust,0,10,15,194,0.417525773,0.046391753,0.536082474,1,0.276714602
28444,39,24741,3,11,3,0,0,17,10,10,0,0,0,20,nowin,loss,beat,dlwin,0,10,14,191,0.429319372,0.062827225,0.57591623,0,0.033760763
28445,39,24741,6,10,0,2,0,18,10,10,0,0,0,20,nowin,loss,beat,dlwin,0,10,16,191,0.429319372,0.062827225,0.57591623,0,0.033760763
28446,12,24742,11,10,0,0,0,21,2,9,5,8,0,24,win,win,dlbust,bust,25,0,21,189,0.470899471,0.015873016,0.613756614,3,0.929171178
28447,104,24742,10,10,0,0,0,20,2,9,5,8,0,24,nowin,win,dlbust,bust,20,0,20,209,0.363636364,0.052631579,0.593301435,0,0.018359419
28448,14,24742,10,10,0,0,0,20,2,9,5,8,0,24,nowin,win,dlbust,bust,20,0,20,202,0.391089109,0.01980198,0.628712871,2,0.577264877
28449,107,24742,7,10,0,0,0,17,2,9,5,8,0,24,nowin,win,dlbust,bust,20,0,17,218,0.444954128,0.073394495,0.600917431,2,0.605210014
28450,102,24742,2,9,3,0,0,14,2,9,5,8,0,24,nowin,win,dlbust,bust,20,0,11,192,0.338541667,0.046875,0.5625,0,0.003306118
28451,109,24742,2,10,0,10,0,22,2,9,5,8,0,24,nowin,loss,bust,plbust,0,10,12,221,0.461538462,0.058823529,0.597285068,3,0.901830309
28452,16,24743,7,4,8,0,0,19,10,6,9,0,0,25,nowin,win,dlbust,bust,20,0,11,220,0.427272727,0.081818182,0.6,2,0.588660176
28453,69,24743,6,7,0,10,0,23,10,6,9,0,0,25,nowin,loss,bust,plbust,0,10,13,194,0.365979381,0.030927835,0.515463918,0,0
28454,150,24743,3,10,0,10,0,23,10,6,9,0,0,25,nowin,loss,bust,plbust,0,10,13,192,0.401041667,0.036458333,0.567708333,0,0.023287458
28455,78,24743,9,10,0,0,0,19,10,6,9,0,0,25,nowin,win,dlbust,bust,20,0,19,201,0.517412935,0.034825871,0.587064677,3,0.95871112
28456,120,24743,10,7,0,0,0,17,10,6,9,0,0,25,nowin,win,dlbust,bust,20,0,17,202,0.440594059,0.034653465,0.618811881,2,0.614441029
28457,5,24743,10,8,0,0,0,18,10,6,9,0,0,25,nowin,win,dlbust,bust,20,0,18,203,0.42364532,0.02955665,0.596059113,2,0.582508076
28458,82,24744,10,6,0,0,0,16,5,7,7,0,0,19,nowin,loss,beat,dlwin,0,10,16,225,0.408888889,0.075555556,0.577777778,0,0.028101874
28459,106,24744,7,9,0,0,0,16,5,7,7,0,0,19,nowin,loss,beat,dlwin,0,10,16,192,0.411458333,0.026041667,0.557291667,0,0.023854304
28460,64,24744,7,4,5,0,0,16,5,7,7,0,0,19,nowin,loss,beat,dlwin,0,10,11,187,0.363636364,0.048128342,0.631016043,0,0.027594885
28461,100,24744,7,9,0,0,0,16,5,7,7,0,0,19,nowin,loss,beat,dlwin,0,10,16,190,0.452631579,0.036842105,0.594736842,3,0.888671154
28462,6,24744,2,8,8,0,0,18,5,7,7,0,0,19,nowin,loss,beat,dlwin,0,10,10,191,0.439790576,0.047120419,0.581151832,1,0.31211505
28463,27,24744,6,8,0,0,0,14,5,7,7,0,0,19,nowin,loss,beat,dlwin,0,10,14,178,0.370786517,0.016853933,0.573033708,0,0.015536309
28464,110,24745,3,4,5,9,0,21,10,6,3,0,0,19,nowin,win,plwin,beat,20,0,7,192,0.416666667,0.046875,0.557291667,0,0.025413132
28465,145,24745,10,10,0,0,0,20,10,6,3,0,0,19,nowin,win,plwin,beat,20,0,20,188,0.441489362,0.031914894,0.622340426,2,0.617837093
28466,44,24745,2,10,0,10,0,22,10,6,3,0,0,19,nowin,loss,bust,plbust,0,10,12,219,0.433789954,0.050228311,0.534246575,1,0.285551035
28467,75,24745,6,7,0,5,0,18,10,6,3,0,0,19,nowin,loss,beat,dlwin,0,10,13,191,0.418848168,0.052356021,0.570680628,0,0.029344702
28468,55,24745,10,2,0,7,0,19,10,6,3,0,0,19,nowin,push,push,push,10,0,12,191,0.371727749,0.057591623,0.54973822,0,0.01011347
28469,13,24745,10,8,0,0,0,18,10,6,3,0,0,19,nowin,loss,beat,dlwin,0,10,18,206,0.417475728,0.063106796,0.621359223,2,0.59555479
28470,126,24746,5,10,0,10,0,25,9,8,0,0,0,17,nowin,loss,bust,plbust,0,10,15,188,0.457446809,0.074468085,0.60106383,3,0.900633203
28471,121,24746,10,5,0,10,0,25,9,8,0,0,0,17,nowin,loss,bust,plbust,0,10,15,195,0.456410256,0.025641026,0.512820513,1,0.288597791
28472,37,24746,10,5,0,3,0,18,9,8,0,0,0,17,nowin,win,plwin,beat,20,0,15,208,0.394230769,0.038461538,0.581730769,0,0.024682772
28473,128,24746,11,10,0,0,0,21,9,8,0,0,0,17,win,win,plwin,beat,25,0,21,227,0.356828194,0.052863436,0.577092511,0,0.012352564
28474,135,24746,4,6,2,2,9,23,9,8,0,0,0,17,nowin,loss,bust,plbust,0,10,10,179,0.391061453,0.067039106,0.586592179,0,0.024924662
28475,55,24746,4,10,0,10,0,24,9,8,0,0,0,17,nowin,loss,bust,plbust,0,10,14,191,0.371727749,0.057591623,0.54973822,0,0.01011347
28476,27,24747,10,2,0,9,0,21,3,10,10,0,0,23,nowin,win,dlbust,bust,20,0,12,178,0.370786517,0.016853933,0.573033708,0,0.015536309
28477,133,24747,10,10,0,0,0,20,3,10,10,0,0,23,nowin,win,dlbust,bust,20,0,20,201,0.47761194,0.064676617,0.611940299,3,0.935428111
28478,95,24747,5,10,0,0,0,15,3,10,10,0,0,23,nowin,win,dlbust,bust,20,0,15,218,0.412844037,0.04587156,0.559633028,0,0.024842385
28479,114,24747,7,6,0,0,0,13,3,10,10,0,0,23,nowin,win,dlbust,bust,20,0,13,198,0.47979798,0.025252525,0.611111111,3,0.937232995
28480,66,24747,10,10,0,0,0,20,3,10,10,0,0,23,nowin,win,dlbust,bust,20,0,20,217,0.456221198,0.064516129,0.626728111,3,0.924304367
28481,118,24747,7,3,11,0,0,21,3,10,10,0,0,23,nowin,win,dlbust,bust,20,0,10,216,0.393518519,0.037037037,0.555555556,0,0.018059873
28482,134,24748,10,10,0,0,0,20,11,10,0,0,0,21,nowin,loss,beat,dlwin,0,10,20,185,0.443243243,0.021621622,0.545945946,1,0.296939509
28483,125,24748,10,6,0,8,0,24,11,10,0,0,0,21,nowin,loss,bust,plbust,0,10,16,219,0.438356164,0.050228311,0.575342466,1,0.308411257
28484,84,24748,5,4,10,0,0,19,11,10,0,0,0,21,nowin,loss,beat,dlwin,0,10,9,195,0.379487179,0.056410256,0.569230769,0,0.017209119
28485,66,24748,9,10,0,0,0,19,11,10,0,0,0,21,nowin,loss,beat,dlwin,0,10,19,217,0.456221198,0.064516129,0.626728111,3,0.924304367
28486,81,24748,4,10,0,6,0,20,11,10,0,0,0,21,nowin,loss,beat,dlwin,0,10,14,182,0.395604396,0.043956044,0.60989011,2,0.567491261
28487,50,24748,3,3,8,4,0,18,11,10,0,0,0,21,nowin,loss,beat,dlwin,0,10,6,202,0.405940594,0.04950495,0.54950495,0,0.020296079
28488,62,24749,10,11,0,0,0,21,6,5,4,4,0,19,win,win,plwin,beat,25,0,21,178,0.370786517,0.028089888,0.54494382,0,0.008657722
28489,60,24749,9,10,0,0,0,19,6,5,4,4,0,19,nowin,push,push,push,10,0,19,227,0.418502203,0.022026432,0.559471366,0,0.026496258
28490,102,24749,10,8,0,0,0,18,6,5,4,4,0,19,nowin,loss,beat,dlwin,0,10,18,192,0.338541667,0.046875,0.5625,0,0.003306118
28491,6,24749,3,9,0,0,0,12,6,5,4,4,0,19,nowin,loss,beat,dlwin,0,10,12,191,0.439790576,0.047120419,0.581151832,1,0.31211505
28492,16,24749,7,11,0,0,0,18,6,5,4,4,0,19,nowin,loss,beat,dlwin,0,10,18,220,0.427272727,0.081818182,0.6,2,0.588660176
28493,27,24749,1,6,10,0,0,17,6,5,4,4,0,19,nowin,loss,beat,dlwin,0,10,7,178,0.370786517,0.016853933,0.573033708,0,0.015536309
28494,82,24750,10,9,0,0,0,19,7,6,3,8,0,24,nowin,win,dlbust,bust,20,0,19,225,0.408888889,0.075555556,0.577777778,0,0.028101874
28495,131,24750,5,6,8,0,0,19,7,6,3,8,0,24,nowin,win,dlbust,bust,20,0,11,217,0.410138249,0.069124424,0.543778802,0,0.02015021
28496,54,24750,8,6,0,1,3,18,7,6,3,8,0,24,nowin,win,dlbust,bust,20,0,14,185,0.437837838,0.032432432,0.556756757,1,0.29899854
28497,61,24750,2,9,1,2,7,21,7,6,3,8,0,24,nowin,win,dlbust,bust,20,0,11,194,0.427835052,0.077319588,0.603092784,2,0.591437139
28498,15,24750,9,7,0,10,0,26,7,6,3,8,0,24,nowin,loss,bust,plbust,0,10,16,212,0.410377358,0.051886792,0.561320755,0,0.024517408
28499,23,24750,10,10,0,0,0,20,7,6,3,8,0,24,nowin,win,dlbust,bust,20,0,20,208,0.427884615,0.0625,0.552884615,1,0.29114424
28500,19,24751,5,3,2,10,0,20,1,5,10,10,0,26,nowin,win,dlbust,bust,20,0,8,237,0.41350211,0.054852321,0.628691983,2,0.597373826
28501,33,24751,10,10,0,0,0,20,1,5,10,10,0,26,nowin,win,dlbust,bust,20,0,20,192,0.4375,0.057291667,0.625,2,0.616208916
28502,18,24751,6,9,0,6,0,21,1,5,10,10,0,26,nowin,win,dlbust,bust,20,0,15,182,0.461538462,0.043956044,0.587912088,3,0.892649374
28503,74,24751,2,9,5,1,0,17,1,5,10,10,0,26,nowin,win,dlbust,bust,20,0,11,209,0.411483254,0.04784689,0.531100478,0,0.017448125
28504,99,24751,10,10,0,0,0,20,1,5,10,10,0,26,nowin,win,dlbust,bust,20,0,20,207,0.47826087,0.062801932,0.637681159,3,0.961418446
28505,37,24751,10,11,0,0,0,21,1,5,10,10,0,26,win,win,dlbust,bust,25,0,21,208,0.394230769,0.038461538,0.581730769,0,0.024682772
28506,13,24752,10,6,0,10,0,26,10,10,0,0,0,20,nowin,loss,bust,plbust,0,10,16,206,0.417475728,0.063106796,0.621359223,2,0.59555479
28507,32,24752,7,8,0,10,0,25,10,10,0,0,0,20,nowin,loss,bust,plbust,0,10,15,189,0.391534392,0.037037037,0.53968254,0,0.013579086
28508,60,24752,9,11,0,0,0,20,10,10,0,0,0,20,nowin,push,push,push,10,0,20,227,0.418502203,0.022026432,0.559471366,0,0.026496258
28509,131,24752,6,8,0,10,0,24,10,10,0,0,0,20,nowin,loss,bust,plbust,0,10,14,217,0.410138249,0.069124424,0.543778802,0,0.02015021
28510,102,24752,8,4,0,9,0,21,10,10,0,0,0,20,nowin,win,plwin,beat,20,0,12,192,0.338541667,0.046875,0.5625,0,0.003306118
28511,25,24752,10,2,0,9,0,21,10,10,0,0,0,20,nowin,win,plwin,beat,20,0,12,190,0.463157895,0.063157895,0.536842105,1,0.304401563
28512,28,24753,9,8,0,0,0,17,10,9,0,0,0,19,nowin,loss,beat,dlwin,0,10,17,199,0.422110553,0.045226131,0.542713568,1,0.282706618
28513,132,24753,2,10,0,4,6,22,10,9,0,0,0,19,nowin,loss,bust,plbust,0,10,12,194,0.412371134,0.036082474,0.649484536,2,0.611633238
28514,118,24753,6,5,7,0,0,18,10,9,0,0,0,19,nowin,loss,beat,dlwin,0,10,11,216,0.393518519,0.037037037,0.555555556,0,0.018059873
28515,141,24753,10,10,0,0,0,20,10,9,0,0,0,19,nowin,win,plwin,beat,20,0,20,202,0.420792079,0.074257426,0.564356436,0,0.028377851
28516,22,24753,10,10,0,0,0,20,10,9,0,0,0,19,nowin,win,plwin,beat,20,0,20,187,0.481283422,0.042780749,0.577540107,3,0.906128176
28517,107,24753,11,10,0,0,0,21,10,9,0,0,0,19,win,win,plwin,beat,25,0,21,218,0.444954128,0.073394495,0.600917431,2,0.605210014
28518,76,24754,10,9,0,0,0,19,5,10,4,0,0,19,nowin,push,push,push,10,0,19,189,0.534391534,0.079365079,0.608465608,3,1
28519,17,24754,6,2,9,0,0,17,5,10,4,0,0,19,nowin,loss,beat,dlwin,0,10,8,171,0.444444444,0.070175439,0.555555556,1,0.302364894
28520,121,24754,10,7,0,0,0,17,5,10,4,0,0,19,nowin,loss,beat,dlwin,0,10,17,195,0.456410256,0.025641026,0.512820513,1,0.288597791
28521,1,24754,2,3,10,0,0,15,5,10,4,0,0,19,nowin,loss,beat,dlwin,0,10,5,197,0.406091371,0.025380711,0.649746193,2,0.606186955
28522,146,24754,2,6,9,0,0,17,5,10,4,0,0,19,nowin,loss,beat,dlwin,0,10,8,221,0.43438914,0.040723982,0.542986425,1,0.290190091
28523,36,24754,7,7,0,0,0,14,5,10,4,0,0,19,nowin,loss,beat,dlwin,0,10,14,229,0.445414847,0.056768559,0.655021834,2,0.645370571
28524,83,24755,4,10,0,0,0,14,2,4,10,10,0,26,nowin,win,dlbust,bust,20,0,14,193,0.424870466,0.051813472,0.678756477,2,0.644360335
28525,92,24755,11,10,0,0,0,21,2,4,10,10,0,26,win,win,dlbust,bust,25,0,21,186,0.446236559,0.059139785,0.564516129,1,0.307826125
28526,12,24755,3,10,0,0,0,13,2,4,10,10,0,26,nowin,win,dlbust,bust,20,0,13,189,0.470899471,0.015873016,0.613756614,3,0.929171178
28527,136,24755,10,10,0,0,0,20,2,4,10,10,0,26,nowin,win,dlbust,bust,20,0,20,194,0.396907216,0.025773196,0.597938144,0,0.029452644
28528,110,24755,8,5,0,0,0,13,2,4,10,10,0,26,nowin,win,dlbust,bust,20,0,13,192,0.416666667,0.046875,0.557291667,0,0.025413132
28529,73,24755,9,4,0,0,0,13,2,4,10,10,0,26,nowin,win,dlbust,bust,20,0,13,181,0.375690608,0.011049724,0.596685083,0,0.022795773
28530,1,24756,10,8,0,0,0,18,7,6,9,0,0,22,nowin,win,dlbust,bust,20,0,18,197,0.406091371,0.025380711,0.649746193,2,0.606186955
28531,108,24756,10,3,0,5,0,18,7,6,9,0,0,22,nowin,win,dlbust,bust,20,0,13,193,0.435233161,0.056994819,0.559585492,1,0.298824795
28532,94,24756,7,10,0,0,0,17,7,6,9,0,0,22,nowin,win,dlbust,bust,20,0,17,183,0.43715847,0.043715847,0.540983607,1,0.290866892
28533,42,24756,10,10,0,0,0,20,7,6,9,0,0,22,nowin,win,dlbust,bust,20,0,20,212,0.443396226,0.051886792,0.570754717,1,0.309181312
28534,133,24756,4,10,0,10,0,24,7,6,9,0,0,22,nowin,loss,bust,plbust,0,10,14,201,0.47761194,0.064676617,0.611940299,3,0.935428111
28535,55,24756,1,1,10,10,0,22,7,6,9,0,0,22,nowin,loss,bust,plbust,0,10,2,191,0.371727749,0.057591623,0.54973822,0,0.01011347
28536,92,24757,10,10,0,0,0,20,3,10,10,0,0,23,nowin,win,dlbust,bust,20,0,20,186,0.446236559,0.059139785,0.564516129,1,0.307826125
28537,85,24757,11,10,0,0,0,21,3,10,10,0,0,23,win,win,dlbust,bust,25,0,21,195,0.41025641,0.066666667,0.594871795,0,0.03269711
28538,117,24757,3,9,0,10,0,22,3,10,10,0,0,23,nowin,loss,bust,plbust,0,10,12,173,0.410404624,0.069364162,0.606936416,2,0.578610282
28539,71,24757,10,11,0,0,0,21,3,10,10,0,0,23,win,win,dlbust,bust,25,0,21,193,0.352331606,0.046632124,0.585492228,0,0.013063661
28540,2,24757,5,9,0,0,0,14,3,10,10,0,0,23,nowin,win,dlbust,bust,20,0,14,200,0.445,0.035,0.64,2,0.633962549
28541,108,24757,10,8,0,0,0,18,3,10,10,0,0,23,nowin,win,dlbust,bust,20,0,18,193,0.435233161,0.056994819,0.559585492,1,0.298824795
28542,82,24758,7,7,0,0,0,14,4,11,4,0,0,19,nowin,loss,beat,dlwin,0,10,14,225,0.408888889,0.075555556,0.577777778,0,0.028101874
28543,138,24758,10,5,0,0,0,15,4,11,4,0,0,19,nowin,loss,beat,dlwin,0,10,15,190,0.442105263,0.047368421,0.610526316,2,0.609711065
28544,137,24758,10,11,0,0,0,21,4,11,4,0,0,19,win,win,plwin,beat,25,0,21,194,0.417525773,0.046391753,0.536082474,1,0.276714602
28545,17,24758,8,10,0,0,0,18,4,11,4,0,0,19,nowin,loss,beat,dlwin,0,10,18,171,0.444444444,0.070175439,0.555555556,1,0.302364894
28546,82,24758,10,2,0,0,0,12,4,11,4,0,0,19,nowin,loss,beat,dlwin,0,10,12,225,0.408888889,0.075555556,0.577777778,0,0.028101874
28547,13,24758,10,11,0,0,0,21,4,11,4,0,0,19,win,win,plwin,beat,25,0,21,206,0.417475728,0.063106796,0.621359223,2,0.59555479
28548,145,24759,10,3,0,0,0,13,5,10,6,0,0,21,nowin,loss,beat,dlwin,0,10,13,188,0.441489362,0.031914894,0.622340426,2,0.617837093
28549,128,24759,10,3,0,0,0,13,5,10,6,0,0,21,nowin,loss,beat,dlwin,0,10,13,227,0.356828194,0.052863436,0.577092511,0,0.012352564
28550,120,24759,1,6,9,0,0,16,5,10,6,0,0,21,nowin,loss,beat,dlwin,0,10,7,202,0.440594059,0.034653465,0.618811881,2,0.614441029
28551,68,24759,10,10,0,0,0,20,5,10,6,0,0,21,nowin,loss,beat,dlwin,0,10,20,205,0.434146341,0.029268293,0.6,2,0.59483189
28552,117,24759,8,10,0,0,0,18,5,10,6,0,0,21,nowin,loss,beat,dlwin,0,10,18,173,0.410404624,0.069364162,0.606936416,2,0.578610282
28553,68,24759,2,5,2,9,0,18,5,10,6,0,0,21,nowin,loss,beat,dlwin,0,10,7,205,0.434146341,0.029268293,0.6,2,0.59483189
28554,11,24760,2,6,8,3,0,19,11,10,0,0,0,21,nowin,loss,beat,dlwin,0,10,8,236,0.457627119,0.016949153,0.588983051,3,0.889015813
28555,71,24760,5,7,0,3,10,25,11,10,0,0,0,21,nowin,loss,bust,plbust,0,10,12,193,0.352331606,0.046632124,0.585492228,0,0.013063661
28556,7,24760,7,10,0,0,0,17,11,10,0,0,0,21,nowin,loss,beat,dlwin,0,10,17,183,0.442622951,0.06010929,0.62295082,2,0.619303341
28557,124,24760,3,6,10,0,0,19,11,10,0,0,0,21,nowin,loss,beat,dlwin,0,10,9,202,0.47029703,0.064356436,0.584158416,3,0.899458193
28558,119,24760,7,8,0,8,0,23,11,10,0,0,0,21,nowin,loss,bust,plbust,0,10,15,190,0.405263158,0.068421053,0.515789474,0,0.011837158
28559,87,24760,9,11,0,0,0,20,11,10,0,0,0,21,nowin,loss,beat,dlwin,0,10,20,202,0.405940594,0.054455446,0.628712871,2,0.590599801
28560,149,24761,5,3,10,0,0,18,6,10,3,0,0,19,nowin,loss,beat,dlwin,0,10,8,225,0.457777778,0.057777778,0.648888889,2,0.651965595
28561,11,24761,10,10,0,0,0,20,6,10,3,0,0,19,nowin,win,plwin,beat,20,0,20,236,0.457627119,0.016949153,0.588983051,3,0.889015813
28562,80,24761,4,10,0,0,0,14,6,10,3,0,0,19,nowin,loss,beat,dlwin,0,10,14,186,0.419354839,0.059139785,0.623655914,2,0.59892924
28563,49,24761,6,9,0,0,0,15,6,10,3,0,0,19,nowin,loss,beat,dlwin,0,10,15,207,0.396135266,0.053140097,0.594202899,0,0.028306925
28564,103,24761,10,5,0,0,0,15,6,10,3,0,0,19,nowin,loss,beat,dlwin,0,10,15,203,0.379310345,0.064039409,0.551724138,0,0.012869209
28565,93,24761,10,11,0,0,0,21,6,10,3,0,0,19,win,win,plwin,beat,25,0,21,175,0.485714286,0.051428571,0.548571429,1,0.323648091
28566,37,24762,2,8,10,0,0,20,10,9,0,0,0,19,nowin,win,plwin,beat,20,0,10,208,0.394230769,0.038461538,0.581730769,0,0.024682772
28567,73,24762,9,6,0,10,0,25,10,9,0,0,0,19,nowin,loss,bust,plbust,0,10,15,181,0.375690608,0.011049724,0.596685083,0,0.022795773
28568,16,24762,9,3,0,10,0,22,10,9,0,0,0,19,nowin,loss,bust,plbust,0,10,12,220,0.427272727,0.081818182,0.6,2,0.588660176
28569,46,24762,3,6,5,3,0,17,10,9,0,0,0,19,nowin,loss,beat,dlwin,0,10,9,186,0.403225806,0.048387097,0.591397849,0,0.029742194
28570,80,24762,5,10,0,10,0,25,10,9,0,0,0,19,nowin,loss,bust,plbust,0,10,15,186,0.419354839,0.059139785,0.623655914,2,0.59892924
28571,35,24762,10,10,0,0,0,20,10,9,0,0,0,19,nowin,win,plwin,beat,20,0,20,202,0.410891089,0.044554455,0.633663366,2,0.598681573
28572,28,24763,8,4,0,4,0,16,3,4,3,10,0,20,nowin,loss,beat,dlwin,0,10,12,199,0.422110553,0.045226131,0.542713568,1,0.282706618
28573,50,24763,3,9,0,4,0,16,3,4,3,10,0,20,nowin,loss,beat,dlwin,0,10,12,202,0.405940594,0.04950495,0.54950495,0,0.020296079
28574,59,24763,5,6,1,7,0,19,3,4,3,10,0,20,nowin,loss,beat,dlwin,0,10,11,228,0.429824561,0.048245614,0.543859649,1,0.287885446
28575,12,24763,9,5,0,0,0,14,3,4,3,10,0,20,nowin,loss,beat,dlwin,0,10,14,189,0.470899471,0.015873016,0.613756614,3,0.929171178
28576,28,24763,6,10,0,0,0,16,3,4,3,10,0,20,nowin,loss,beat,dlwin,0,10,16,199,0.422110553,0.045226131,0.542713568,1,0.282706618
28577,133,24763,5,4,11,0,0,20,3,4,3,10,0,20,nowin,push,push,push,10,0,9,201,0.47761194,0.064676617,0.611940299,3,0.935428111
28578,119,24764,10,5,0,2,0,17,11,9,0,0,0,20,nowin,loss,beat,dlwin,0,10,15,190,0.405263158,0.068421053,0.515789474,0,0.011837158
28579,65,24764,4,1,10,8,0,23,11,9,0,0,0,20,nowin,loss,bust,plbust,0,10,5,203,0.492610837,0.054187192,0.571428571,3,0.913702814
28580,109,24764,2,4,10,10,0,26,11,9,0,0,0,20,nowin,loss,bust,plbust,0,10,6,221,0.461538462,0.058823529,0.597285068,3,0.901830309
28581,92,24764,11,9,0,0,0,20,11,9,0,0,0,20,nowin,push,push,push,10,0,20,186,0.446236559,0.059139785,0.564516129,1,0.307826125
28582,65,24764,8,8,0,8,0,24,11,9,0,0,0,20,nowin,loss,bust,plbust,0,10,16,203,0.492610837,0.054187192,0.571428571,3,0.913702814
28583,24,24764,3,10,0,4,0,17,11,9,0,0,0,20,nowin,loss,beat,dlwin,0,10,13,207,0.458937198,0.048309179,0.570048309,1,0.318138014
28584,27,24765,10,8,0,0,0,18,10,10,0,0,0,20,nowin,loss,beat,dlwin,0,10,18,178,0.370786517,0.016853933,0.573033708,0,0.015536309
28585,13,24765,9,10,0,0,0,19,10,10,0,0,0,20,nowin,loss,beat,dlwin,0,10,19,206,0.417475728,0.063106796,0.621359223,2,0.59555479
28586,106,24765,10,5,0,10,0,25,10,10,0,0,0,20,nowin,loss,bust,plbust,0,10,15,192,0.411458333,0.026041667,0.557291667,0,0.023854304
28587,130,24765,2,6,9,0,0,17,10,10,0,0,0,20,nowin,loss,beat,dlwin,0,10,8,219,0.410958904,0.03652968,0.566210046,0,0.025888739
28588,89,24765,10,2,0,8,0,20,10,10,0,0,0,20,nowin,push,push,push,10,0,12,212,0.537735849,0.047169811,0.594339623,3,0.990167191
28589,79,24765,9,3,0,1,5,18,10,10,0,0,0,20,nowin,loss,beat,dlwin,0,10,12,211,0.436018957,0.028436019,0.672985782,2,0.650131054
28590,41,24766,10,9,0,0,0,19,2,6,9,0,0,17,nowin,win,plwin,beat,20,0,19,192,0.364583333,0.036458333,0.520833333,0,0.00089702
28591,6,24766,5,9,0,0,0,14,2,6,9,0,0,17,nowin,loss,beat,dlwin,0,10,14,191,0.439790576,0.047120419,0.581151832,1,0.31211505
28592,9,24766,3,5,11,0,0,19,2,6,9,0,0,17,nowin,win,plwin,beat,20,0,8,194,0.37628866,0.015463918,0.541237113,0,0.009396796
28593,71,24766,4,10,0,0,0,14,2,6,9,0,0,17,nowin,loss,beat,dlwin,0,10,14,193,0.352331606,0.046632124,0.585492228,0,0.013063661
28594,115,24766,2,10,0,10,0,22,2,6,9,0,0,17,nowin,loss,bust,plbust,0,10,12,194,0.427835052,0.041237113,0.592783505,2,0.583863602
28595,114,24766,4,1,9,0,0,14,2,6,9,0,0,17,nowin,loss,beat,dlwin,0,10,5,198,0.47979798,0.025252525,0.611111111,3,0.937232995
28596,31,24767,5,2,10,0,0,17,10,7,0,0,0,17,nowin,push,push,push,10,0,7,188,0.473404255,0.058510638,0.515957447,1,0.300306557
28597,4,24767,3,6,6,4,0,19,10,7,0,0,0,17,nowin,win,plwin,beat,20,0,9,217,0.460829493,0.036866359,0.562211982,1,0.315432839
28598,107,24767,7,4,9,0,0,20,10,7,0,0,0,17,nowin,win,plwin,beat,20,0,11,218,0.444954128,0.073394495,0.600917431,2,0.605210014
28599,56,24767,2,9,2,8,0,21,10,7,0,0,0,17,nowin,win,plwin,beat,20,0,11,175,0.4,0.057142857,0.582857143,0,0.026685297
28600,36,24767,9,3,0,1,9,22,10,7,0,0,0,17,nowin,loss,bust,plbust,0,10,12,229,0.445414847,0.056768559,0.655021834,2,0.645370571
28601,2,24767,10,5,0,9,0,24,10,7,0,0,0,17,nowin,loss,bust,plbust,0,10,15,200,0.445,0.035,0.64,2,0.633962549
28602,114,24768,11,7,0,0,0,18,7,6,7,0,0,20,nowin,loss,beat,dlwin,0,10,18,198,0.47979798,0.025252525,0.611111111,3,0.937232995
28603,77,24768,11,2,5,0,0,18,7,6,7,0,0,20,nowin,loss,beat,dlwin,0,10,13,200,0.455,0.04,0.62,3,0.916252116
28604,138,24768,2,10,0,1,2,15,7,6,7,0,0,20,nowin,loss,beat,dlwin,0,10,12,190,0.442105263,0.047368421,0.610526316,2,0.609711065
28605,117,24768,5,6,10,0,0,21,7,6,7,0,0,20,nowin,win,plwin,beat,20,0,11,173,0.410404624,0.069364162,0.606936416,2,0.578610282
28606,102,24768,8,6,0,7,0,21,7,6,7,0,0,20,nowin,win,plwin,beat,20,0,14,192,0.338541667,0.046875,0.5625,0,0.003306118
28607,101,24768,9,4,0,10,0,23,7,6,7,0,0,20,nowin,loss,bust,plbust,0,10,13,205,0.424390244,0.068292683,0.63902439,2,0.614740646
28608,146,24769,6,5,3,0,0,14,2,10,10,0,0,22,nowin,win,dlbust,bust,20,0,11,221,0.43438914,0.040723982,0.542986425,1,0.290190091
28609,3,24769,4,3,9,0,0,16,2,10,10,0,0,22,nowin,win,dlbust,bust,20,0,7,190,0.431578947,0.026315789,0.542105263,1,0.288076384
28610,131,24769,8,10,0,0,0,18,2,10,10,0,0,22,nowin,win,dlbust,bust,20,0,18,217,0.410138249,0.069124424,0.543778802,0,0.02015021
28611,146,24769,2,6,7,0,0,15,2,10,10,0,0,22,nowin,win,dlbust,bust,20,0,8,221,0.43438914,0.040723982,0.542986425,1,0.290190091
28612,57,24769,2,4,2,8,0,16,2,10,10,0,0,22,nowin,win,dlbust,bust,20,0,6,192,0.46875,0.052083333,0.59375,3,0.907001181
28613,4,24769,10,10,0,0,0,20,2,10,10,0,0,22,nowin,win,dlbust,bust,20,0,20,217,0.460829493,0.036866359,0.562211982,1,0.315432839
28614,102,24770,5,10,0,1,10,26,8,4,2,7,0,21,nowin,loss,bust,plbust,0,10,15,192,0.338541667,0.046875,0.5625,0,0.003306118
28615,6,24770,9,5,0,7,0,21,8,4,2,7,0,21,nowin,push,push,push,10,0,14,191,0.439790576,0.047120419,0.581151832,1,0.31211505
28616,119,24770,9,2,7,0,0,18,8,4,2,7,0,21,nowin,loss,beat,dlwin,0,10,11,190,0.405263158,0.068421053,0.515789474,0,0.011837158
28617,120,24770,4,6,10,0,0,20,8,4,2,7,0,21,nowin,loss,beat,dlwin,0,10,10,202,0.440594059,0.034653465,0.618811881,2,0.614441029
28618,15,24770,7,10,0,0,0,17,8,4,2,7,0,21,nowin,loss,beat,dlwin,0,10,17,212,0.410377358,0.051886792,0.561320755,0,0.024517408
28619,118,24770,8,6,0,10,0,24,8,4,2,7,0,21,nowin,loss,bust,plbust,0,10,14,216,0.393518519,0.037037037,0.555555556,0,0.018059873
28620,44,24771,5,10,0,10,0,25,7,7,6,0,0,20,nowin,loss,bust,plbust,0,10,15,219,0.433789954,0.050228311,0.534246575,1,0.285551035
28621,16,24771,6,9,0,5,0,20,7,7,6,0,0,20,nowin,push,push,push,10,0,15,220,0.427272727,0.081818182,0.6,2,0.588660176
28622,69,24771,10,8,0,0,0,18,7,7,6,0,0,20,nowin,loss,beat,dlwin,0,10,18,194,0.365979381,0.030927835,0.515463918,0,0
28623,54,24771,3,9,0,10,0,22,7,7,6,0,0,20,nowin,loss,bust,plbust,0,10,12,185,0.437837838,0.032432432,0.556756757,1,0.29899854
28624,59,24771,10,6,0,5,0,21,7,7,6,0,0,20,nowin,win,plwin,beat,20,0,16,228,0.429824561,0.048245614,0.543859649,1,0.287885446
28625,49,24771,10,2,0,3,6,21,7,7,6,0,0,20,nowin,win,plwin,beat,20,0,12,207,0.396135266,0.053140097,0.594202899,0,0.028306925
28626,54,24772,6,10,0,1,0,17,10,4,8,0,0,22,nowin,win,dlbust,bust,20,0,16,185,0.437837838,0.032432432,0.556756757,1,0.29899854
28627,77,24772,7,9,0,10,0,26,10,4,8,0,0,22,nowin,loss,bust,plbust,0,10,16,200,0.455,0.04,0.62,3,0.916252116
28628,38,24772,4,9,0,10,0,23,10,4,8,0,0,22,nowin,loss,bust,plbust,0,10,13,202,0.361386139,0.03960396,0.564356436,0,0.010597953
28629,66,24772,1,6,10,0,0,17,10,4,8,0,0,22,nowin,win,dlbust,bust,20,0,7,217,0.456221198,0.064516129,0.626728111,3,0.924304367
28630,35,24772,2,3,8,10,0,23,10,4,8,0,0,22,nowin,loss,bust,plbust,0,10,5,202,0.410891089,0.044554455,0.633663366,2,0.598681573
28631,96,24772,3,2,5,5,7,22,10,4,8,0,0,22,nowin,loss,bust,plbust,0,10,5,190,0.468421053,0.057894737,0.584210526,3,0.897263354
28632,122,24773,3,8,5,0,0,16,5,9,2,1,0,17,nowin,loss,beat,dlwin,0,10,11,210,0.347619048,0.052380952,0.59047619,0,0.012873677
28633,8,24773,11,10,0,0,0,21,5,9,2,1,0,17,win,win,plwin,beat,25,0,21,181,0.44198895,0.071823204,0.596685083,2,0.599438402
28634,103,24773,8,10,0,0,0,18,5,9,2,1,0,17,nowin,win,plwin,beat,20,0,18,203,0.379310345,0.064039409,0.551724138,0,0.012869209
28635,139,24773,8,7,0,0,0,15,5,9,2,1,0,17,nowin,loss,beat,dlwin,0,10,15,192,0.380208333,0.036458333,0.59375,0,0.023429169
28636,56,24773,10,6,0,0,0,16,5,9,2,1,0,17,nowin,loss,beat,dlwin,0,10,16,175,0.4,0.057142857,0.582857143,0,0.026685297
28637,128,24773,3,6,10,0,0,19,5,9,2,1,0,17,nowin,win,plwin,beat,20,0,9,227,0.356828194,0.052863436,0.577092511,0,0.012352564
28638,76,24774,9,6,0,0,0,15,6,6,6,0,0,18,nowin,loss,beat,dlwin,0,10,15,189,0.534391534,0.079365079,0.608465608,3,1
28639,2,24774,11,10,0,0,0,21,6,6,6,0,0,18,win,win,plwin,beat,25,0,21,200,0.445,0.035,0.64,2,0.633962549
28640,17,24774,2,10,0,0,0,12,6,6,6,0,0,18,nowin,loss,beat,dlwin,0,10,12,171,0.444444444,0.070175439,0.555555556,1,0.302364894
28641,139,24774,5,8,0,0,0,13,6,6,6,0,0,18,nowin,loss,beat,dlwin,0,10,13,192,0.380208333,0.036458333,0.59375,0,0.023429169
28642,146,24774,2,8,11,0,0,21,6,6,6,0,0,18,nowin,win,plwin,beat,20,0,10,221,0.43438914,0.040723982,0.542986425,1,0.290190091
28643,107,24774,10,10,0,0,0,20,6,6,6,0,0,18,nowin,win,plwin,beat,20,0,20,218,0.444954128,0.073394495,0.600917431,2,0.605210014
28644,138,24775,2,11,3,4,0,20,7,9,10,0,0,26,nowin,win,dlbust,bust,20,0,13,190,0.442105263,0.047368421,0.610526316,2,0.609711065
28645,26,24775,10,3,0,8,0,21,7,9,10,0,0,26,nowin,win,dlbust,bust,20,0,13,203,0.463054187,0.0591133,0.541871921,1,0.306802864
28646,70,24775,3,4,2,2,2,13,7,9,10,0,0,26,nowin,win,dlbust,bust,20,0,7,228,0.385964912,0.039473684,0.557017544,0,0.016157125
28647,82,24775,11,6,2,0,0,19,7,9,10,0,0,26,nowin,win,dlbust,bust,20,0,17,225,0.408888889,0.075555556,0.577777778,0,0.028101874
28648,20,24775,5,10,0,8,0,23,7,9,10,0,0,26,nowin,loss,bust,plbust,0,10,15,186,0.456989247,0.037634409,0.537634409,1,0.301097108
28649,4,24775,2,10,0,10,0,22,7,9,10,0,0,26,nowin,loss,bust,plbust,0,10,12,217,0.460829493,0.036866359,0.562211982,1,0.315432839
28650,35,24776,4,6,10,0,0,20,10,11,0,0,0,21,nowin,loss,beat,dlwin,0,10,10,202,0.410891089,0.044554455,0.633663366,2,0.598681573
28651,101,24776,10,11,0,0,0,21,10,11,0,0,0,21,win,push,push,push,10,0,21,205,0.424390244,0.068292683,0.63902439,2,0.614740646
28652,111,24776,10,10,0,0,0,20,10,11,0,0,0,21,nowin,loss,beat,dlwin,0,10,20,180,0.433333333,0.055555556,0.611111111,2,0.602264492
28653,7,24776,7,7,0,9,0,23,10,11,0,0,0,21,nowin,loss,bust,plbust,0,10,14,183,0.442622951,0.06010929,0.62295082,2,0.619303341
28654,146,24776,11,7,0,0,0,18,10,11,0,0,0,21,nowin,loss,beat,dlwin,0,10,18,221,0.43438914,0.040723982,0.542986425,1,0.290190091
28655,15,24776,1,4,10,10,0,25,10,11,0,0,0,21,nowin,loss,bust,plbust,0,10,5,212,0.410377358,0.051886792,0.561320755,0,0.024517408
28656,136,24777,6,10,0,2,0,18,10,9,0,0,0,19,nowin,loss,beat,dlwin,0,10,16,194,0.396907216,0.025773196,0.597938144,0,0.029452644
28657,69,24777,8,9,0,0,0,17,10,9,0,0,0,19,nowin,loss,beat,dlwin,0,10,17,194,0.365979381,0.030927835,0.515463918,0,0
28658,96,24777,11,10,0,0,0,21,10,9,0,0,0,19,win,win,plwin,beat,25,0,21,190,0.468421053,0.057894737,0.584210526,3,0.897263354
28659,46,24777,10,4,0,10,0,24,10,9,0,0,0,19,nowin,loss,bust,plbust,0,10,14,186,0.403225806,0.048387097,0.591397849,0,0.029742194
28660,69,24777,10,2,0,10,0,22,10,9,0,0,0,19,nowin,loss,bust,plbust,0,10,12,194,0.365979381,0.030927835,0.515463918,0,0
28661,88,24777,10,10,0,0,0,20,10,9,0,0,0,19,nowin,win,plwin,beat,20,0,20,206,0.466019417,0.033980583,0.54368932,1,0.309467903
28662,74,24778,3,10,0,4,0,17,10,10,0,0,0,20,nowin,loss,beat,dlwin,0,10,13,209,0.411483254,0.04784689,0.531100478,0,0.017448125
28663,121,24778,7,6,0,10,0,23,10,10,0,0,0,20,nowin,loss,bust,plbust,0,10,13,195,0.456410256,0.025641026,0.512820513,1,0.288597791
28664,140,24778,3,10,0,10,0,23,10,10,0,0,0,20,nowin,loss,bust,plbust,0,10,13,210,0.466666667,0.023809524,0.604761905,3,0.915293335
28665,89,24778,7,10,0,0,0,17,10,10,0,0,0,20,nowin,loss,beat,dlwin,0,10,17,212,0.537735849,0.047169811,0.594339623,3,0.990167191
28666,92,24778,10,11,0,0,0,21,10,10,0,0,0,20,win,win,plwin,beat,25,0,21,186,0.446236559,0.059139785,0.564516129,1,0.307826125
28667,95,24778,10,10,0,0,0,20,10,10,0,0,0,20,nowin,push,push,push,10,0,20,218,0.412844037,0.04587156,0.559633028,0,0.024842385
28668,86,24779,7,11,0,0,0,18,6,11,0,0,0,17,nowin,win,plwin,beat,20,0,18,196,0.454081633,0.040816327,0.591836735,3,0.887566443
28669,132,24779,10,5,0,0,0,15,6,11,0,0,0,17,nowin,loss,beat,dlwin,0,10,15,194,0.412371134,0.036082474,0.649484536,2,0.611633238
28670,114,24779,6,3,6,0,0,15,6,11,0,0,0,17,nowin,loss,beat,dlwin,0,10,9,198,0.47979798,0.025252525,0.611111111,3,0.937232995
28671,123,24779,10,4,0,0,0,14,6,11,0,0,0,17,nowin,loss,beat,dlwin,0,10,14,205,0.43902439,0.034146341,0.614634146,2,0.609962544
28672,145,24779,2,9,10,0,0,21,6,11,0,0,0,17,nowin,win,plwin,beat,20,0,11,188,0.441489362,0.031914894,0.622340426,2,0.617837093
28673,54,24779,5,10,0,0,0,15,6,11,0,0,0,17,nowin,loss,beat,dlwin,0,10,15,185,0.437837838,0.032432432,0.556756757,1,0.29899854
28674,66,24780,10,5,0,5,0,20,7,9,10,0,0,26,nowin,win,dlbust,bust,20,0,15,217,0.456221198,0.064516129,0.626728111,3,0.924304367
28675,8,24780,11,10,0,0,0,21,7,9,10,0,0,26,win,win,dlbust,bust,25,0,21,181,0.44198895,0.071823204,0.596685083,2,0.599438402
28676,52,24780,11,2,8,0,0,21,7,9,10,0,0,26,nowin,win,dlbust,bust,20,0,13,217,0.414746544,0.02764977,0.599078341,2,0.576736024
28677,98,24780,10,8,0,0,0,18,7,9,10,0,0,26,nowin,win,dlbust,bust,20,0,18,220,0.422727273,0.054545455,0.55,1,0.28664435
28678,92,24780,9,7,0,9,0,25,7,9,10,0,0,26,nowin,loss,bust,plbust,0,10,16,186,0.446236559,0.059139785,0.564516129,1,0.307826125
28679,41,24780,2,11,3,1,0,17,7,9,10,0,0,26,nowin,win,dlbust,bust,20,0,13,192,0.364583333,0.036458333,0.520833333,0,0.00089702
28680,41,24781,10,11,0,0,0,21,4,3,10,0,0,17,win,win,plwin,beat,25,0,21,192,0.364583333,0.036458333,0.520833333,0,0.00089702
28681,135,24781,8,10,0,0,0,18,4,3,10,0,0,17,nowin,win,plwin,beat,20,0,18,179,0.391061453,0.067039106,0.586592179,0,0.024924662
28682,142,24781,10,8,0,0,0,18,4,3,10,0,0,17,nowin,win,plwin,beat,20,0,18,211,0.417061611,0.047393365,0.526066351,1,0.271531309
28683,85,24781,10,10,0,0,0,20,4,3,10,0,0,17,nowin,win,plwin,beat,20,0,20,195,0.41025641,0.066666667,0.594871795,0,0.03269711
28684,59,24781,10,3,0,0,0,13,4,3,10,0,0,17,nowin,loss,beat,dlwin,0,10,13,228,0.429824561,0.048245614,0.543859649,1,0.287885446
28685,7,24781,8,3,10,0,0,21,4,3,10,0,0,17,nowin,win,plwin,beat,20,0,11,183,0.442622951,0.06010929,0.62295082,2,0.619303341
28686,63,24782,5,8,0,10,0,23,10,11,0,0,0,21,nowin,loss,bust,plbust,0,10,13,216,0.467592593,0.037037037,0.62037037,3,0.931690496
28687,70,24782,4,6,6,2,0,18,10,11,0,0,0,21,nowin,loss,beat,dlwin,0,10,10,228,0.385964912,0.039473684,0.557017544,0,0.016157125
28688,70,24782,7,11,0,0,0,18,10,11,0,0,0,21,nowin,loss,beat,dlwin,0,10,18,228,0.385964912,0.039473684,0.557017544,0,0.016157125
28689,128,24782,8,5,0,5,0,18,10,11,0,0,0,21,nowin,loss,beat,dlwin,0,10,13,227,0.356828194,0.052863436,0.577092511,0,0.012352564
28690,13,24782,10,7,0,0,0,17,10,11,0,0,0,21,nowin,loss,beat,dlwin,0,10,17,206,0.417475728,0.063106796,0.621359223,2,0.59555479
28691,10,24782,10,10,0,0,0,20,10,11,0,0,0,21,nowin,loss,beat,dlwin,0,10,20,191,0.413612565,0.057591623,0.596858639,2,0.574087175
28692,114,24783,11,7,0,0,0,18,3,8,5,5,0,21,nowin,loss,beat,dlwin,0,10,18,198,0.47979798,0.025252525,0.611111111,3,0.937232995
28693,105,24783,3,5,3,10,0,21,3,8,5,5,0,21,nowin,push,push,push,10,0,8,198,0.414141414,0.070707071,0.590909091,0,0.032889494
28694,119,24783,4,9,0,0,0,13,3,8,5,5,0,21,nowin,loss,beat,dlwin,0,10,13,190,0.405263158,0.068421053,0.515789474,0,0.011837158
28695,129,24783,10,7,0,0,0,17,3,8,5,5,0,21,nowin,loss,beat,dlwin,0,10,17,201,0.422885572,0.064676617,0.55721393,0,0.027255383
28696,150,24783,10,4,0,0,0,14,3,8,5,5,0,21,nowin,loss,beat,dlwin,0,10,14,192,0.401041667,0.036458333,0.567708333,0,0.023287458
28697,13,24783,5,3,8,0,0,16,3,8,5,5,0,21,nowin,loss,beat,dlwin,0,10,8,206,0.417475728,0.063106796,0.621359223,2,0.59555479
28698,83,24784,4,4,5,0,0,13,3,3,7,1,10,24,nowin,win,dlbust,bust,20,0,8,193,0.424870466,0.051813472,0.678756477,2,0.644360335
28699,87,24784,2,10,0,2,0,14,3,3,7,1,10,24,nowin,win,dlbust,bust,20,0,12,202,0.405940594,0.054455446,0.628712871,2,0.590599801
28700,59,24784,2,10,0,2,0,14,3,3,7,1,10,24,nowin,win,dlbust,bust,20,0,12,228,0.429824561,0.048245614,0.543859649,1,0.287885446
28701,127,24784,5,7,0,9,0,21,3,3,7,1,10,24,nowin,win,dlbust,bust,20,0,12,201,0.402985075,0.029850746,0.60199005,0,0.032263937
28702,62,24784,9,6,0,0,0,15,3,3,7,1,10,24,nowin,win,dlbust,bust,20,0,15,178,0.370786517,0.028089888,0.54494382,0,0.008657722
28703,119,24784,5,10,0,0,0,15,3,3,7,1,10,24,nowin,win,dlbust,bust,20,0,15,190,0.405263158,0.068421053,0.515789474,0,0.011837158
28704,81,24785,10,10,0,0,0,20,10,11,0,0,0,21,nowin,loss,beat,dlwin,0,10,20,182,0.395604396,0.043956044,0.60989011,2,0.567491261
28705,145,24785,7,6,0,6,0,19,10,11,0,0,0,21,nowin,loss,beat,dlwin,0,10,13,188,0.441489362,0.031914894,0.622340426,2,0.617837093
28706,44,24785,6,10,0,5,0,21,10,11,0,0,0,21,nowin,push,push,push,10,0,16,219,0.433789954,0.050228311,0.534246575,1,0.285551035
28707,30,24785,9,10,0,0,0,19,10,11,0,0,0,21,nowin,loss,beat,dlwin,0,10,19,206,0.393203883,0.033980583,0.601941748,0,0.029324648
28708,80,24785,10,2,0,1,2,15,10,11,0,0,0,21,nowin,loss,beat,dlwin,0,10,12,186,0.419354839,0.059139785,0.623655914,2,0.59892924
28709,85,24785,9,10,0,0,0,19,10,11,0,0,0,21,nowin,loss,beat,dlwin,0,10,19,195,0.41025641,0.066666667,0.594871795,0,0.03269711
28710,79,24786,2,7,8,0,0,17,10,11,0,0,0,21,nowin,loss,beat,dlwin,0,10,9,211,0.436018957,0.028436019,0.672985782,2,0.650131054
28711,67,24786,4,6,4,8,0,22,10,11,0,0,0,21,nowin,loss,bust,plbust,0,10,10,195,0.369230769,0.041025641,0.569230769,0,0.014139427
28712,116,24786,6,3,4,2,8,23,10,11,0,0,0,21,nowin,loss,bust,plbust,0,10,9,195,0.425641026,0.056410256,0.538461538,1,0.28273747
28713,11,24786,9,10,0,0,0,19,10,11,0,0,0,21,nowin,loss,beat,dlwin,0,10,19,236,0.457627119,0.016949153,0.588983051,3,0.889015813
28714,60,24786,9,2,1,7,0,19,10,11,0,0,0,21,nowin,loss,beat,dlwin,0,10,11,227,0.418502203,0.022026432,0.559471366,0,0.026496258
28715,77,24786,10,10,0,0,0,20,10,11,0,0,0,21,nowin,loss,beat,dlwin,0,10,20,200,0.455,0.04,0.62,3,0.916252116
28716,9,24787,8,10,0,0,0,18,11,1,6,0,0,18,nowin,push,push,push,10,0,18,194,0.37628866,0.015463918,0.541237113,0,0.009396796
28717,136,24787,6,6,0,9,0,21,11,1,6,0,0,18,nowin,win,plwin,beat,20,0,12,194,0.396907216,0.025773196,0.597938144,0,0.029452644
28718,30,24787,5,8,0,10,0,23,11,1,6,0,0,18,nowin,loss,bust,plbust,0,10,13,206,0.393203883,0.033980583,0.601941748,0,0.029324648
28719,96,24787,10,8,0,0,0,18,11,1,6,0,0,18,nowin,push,push,push,10,0,18,190,0.468421053,0.057894737,0.584210526,3,0.897263354
28720,59,24787,3,5,10,0,0,18,11,1,6,0,0,18,nowin,push,push,push,10,0,8,228,0.429824561,0.048245614,0.543859649,1,0.287885446
28721,12,24787,10,10,0,0,0,20,11,1,6,0,0,18,nowin,win,plwin,beat,20,0,20,189,0.470899471,0.015873016,0.613756614,3,0.929171178
28722,66,24788,8,4,0,4,7,23,9,10,0,0,0,19,nowin,loss,bust,plbust,0,10,12,217,0.456221198,0.064516129,0.626728111,3,0.924304367
28723,80,24788,11,10,0,0,0,21,9,10,0,0,0,19,win,win,plwin,beat,25,0,21,186,0.419354839,0.059139785,0.623655914,2,0.59892924
28724,62,24788,2,6,5,6,0,19,9,10,0,0,0,19,nowin,push,push,push,10,0,8,178,0.370786517,0.028089888,0.54494382,0,0.008657722
28725,62,24788,11,10,0,0,0,21,9,10,0,0,0,19,win,win,plwin,beat,25,0,21,178,0.370786517,0.028089888,0.54494382,0,0.008657722
28726,40,24788,2,3,3,1,10,19,9,10,0,0,0,19,nowin,push,push,push,10,0,5,196,0.367346939,0.030612245,0.617346939,0,0.025358183
28727,95,24788,4,10,0,7,0,21,9,10,0,0,0,19,nowin,win,plwin,beat,20,0,14,218,0.412844037,0.04587156,0.559633028,0,0.024842385
28728,86,24789,10,6,0,0,0,16,4,8,1,9,0,22,nowin,win,dlbust,bust,20,0,16,196,0.454081633,0.040816327,0.591836735,3,0.887566443
28729,136,24789,10,11,0,0,0,21,4,8,1,9,0,22,win,win,dlbust,bust,25,0,21,194,0.396907216,0.025773196,0.597938144,0,0.029452644
28730,138,24789,11,5,2,0,0,18,4,8,1,9,0,22,nowin,win,dlbust,bust,20,0,16,190,0.442105263,0.047368421,0.610526316,2,0.609711065
28731,59,24789,6,7,0,0,0,13,4,8,1,9,0,22,nowin,win,dlbust,bust,20,0,13,228,0.429824561,0.048245614,0.543859649,1,0.287885446
28732,48,24789,10,9,0,0,0,19,4,8,1,9,0,22,nowin,win,dlbust,bust,20,0,19,203,0.413793103,0.019704433,0.600985222,2,0.577280801
28733,140,24789,2,2,10,0,0,14,4,8,1,9,0,22,nowin,win,dlbust,bust,20,0,4,210,0.466666667,0.023809524,0.604761905,3,0.915293335
28734,119,24790,10,6,0,10,0,26,11,8,0,0,0,19,nowin,loss,bust,plbust,0,10,16,190,0.405263158,0.068421053,0.515789474,0,0.011837158
28735,125,24790,3,5,11,0,0,19,11,8,0,0,0,19,nowin,push,push,push,10,0,8,219,0.438356164,0.050228311,0.575342466,1,0.308411257
28736,2,24790,10,7,0,0,0,17,11,8,0,0,0,19,nowin,loss,beat,dlwin,0,10,17,200,0.445,0.035,0.64,2,0.633962549
28737,75,24790,10,10,0,0,0,20,11,8,0,0,0,19,nowin,win,plwin,beat,20,0,20,191,0.418848168,0.052356021,0.570680628,0,0.029344702
28738,62,24790,7,9,0,10,0,26,11,8,0,0,0,19,nowin,loss,bust,plbust,0,10,16,178,0.370786517,0.028089888,0.54494382,0,0.008657722
28739,9,24790,2,11,2,3,0,18,11,8,0,0,0,19,nowin,loss,beat,dlwin,0,10,13,194,0.37628866,0.015463918,0.541237113,0,0.009396796
28740,49,24791,4,10,0,0,0,14,2,10,2,3,0,17,nowin,loss,beat,dlwin,0,10,14,207,0.396135266,0.053140097,0.594202899,0,0.028306925
28741,64,24791,3,9,0,1,0,13,2,10,2,3,0,17,nowin,loss,beat,dlwin,0,10,12,187,0.363636364,0.048128342,0.631016043,0,0.027594885
28742,99,24791,7,2,4,0,0,13,2,10,2,3,0,17,nowin,loss,beat,dlwin,0,10,9,207,0.47826087,0.062801932,0.637681159,3,0.961418446
28743,9,24791,6,9,0,0,0,15,2,10,2,3,0,17,nowin,loss,beat,dlwin,0,10,15,194,0.37628866,0.015463918,0.541237113,0,0.009396796
28744,128,24791,3,8,5,0,0,16,2,10,2,3,0,17,nowin,loss,beat,dlwin,0,10,11,227,0.356828194,0.052863436,0.577092511,0,0.012352564
28745,91,24791,10,6,0,0,0,16,2,10,2,3,0,17,nowin,loss,beat,dlwin,0,10,16,194,0.417525773,0.046391753,0.515463918,1,0.266616552
28746,5,24792,10,8,0,0,0,18,10,8,0,0,0,18,nowin,push,push,push,10,0,18,203,0.42364532,0.02955665,0.596059113,2,0.582508076
28747,40,24792,8,10,0,0,0,18,10,8,0,0,0,18,nowin,push,push,push,10,0,18,196,0.367346939,0.030612245,0.617346939,0,0.025358183
28748,56,24792,8,6,0,1,5,20,10,8,0,0,0,18,nowin,win,plwin,beat,20,0,14,175,0.4,0.057142857,0.582857143,0,0.026685297
28749,146,24792,10,10,0,0,0,20,10,8,0,0,0,18,nowin,win,plwin,beat,20,0,20,221,0.43438914,0.040723982,0.542986425,1,0.290190091
28750,131,24792,10,10,0,0,0,20,10,8,0,0,0,18,nowin,win,plwin,beat,20,0,20,217,0.410138249,0.069124424,0.543778802,0,0.02015021
28751,133,24792,10,8,0,0,0,18,10,8,0,0,0,18,nowin,push,push,push,10,0,18,201,0.47761194,0.064676617,0.611940299,3,0.935428111
28752,128,24793,9,10,0,0,0,19,10,10,0,0,0,20,nowin,loss,beat,dlwin,0,10,19,227,0.356828194,0.052863436,0.577092511,0,0.012352564
28753,47,24793,7,11,0,0,0,18,10,10,0,0,0,20,nowin,loss,beat,dlwin,0,10,18,210,0.438095238,0.057142857,0.623809524,2,0.615868808
28754,128,24793,7,10,0,0,0,17,10,10,0,0,0,20,nowin,loss,beat,dlwin,0,10,17,227,0.356828194,0.052863436,0.577092511,0,0.012352564
28755,61,24793,7,10,0,0,0,17,10,10,0,0,0,20,nowin,loss,beat,dlwin,0,10,17,194,0.427835052,0.077319588,0.603092784,2,0.591437139
28756,101,24793,8,10,0,0,0,18,10,10,0,0,0,20,nowin,loss,beat,dlwin,0,10,18,205,0.424390244,0.068292683,0.63902439,2,0.614740646
28757,13,24793,6,8,0,6,0,20,10,10,0,0,0,20,nowin,push,push,push,10,0,14,206,0.417475728,0.063106796,0.621359223,2,0.59555479
28758,87,24794,2,6,10,0,0,18,10,10,0,0,0,20,nowin,loss,beat,dlwin,0,10,8,202,0.405940594,0.054455446,0.628712871,2,0.590599801
28759,8,24794,10,11,0,0,0,21,10,10,0,0,0,20,win,win,plwin,beat,25,0,21,181,0.44198895,0.071823204,0.596685083,2,0.599438402
28760,139,24794,10,9,0,0,0,19,10,10,0,0,0,20,nowin,loss,beat,dlwin,0,10,19,192,0.380208333,0.036458333,0.59375,0,0.023429169
28761,43,24794,8,10,0,0,0,18,10,10,0,0,0,20,nowin,loss,beat,dlwin,0,10,18,192,0.40625,0.041666667,0.609375,2,0.576671372
28762,12,24794,10,2,0,4,7,23,10,10,0,0,0,20,nowin,loss,bust,plbust,0,10,12,189,0.470899471,0.015873016,0.613756614,3,0.929171178
28763,28,24794,2,1,10,2,8,23,10,10,0,0,0,20,nowin,loss,bust,plbust,0,10,3,199,0.422110553,0.045226131,0.542713568,1,0.282706618
28764,42,24795,6,11,4,0,0,21,10,9,0,0,0,19,nowin,win,plwin,beat,20,0,17,212,0.443396226,0.051886792,0.570754717,1,0.309181312
28765,4,24795,2,10,0,4,2,18,10,9,0,0,0,19,nowin,loss,beat,dlwin,0,10,12,217,0.460829493,0.036866359,0.562211982,1,0.315432839
28766,116,24795,10,11,0,0,0,21,10,9,0,0,0,19,win,win,plwin,beat,25,0,21,195,0.425641026,0.056410256,0.538461538,1,0.28273747
28767,13,24795,2,8,11,0,0,21,10,9,0,0,0,19,nowin,win,plwin,beat,20,0,10,206,0.417475728,0.063106796,0.621359223,2,0.59555479
28768,15,24795,10,8,0,0,0,18,10,9,0,0,0,19,nowin,loss,beat,dlwin,0,10,18,212,0.410377358,0.051886792,0.561320755,0,0.024517408
28769,19,24795,7,4,2,10,0,23,10,9,0,0,0,19,nowin,loss,bust,plbust,0,10,11,237,0.41350211,0.054852321,0.628691983,2,0.597373826
28770,37,24796,3,9,0,10,0,22,10,11,0,0,0,21,nowin,loss,bust,plbust,0,10,12,208,0.394230769,0.038461538,0.581730769,0,0.024682772
28771,60,24796,10,10,0,0,0,20,10,11,0,0,0,21,nowin,loss,beat,dlwin,0,10,20,227,0.418502203,0.022026432,0.559471366,0,0.026496258
28772,80,24796,5,5,5,6,0,21,10,11,0,0,0,21,nowin,push,push,push,10,0,10,186,0.419354839,0.059139785,0.623655914,2,0.59892924
28773,80,24796,11,10,0,0,0,21,10,11,0,0,0,21,win,push,push,push,10,0,21,186,0.419354839,0.059139785,0.623655914,2,0.59892924
28774,56,24796,5,10,0,10,0,25,10,11,0,0,0,21,nowin,loss,bust,plbust,0,10,15,175,0.4,0.057142857,0.582857143,0,0.026685297
28775,118,24796,6,9,0,10,0,25,10,11,0,0,0,21,nowin,loss,bust,plbust,0,10,15,216,0.393518519,0.037037037,0.555555556,0,0.018059873
28776,61,24797,9,10,0,0,0,19,3,3,10,1,0,17,nowin,win,plwin,beat,20,0,19,194,0.427835052,0.077319588,0.603092784,2,0.591437139
28777,107,24797,2,2,7,10,0,21,3,3,10,1,0,17,nowin,win,plwin,beat,20,0,4,218,0.444954128,0.073394495,0.600917431,2,0.605210014
28778,84,24797,10,7,0,0,0,17,3,3,10,1,0,17,nowin,push,push,push,10,0,17,195,0.379487179,0.056410256,0.569230769,0,0.017209119
28779,12,24797,7,3,7,0,0,17,3,3,10,1,0,17,nowin,push,push,push,10,0,10,189,0.470899471,0.015873016,0.613756614,3,0.929171178
28780,35,24797,4,3,8,0,0,15,3,3,10,1,0,17,nowin,loss,beat,dlwin,0,10,7,202,0.410891089,0.044554455,0.633663366,2,0.598681573
28781,96,24797,3,10,0,0,0,13,3,3,10,1,0,17,nowin,loss,beat,dlwin,0,10,13,190,0.468421053,0.057894737,0.584210526,3,0.897263354
28782,23,24798,9,10,0,0,0,19,7,2,3,7,0,19,nowin,push,push,push,10,0,19,208,0.427884615,0.0625,0.552884615,1,0.29114424
28783,90,24798,11,10,0,0,0,21,7,2,3,7,0,19,win,win,plwin,beat,25,0,21,201,0.447761194,0.049751244,0.60199005,3,0.889945023
28784,16,24798,7,10,0,0,0,17,7,2,3,7,0,19,nowin,loss,beat,dlwin,0,10,17,220,0.427272727,0.081818182,0.6,2,0.588660176
28785,100,24798,10,10,0,0,0,20,7,2,3,7,0,19,nowin,win,plwin,beat,20,0,20,190,0.452631579,0.036842105,0.594736842,3,0.888671154
28786,83,24798,6,5,9,0,0,20,7,2,3,7,0,19,nowin,win,plwin,beat,20,0,11,193,0.424870466,0.051813472,0.678756477,2,0.644360335
28787,68,24798,9,6,0,9,0,24,7,2,3,7,0,19,nowin,loss,bust,plbust,0,10,15,205,0.434146341,0.029268293,0.6,2,0.59483189
28788,30,24799,6,2,2,6,5,21,8,10,0,0,0,18,nowin,win,plwin,beat,20,0,8,206,0.393203883,0.033980583,0.601941748,0,0.029324648
28789,6,24799,10,11,0,0,0,21,8,10,0,0,0,18,win,win,plwin,beat,25,0,21,191,0.439790576,0.047120419,0.581151832,1,0.31211505
28790,110,24799,2,7,4,10,0,23,8,10,0,0,0,18,nowin,loss,bust,plbust,0,10,9,192,0.416666667,0.046875,0.557291667,0,0.025413132
28791,150,24799,4,1,7,6,0,18,8,10,0,0,0,18,nowin,push,push,push,10,0,5,192,0.401041667,0.036458333,0.567708333,0,0.023287458
28792,15,24799,2,11,8,0,0,21,8,10,0,0,0,18,nowin,win,plwin,beat,20,0,13,212,0.410377358,0.051886792,0.561320755,0,0.024517408
28793,55,24799,3,5,10,0,0,18,8,10,0,0,0,18,nowin,push,push,push,10,0,8,191,0.371727749,0.057591623,0.54973822,0,0.01011347
28794,109,24800,10,6,0,1,0,17,10,10,0,0,0,20,nowin,loss,beat,dlwin,0,10,16,221,0.461538462,0.058823529,0.597285068,3,0.901830309
28795,43,24800,4,10,0,4,0,18,10,10,0,0,0,20,nowin,loss,beat,dlwin,0,10,14,192,0.40625,0.041666667,0.609375,2,0.576671372
28796,61,24800,7,11,0,0,0,18,10,10,0,0,0,20,nowin,loss,beat,dlwin,0,10,18,194,0.427835052,0.077319588,0.603092784,2,0.591437139
28797,119,24800,5,11,4,0,0,20,10,10,0,0,0,20,nowin,push,push,push,10,0,16,190,0.405263158,0.068421053,0.515789474,0,0.011837158
28798,32,24800,5,10,0,10,0,25,10,10,0,0,0,20,nowin,loss,bust,plbust,0,10,15,189,0.391534392,0.037037037,0.53968254,0,0.013579086
28799,28,24800,5,1,8,10,0,24,10,10,0,0,0,20,nowin,loss,bust,plbust,0,10,6,199,0.422110553,0.045226131,0.542713568,1,0.282706618
28800,104,24801,10,10,0,0,0,20,4,10,2,6,0,22,nowin,win,dlbust,bust,20,0,20,209,0.363636364,0.052631579,0.593301435,0,0.018359419
28801,95,24801,11,4,2,0,0,17,4,10,2,6,0,22,nowin,win,dlbust,bust,20,0,15,218,0.412844037,0.04587156,0.559633028,0,0.024842385
28802,84,24801,10,5,0,0,0,15,4,10,2,6,0,22,nowin,win,dlbust,bust,20,0,15,195,0.379487179,0.056410256,0.569230769,0,0.017209119
28803,76,24801,1,3,9,0,0,13,4,10,2,6,0,22,nowin,win,dlbust,bust,20,0,4,189,0.534391534,0.079365079,0.608465608,3,1
28804,51,24801,6,9,0,0,0,15,4,10,2,6,0,22,nowin,win,dlbust,bust,20,0,15,189,0.529100529,0.068783069,0.608465608,3,0.993665715
28805,106,24801,6,10,0,0,0,16,4,10,2,6,0,22,nowin,win,dlbust,bust,20,0,16,192,0.411458333,0.026041667,0.557291667,0,0.023854304
28806,138,24802,9,2,10,0,0,21,5,5,7,0,0,17,nowin,win,plwin,beat,20,0,11,190,0.442105263,0.047368421,0.610526316,2,0.609711065
28807,41,24802,8,6,0,0,0,14,5,5,7,0,0,17,nowin,loss,beat,dlwin,0,10,14,192,0.364583333,0.036458333,0.520833333,0,0.00089702
28808,18,24802,5,9,0,0,0,14,5,5,7,0,0,17,nowin,loss,beat,dlwin,0,10,14,182,0.461538462,0.043956044,0.587912088,3,0.892649374
28809,107,24802,5,10,0,0,0,15,5,5,7,0,0,17,nowin,loss,beat,dlwin,0,10,15,218,0.444954128,0.073394495,0.600917431,2,0.605210014
28810,104,24802,10,8,0,0,0,18,5,5,7,0,0,17,nowin,win,plwin,beat,20,0,18,209,0.363636364,0.052631579,0.593301435,0,0.018359419
28811,60,24802,7,5,0,0,0,12,5,5,7,0,0,17,nowin,loss,beat,dlwin,0,10,12,227,0.418502203,0.022026432,0.559471366,0,0.026496258
28812,149,24803,8,3,4,8,0,23,9,2,4,7,0,22,nowin,loss,bust,plbust,0,10,11,225,0.457777778,0.057777778,0.648888889,2,0.651965595
28813,48,24803,2,3,7,2,5,19,9,2,4,7,0,22,nowin,win,dlbust,bust,20,0,5,203,0.413793103,0.019704433,0.600985222,2,0.577280801
28814,144,24803,3,4,3,5,8,23,9,2,4,7,0,22,nowin,loss,bust,plbust,0,10,7,202,0.386138614,0.054455446,0.564356436,0,0.018006244
28815,83,24803,3,10,0,6,0,19,9,2,4,7,0,22,nowin,win,dlbust,bust,20,0,13,193,0.424870466,0.051813472,0.678756477,2,0.644360335
28816,53,24803,5,7,0,1,1,14,9,2,4,7,0,22,nowin,win,dlbust,bust,20,0,12,250,0.372,0.064,0.564,0,0.013687345
28817,71,24803,10,8,0,0,0,18,9,2,4,7,0,22,nowin,win,dlbust,bust,20,0,18,193,0.352331606,0.046632124,0.585492228,0,0.013063661
28818,16,24804,10,8,0,0,0,18,11,4,4,0,0,19,nowin,loss,beat,dlwin,0,10,18,220,0.427272727,0.081818182,0.6,2,0.588660176
28819,140,24804,11,3,7,0,0,21,11,4,4,0,0,19,nowin,win,plwin,beat,20,0,14,210,0.466666667,0.023809524,0.604761905,3,0.915293335
28820,135,24804,2,2,2,1,4,11,11,4,4,0,0,19,nowin,loss,beat,dlwin,0,10,4,179,0.391061453,0.067039106,0.586592179,0,0.024924662
28821,101,24804,11,2,6,0,0,19,11,4,4,0,0,19,nowin,push,push,push,10,0,13,205,0.424390244,0.068292683,0.63902439,2,0.614740646
28822,108,24804,11,4,6,0,0,21,11,4,4,0,0,19,nowin,win,plwin,beat,20,0,15,193,0.435233161,0.056994819,0.559585492,1,0.298824795
28823,16,24804,10,8,0,0,0,18,11,4,4,0,0,19,nowin,loss,beat,dlwin,0,10,18,220,0.427272727,0.081818182,0.6,2,0.588660176
28824,25,24805,7,9,0,4,0,20,10,6,4,0,0,20,nowin,push,push,push,10,0,16,190,0.463157895,0.063157895,0.536842105,1,0.304401563
28825,104,24805,3,3,8,3,0,17,10,6,4,0,0,20,nowin,loss,beat,dlwin,0,10,6,209,0.363636364,0.052631579,0.593301435,0,0.018359419
28826,82,24805,7,10,0,0,0,17,10,6,4,0,0,20,nowin,loss,beat,dlwin,0,10,17,225,0.408888889,0.075555556,0.577777778,0,0.028101874
28827,20,24805,10,2,0,1,1,14,10,6,4,0,0,20,nowin,loss,beat,dlwin,0,10,12,186,0.456989247,0.037634409,0.537634409,1,0.301097108
28828,61,24805,8,6,0,10,0,24,10,6,4,0,0,20,nowin,loss,bust,plbust,0,10,14,194,0.427835052,0.077319588,0.603092784,2,0.591437139
28829,94,24805,3,5,4,10,0,22,10,6,4,0,0,20,nowin,loss,bust,plbust,0,10,8,183,0.43715847,0.043715847,0.540983607,1,0.290866892
28830,57,24806,5,3,6,10,0,24,10,10,0,0,0,20,nowin,loss,bust,plbust,0,10,8,192,0.46875,0.052083333,0.59375,3,0.907001181
28831,123,24806,11,2,8,0,0,21,10,10,0,0,0,20,nowin,win,plwin,beat,20,0,13,205,0.43902439,0.034146341,0.614634146,2,0.609962544
28832,94,24806,10,10,0,0,0,20,10,10,0,0,0,20,nowin,push,push,push,10,0,20,183,0.43715847,0.043715847,0.540983607,1,0.290866892
28833,52,24806,2,6,9,0,0,17,10,10,0,0,0,20,nowin,loss,beat,dlwin,0,10,8,217,0.414746544,0.02764977,0.599078341,2,0.576736024
28834,67,24806,11,10,0,0,0,21,10,10,0,0,0,20,win,win,plwin,beat,25,0,21,195,0.369230769,0.041025641,0.569230769,0,0.014139427
28835,21,24806,10,7,0,0,0,17,10,10,0,0,0,20,nowin,loss,beat,dlwin,0,10,17,214,0.359813084,0.042056075,0.626168224,0,0.025263474
28836,102,24807,10,4,0,0,0,14,4,10,3,0,0,17,nowin,loss,beat,dlwin,0,10,14,192,0.338541667,0.046875,0.5625,0,0.003306118
28837,36,24807,4,10,0,0,0,14,4,10,3,0,0,17,nowin,loss,beat,dlwin,0,10,14,229,0.445414847,0.056768559,0.655021834,2,0.645370571
28838,91,24807,2,10,0,0,0,12,4,10,3,0,0,17,nowin,loss,beat,dlwin,0,10,12,194,0.417525773,0.046391753,0.515463918,1,0.266616552
28839,137,24807,10,2,0,0,0,12,4,10,3,0,0,17,nowin,loss,beat,dlwin,0,10,12,194,0.417525773,0.046391753,0.536082474,1,0.276714602
28840,49,24807,10,3,0,0,0,13,4,10,3,0,0,17,nowin,loss,beat,dlwin,0,10,13,207,0.396135266,0.053140097,0.594202899,0,0.028306925
28841,45,24807,9,6,0,0,0,15,4,10,3,0,0,17,nowin,loss,beat,dlwin,0,10,15,196,0.428571429,0.051020408,0.612244898,2,0.598821767
28842,80,24808,10,8,0,0,0,18,8,10,0,0,0,18,nowin,push,push,push,10,0,18,186,0.419354839,0.059139785,0.623655914,2,0.59892924
28843,1,24808,10,3,0,7,0,20,8,10,0,0,0,18,nowin,win,plwin,beat,20,0,13,197,0.406091371,0.025380711,0.649746193,2,0.606186955
28844,111,24808,5,8,0,6,0,19,8,10,0,0,0,18,nowin,win,plwin,beat,20,0,13,180,0.433333333,0.055555556,0.611111111,2,0.602264492
28845,101,24808,5,2,9,1,0,17,8,10,0,0,0,18,nowin,loss,beat,dlwin,0,10,7,205,0.424390244,0.068292683,0.63902439,2,0.614740646
28846,99,24808,5,3,4,8,0,20,8,10,0,0,0,18,nowin,win,plwin,beat,20,0,8,207,0.47826087,0.062801932,0.637681159,3,0.961418446
28847,40,24808,5,5,2,10,0,22,8,10,0,0,0,18,nowin,loss,bust,plbust,0,10,10,196,0.367346939,0.030612245,0.617346939,0,0.025358183
28848,117,24809,11,10,0,0,0,21,10,5,10,0,0,25,win,win,dlbust,bust,25,0,21,173,0.410404624,0.069364162,0.606936416,2,0.578610282
28849,11,24809,3,5,2,9,0,19,10,5,10,0,0,25,nowin,win,dlbust,bust,20,0,8,236,0.457627119,0.016949153,0.588983051,3,0.889015813
28850,12,24809,10,10,0,0,0,20,10,5,10,0,0,25,nowin,win,dlbust,bust,20,0,20,189,0.470899471,0.015873016,0.613756614,3,0.929171178
28851,106,24809,5,9,0,10,0,24,10,5,10,0,0,25,nowin,loss,bust,plbust,0,10,14,192,0.411458333,0.026041667,0.557291667,0,0.023854304
28852,123,24809,5,8,0,4,0,17,10,5,10,0,0,25,nowin,win,dlbust,bust,20,0,13,205,0.43902439,0.034146341,0.614634146,2,0.609962544
28853,94,24809,7,3,3,10,0,23,10,5,10,0,0,25,nowin,loss,bust,plbust,0,10,10,183,0.43715847,0.043715847,0.540983607,1,0.290866892
28854,101,24810,10,7,0,0,0,17,10,9,0,0,0,19,nowin,loss,beat,dlwin,0,10,17,205,0.424390244,0.068292683,0.63902439,2,0.614740646
28855,115,24810,11,5,2,0,0,18,10,9,0,0,0,19,nowin,loss,beat,dlwin,0,10,16,194,0.427835052,0.041237113,0.592783505,2,0.583863602
28856,107,24810,3,6,11,0,0,20,10,9,0,0,0,19,nowin,win,plwin,beat,20,0,9,218,0.444954128,0.073394495,0.600917431,2,0.605210014
28857,2,24810,10,7,0,0,0,17,10,9,0,0,0,19,nowin,loss,beat,dlwin,0,10,17,200,0.445,0.035,0.64,2,0.633962549
28858,61,24810,10,11,0,0,0,21,10,9,0,0,0,19,win,win,plwin,beat,25,0,21,194,0.427835052,0.077319588,0.603092784,2,0.591437139
28859,42,24810,11,1,1,1,3,17,10,9,0,0,0,19,nowin,loss,beat,dlwin,0,10,12,212,0.443396226,0.051886792,0.570754717,1,0.309181312
28860,67,24811,10,4,0,0,0,14,6,10,1,0,0,17,nowin,loss,beat,dlwin,0,10,14,195,0.369230769,0.041025641,0.569230769,0,0.014139427
28861,30,24811,9,9,0,0,0,18,6,10,1,0,0,17,nowin,win,plwin,beat,20,0,18,206,0.393203883,0.033980583,0.601941748,0,0.029324648
28862,105,24811,10,5,0,0,0,15,6,10,1,0,0,17,nowin,loss,beat,dlwin,0,10,15,198,0.414141414,0.070707071,0.590909091,0,0.032889494
28863,48,24811,10,2,0,0,0,12,6,10,1,0,0,17,nowin,loss,beat,dlwin,0,10,12,203,0.413793103,0.019704433,0.600985222,2,0.577280801
28864,18,24811,11,2,7,0,0,20,6,10,1,0,0,17,nowin,win,plwin,beat,20,0,13,182,0.461538462,0.043956044,0.587912088,3,0.892649374
28865,44,24811,8,4,0,0,0,12,6,10,1,0,0,17,nowin,loss,beat,dlwin,0,10,12,219,0.433789954,0.050228311,0.534246575,1,0.285551035
28866,98,24812,10,5,0,0,0,15,3,5,9,0,0,17,nowin,loss,beat,dlwin,0,10,15,220,0.422727273,0.054545455,0.55,1,0.28664435
28867,60,24812,10,10,0,0,0,20,3,5,9,0,0,17,nowin,win,plwin,beat,20,0,20,227,0.418502203,0.022026432,0.559471366,0,0.026496258
28868,125,24812,3,10,0,0,0,13,3,5,9,0,0,17,nowin,loss,beat,dlwin,0,10,13,219,0.438356164,0.050228311,0.575342466,1,0.308411257
28869,1,24812,10,11,0,0,0,21,3,5,9,0,0,17,win,win,plwin,beat,25,0,21,197,0.406091371,0.025380711,0.649746193,2,0.606186955
28870,15,24812,10,10,0,0,0,20,3,5,9,0,0,17,nowin,win,plwin,beat,20,0,20,212,0.410377358,0.051886792,0.561320755,0,0.024517408
28871,120,24812,10,11,0,0,0,21,3,5,9,0,0,17,win,win,plwin,beat,25,0,21,202,0.440594059,0.034653465,0.618811881,2,0.614441029
28872,1,24813,7,10,0,0,0,17,10,6,3,0,0,19,nowin,loss,beat,dlwin,0,10,17,197,0.406091371,0.025380711,0.649746193,2,0.606186955
28873,48,24813,4,3,2,3,6,18,10,6,3,0,0,19,nowin,loss,beat,dlwin,0,10,7,203,0.413793103,0.019704433,0.600985222,2,0.577280801
28874,38,24813,3,7,4,1,10,25,10,6,3,0,0,19,nowin,loss,bust,plbust,0,10,10,202,0.361386139,0.03960396,0.564356436,0,0.010597953
28875,128,24813,4,2,4,2,10,22,10,6,3,0,0,19,nowin,loss,bust,plbust,0,10,6,227,0.356828194,0.052863436,0.577092511,0,0.012352564
28876,71,24813,8,10,0,0,0,18,10,6,3,0,0,19,nowin,loss,beat,dlwin,0,10,18,193,0.352331606,0.046632124,0.585492228,0,0.013063661
28877,107,24813,4,8,0,6,0,18,10,6,3,0,0,19,nowin,loss,beat,dlwin,0,10,12,218,0.444954128,0.073394495,0.600917431,2,0.605210014
28878,68,24814,2,5,10,0,0,17,11,6,0,0,0,17,nowin,push,push,push,10,0,7,205,0.434146341,0.029268293,0.6,2,0.59483189
28879,99,24814,8,10,0,0,0,18,11,6,0,0,0,17,nowin,win,plwin,beat,20,0,18,207,0.47826087,0.062801932,0.637681159,3,0.961418446
28880,136,24814,8,9,0,0,0,17,11,6,0,0,0,17,nowin,push,push,push,10,0,17,194,0.396907216,0.025773196,0.597938144,0,0.029452644
28881,21,24814,9,9,0,0,0,18,11,6,0,0,0,17,nowin,win,plwin,beat,20,0,18,214,0.359813084,0.042056075,0.626168224,0,0.025263474
28882,15,24814,8,11,0,0,0,19,11,6,0,0,0,17,nowin,win,plwin,beat,20,0,19,212,0.410377358,0.051886792,0.561320755,0,0.024517408
28883,71,24814,6,7,0,3,10,26,11,6,0,0,0,17,nowin,loss,bust,plbust,0,10,13,193,0.352331606,0.046632124,0.585492228,0,0.013063661
28884,131,24815,10,5,0,3,0,18,8,10,0,0,0,18,nowin,push,push,push,10,0,15,217,0.410138249,0.069124424,0.543778802,0,0.02015021
28885,70,24815,10,4,0,6,0,20,8,10,0,0,0,18,nowin,win,plwin,beat,20,0,14,228,0.385964912,0.039473684,0.557017544,0,0.016157125
28886,5,24815,5,8,0,9,0,22,8,10,0,0,0,18,nowin,loss,bust,plbust,0,10,13,203,0.42364532,0.02955665,0.596059113,2,0.582508076
28887,123,24815,9,11,0,0,0,20,8,10,0,0,0,18,nowin,win,plwin,beat,20,0,20,205,0.43902439,0.034146341,0.614634146,2,0.609962544
28888,47,24815,9,8,0,0,0,17,8,10,0,0,0,18,nowin,loss,beat,dlwin,0,10,17,210,0.438095238,0.057142857,0.623809524,2,0.615868808
28889,50,24815,9,2,7,0,0,18,8,10,0,0,0,18,nowin,push,push,push,10,0,11,202,0.405940594,0.04950495,0.54950495,0,0.020296079
28890,42,24816,10,10,0,0,0,20,3,10,3,10,0,26,nowin,win,dlbust,bust,20,0,20,212,0.443396226,0.051886792,0.570754717,1,0.309181312
28891,69,24816,6,8,0,0,0,14,3,10,3,10,0,26,nowin,win,dlbust,bust,20,0,14,194,0.365979381,0.030927835,0.515463918,0,0
28892,23,24816,10,8,0,0,0,18,3,10,3,10,0,26,nowin,win,dlbust,bust,20,0,18,208,0.427884615,0.0625,0.552884615,1,0.29114424
28893,107,24816,8,10,0,0,0,18,3,10,3,10,0,26,nowin,win,dlbust,bust,20,0,18,218,0.444954128,0.073394495,0.600917431,2,0.605210014
28894,134,24816,2,9,10,0,0,21,3,10,3,10,0,26,nowin,win,dlbust,bust,20,0,11,185,0.443243243,0.021621622,0.545945946,1,0.296939509
28895,81,24816,7,11,0,0,0,18,3,10,3,10,0,26,nowin,win,dlbust,bust,20,0,18,182,0.395604396,0.043956044,0.60989011,2,0.567491261
28896,5,24817,8,4,0,10,0,22,8,5,1,1,3,18,nowin,loss,bust,plbust,0,10,12,203,0.42364532,0.02955665,0.596059113,2,0.582508076
28897,69,24817,10,11,0,0,0,21,8,5,1,1,3,18,win,win,plwin,beat,25,0,21,194,0.365979381,0.030927835,0.515463918,0,0
28898,82,24817,11,4,6,0,0,21,8,5,1,1,3,18,nowin,win,plwin,beat,20,0,15,225,0.408888889,0.075555556,0.577777778,0,0.028101874
28899,62,24817,4,10,0,7,0,21,8,5,1,1,3,18,nowin,win,plwin,beat,20,0,14,178,0.370786517,0.028089888,0.54494382,0,0.008657722
28900,132,24817,3,2,10,9,0,24,8,5,1,1,3,18,nowin,loss,bust,plbust,0,10,5,194,0.412371134,0.036082474,0.649484536,2,0.611633238
28901,61,24817,10,11,0,0,0,21,8,5,1,1,3,18,win,win,plwin,beat,25,0,21,194,0.427835052,0.077319588,0.603092784,2,0.591437139
28902,2,24818,5,10,0,4,0,19,7,2,9,0,0,18,nowin,win,plwin,beat,20,0,15,200,0.445,0.035,0.64,2,0.633962549
28903,66,24818,10,4,0,2,9,25,7,2,9,0,0,18,nowin,loss,bust,plbust,0,10,14,217,0.456221198,0.064516129,0.626728111,3,0.924304367
28904,82,24818,11,7,0,0,0,18,7,2,9,0,0,18,nowin,push,push,push,10,0,18,225,0.408888889,0.075555556,0.577777778,0,0.028101874
28905,35,24818,2,6,8,10,0,26,7,2,9,0,0,18,nowin,loss,bust,plbust,0,10,8,202,0.410891089,0.044554455,0.633663366,2,0.598681573
28906,68,24818,7,5,0,7,0,19,7,2,9,0,0,18,nowin,win,plwin,beat,20,0,12,205,0.434146341,0.029268293,0.6,2,0.59483189
28907,122,24818,10,2,0,6,0,18,7,2,9,0,0,18,nowin,push,push,push,10,0,12,210,0.347619048,0.052380952,0.59047619,0,0.012873677
28908,78,24819,2,10,0,10,0,22,3,4,2,10,0,19,nowin,loss,bust,plbust,0,10,12,201,0.517412935,0.034825871,0.587064677,3,0.95871112
28909,15,24819,3,5,9,0,0,17,3,4,2,10,0,19,nowin,loss,beat,dlwin,0,10,8,212,0.410377358,0.051886792,0.561320755,0,0.024517408
28910,140,24819,10,4,0,0,0,14,3,4,2,10,0,19,nowin,loss,beat,dlwin,0,10,14,210,0.466666667,0.023809524,0.604761905,3,0.915293335
28911,106,24819,9,4,0,0,0,13,3,4,2,10,0,19,nowin,loss,beat,dlwin,0,10,13,192,0.411458333,0.026041667,0.557291667,0,0.023854304
28912,106,24819,10,3,0,0,0,13,3,4,2,10,0,19,nowin,loss,beat,dlwin,0,10,13,192,0.411458333,0.026041667,0.557291667,0,0.023854304
28913,50,24819,2,10,0,4,0,16,3,4,2,10,0,19,nowin,loss,beat,dlwin,0,10,12,202,0.405940594,0.04950495,0.54950495,0,0.020296079
28914,20,24820,9,7,0,0,0,16,2,2,10,1,5,20,nowin,loss,beat,dlwin,0,10,16,186,0.456989247,0.037634409,0.537634409,1,0.301097108
28915,32,24820,10,4,0,0,0,14,2,2,10,1,5,20,nowin,loss,beat,dlwin,0,10,14,189,0.391534392,0.037037037,0.53968254,0,0.013579086
28916,132,24820,6,3,10,0,0,19,2,2,10,1,5,20,nowin,loss,beat,dlwin,0,10,9,194,0.412371134,0.036082474,0.649484536,2,0.611633238
28917,15,24820,7,8,0,0,0,15,2,2,10,1,5,20,nowin,loss,beat,dlwin,0,10,15,212,0.410377358,0.051886792,0.561320755,0,0.024517408
28918,21,24820,6,3,11,0,0,20,2,2,10,1,5,20,nowin,push,push,push,10,0,9,214,0.359813084,0.042056075,0.626168224,0,0.025263474
28919,21,24820,10,10,0,0,0,20,2,2,10,1,5,20,nowin,push,push,push,10,0,20,214,0.359813084,0.042056075,0.626168224,0,0.025263474
28920,130,24821,9,3,0,10,0,22,10,10,0,0,0,20,nowin,loss,bust,plbust,0,10,12,219,0.410958904,0.03652968,0.566210046,0,0.025888739
28921,62,24821,10,10,0,0,0,20,10,10,0,0,0,20,nowin,push,push,push,10,0,20,178,0.370786517,0.028089888,0.54494382,0,0.008657722
28922,144,24821,7,10,0,0,0,17,10,10,0,0,0,20,nowin,loss,beat,dlwin,0,10,17,202,0.386138614,0.054455446,0.564356436,0,0.018006244
28923,75,24821,10,3,0,9,0,22,10,10,0,0,0,20,nowin,loss,bust,plbust,0,10,13,191,0.418848168,0.052356021,0.570680628,0,0.029344702
28924,3,24821,10,9,0,0,0,19,10,10,0,0,0,20,nowin,loss,beat,dlwin,0,10,19,190,0.431578947,0.026315789,0.542105263,1,0.288076384
28925,35,24821,2,6,5,7,0,20,10,10,0,0,0,20,nowin,push,push,push,10,0,8,202,0.410891089,0.044554455,0.633663366,2,0.598681573
28926,117,24822,5,10,0,2,0,17,9,10,0,0,0,19,nowin,loss,beat,dlwin,0,10,15,173,0.410404624,0.069364162,0.606936416,2,0.578610282
28927,107,24822,3,9,0,9,0,21,9,10,0,0,0,19,nowin,win,plwin,beat,20,0,12,218,0.444954128,0.073394495,0.600917431,2,0.605210014
28928,102,24822,10,3,0,10,0,23,9,10,0,0,0,19,nowin,loss,bust,plbust,0,10,13,192,0.338541667,0.046875,0.5625,0,0.003306118
28929,63,24822,10,5,0,2,0,17,9,10,0,0,0,19,nowin,loss,beat,dlwin,0,10,15,216,0.467592593,0.037037037,0.62037037,3,0.931690496
28930,2,24822,10,4,0,10,0,24,9,10,0,0,0,19,nowin,loss,bust,plbust,0,10,14,200,0.445,0.035,0.64,2,0.633962549
28931,120,24822,6,5,10,0,0,21,9,10,0,0,0,19,nowin,win,plwin,beat,20,0,11,202,0.440594059,0.034653465,0.618811881,2,0.614441029
28932,38,24823,10,10,0,0,0,20,10,9,0,0,0,19,nowin,win,plwin,beat,20,0,20,202,0.361386139,0.03960396,0.564356436,0,0.010597953
28933,76,24823,6,11,3,0,0,20,10,9,0,0,0,19,nowin,win,plwin,beat,20,0,17,189,0.534391534,0.079365079,0.608465608,3,1
28934,48,24823,2,10,0,10,0,22,10,9,0,0,0,19,nowin,loss,bust,plbust,0,10,12,203,0.413793103,0.019704433,0.600985222,2,0.577280801
28935,117,24823,3,8,4,4,0,19,10,9,0,0,0,19,nowin,push,push,push,10,0,11,173,0.410404624,0.069364162,0.606936416,2,0.578610282
28936,19,24823,10,4,0,3,0,17,10,9,0,0,0,19,nowin,loss,beat,dlwin,0,10,14,237,0.41350211,0.054852321,0.628691983,2,0.597373826
28937,73,24823,3,10,0,10,0,23,10,9,0,0,0,19,nowin,loss,bust,plbust,0,10,13,181,0.375690608,0.011049724,0.596685083,0,0.022795773
28938,139,24824,8,10,0,0,0,18,10,7,0,0,0,17,nowin,win,plwin,beat,20,0,18,192,0.380208333,0.036458333,0.59375,0,0.023429169
28939,86,24824,11,10,0,0,0,21,10,7,0,0,0,17,win,win,plwin,beat,25,0,21,196,0.454081633,0.040816327,0.591836735,3,0.887566443
28940,140,24824,9,2,10,0,0,21,10,7,0,0,0,17,nowin,win,plwin,beat,20,0,11,210,0.466666667,0.023809524,0.604761905,3,0.915293335
28941,149,24824,7,7,0,10,0,24,10,7,0,0,0,17,nowin,loss,bust,plbust,0,10,14,225,0.457777778,0.057777778,0.648888889,2,0.651965595
28942,66,24824,4,4,7,4,0,19,10,7,0,0,0,17,nowin,win,plwin,beat,20,0,8,217,0.456221198,0.064516129,0.626728111,3,0.924304367
28943,87,24824,8,8,0,10,0,26,10,7,0,0,0,17,nowin,loss,bust,plbust,0,10,16,202,0.405940594,0.054455446,0.628712871,2,0.590599801
28944,112,24825,4,7,10,0,0,21,11,10,0,0,0,21,nowin,push,push,push,10,0,11,203,0.448275862,0.054187192,0.600985222,3,0.889576933
28945,124,24825,3,2,7,3,8,23,11,10,0,0,0,21,nowin,loss,bust,plbust,0,10,5,202,0.47029703,0.064356436,0.584158416,3,0.899458193
28946,28,24825,8,10,0,0,0,18,11,10,0,0,0,21,nowin,loss,beat,dlwin,0,10,18,199,0.422110553,0.045226131,0.542713568,1,0.282706618
28947,25,24825,5,9,0,10,0,24,11,10,0,0,0,21,nowin,loss,bust,plbust,0,10,14,190,0.463157895,0.063157895,0.536842105,1,0.304401563
28948,109,24825,8,10,0,0,0,18,11,10,0,0,0,21,nowin,loss,beat,dlwin,0,10,18,221,0.461538462,0.058823529,0.597285068,3,0.901830309
28949,82,24825,10,11,0,0,0,21,11,10,0,0,0,21,win,push,push,push,10,0,21,225,0.408888889,0.075555556,0.577777778,0,0.028101874
28950,41,24826,10,10,0,0,0,20,7,11,0,0,0,18,nowin,win,plwin,beat,20,0,20,192,0.364583333,0.036458333,0.520833333,0,0.00089702
28951,136,24826,8,6,0,1,10,25,7,11,0,0,0,18,nowin,loss,bust,plbust,0,10,14,194,0.396907216,0.025773196,0.597938144,0,0.029452644
28952,123,24826,5,7,0,10,0,22,7,11,0,0,0,18,nowin,loss,bust,plbust,0,10,12,205,0.43902439,0.034146341,0.614634146,2,0.609962544
28953,124,24826,5,9,0,9,0,23,7,11,0,0,0,18,nowin,loss,bust,plbust,0,10,14,202,0.47029703,0.064356436,0.584158416,3,0.899458193
28954,102,24826,8,9,0,0,0,17,7,11,0,0,0,18,nowin,loss,beat,dlwin,0,10,17,192,0.338541667,0.046875,0.5625,0,0.003306118
28955,10,24826,7,2,4,1,5,19,7,11,0,0,0,18,nowin,win,plwin,beat,20,0,9,191,0.413612565,0.057591623,0.596858639,2,0.574087175
28956,132,24827,7,5,0,0,0,12,4,10,8,0,0,22,nowin,win,dlbust,bust,20,0,12,194,0.412371134,0.036082474,0.649484536,2,0.611633238
28957,94,24827,3,11,6,0,0,20,4,10,8,0,0,22,nowin,win,dlbust,bust,20,0,14,183,0.43715847,0.043715847,0.540983607,1,0.290866892
28958,115,24827,6,10,0,0,0,16,4,10,8,0,0,22,nowin,win,dlbust,bust,20,0,16,194,0.427835052,0.041237113,0.592783505,2,0.583863602
28959,106,24827,5,7,0,0,0,12,4,10,8,0,0,22,nowin,win,dlbust,bust,20,0,12,192,0.411458333,0.026041667,0.557291667,0,0.023854304
28960,97,24827,9,9,0,0,0,18,4,10,8,0,0,22,nowin,win,dlbust,bust,20,0,18,182,0.450549451,0.06043956,0.692307692,2,0.677372279
28961,25,24827,4,10,0,0,0,14,4,10,8,0,0,22,nowin,win,dlbust,bust,20,0,14,190,0.463157895,0.063157895,0.536842105,1,0.304401563
28962,132,24828,5,1,10,10,0,26,8,2,10,0,0,20,nowin,loss,bust,plbust,0,10,6,194,0.412371134,0.036082474,0.649484536,2,0.611633238
28963,125,24828,5,10,0,8,0,23,8,2,10,0,0,20,nowin,loss,bust,plbust,0,10,15,219,0.438356164,0.050228311,0.575342466,1,0.308411257
28964,36,24828,6,1,9,9,0,25,8,2,10,0,0,20,nowin,loss,bust,plbust,0,10,7,229,0.445414847,0.056768559,0.655021834,2,0.645370571
28965,35,24828,2,6,3,10,0,21,8,2,10,0,0,20,nowin,win,plwin,beat,20,0,8,202,0.410891089,0.044554455,0.633663366,2,0.598681573
28966,37,24828,9,10,0,0,0,19,8,2,10,0,0,20,nowin,loss,beat,dlwin,0,10,19,208,0.394230769,0.038461538,0.581730769,0,0.024682772
28967,35,24828,7,10,0,0,0,17,8,2,10,0,0,20,nowin,loss,beat,dlwin,0,10,17,202,0.410891089,0.044554455,0.633663366,2,0.598681573
28968,1,24829,10,10,0,0,0,20,10,4,5,0,0,19,nowin,win,plwin,beat,20,0,20,197,0.406091371,0.025380711,0.649746193,2,0.606186955
28969,12,24829,4,1,10,2,0,17,10,4,5,0,0,19,nowin,loss,beat,dlwin,0,10,5,189,0.470899471,0.015873016,0.613756614,3,0.929171178
28970,96,24829,4,4,4,10,0,22,10,4,5,0,0,19,nowin,loss,bust,plbust,0,10,8,190,0.468421053,0.057894737,0.584210526,3,0.897263354
28971,58,24829,3,10,0,10,0,23,10,4,5,0,0,19,nowin,loss,bust,plbust,0,10,13,195,0.430769231,0.041025641,0.584615385,2,0.580497586
28972,120,24829,8,10,0,0,0,18,10,4,5,0,0,19,nowin,loss,beat,dlwin,0,10,18,202,0.440594059,0.034653465,0.618811881,2,0.614441029
28973,36,24829,8,6,0,5,0,19,10,4,5,0,0,19,nowin,push,push,push,10,0,14,229,0.445414847,0.056768559,0.655021834,2,0.645370571
28974,33,24830,10,5,0,5,0,20,10,6,3,0,0,19,nowin,win,plwin,beat,20,0,15,192,0.4375,0.057291667,0.625,2,0.616208916
28975,16,24830,10,11,0,0,0,21,10,6,3,0,0,19,win,win,plwin,beat,25,0,21,220,0.427272727,0.081818182,0.6,2,0.588660176
28976,52,24830,2,2,2,2,1,9,10,6,3,0,0,19,nowin,loss,beat,dlwin,0,10,4,217,0.414746544,0.02764977,0.599078341,2,0.576736024
28977,36,24830,10,4,0,6,0,20,10,6,3,0,0,19,nowin,win,plwin,beat,20,0,14,229,0.445414847,0.056768559,0.655021834,2,0.645370571
28978,71,24830,10,3,0,10,0,23,10,6,3,0,0,19,nowin,loss,bust,plbust,0,10,13,193,0.352331606,0.046632124,0.585492228,0,0.013063661
28979,74,24830,4,11,3,0,0,18,10,6,3,0,0,19,nowin,loss,beat,dlwin,0,10,15,209,0.411483254,0.04784689,0.531100478,0,0.017448125
28980,107,24831,11,2,8,0,0,21,3,5,7,10,0,25,nowin,win,dlbust,bust,20,0,13,218,0.444954128,0.073394495,0.600917431,2,0.605210014
28981,134,24831,3,10,0,0,0,13,3,5,7,10,0,25,nowin,win,dlbust,bust,20,0,13,185,0.443243243,0.021621622,0.545945946,1,0.296939509
28982,53,24831,3,11,7,0,0,21,3,5,7,10,0,25,nowin,win,dlbust,bust,20,0,14,250,0.372,0.064,0.564,0,0.013687345
28983,81,24831,10,10,0,0,0,20,3,5,7,10,0,25,nowin,win,dlbust,bust,20,0,20,182,0.395604396,0.043956044,0.60989011,2,0.567491261
28984,138,24831,10,10,0,0,0,20,3,5,7,10,0,25,nowin,win,dlbust,bust,20,0,20,190,0.442105263,0.047368421,0.610526316,2,0.609711065
28985,116,24831,7,10,0,0,0,17,3,5,7,10,0,25,nowin,win,dlbust,bust,20,0,17,195,0.425641026,0.056410256,0.538461538,1,0.28273747
28986,126,24832,11,10,0,0,0,21,11,10,0,0,0,21,win,push,push,push,10,0,21,188,0.457446809,0.074468085,0.60106383,3,0.900633203
28987,99,24832,8,7,0,10,0,25,11,10,0,0,0,21,nowin,loss,bust,plbust,0,10,15,207,0.47826087,0.062801932,0.637681159,3,0.961418446
28988,7,24832,8,4,0,10,0,22,11,10,0,0,0,21,nowin,loss,bust,plbust,0,10,12,183,0.442622951,0.06010929,0.62295082,2,0.619303341
28989,30,24832,3,10,0,8,0,21,11,10,0,0,0,21,nowin,push,push,push,10,0,13,206,0.393203883,0.033980583,0.601941748,0,0.029324648
28990,105,24832,9,10,0,0,0,19,11,10,0,0,0,21,nowin,loss,beat,dlwin,0,10,19,198,0.414141414,0.070707071,0.590909091,0,0.032889494
28991,49,24832,4,1,10,7,0,22,11,10,0,0,0,21,nowin,loss,bust,plbust,0,10,5,207,0.396135266,0.053140097,0.594202899,0,0.028306925
28992,97,24833,10,4,0,6,0,20,8,10,0,0,0,18,nowin,win,plwin,beat,20,0,14,182,0.450549451,0.06043956,0.692307692,2,0.677372279
28993,98,24833,2,10,0,10,0,22,8,10,0,0,0,18,nowin,loss,bust,plbust,0,10,12,220,0.422727273,0.054545455,0.55,1,0.28664435
28994,30,24833,6,6,0,10,0,22,8,10,0,0,0,18,nowin,loss,bust,plbust,0,10,12,206,0.393203883,0.033980583,0.601941748,0,0.029324648
28995,99,24833,10,3,0,10,0,23,8,10,0,0,0,18,nowin,loss,bust,plbust,0,10,13,207,0.47826087,0.062801932,0.637681159,3,0.961418446
28996,128,24833,9,9,0,0,0,18,8,10,0,0,0,18,nowin,push,push,push,10,0,18,227,0.356828194,0.052863436,0.577092511,0,0.012352564
28997,20,24833,9,10,0,0,0,19,8,10,0,0,0,18,nowin,win,plwin,beat,20,0,19,186,0.456989247,0.037634409,0.537634409,1,0.301097108
28998,109,24834,4,4,4,0,0,12,4,7,3,5,0,19,nowin,loss,beat,dlwin,0,10,8,221,0.461538462,0.058823529,0.597285068,3,0.901830309
28999,147,24834,3,10,0,0,0,13,4,7,3,5,0,19,nowin,loss,beat,dlwin,0,10,13,205,0.380487805,0.014634146,0.536585366,0,0.00951447
29000,3,24834,6,10,0,0,0,16,4,7,3,5,0,19,nowin,loss,beat,dlwin,0,10,16,190,0.431578947,0.026315789,0.542105263,1,0.288076384
29001,141,24834,9,11,0,0,0,20,4,7,3,5,0,19,nowin,win,plwin,beat,20,0,20,202,0.420792079,0.074257426,0.564356436,0,0.028377851
29002,37,24834,3,5,11,0,0,19,4,7,3,5,0,19,nowin,push,push,push,10,0,8,208,0.394230769,0.038461538,0.581730769,0,0.024682772
29003,85,24834,3,10,0,0,0,13,4,7,3,5,0,19,nowin,loss,beat,dlwin,0,10,13,195,0.41025641,0.066666667,0.594871795,0,0.03269711
29004,146,24835,2,10,0,2,9,23,11,9,0,0,0,20,nowin,loss,bust,plbust,0,10,12,221,0.43438914,0.040723982,0.542986425,1,0.290190091
29005,2,24835,9,10,0,0,0,19,11,9,0,0,0,20,nowin,loss,beat,dlwin,0,10,19,200,0.445,0.035,0.64,2,0.633962549
29006,11,24835,10,7,0,0,0,17,11,9,0,0,0,20,nowin,loss,beat,dlwin,0,10,17,236,0.457627119,0.016949153,0.588983051,3,0.889015813
29007,10,24835,10,8,0,0,0,18,11,9,0,0,0,20,nowin,loss,beat,dlwin,0,10,18,191,0.413612565,0.057591623,0.596858639,2,0.574087175
29008,122,24835,8,6,0,10,0,24,11,9,0,0,0,20,nowin,loss,bust,plbust,0,10,14,210,0.347619048,0.052380952,0.59047619,0,0.012873677
29009,86,24835,6,10,0,8,0,24,11,9,0,0,0,20,nowin,loss,bust,plbust,0,10,16,196,0.454081633,0.040816327,0.591836735,3,0.887566443
29010,128,24836,6,7,0,10,0,23,8,2,10,0,0,20,nowin,loss,bust,plbust,0,10,13,227,0.356828194,0.052863436,0.577092511,0,0.012352564
29011,52,24836,10,10,0,0,0,20,8,2,10,0,0,20,nowin,push,push,push,10,0,20,217,0.414746544,0.02764977,0.599078341,2,0.576736024
29012,30,24836,5,4,8,0,0,17,8,2,10,0,0,20,nowin,loss,beat,dlwin,0,10,9,206,0.393203883,0.033980583,0.601941748,0,0.029324648
29013,73,24836,7,10,0,0,0,17,8,2,10,0,0,20,nowin,loss,beat,dlwin,0,10,17,181,0.375690608,0.011049724,0.596685083,0,0.022795773
29014,113,24836,10,10,0,0,0,20,8,2,10,0,0,20,nowin,push,push,push,10,0,20,199,0.407035176,0.055276382,0.668341709,2,0.620695264
29015,125,24836,6,3,10,0,0,19,8,2,10,0,0,20,nowin,loss,beat,dlwin,0,10,9,219,0.438356164,0.050228311,0.575342466,1,0.308411257
29016,132,24837,9,10,0,0,0,19,10,11,0,0,0,21,nowin,loss,beat,dlwin,0,10,19,194,0.412371134,0.036082474,0.649484536,2,0.611633238
29017,68,24837,2,6,6,10,0,24,10,11,0,0,0,21,nowin,loss,bust,plbust,0,10,8,205,0.434146341,0.029268293,0.6,2,0.59483189
29018,126,24837,2,1,10,7,0,20,10,11,0,0,0,21,nowin,loss,beat,dlwin,0,10,3,188,0.457446809,0.074468085,0.60106383,3,0.900633203
29019,43,24837,10,10,0,0,0,20,10,11,0,0,0,21,nowin,loss,beat,dlwin,0,10,20,192,0.40625,0.041666667,0.609375,2,0.576671372
29020,5,24837,9,2,1,9,0,21,10,11,0,0,0,21,nowin,push,push,push,10,0,11,203,0.42364532,0.02955665,0.596059113,2,0.582508076
29021,70,24837,5,7,0,3,10,25,10,11,0,0,0,21,nowin,loss,bust,plbust,0,10,12,228,0.385964912,0.039473684,0.557017544,0,0.016157125
29022,28,24838,10,10,0,0,0,20,1,2,10,10,0,23,nowin,win,dlbust,bust,20,0,20,199,0.422110553,0.045226131,0.542713568,1,0.282706618
29023,18,24838,10,3,0,4,0,17,1,2,10,10,0,23,nowin,win,dlbust,bust,20,0,13,182,0.461538462,0.043956044,0.587912088,3,0.892649374
29024,144,24838,10,7,0,0,0,17,1,2,10,10,0,23,nowin,win,dlbust,bust,20,0,17,202,0.386138614,0.054455446,0.564356436,0,0.018006244
29025,1,24838,10,10,0,0,0,20,1,2,10,10,0,23,nowin,win,dlbust,bust,20,0,20,197,0.406091371,0.025380711,0.649746193,2,0.606186955
29026,76,24838,5,6,1,3,1,16,1,2,10,10,0,23,nowin,win,dlbust,bust,20,0,11,189,0.534391534,0.079365079,0.608465608,3,1
29027,150,24838,6,8,0,6,0,20,1,2,10,10,0,23,nowin,win,dlbust,bust,20,0,14,192,0.401041667,0.036458333,0.567708333,0,0.023287458
29028,142,24839,8,7,0,0,0,15,4,7,10,0,0,21,nowin,loss,beat,dlwin,0,10,15,211,0.417061611,0.047393365,0.526066351,1,0.271531309
29029,148,24839,4,10,0,0,0,14,4,7,10,0,0,21,nowin,loss,beat,dlwin,0,10,14,204,0.401960784,0.078431373,0.593137255,0,0.029789521
29030,46,24839,10,6,0,0,0,16,4,7,10,0,0,21,nowin,loss,beat,dlwin,0,10,16,186,0.403225806,0.048387097,0.591397849,0,0.029742194
29031,1,24839,6,10,0,0,0,16,4,7,10,0,0,21,nowin,loss,beat,dlwin,0,10,16,197,0.406091371,0.025380711,0.649746193,2,0.606186955
29032,56,24839,10,11,0,0,0,21,4,7,10,0,0,21,win,push,push,push,10,0,21,175,0.4,0.057142857,0.582857143,0,0.026685297
29033,107,24839,6,10,0,0,0,16,4,7,10,0,0,21,nowin,loss,beat,dlwin,0,10,16,218,0.444954128,0.073394495,0.600917431,2,0.605210014
29034,40,24840,3,11,7,0,0,21,10,6,10,0,0,26,nowin,win,dlbust,bust,20,0,14,196,0.367346939,0.030612245,0.617346939,0,0.025358183
29035,108,24840,10,7,0,0,0,17,10,6,10,0,0,26,nowin,win,dlbust,bust,20,0,17,193,0.435233161,0.056994819,0.559585492,1,0.298824795
29036,34,24840,10,9,0,0,0,19,10,6,10,0,0,26,nowin,win,dlbust,bust,20,0,19,202,0.5,0.079207921,0.618811881,3,0.968961434
29037,109,24840,10,3,0,5,0,18,10,6,10,0,0,26,nowin,win,dlbust,bust,20,0,13,221,0.461538462,0.058823529,0.597285068,3,0.901830309
29038,147,24840,4,8,0,6,0,18,10,6,10,0,0,26,nowin,win,dlbust,bust,20,0,12,205,0.380487805,0.014634146,0.536585366,0,0.00951447
29039,75,24840,6,10,0,10,0,26,10,6,10,0,0,26,nowin,loss,bust,plbust,0,10,16,191,0.418848168,0.052356021,0.570680628,0,0.029344702
29040,116,24841,3,2,10,4,0,19,10,3,9,0,0,22,nowin,win,dlbust,bust,20,0,5,195,0.425641026,0.056410256,0.538461538,1,0.28273747
29041,109,24841,6,8,0,5,0,19,10,3,9,0,0,22,nowin,win,dlbust,bust,20,0,14,221,0.461538462,0.058823529,0.597285068,3,0.901830309
29042,61,24841,1,4,10,2,0,17,10,3,9,0,0,22,nowin,win,dlbust,bust,20,0,5,194,0.427835052,0.077319588,0.603092784,2,0.591437139
29043,42,24841,11,5,4,0,0,20,10,3,9,0,0,22,nowin,win,dlbust,bust,20,0,16,212,0.443396226,0.051886792,0.570754717,1,0.309181312
29044,124,24841,3,6,2,3,2,16,10,3,9,0,0,22,nowin,win,dlbust,bust,20,0,9,202,0.47029703,0.064356436,0.584158416,3,0.899458193
29045,110,24841,9,9,0,0,0,18,10,3,9,0,0,22,nowin,win,dlbust,bust,20,0,18,192,0.416666667,0.046875,0.557291667,0,0.025413132
29046,124,24842,10,5,0,10,0,25,10,8,0,0,0,18,nowin,loss,bust,plbust,0,10,15,202,0.47029703,0.064356436,0.584158416,3,0.899458193
29047,29,24842,10,10,0,0,0,20,10,8,0,0,0,18,nowin,win,plwin,beat,20,0,20,189,0.44973545,0.058201058,0.544973545,1,0.300349439
29048,30,24842,5,10,0,10,0,25,10,8,0,0,0,18,nowin,loss,bust,plbust,0,10,15,206,0.393203883,0.033980583,0.601941748,0,0.029324648
29049,77,24842,10,10,0,0,0,20,10,8,0,0,0,18,nowin,win,plwin,beat,20,0,20,200,0.455,0.04,0.62,3,0.916252116
29050,79,24842,10,10,0,0,0,20,10,8,0,0,0,18,nowin,win,plwin,beat,20,0,20,211,0.436018957,0.028436019,0.672985782,2,0.650131054
29051,91,24842,5,10,0,10,0,25,10,8,0,0,0,18,nowin,loss,bust,plbust,0,10,15,194,0.417525773,0.046391753,0.515463918,1,0.266616552
29052,76,24843,4,7,1,10,0,22,10,4,10,0,0,24,nowin,loss,bust,plbust,0,10,11,189,0.534391534,0.079365079,0.608465608,3,1
29053,104,24843,10,6,0,10,0,26,10,4,10,0,0,24,nowin,loss,bust,plbust,0,10,16,209,0.363636364,0.052631579,0.593301435,0,0.018359419
29054,2,24843,6,2,8,10,0,26,10,4,10,0,0,24,nowin,loss,bust,plbust,0,10,8,200,0.445,0.035,0.64,2,0.633962549
29055,87,24843,6,5,9,0,0,20,10,4,10,0,0,24,nowin,win,dlbust,bust,20,0,11,202,0.405940594,0.054455446,0.628712871,2,0.590599801
29056,115,24843,4,11,2,0,0,17,10,4,10,0,0,24,nowin,win,dlbust,bust,20,0,15,194,0.427835052,0.041237113,0.592783505,2,0.583863602
29057,47,24843,9,6,0,2,0,17,10,4,10,0,0,24,nowin,win,dlbust,bust,20,0,15,210,0.438095238,0.057142857,0.623809524,2,0.615868808
29058,10,24844,9,10,0,0,0,19,3,10,8,0,0,21,nowin,loss,beat,dlwin,0,10,19,191,0.413612565,0.057591623,0.596858639,2,0.574087175
29059,104,24844,10,10,0,0,0,20,3,10,8,0,0,21,nowin,loss,beat,dlwin,0,10,20,209,0.363636364,0.052631579,0.593301435,0,0.018359419
29060,94,24844,6,10,0,0,0,16,3,10,8,0,0,21,nowin,loss,beat,dlwin,0,10,16,183,0.43715847,0.043715847,0.540983607,1,0.290866892
29061,53,24844,10,6,0,0,0,16,3,10,8,0,0,21,nowin,loss,beat,dlwin,0,10,16,250,0.372,0.064,0.564,0,0.013687345
29062,15,24844,7,3,9,0,0,19,3,10,8,0,0,21,nowin,loss,beat,dlwin,0,10,10,212,0.410377358,0.051886792,0.561320755,0,0.024517408
29063,118,24844,10,10,0,0,0,20,3,10,8,0,0,21,nowin,loss,beat,dlwin,0,10,20,216,0.393518519,0.037037037,0.555555556,0,0.018059873
29064,117,24845,7,6,0,0,0,13,2,10,4,9,0,25,nowin,win,dlbust,bust,20,0,13,173,0.410404624,0.069364162,0.606936416,2,0.578610282
29065,130,24845,8,10,0,0,0,18,2,10,4,9,0,25,nowin,win,dlbust,bust,20,0,18,219,0.410958904,0.03652968,0.566210046,0,0.025888739
29066,129,24845,9,11,0,0,0,20,2,10,4,9,0,25,nowin,win,dlbust,bust,20,0,20,201,0.422885572,0.064676617,0.55721393,0,0.027255383
29067,67,24845,3,10,0,0,0,13,2,10,4,9,0,25,nowin,win,dlbust,bust,20,0,13,195,0.369230769,0.041025641,0.569230769,0,0.014139427
29068,32,24845,9,10,0,0,0,19,2,10,4,9,0,25,nowin,win,dlbust,bust,20,0,19,189,0.391534392,0.037037037,0.53968254,0,0.013579086
29069,121,24845,11,7,0,0,0,18,2,10,4,9,0,25,nowin,win,dlbust,bust,20,0,18,195,0.456410256,0.025641026,0.512820513,1,0.288597791
29070,68,24846,8,8,0,3,0,19,7,10,0,0,0,17,nowin,win,plwin,beat,20,0,16,205,0.434146341,0.029268293,0.6,2,0.59483189
29071,107,24846,10,10,0,0,0,20,7,10,0,0,0,17,nowin,win,plwin,beat,20,0,20,218,0.444954128,0.073394495,0.600917431,2,0.605210014
29072,72,24846,10,10,0,0,0,20,7,10,0,0,0,17,nowin,win,plwin,beat,20,0,20,185,0.394594595,0.032432432,0.508108108,0,0.006763115
29073,46,24846,6,3,11,0,0,20,7,10,0,0,0,17,nowin,win,plwin,beat,20,0,9,186,0.403225806,0.048387097,0.591397849,0,0.029742194
29074,120,24846,5,10,0,8,0,23,7,10,0,0,0,17,nowin,loss,bust,plbust,0,10,15,202,0.440594059,0.034653465,0.618811881,2,0.614441029
29075,146,24846,3,6,8,0,0,17,7,10,0,0,0,17,nowin,push,push,push,10,0,9,221,0.43438914,0.040723982,0.542986425,1,0.290190091
29076,31,24847,4,5,3,10,0,22,8,3,8,0,0,19,nowin,loss,bust,plbust,0,10,9,188,0.473404255,0.058510638,0.515957447,1,0.300306557
29077,89,24847,8,2,5,8,0,23,8,3,8,0,0,19,nowin,loss,bust,plbust,0,10,10,212,0.537735849,0.047169811,0.594339623,3,0.990167191
29078,5,24847,11,9,0,0,0,20,8,3,8,0,0,19,nowin,win,plwin,beat,20,0,20,203,0.42364532,0.02955665,0.596059113,2,0.582508076
29079,59,24847,11,5,1,0,0,17,8,3,8,0,0,19,nowin,loss,beat,dlwin,0,10,16,228,0.429824561,0.048245614,0.543859649,1,0.287885446
29080,49,24847,8,3,4,1,3,19,8,3,8,0,0,19,nowin,push,push,push,10,0,11,207,0.396135266,0.053140097,0.594202899,0,0.028306925
29081,65,24847,5,5,4,5,0,19,8,3,8,0,0,19,nowin,push,push,push,10,0,10,203,0.492610837,0.054187192,0.571428571,3,0.913702814
29082,65,24848,4,2,9,0,0,15,5,10,2,0,0,17,nowin,loss,beat,dlwin,0,10,6,203,0.492610837,0.054187192,0.571428571,3,0.913702814
29083,89,24848,9,3,0,0,0,12,5,10,2,0,0,17,nowin,loss,beat,dlwin,0,10,12,212,0.537735849,0.047169811,0.594339623,3,0.990167191
29084,136,24848,6,4,10,0,0,20,5,10,2,0,0,17,nowin,win,plwin,beat,20,0,10,194,0.396907216,0.025773196,0.597938144,0,0.029452644
29085,36,24848,10,10,0,0,0,20,5,10,2,0,0,17,nowin,win,plwin,beat,20,0,20,229,0.445414847,0.056768559,0.655021834,2,0.645370571
29086,50,24848,10,5,0,0,0,15,5,10,2,0,0,17,nowin,loss,beat,dlwin,0,10,15,202,0.405940594,0.04950495,0.54950495,0,0.020296079
29087,51,24848,3,2,10,0,0,15,5,10,2,0,0,17,nowin,loss,beat,dlwin,0,10,5,189,0.529100529,0.068783069,0.608465608,3,0.993665715
29088,17,24849,4,9,0,5,0,18,11,7,0,0,0,18,nowin,push,push,push,10,0,13,171,0.444444444,0.070175439,0.555555556,1,0.302364894
29089,97,24849,11,9,0,0,0,20,11,7,0,0,0,18,nowin,win,plwin,beat,20,0,20,182,0.450549451,0.06043956,0.692307692,2,0.677372279
29090,83,24849,10,8,0,0,0,18,11,7,0,0,0,18,nowin,push,push,push,10,0,18,193,0.424870466,0.051813472,0.678756477,2,0.644360335
29091,140,24849,10,7,0,0,0,17,11,7,0,0,0,18,nowin,loss,beat,dlwin,0,10,17,210,0.466666667,0.023809524,0.604761905,3,0.915293335
29092,19,24849,5,1,10,4,0,20,11,7,0,0,0,18,nowin,win,plwin,beat,20,0,6,237,0.41350211,0.054852321,0.628691983,2,0.597373826
29093,134,24849,10,6,0,5,0,21,11,7,0,0,0,18,nowin,win,plwin,beat,20,0,16,185,0.443243243,0.021621622,0.545945946,1,0.296939509
29094,21,24850,7,6,0,1,9,23,11,5,4,0,0,20,nowin,loss,bust,plbust,0,10,13,214,0.359813084,0.042056075,0.626168224,0,0.025263474
29095,142,24850,7,8,0,1,2,18,11,5,4,0,0,20,nowin,loss,beat,dlwin,0,10,15,211,0.417061611,0.047393365,0.526066351,1,0.271531309
29096,7,24850,5,10,0,6,0,21,11,5,4,0,0,20,nowin,win,plwin,beat,20,0,15,183,0.442622951,0.06010929,0.62295082,2,0.619303341
29097,89,24850,6,7,0,10,0,23,11,5,4,0,0,20,nowin,loss,bust,plbust,0,10,13,212,0.537735849,0.047169811,0.594339623,3,0.990167191
29098,143,24850,10,10,0,0,0,20,11,5,4,0,0,20,nowin,push,push,push,10,0,20,203,0.463054187,0.044334975,0.57635468,3,0.883143365
29099,115,24850,10,10,0,0,0,20,11,5,4,0,0,20,nowin,push,push,push,10,0,20,194,0.427835052,0.041237113,0.592783505,2,0.583863602
29100,17,24851,10,10,0,0,0,20,10,10,0,0,0,20,nowin,push,push,push,10,0,20,171,0.444444444,0.070175439,0.555555556,1,0.302364894
29101,92,24851,10,6,0,10,0,26,10,10,0,0,0,20,nowin,loss,bust,plbust,0,10,16,186,0.446236559,0.059139785,0.564516129,1,0.307826125
29102,146,24851,9,10,0,0,0,19,10,10,0,0,0,20,nowin,loss,beat,dlwin,0,10,19,221,0.43438914,0.040723982,0.542986425,1,0.290190091
29103,148,24851,5,8,0,3,1,17,10,10,0,0,0,20,nowin,loss,beat,dlwin,0,10,13,204,0.401960784,0.078431373,0.593137255,0,0.029789521
29104,113,24851,10,7,0,0,0,17,10,10,0,0,0,20,nowin,loss,beat,dlwin,0,10,17,199,0.407035176,0.055276382,0.668341709,2,0.620695264
29105,7,24851,10,9,0,0,0,19,10,10,0,0,0,20,nowin,loss,beat,dlwin,0,10,19,183,0.442622951,0.06010929,0.62295082,2,0.619303341
29106,21,24852,10,9,0,0,0,19,11,9,0,0,0,20,nowin,loss,beat,dlwin,0,10,19,214,0.359813084,0.042056075,0.626168224,0,0.025263474
29107,121,24852,2,9,10,0,0,21,11,9,0,0,0,20,nowin,win,plwin,beat,20,0,11,195,0.456410256,0.025641026,0.512820513,1,0.288597791
29108,101,24852,5,5,5,10,0,25,11,9,0,0,0,20,nowin,loss,bust,plbust,0,10,10,205,0.424390244,0.068292683,0.63902439,2,0.614740646
29109,7,24852,4,4,6,10,0,24,11,9,0,0,0,20,nowin,loss,bust,plbust,0,10,8,183,0.442622951,0.06010929,0.62295082,2,0.619303341
29110,91,24852,11,3,6,0,0,20,11,9,0,0,0,20,nowin,push,push,push,10,0,14,194,0.417525773,0.046391753,0.515463918,1,0.266616552
29111,30,24852,1,3,10,5,0,19,11,9,0,0,0,20,nowin,loss,beat,dlwin,0,10,4,206,0.393203883,0.033980583,0.601941748,0,0.029324648
29112,33,24853,11,9,0,0,0,20,2,6,10,0,0,18,nowin,win,plwin,beat,20,0,20,192,0.4375,0.057291667,0.625,2,0.616208916
29113,118,24853,9,10,0,0,0,19,2,6,10,0,0,18,nowin,win,plwin,beat,20,0,19,216,0.393518519,0.037037037,0.555555556,0,0.018059873
29114,123,24853,10,8,0,0,0,18,2,6,10,0,0,18,nowin,push,push,push,10,0,18,205,0.43902439,0.034146341,0.614634146,2,0.609962544
29115,26,24853,9,3,0,10,0,22,2,6,10,0,0,18,nowin,loss,bust,plbust,0,10,12,203,0.463054187,0.0591133,0.541871921,1,0.306802864
29116,26,24853,2,5,11,0,0,18,2,6,10,0,0,18,nowin,push,push,push,10,0,7,203,0.463054187,0.0591133,0.541871921,1,0.306802864
29117,9,24853,8,5,0,0,0,13,2,6,10,0,0,18,nowin,loss,beat,dlwin,0,10,13,194,0.37628866,0.015463918,0.541237113,0,0.009396796
29118,128,24854,10,10,0,0,0,20,6,4,2,2,4,18,nowin,win,plwin,beat,20,0,20,227,0.356828194,0.052863436,0.577092511,0,0.012352564
29119,28,24854,3,3,10,0,0,16,6,4,2,2,4,18,nowin,loss,beat,dlwin,0,10,6,199,0.422110553,0.045226131,0.542713568,1,0.282706618
29120,43,24854,7,10,0,0,0,17,6,4,2,2,4,18,nowin,loss,beat,dlwin,0,10,17,192,0.40625,0.041666667,0.609375,2,0.576671372
29121,11,24854,3,10,0,0,0,13,6,4,2,2,4,18,nowin,loss,beat,dlwin,0,10,13,236,0.457627119,0.016949153,0.588983051,3,0.889015813
29122,135,24854,6,5,10,0,0,21,6,4,2,2,4,18,nowin,win,plwin,beat,20,0,11,179,0.391061453,0.067039106,0.586592179,0,0.024924662
29123,13,24854,4,5,11,0,0,20,6,4,2,2,4,18,nowin,win,plwin,beat,20,0,9,206,0.417475728,0.063106796,0.621359223,2,0.59555479
29124,80,24855,9,10,0,0,0,19,5,8,8,0,0,21,nowin,loss,beat,dlwin,0,10,19,186,0.419354839,0.059139785,0.623655914,2,0.59892924
29125,18,24855,11,10,0,0,0,21,5,8,8,0,0,21,win,push,push,push,10,0,21,182,0.461538462,0.043956044,0.587912088,3,0.892649374
29126,3,24855,9,8,0,0,0,17,5,8,8,0,0,21,nowin,loss,beat,dlwin,0,10,17,190,0.431578947,0.026315789,0.542105263,1,0.288076384
29127,136,24855,2,3,10,0,0,15,5,8,8,0,0,21,nowin,loss,beat,dlwin,0,10,5,194,0.396907216,0.025773196,0.597938144,0,0.029452644
29128,88,24855,6,6,0,0,0,12,5,8,8,0,0,21,nowin,loss,beat,dlwin,0,10,12,206,0.466019417,0.033980583,0.54368932,1,0.309467903
29129,132,24855,4,2,6,0,0,12,5,8,8,0,0,21,nowin,loss,beat,dlwin,0,10,6,194,0.412371134,0.036082474,0.649484536,2,0.611633238
29130,99,24856,11,9,0,0,0,20,10,3,10,0,0,23,nowin,win,dlbust,bust,20,0,20,207,0.47826087,0.062801932,0.637681159,3,0.961418446
29131,23,24856,4,11,5,0,0,20,10,3,10,0,0,23,nowin,win,dlbust,bust,20,0,15,208,0.427884615,0.0625,0.552884615,1,0.29114424
29132,70,24856,10,4,0,7,0,21,10,3,10,0,0,23,nowin,win,dlbust,bust,20,0,14,228,0.385964912,0.039473684,0.557017544,0,0.016157125
29133,123,24856,3,10,0,10,0,23,10,3,10,0,0,23,nowin,loss,bust,plbust,0,10,13,205,0.43902439,0.034146341,0.614634146,2,0.609962544
29134,67,24856,10,10,0,0,0,20,10,3,10,0,0,23,nowin,win,dlbust,bust,20,0,20,195,0.369230769,0.041025641,0.569230769,0,0.014139427
29135,34,24856,10,10,0,0,0,20,10,3,10,0,0,23,nowin,win,dlbust,bust,20,0,20,202,0.5,0.079207921,0.618811881,3,0.968961434
29136,43,24857,4,10,0,10,0,24,10,10,0,0,0,20,nowin,loss,bust,plbust,0,10,14,192,0.40625,0.041666667,0.609375,2,0.576671372
29137,65,24857,4,10,0,2,10,26,10,10,0,0,0,20,nowin,loss,bust,plbust,0,10,14,203,0.492610837,0.054187192,0.571428571,3,0.913702814
29138,37,24857,4,8,0,3,7,22,10,10,0,0,0,20,nowin,loss,bust,plbust,0,10,12,208,0.394230769,0.038461538,0.581730769,0,0.024682772
29139,1,24857,10,8,0,0,0,18,10,10,0,0,0,20,nowin,loss,beat,dlwin,0,10,18,197,0.406091371,0.025380711,0.649746193,2,0.606186955
29140,79,24857,10,3,0,1,6,20,10,10,0,0,0,20,nowin,push,push,push,10,0,13,211,0.436018957,0.028436019,0.672985782,2,0.650131054
29141,110,24857,7,10,0,0,0,17,10,10,0,0,0,20,nowin,loss,beat,dlwin,0,10,17,192,0.416666667,0.046875,0.557291667,0,0.025413132
29142,61,24858,10,6,0,6,0,22,7,10,0,0,0,17,nowin,loss,bust,plbust,0,10,16,194,0.427835052,0.077319588,0.603092784,2,0.591437139
29143,17,24858,8,10,0,0,0,18,7,10,0,0,0,17,nowin,win,plwin,beat,20,0,18,171,0.444444444,0.070175439,0.555555556,1,0.302364894
29144,30,24858,8,10,0,0,0,18,7,10,0,0,0,17,nowin,win,plwin,beat,20,0,18,206,0.393203883,0.033980583,0.601941748,0,0.029324648
29145,74,24858,4,7,8,0,0,19,7,10,0,0,0,17,nowin,win,plwin,beat,20,0,11,209,0.411483254,0.04784689,0.531100478,0,0.017448125
29146,88,24858,2,10,0,10,0,22,7,10,0,0,0,17,nowin,loss,bust,plbust,0,10,12,206,0.466019417,0.033980583,0.54368932,1,0.309467903
29147,125,24858,6,3,10,0,0,19,7,10,0,0,0,17,nowin,win,plwin,beat,20,0,9,219,0.438356164,0.050228311,0.575342466,1,0.308411257
29148,63,24859,10,10,0,0,0,20,10,10,0,0,0,20,nowin,push,push,push,10,0,20,216,0.467592593,0.037037037,0.62037037,3,0.931690496
29149,18,24859,10,4,0,6,0,20,10,10,0,0,0,20,nowin,push,push,push,10,0,14,182,0.461538462,0.043956044,0.587912088,3,0.892649374
29150,80,24859,8,4,0,2,10,24,10,10,0,0,0,20,nowin,loss,bust,plbust,0,10,12,186,0.419354839,0.059139785,0.623655914,2,0.59892924
29151,30,24859,10,7,0,0,0,17,10,10,0,0,0,20,nowin,loss,beat,dlwin,0,10,17,206,0.393203883,0.033980583,0.601941748,0,0.029324648
29152,131,24859,10,8,0,0,0,18,10,10,0,0,0,20,nowin,loss,beat,dlwin,0,10,18,217,0.410138249,0.069124424,0.543778802,0,0.02015021
29153,126,24859,8,5,0,10,0,23,10,10,0,0,0,20,nowin,loss,bust,plbust,0,10,13,188,0.457446809,0.074468085,0.60106383,3,0.900633203
29154,36,24860,8,3,4,8,0,23,11,2,7,0,0,20,nowin,loss,bust,plbust,0,10,11,229,0.445414847,0.056768559,0.655021834,2,0.645370571
29155,109,24860,7,10,0,0,0,17,11,2,7,0,0,20,nowin,loss,beat,dlwin,0,10,17,221,0.461538462,0.058823529,0.597285068,3,0.901830309
29156,6,24860,5,8,0,10,0,23,11,2,7,0,0,20,nowin,loss,bust,plbust,0,10,13,191,0.439790576,0.047120419,0.581151832,1,0.31211505
29157,23,24860,7,3,3,10,0,23,11,2,7,0,0,20,nowin,loss,bust,plbust,0,10,10,208,0.427884615,0.0625,0.552884615,1,0.29114424
29158,133,24860,10,7,0,0,0,17,11,2,7,0,0,20,nowin,loss,beat,dlwin,0,10,17,201,0.47761194,0.064676617,0.611940299,3,0.935428111
29159,93,24860,3,10,0,7,0,20,11,2,7,0,0,20,nowin,push,push,push,10,0,13,175,0.485714286,0.051428571,0.548571429,1,0.323648091
29160,12,24861,10,5,0,10,0,25,9,5,10,0,0,24,nowin,loss,bust,plbust,0,10,15,189,0.470899471,0.015873016,0.613756614,3,0.929171178
29161,101,24861,6,10,0,10,0,26,9,5,10,0,0,24,nowin,loss,bust,plbust,0,10,16,205,0.424390244,0.068292683,0.63902439,2,0.614740646
29162,51,24861,3,7,3,10,0,23,9,5,10,0,0,24,nowin,loss,bust,plbust,0,10,10,189,0.529100529,0.068783069,0.608465608,3,0.993665715
29163,148,24861,4,9,0,8,0,21,9,5,10,0,0,24,nowin,win,dlbust,bust,20,0,13,204,0.401960784,0.078431373,0.593137255,0,0.029789521
29164,55,24861,10,4,0,1,2,17,9,5,10,0,0,24,nowin,win,dlbust,bust,20,0,14,191,0.371727749,0.057591623,0.54973822,0,0.01011347
29165,24,24861,11,9,0,0,0,20,9,5,10,0,0,24,nowin,win,dlbust,bust,20,0,20,207,0.458937198,0.048309179,0.570048309,1,0.318138014
29166,74,24862,11,9,0,0,0,20,8,2,4,7,0,21,nowin,loss,beat,dlwin,0,10,20,209,0.411483254,0.04784689,0.531100478,0,0.017448125
29167,78,24862,6,9,0,1,1,17,8,2,4,7,0,21,nowin,loss,beat,dlwin,0,10,15,201,0.517412935,0.034825871,0.587064677,3,0.95871112
29168,74,24862,10,5,0,5,0,20,8,2,4,7,0,21,nowin,loss,beat,dlwin,0,10,15,209,0.411483254,0.04784689,0.531100478,0,0.017448125
29169,73,24862,3,10,0,10,0,23,8,2,4,7,0,21,nowin,loss,bust,plbust,0,10,13,181,0.375690608,0.011049724,0.596685083,0,0.022795773
29170,31,24862,10,2,0,7,0,19,8,2,4,7,0,21,nowin,loss,beat,dlwin,0,10,12,188,0.473404255,0.058510638,0.515957447,1,0.300306557
29171,114,24862,10,9,0,0,0,19,8,2,4,7,0,21,nowin,loss,beat,dlwin,0,10,19,198,0.47979798,0.025252525,0.611111111,3,0.937232995
29172,88,24863,9,6,0,2,0,17,10,10,0,0,0,20,nowin,loss,beat,dlwin,0,10,15,206,0.466019417,0.033980583,0.54368932,1,0.309467903
29173,101,24863,6,7,0,8,0,21,10,10,0,0,0,20,nowin,win,plwin,beat,20,0,13,205,0.424390244,0.068292683,0.63902439,2,0.614740646
29174,123,24863,10,11,0,0,0,21,10,10,0,0,0,20,win,win,plwin,beat,25,0,21,205,0.43902439,0.034146341,0.614634146,2,0.609962544
29175,75,24863,10,10,0,0,0,20,10,10,0,0,0,20,nowin,push,push,push,10,0,20,191,0.418848168,0.052356021,0.570680628,0,0.029344702
29176,16,24863,10,10,0,0,0,20,10,10,0,0,0,20,nowin,push,push,push,10,0,20,220,0.427272727,0.081818182,0.6,2,0.588660176
29177,122,24863,5,9,0,8,0,22,10,10,0,0,0,20,nowin,loss,bust,plbust,0,10,14,210,0.347619048,0.052380952,0.59047619,0,0.012873677
29178,59,24864,10,11,0,0,0,21,6,7,1,2,10,26,win,win,dlbust,bust,25,0,21,228,0.429824561,0.048245614,0.543859649,1,0.287885446
29179,22,24864,8,5,0,0,0,13,6,7,1,2,10,26,nowin,win,dlbust,bust,20,0,13,187,0.481283422,0.042780749,0.577540107,3,0.906128176
29180,70,24864,5,6,9,0,0,20,6,7,1,2,10,26,nowin,win,dlbust,bust,20,0,11,228,0.385964912,0.039473684,0.557017544,0,0.016157125
29181,59,24864,7,10,0,0,0,17,6,7,1,2,10,26,nowin,win,dlbust,bust,20,0,17,228,0.429824561,0.048245614,0.543859649,1,0.287885446
29182,54,24864,5,10,0,0,0,15,6,7,1,2,10,26,nowin,win,dlbust,bust,20,0,15,185,0.437837838,0.032432432,0.556756757,1,0.29899854
29183,142,24864,4,10,0,0,0,14,6,7,1,2,10,26,nowin,win,dlbust,bust,20,0,14,211,0.417061611,0.047393365,0.526066351,1,0.271531309
29184,89,24865,8,2,8,0,0,18,3,6,10,0,0,19,nowin,loss,beat,dlwin,0,10,10,212,0.537735849,0.047169811,0.594339623,3,0.990167191
29185,80,24865,10,7,0,0,0,17,3,6,10,0,0,19,nowin,loss,beat,dlwin,0,10,17,186,0.419354839,0.059139785,0.623655914,2,0.59892924
29186,11,24865,9,7,0,0,0,16,3,6,10,0,0,19,nowin,loss,beat,dlwin,0,10,16,236,0.457627119,0.016949153,0.588983051,3,0.889015813
29187,61,24865,2,4,10,0,0,16,3,6,10,0,0,19,nowin,loss,beat,dlwin,0,10,6,194,0.427835052,0.077319588,0.603092784,2,0.591437139
29188,73,24865,6,2,10,0,0,18,3,6,10,0,0,19,nowin,loss,beat,dlwin,0,10,8,181,0.375690608,0.011049724,0.596685083,0,0.022795773
29189,48,24865,8,10,0,0,0,18,3,6,10,0,0,19,nowin,loss,beat,dlwin,0,10,18,203,0.413793103,0.019704433,0.600985222,2,0.577280801
29190,138,24866,10,2,0,3,4,19,10,9,0,0,0,19,nowin,push,push,push,10,0,12,190,0.442105263,0.047368421,0.610526316,2,0.609711065
29191,37,24866,2,3,6,3,1,15,10,9,0,0,0,19,nowin,loss,beat,dlwin,0,10,5,208,0.394230769,0.038461538,0.581730769,0,0.024682772
29192,11,24866,10,2,0,2,9,23,10,9,0,0,0,19,nowin,loss,bust,plbust,0,10,12,236,0.457627119,0.016949153,0.588983051,3,0.889015813
29193,129,24866,10,10,0,0,0,20,10,9,0,0,0,19,nowin,win,plwin,beat,20,0,20,201,0.422885572,0.064676617,0.55721393,0,0.027255383
29194,115,24866,2,11,6,0,0,19,10,9,0,0,0,19,nowin,push,push,push,10,0,13,194,0.427835052,0.041237113,0.592783505,2,0.583863602
29195,98,24866,11,6,2,0,0,19,10,9,0,0,0,19,nowin,push,push,push,10,0,17,220,0.422727273,0.054545455,0.55,1,0.28664435
29196,39,24867,10,10,0,0,0,20,9,10,0,0,0,19,nowin,win,plwin,beat,20,0,20,191,0.429319372,0.062827225,0.57591623,0,0.033760763
29197,128,24867,10,10,0,0,0,20,9,10,0,0,0,19,nowin,win,plwin,beat,20,0,20,227,0.356828194,0.052863436,0.577092511,0,0.012352564
29198,69,24867,10,10,0,0,0,20,9,10,0,0,0,19,nowin,win,plwin,beat,20,0,20,194,0.365979381,0.030927835,0.515463918,0,0
29199,37,24867,7,5,0,10,0,22,9,10,0,0,0,19,nowin,loss,bust,plbust,0,10,12,208,0.394230769,0.038461538,0.581730769,0,0.024682772
29200,82,24867,11,1,2,9,0,23,9,10,0,0,0,19,nowin,loss,bust,plbust,0,10,12,225,0.408888889,0.075555556,0.577777778,0,0.028101874
29201,43,24867,7,3,10,0,0,20,9,10,0,0,0,19,nowin,win,plwin,beat,20,0,10,192,0.40625,0.041666667,0.609375,2,0.576671372
29202,40,24868,10,5,0,10,0,25,10,3,10,0,0,23,nowin,loss,bust,plbust,0,10,15,196,0.367346939,0.030612245,0.617346939,0,0.025358183
29203,65,24868,10,2,0,1,2,15,10,3,10,0,0,23,nowin,win,dlbust,bust,20,0,12,203,0.492610837,0.054187192,0.571428571,3,0.913702814
29204,5,24868,10,6,0,10,0,26,10,3,10,0,0,23,nowin,loss,bust,plbust,0,10,16,203,0.42364532,0.02955665,0.596059113,2,0.582508076
29205,9,24868,4,2,10,10,0,26,10,3,10,0,0,23,nowin,loss,bust,plbust,0,10,6,194,0.37628866,0.015463918,0.541237113,0,0.009396796
29206,74,24868,11,9,0,0,0,20,10,3,10,0,0,23,nowin,win,dlbust,bust,20,0,20,209,0.411483254,0.04784689,0.531100478,0,0.017448125
29207,21,24868,8,10,0,0,0,18,10,3,10,0,0,23,nowin,win,dlbust,bust,20,0,18,214,0.359813084,0.042056075,0.626168224,0,0.025263474
29208,40,24869,6,4,6,8,0,24,10,8,0,0,0,18,nowin,loss,bust,plbust,0,10,10,196,0.367346939,0.030612245,0.617346939,0,0.025358183
29209,54,24869,10,11,0,0,0,21,10,8,0,0,0,18,win,win,plwin,beat,25,0,21,185,0.437837838,0.032432432,0.556756757,1,0.29899854
29210,10,24869,3,3,9,2,0,17,10,8,0,0,0,18,nowin,loss,beat,dlwin,0,10,6,191,0.413612565,0.057591623,0.596858639,2,0.574087175
29211,28,24869,2,8,9,0,0,19,10,8,0,0,0,18,nowin,win,plwin,beat,20,0,10,199,0.422110553,0.045226131,0.542713568,1,0.282706618
29212,78,24869,10,11,0,0,0,21,10,8,0,0,0,18,win,win,plwin,beat,25,0,21,201,0.517412935,0.034825871,0.587064677,3,0.95871112
29213,86,24869,2,10,0,10,0,22,10,8,0,0,0,18,nowin,loss,bust,plbust,0,10,12,196,0.454081633,0.040816327,0.591836735,3,0.887566443
29214,108,24870,5,10,0,10,0,25,10,8,0,0,0,18,nowin,loss,bust,plbust,0,10,15,193,0.435233161,0.056994819,0.559585492,1,0.298824795
29215,34,24870,5,3,10,0,0,18,10,8,0,0,0,18,nowin,push,push,push,10,0,8,202,0.5,0.079207921,0.618811881,3,0.968961434
29216,19,24870,6,1,9,9,0,25,10,8,0,0,0,18,nowin,loss,bust,plbust,0,10,7,237,0.41350211,0.054852321,0.628691983,2,0.597373826
29217,99,24870,7,10,0,0,0,17,10,8,0,0,0,18,nowin,loss,beat,dlwin,0,10,17,207,0.47826087,0.062801932,0.637681159,3,0.961418446
29218,142,24870,3,3,6,10,0,22,10,8,0,0,0,18,nowin,loss,bust,plbust,0,10,6,211,0.417061611,0.047393365,0.526066351,1,0.271531309
29219,80,24870,6,8,0,1,10,25,10,8,0,0,0,18,nowin,loss,bust,plbust,0,10,14,186,0.419354839,0.059139785,0.623655914,2,0.59892924
29220,38,24871,9,10,0,0,0,19,8,10,0,0,0,18,nowin,win,plwin,beat,20,0,19,202,0.361386139,0.03960396,0.564356436,0,0.010597953
29221,43,24871,8,10,0,0,0,18,8,10,0,0,0,18,nowin,push,push,push,10,0,18,192,0.40625,0.041666667,0.609375,2,0.576671372
29222,44,24871,10,10,0,0,0,20,8,10,0,0,0,18,nowin,win,plwin,beat,20,0,20,219,0.433789954,0.050228311,0.534246575,1,0.285551035
29223,94,24871,4,6,10,0,0,20,8,10,0,0,0,18,nowin,win,plwin,beat,20,0,10,183,0.43715847,0.043715847,0.540983607,1,0.290866892
29224,97,24871,8,10,0,0,0,18,8,10,0,0,0,18,nowin,push,push,push,10,0,18,182,0.450549451,0.06043956,0.692307692,2,0.677372279
29225,129,24871,4,4,10,0,0,18,8,10,0,0,0,18,nowin,push,push,push,10,0,8,201,0.422885572,0.064676617,0.55721393,0,0.027255383
29226,119,24872,3,2,6,2,2,15,9,3,4,10,0,26,nowin,win,dlbust,bust,20,0,5,190,0.405263158,0.068421053,0.515789474,0,0.011837158
29227,103,24872,10,10,0,0,0,20,9,3,4,10,0,26,nowin,win,dlbust,bust,20,0,20,203,0.379310345,0.064039409,0.551724138,0,0.012869209
29228,49,24872,2,1,10,6,0,19,9,3,4,10,0,26,nowin,win,dlbust,bust,20,0,3,207,0.396135266,0.053140097,0.594202899,0,0.028306925
29229,150,24872,10,4,0,2,7,23,9,3,4,10,0,26,nowin,loss,bust,plbust,0,10,14,192,0.401041667,0.036458333,0.567708333,0,0.023287458
29230,2,24872,2,6,9,0,0,17,9,3,4,10,0,26,nowin,win,dlbust,bust,20,0,8,200,0.445,0.035,0.64,2,0.633962549
29231,15,24872,2,5,7,10,0,24,9,3,4,10,0,26,nowin,loss,bust,plbust,0,10,7,212,0.410377358,0.051886792,0.561320755,0,0.024517408
29232,84,24873,10,10,0,0,0,20,10,9,0,0,0,19,nowin,win,plwin,beat,20,0,20,195,0.379487179,0.056410256,0.569230769,0,0.017209119
29233,33,24873,2,2,4,10,0,18,10,9,0,0,0,19,nowin,loss,beat,dlwin,0,10,4,192,0.4375,0.057291667,0.625,2,0.616208916
29234,28,24873,4,10,0,8,0,22,10,9,0,0,0,19,nowin,loss,bust,plbust,0,10,14,199,0.422110553,0.045226131,0.542713568,1,0.282706618
29235,59,24873,10,11,0,0,0,21,10,9,0,0,0,19,win,win,plwin,beat,25,0,21,228,0.429824561,0.048245614,0.543859649,1,0.287885446
29236,50,24873,3,5,10,0,0,18,10,9,0,0,0,19,nowin,loss,beat,dlwin,0,10,8,202,0.405940594,0.04950495,0.54950495,0,0.020296079
29237,84,24873,8,7,0,5,0,20,10,9,0,0,0,19,nowin,win,plwin,beat,20,0,15,195,0.379487179,0.056410256,0.569230769,0,0.017209119
29238,27,24874,4,10,0,1,6,21,10,5,10,0,0,25,nowin,win,dlbust,bust,20,0,14,178,0.370786517,0.016853933,0.573033708,0,0.015536309
29239,129,24874,3,5,9,0,0,17,10,5,10,0,0,25,nowin,win,dlbust,bust,20,0,8,201,0.422885572,0.064676617,0.55721393,0,0.027255383
29240,94,24874,10,9,0,0,0,19,10,5,10,0,0,25,nowin,win,dlbust,bust,20,0,19,183,0.43715847,0.043715847,0.540983607,1,0.290866892
29241,116,24874,8,10,0,0,0,18,10,5,10,0,0,25,nowin,win,dlbust,bust,20,0,18,195,0.425641026,0.056410256,0.538461538,1,0.28273747
29242,137,24874,8,10,0,0,0,18,10,5,10,0,0,25,nowin,win,dlbust,bust,20,0,18,194,0.417525773,0.046391753,0.536082474,1,0.276714602
29243,89,24874,10,10,0,0,0,20,10,5,10,0,0,25,nowin,win,dlbust,bust,20,0,20,212,0.537735849,0.047169811,0.594339623,3,0.990167191
29244,127,24875,10,8,0,0,0,18,3,7,4,10,0,24,nowin,win,dlbust,bust,20,0,18,201,0.402985075,0.029850746,0.60199005,0,0.032263937
29245,36,24875,7,10,0,0,0,17,3,7,4,10,0,24,nowin,win,dlbust,bust,20,0,17,229,0.445414847,0.056768559,0.655021834,2,0.645370571
29246,91,24875,10,8,0,0,0,18,3,7,4,10,0,24,nowin,win,dlbust,bust,20,0,18,194,0.417525773,0.046391753,0.515463918,1,0.266616552
29247,2,24875,5,6,9,0,0,20,3,7,4,10,0,24,nowin,win,dlbust,bust,20,0,11,200,0.445,0.035,0.64,2,0.633962549
29248,52,24875,9,10,0,0,0,19,3,7,4,10,0,24,nowin,win,dlbust,bust,20,0,19,217,0.414746544,0.02764977,0.599078341,2,0.576736024
29249,78,24875,10,11,0,0,0,21,3,7,4,10,0,24,win,win,dlbust,bust,25,0,21,201,0.517412935,0.034825871,0.587064677,3,0.95871112
29250,29,24876,10,10,0,0,0,20,6,8,5,0,0,19,nowin,win,plwin,beat,20,0,20,189,0.44973545,0.058201058,0.544973545,1,0.300349439
29251,139,24876,9,2,10,0,0,21,6,8,5,0,0,19,nowin,win,plwin,beat,20,0,11,192,0.380208333,0.036458333,0.59375,0,0.023429169
29252,108,24876,7,5,0,0,0,12,6,8,5,0,0,19,nowin,loss,beat,dlwin,0,10,12,193,0.435233161,0.056994819,0.559585492,1,0.298824795
29253,67,24876,10,5,0,0,0,15,6,8,5,0,0,19,nowin,loss,beat,dlwin,0,10,15,195,0.369230769,0.041025641,0.569230769,0,0.014139427
29254,65,24876,10,10,0,0,0,20,6,8,5,0,0,19,nowin,win,plwin,beat,20,0,20,203,0.492610837,0.054187192,0.571428571,3,0.913702814
29255,14,24876,2,7,9,0,0,18,6,8,5,0,0,19,nowin,loss,beat,dlwin,0,10,9,202,0.391089109,0.01980198,0.628712871,2,0.577264877
29256,144,24877,5,1,10,10,0,26,10,2,10,0,0,22,nowin,loss,bust,plbust,0,10,6,202,0.386138614,0.054455446,0.564356436,0,0.018006244
29257,107,24877,8,2,2,7,0,19,10,2,10,0,0,22,nowin,win,dlbust,bust,20,0,10,218,0.444954128,0.073394495,0.600917431,2,0.605210014
29258,6,24877,10,10,0,0,0,20,10,2,10,0,0,22,nowin,win,dlbust,bust,20,0,20,191,0.439790576,0.047120419,0.581151832,1,0.31211505
29259,13,24877,1,5,10,2,0,18,10,2,10,0,0,22,nowin,win,dlbust,bust,20,0,6,206,0.417475728,0.063106796,0.621359223,2,0.59555479
29260,18,24877,10,7,0,0,0,17,10,2,10,0,0,22,nowin,win,dlbust,bust,20,0,17,182,0.461538462,0.043956044,0.587912088,3,0.892649374
29261,44,24877,9,6,0,5,0,20,10,2,10,0,0,22,nowin,win,dlbust,bust,20,0,15,219,0.433789954,0.050228311,0.534246575,1,0.285551035
29262,113,24878,10,8,0,0,0,18,10,3,10,0,0,23,nowin,win,dlbust,bust,20,0,18,199,0.407035176,0.055276382,0.668341709,2,0.620695264
29263,109,24878,6,8,0,3,0,17,10,3,10,0,0,23,nowin,win,dlbust,bust,20,0,14,221,0.461538462,0.058823529,0.597285068,3,0.901830309
29264,52,24878,2,3,2,9,8,24,10,3,10,0,0,23,nowin,loss,bust,plbust,0,10,5,217,0.414746544,0.02764977,0.599078341,2,0.576736024
29265,5,24878,4,7,5,6,0,22,10,3,10,0,0,23,nowin,loss,bust,plbust,0,10,11,203,0.42364532,0.02955665,0.596059113,2,0.582508076
29266,81,24878,5,10,0,10,0,25,10,3,10,0,0,23,nowin,loss,bust,plbust,0,10,15,182,0.395604396,0.043956044,0.60989011,2,0.567491261
29267,2,24878,3,10,0,9,0,22,10,3,10,0,0,23,nowin,loss,bust,plbust,0,10,13,200,0.445,0.035,0.64,2,0.633962549
29268,58,24879,2,7,11,0,0,20,3,5,10,0,0,18,nowin,win,plwin,beat,20,0,9,195,0.430769231,0.041025641,0.584615385,2,0.580497586
29269,80,24879,8,8,0,0,0,16,3,5,10,0,0,18,nowin,loss,beat,dlwin,0,10,16,186,0.419354839,0.059139785,0.623655914,2,0.59892924
29270,57,24879,10,5,0,0,0,15,3,5,10,0,0,18,nowin,loss,beat,dlwin,0,10,15,192,0.46875,0.052083333,0.59375,3,0.907001181
29271,112,24879,6,9,0,0,0,15,3,5,10,0,0,18,nowin,loss,beat,dlwin,0,10,15,203,0.448275862,0.054187192,0.600985222,3,0.889576933
29272,10,24879,10,8,0,0,0,18,3,5,10,0,0,18,nowin,push,push,push,10,0,18,191,0.413612565,0.057591623,0.596858639,2,0.574087175
29273,4,24879,10,9,0,0,0,19,3,5,10,0,0,18,nowin,win,plwin,beat,20,0,19,217,0.460829493,0.036866359,0.562211982,1,0.315432839
29274,86,24880,10,10,0,0,0,20,9,3,5,0,0,17,nowin,win,plwin,beat,20,0,20,196,0.454081633,0.040816327,0.591836735,3,0.887566443
29275,6,24880,10,10,0,0,0,20,9,3,5,0,0,17,nowin,win,plwin,beat,20,0,20,191,0.439790576,0.047120419,0.581151832,1,0.31211505
29276,150,24880,6,4,10,0,0,20,9,3,5,0,0,17,nowin,win,plwin,beat,20,0,10,192,0.401041667,0.036458333,0.567708333,0,0.023287458
29277,116,24880,9,8,0,0,0,17,9,3,5,0,0,17,nowin,push,push,push,10,0,17,195,0.425641026,0.056410256,0.538461538,1,0.28273747
29278,94,24880,6,10,0,7,0,23,9,3,5,0,0,17,nowin,loss,bust,plbust,0,10,16,183,0.43715847,0.043715847,0.540983607,1,0.290866892
29279,116,24880,5,7,0,10,0,22,9,3,5,0,0,17,nowin,loss,bust,plbust,0,10,12,195,0.425641026,0.056410256,0.538461538,1,0.28273747
29280,26,24881,8,10,0,0,0,18,10,4,5,0,0,19,nowin,loss,beat,dlwin,0,10,18,203,0.463054187,0.0591133,0.541871921,1,0.306802864
29281,121,24881,5,8,0,8,0,21,10,4,5,0,0,19,nowin,win,plwin,beat,20,0,13,195,0.456410256,0.025641026,0.512820513,1,0.288597791
29282,12,24881,3,10,0,10,0,23,10,4,5,0,0,19,nowin,loss,bust,plbust,0,10,13,189,0.470899471,0.015873016,0.613756614,3,0.929171178
29283,25,24881,10,10,0,0,0,20,10,4,5,0,0,19,nowin,win,plwin,beat,20,0,20,190,0.463157895,0.063157895,0.536842105,1,0.304401563
29284,25,24881,5,5,8,0,0,18,10,4,5,0,0,19,nowin,loss,beat,dlwin,0,10,10,190,0.463157895,0.063157895,0.536842105,1,0.304401563
29285,4,24881,3,7,4,5,0,19,10,4,5,0,0,19,nowin,push,push,push,10,0,10,217,0.460829493,0.036866359,0.562211982,1,0.315432839
29286,99,24882,5,11,5,0,0,21,1,1,10,8,0,20,nowin,win,plwin,beat,20,0,16,207,0.47826087,0.062801932,0.637681159,3,0.961418446
29287,9,24882,10,10,0,0,0,20,1,1,10,8,0,20,nowin,push,push,push,10,0,20,194,0.37628866,0.015463918,0.541237113,0,0.009396796
29288,141,24882,5,10,0,7,0,22,1,1,10,8,0,20,nowin,loss,bust,plbust,0,10,15,202,0.420792079,0.074257426,0.564356436,0,0.028377851
29289,137,24882,3,9,0,10,0,22,1,1,10,8,0,20,nowin,loss,bust,plbust,0,10,12,194,0.417525773,0.046391753,0.536082474,1,0.276714602
29290,56,24882,10,6,0,1,0,17,1,1,10,8,0,20,nowin,loss,beat,dlwin,0,10,16,175,0.4,0.057142857,0.582857143,0,0.026685297
29291,117,24882,1,4,10,10,0,25,1,1,10,8,0,20,nowin,loss,bust,plbust,0,10,5,173,0.410404624,0.069364162,0.606936416,2,0.578610282
29292,25,24883,10,6,0,2,0,18,10,10,0,0,0,20,nowin,loss,beat,dlwin,0,10,16,190,0.463157895,0.063157895,0.536842105,1,0.304401563
29293,99,24883,5,9,0,10,0,24,10,10,0,0,0,20,nowin,loss,bust,plbust,0,10,14,207,0.47826087,0.062801932,0.637681159,3,0.961418446
29294,115,24883,5,6,10,0,0,21,10,10,0,0,0,20,nowin,win,plwin,beat,20,0,11,194,0.427835052,0.041237113,0.592783505,2,0.583863602
29295,99,24883,10,11,0,0,0,21,10,10,0,0,0,20,win,win,plwin,beat,25,0,21,207,0.47826087,0.062801932,0.637681159,3,0.961418446
29296,55,24883,7,5,0,4,5,21,10,10,0,0,0,20,nowin,win,plwin,beat,20,0,12,191,0.371727749,0.057591623,0.54973822,0,0.01011347
29297,4,24883,3,1,9,10,0,23,10,10,0,0,0,20,nowin,loss,bust,plbust,0,10,4,217,0.460829493,0.036866359,0.562211982,1,0.315432839
29298,107,24884,5,2,9,0,0,16,4,5,4,6,0,19,nowin,loss,beat,dlwin,0,10,7,218,0.444954128,0.073394495,0.600917431,2,0.605210014
29299,109,24884,6,3,9,0,0,18,4,5,4,6,0,19,nowin,loss,beat,dlwin,0,10,9,221,0.461538462,0.058823529,0.597285068,3,0.901830309
29300,12,24884,8,3,4,0,0,15,4,5,4,6,0,19,nowin,loss,beat,dlwin,0,10,11,189,0.470899471,0.015873016,0.613756614,3,0.929171178
29301,95,24884,8,2,11,0,0,21,4,5,4,6,0,19,nowin,win,plwin,beat,20,0,10,218,0.412844037,0.04587156,0.559633028,0,0.024842385
29302,88,24884,10,10,0,0,0,20,4,5,4,6,0,19,nowin,win,plwin,beat,20,0,20,206,0.466019417,0.033980583,0.54368932,1,0.309467903
29303,121,24884,10,2,0,0,0,12,4,5,4,6,0,19,nowin,loss,beat,dlwin,0,10,12,195,0.456410256,0.025641026,0.512820513,1,0.288597791
29304,67,24885,10,2,0,4,3,19,10,10,0,0,0,20,nowin,loss,beat,dlwin,0,10,12,195,0.369230769,0.041025641,0.569230769,0,0.014139427
29305,32,24885,5,10,0,6,0,21,10,10,0,0,0,20,nowin,win,plwin,beat,20,0,15,189,0.391534392,0.037037037,0.53968254,0,0.013579086
29306,130,24885,4,10,0,4,0,18,10,10,0,0,0,20,nowin,loss,beat,dlwin,0,10,14,219,0.410958904,0.03652968,0.566210046,0,0.025888739
29307,140,24885,7,3,2,1,1,14,10,10,0,0,0,20,nowin,loss,beat,dlwin,0,10,10,210,0.466666667,0.023809524,0.604761905,3,0.915293335
29308,140,24885,10,10,0,0,0,20,10,10,0,0,0,20,nowin,push,push,push,10,0,20,210,0.466666667,0.023809524,0.604761905,3,0.915293335
29309,67,24885,1,4,10,8,0,23,10,10,0,0,0,20,nowin,loss,bust,plbust,0,10,5,195,0.369230769,0.041025641,0.569230769,0,0.014139427
29310,22,24886,5,1,7,5,0,18,10,10,0,0,0,20,nowin,loss,beat,dlwin,0,10,6,187,0.481283422,0.042780749,0.577540107,3,0.906128176
29311,111,24886,10,11,0,0,0,21,10,10,0,0,0,20,win,win,plwin,beat,25,0,21,180,0.433333333,0.055555556,0.611111111,2,0.602264492
29312,12,24886,3,8,9,0,0,20,10,10,0,0,0,20,nowin,push,push,push,10,0,11,189,0.470899471,0.015873016,0.613756614,3,0.929171178
29313,52,24886,5,1,10,6,0,22,10,10,0,0,0,20,nowin,loss,bust,plbust,0,10,6,217,0.414746544,0.02764977,0.599078341,2,0.576736024
29314,32,24886,3,4,10,0,0,17,10,10,0,0,0,20,nowin,loss,beat,dlwin,0,10,7,189,0.391534392,0.037037037,0.53968254,0,0.013579086
29315,16,24886,10,9,0,0,0,19,10,10,0,0,0,20,nowin,loss,beat,dlwin,0,10,19,220,0.427272727,0.081818182,0.6,2,0.588660176
29316,136,24887,6,1,9,10,0,26,10,10,0,0,0,20,nowin,loss,bust,plbust,0,10,7,194,0.396907216,0.025773196,0.597938144,0,0.029452644
29317,3,24887,3,4,9,3,0,19,10,10,0,0,0,20,nowin,loss,beat,dlwin,0,10,7,190,0.431578947,0.026315789,0.542105263,1,0.288076384
29318,127,24887,10,7,0,0,0,17,10,10,0,0,0,20,nowin,loss,beat,dlwin,0,10,17,201,0.402985075,0.029850746,0.60199005,0,0.032263937
29319,49,24887,10,6,0,2,0,18,10,10,0,0,0,20,nowin,loss,beat,dlwin,0,10,16,207,0.396135266,0.053140097,0.594202899,0,0.028306925
29320,130,24887,6,8,0,6,0,20,10,10,0,0,0,20,nowin,push,push,push,10,0,14,219,0.410958904,0.03652968,0.566210046,0,0.025888739
29321,39,24887,9,10,0,0,0,19,10,10,0,0,0,20,nowin,loss,beat,dlwin,0,10,19,191,0.429319372,0.062827225,0.57591623,0,0.033760763
29322,49,24888,6,3,10,0,0,19,9,11,0,0,0,20,nowin,loss,beat,dlwin,0,10,9,207,0.396135266,0.053140097,0.594202899,0,0.028306925
29323,79,24888,2,9,10,0,0,21,9,11,0,0,0,20,nowin,win,plwin,beat,20,0,11,211,0.436018957,0.028436019,0.672985782,2,0.650131054
29324,65,24888,10,4,0,2,10,26,9,11,0,0,0,20,nowin,loss,bust,plbust,0,10,14,203,0.492610837,0.054187192,0.571428571,3,0.913702814
29325,145,24888,8,8,0,10,0,26,9,11,0,0,0,20,nowin,loss,bust,plbust,0,10,16,188,0.441489362,0.031914894,0.622340426,2,0.617837093
29326,144,24888,10,10,0,0,0,20,9,11,0,0,0,20,nowin,push,push,push,10,0,20,202,0.386138614,0.054455446,0.564356436,0,0.018006244
29327,131,24888,10,8,0,0,0,18,9,11,0,0,0,20,nowin,loss,beat,dlwin,0,10,18,217,0.410138249,0.069124424,0.543778802,0,0.02015021
29328,56,24889,10,4,0,0,0,14,3,10,1,10,0,24,nowin,win,dlbust,bust,20,0,14,175,0.4,0.057142857,0.582857143,0,0.026685297
29329,109,24889,5,7,0,6,0,18,3,10,1,10,0,24,nowin,win,dlbust,bust,20,0,12,221,0.461538462,0.058823529,0.597285068,3,0.901830309
29330,29,24889,8,10,0,0,0,18,3,10,1,10,0,24,nowin,win,dlbust,bust,20,0,18,189,0.44973545,0.058201058,0.544973545,1,0.300349439
29331,44,24889,10,6,0,0,0,16,3,10,1,10,0,24,nowin,win,dlbust,bust,20,0,16,219,0.433789954,0.050228311,0.534246575,1,0.285551035
29332,50,24889,11,10,0,0,0,21,3,10,1,10,0,24,win,win,dlbust,bust,25,0,21,202,0.405940594,0.04950495,0.54950495,0,0.020296079
29333,37,24889,7,7,0,0,0,14,3,10,1,10,0,24,nowin,win,dlbust,bust,20,0,14,208,0.394230769,0.038461538,0.581730769,0,0.024682772
29334,78,24890,10,6,0,0,0,16,2,8,11,0,0,21,nowin,loss,beat,dlwin,0,10,16,201,0.517412935,0.034825871,0.587064677,3,0.95871112
29335,20,24890,6,7,0,0,0,13,2,8,11,0,0,21,nowin,loss,beat,dlwin,0,10,13,186,0.456989247,0.037634409,0.537634409,1,0.301097108
29336,128,24890,9,10,0,0,0,19,2,8,11,0,0,21,nowin,loss,beat,dlwin,0,10,19,227,0.356828194,0.052863436,0.577092511,0,0.012352564
29337,62,24890,10,7,0,0,0,17,2,8,11,0,0,21,nowin,loss,beat,dlwin,0,10,17,178,0.370786517,0.028089888,0.54494382,0,0.008657722
29338,30,24890,5,2,10,0,0,17,2,8,11,0,0,21,nowin,loss,beat,dlwin,0,10,7,206,0.393203883,0.033980583,0.601941748,0,0.029324648
29339,44,24890,5,10,0,0,0,15,2,8,11,0,0,21,nowin,loss,beat,dlwin,0,10,15,219,0.433789954,0.050228311,0.534246575,1,0.285551035
29340,129,24891,2,11,6,0,0,19,4,10,3,0,0,17,nowin,win,plwin,beat,20,0,13,201,0.422885572,0.064676617,0.55721393,0,0.027255383
29341,137,24891,2,10,0,0,0,12,4,10,3,0,0,17,nowin,loss,beat,dlwin,0,10,12,194,0.417525773,0.046391753,0.536082474,1,0.276714602
29342,105,24891,7,10,0,0,0,17,4,10,3,0,0,17,nowin,push,push,push,10,0,17,198,0.414141414,0.070707071,0.590909091,0,0.032889494
29343,57,24891,7,6,0,0,0,13,4,10,3,0,0,17,nowin,loss,beat,dlwin,0,10,13,192,0.46875,0.052083333,0.59375,3,0.907001181
29344,117,24891,11,8,0,0,0,19,4,10,3,0,0,17,nowin,win,plwin,beat,20,0,19,173,0.410404624,0.069364162,0.606936416,2,0.578610282
29345,20,24891,7,6,0,0,0,13,4,10,3,0,0,17,nowin,loss,beat,dlwin,0,10,13,186,0.456989247,0.037634409,0.537634409,1,0.301097108
29346,149,24892,3,10,0,0,0,13,3,6,11,0,0,20,nowin,loss,beat,dlwin,0,10,13,225,0.457777778,0.057777778,0.648888889,2,0.651965595
29347,12,24892,3,3,7,0,0,13,3,6,11,0,0,20,nowin,loss,beat,dlwin,0,10,6,189,0.470899471,0.015873016,0.613756614,3,0.929171178
29348,143,24892,3,7,10,0,0,20,3,6,11,0,0,20,nowin,push,push,push,10,0,10,203,0.463054187,0.044334975,0.57635468,3,0.883143365
29349,122,24892,8,10,0,0,0,18,3,6,11,0,0,20,nowin,loss,beat,dlwin,0,10,18,210,0.347619048,0.052380952,0.59047619,0,0.012873677
29350,43,24892,10,3,0,0,0,13,3,6,11,0,0,20,nowin,loss,beat,dlwin,0,10,13,192,0.40625,0.041666667,0.609375,2,0.576671372
29351,106,24892,2,2,10,0,0,14,3,6,11,0,0,20,nowin,loss,beat,dlwin,0,10,4,192,0.411458333,0.026041667,0.557291667,0,0.023854304
29352,76,24893,5,9,0,5,0,19,10,8,0,0,0,18,nowin,win,plwin,beat,20,0,14,189,0.534391534,0.079365079,0.608465608,3,1
29353,143,24893,10,4,0,6,0,20,10,8,0,0,0,18,nowin,win,plwin,beat,20,0,14,203,0.463054187,0.044334975,0.57635468,3,0.883143365
29354,85,24893,10,10,0,0,0,20,10,8,0,0,0,18,nowin,win,plwin,beat,20,0,20,195,0.41025641,0.066666667,0.594871795,0,0.03269711
29355,46,24893,2,10,0,4,8,24,10,8,0,0,0,18,nowin,loss,bust,plbust,0,10,12,186,0.403225806,0.048387097,0.591397849,0,0.029742194
29356,34,24893,7,6,0,7,0,20,10,8,0,0,0,18,nowin,win,plwin,beat,20,0,13,202,0.5,0.079207921,0.618811881,3,0.968961434
29357,68,24893,2,4,5,1,4,16,10,8,0,0,0,18,nowin,loss,beat,dlwin,0,10,6,205,0.434146341,0.029268293,0.6,2,0.59483189
29358,6,24894,8,3,6,0,0,17,9,4,10,0,0,23,nowin,win,dlbust,bust,20,0,11,191,0.439790576,0.047120419,0.581151832,1,0.31211505
29359,57,24894,8,7,0,9,0,24,9,4,10,0,0,23,nowin,loss,bust,plbust,0,10,15,192,0.46875,0.052083333,0.59375,3,0.907001181
29360,1,24894,11,7,0,0,0,18,9,4,10,0,0,23,nowin,win,dlbust,bust,20,0,18,197,0.406091371,0.025380711,0.649746193,2,0.606186955
29361,53,24894,8,10,0,0,0,18,9,4,10,0,0,23,nowin,win,dlbust,bust,20,0,18,250,0.372,0.064,0.564,0,0.013687345
29362,88,24894,3,10,0,10,0,23,9,4,10,0,0,23,nowin,loss,bust,plbust,0,10,13,206,0.466019417,0.033980583,0.54368932,1,0.309467903
29363,140,24894,1,6,5,10,0,22,9,4,10,0,0,23,nowin,loss,bust,plbust,0,10,7,210,0.466666667,0.023809524,0.604761905,3,0.915293335
29364,148,24895,10,6,0,0,0,16,3,10,1,6,0,20,nowin,loss,beat,dlwin,0,10,16,204,0.401960784,0.078431373,0.593137255,0,0.029789521
29365,63,24895,8,10,0,0,0,18,3,10,1,6,0,20,nowin,loss,beat,dlwin,0,10,18,216,0.467592593,0.037037037,0.62037037,3,0.931690496
29366,78,24895,3,10,0,0,0,13,3,10,1,6,0,20,nowin,loss,beat,dlwin,0,10,13,201,0.517412935,0.034825871,0.587064677,3,0.95871112
29367,1,24895,10,10,0,0,0,20,3,10,1,6,0,20,nowin,push,push,push,10,0,20,197,0.406091371,0.025380711,0.649746193,2,0.606186955
29368,41,24895,3,3,5,10,0,21,3,10,1,6,0,20,nowin,win,plwin,beat,20,0,6,192,0.364583333,0.036458333,0.520833333,0,0.00089702
29369,65,24895,4,4,10,0,0,18,3,10,1,6,0,20,nowin,loss,beat,dlwin,0,10,8,203,0.492610837,0.054187192,0.571428571,3,0.913702814
29370,29,24896,2,10,0,10,0,22,2,6,3,10,0,21,nowin,loss,bust,plbust,0,10,12,189,0.44973545,0.058201058,0.544973545,1,0.300349439
29371,73,24896,5,3,10,0,0,18,2,6,3,10,0,21,nowin,loss,beat,dlwin,0,10,8,181,0.375690608,0.011049724,0.596685083,0,0.022795773
29372,119,24896,7,10,0,0,0,17,2,6,3,10,0,21,nowin,loss,beat,dlwin,0,10,17,190,0.405263158,0.068421053,0.515789474,0,0.011837158
29373,90,24896,2,6,4,10,0,22,2,6,3,10,0,21,nowin,loss,bust,plbust,0,10,8,201,0.447761194,0.049751244,0.60199005,3,0.889945023
29374,133,24896,6,11,4,0,0,21,2,6,3,10,0,21,nowin,push,push,push,10,0,17,201,0.47761194,0.064676617,0.611940299,3,0.935428111
29375,122,24896,8,2,4,0,0,14,2,6,3,10,0,21,nowin,loss,beat,dlwin,0,10,10,210,0.347619048,0.052380952,0.59047619,0,0.012873677
29376,142,24897,9,10,0,0,0,19,8,5,7,0,0,20,nowin,loss,beat,dlwin,0,10,19,211,0.417061611,0.047393365,0.526066351,1,0.271531309
29377,76,24897,4,1,10,4,0,19,8,5,7,0,0,20,nowin,loss,beat,dlwin,0,10,5,189,0.534391534,0.079365079,0.608465608,3,1
29378,150,24897,6,5,6,0,0,17,8,5,7,0,0,20,nowin,loss,beat,dlwin,0,10,11,192,0.401041667,0.036458333,0.567708333,0,0.023287458
29379,115,24897,10,10,0,0,0,20,8,5,7,0,0,20,nowin,push,push,push,10,0,20,194,0.427835052,0.041237113,0.592783505,2,0.583863602
29380,84,24897,5,6,4,10,0,25,8,5,7,0,0,20,nowin,loss,bust,plbust,0,10,11,195,0.379487179,0.056410256,0.569230769,0,0.017209119
29381,20,24897,9,8,0,0,0,17,8,5,7,0,0,20,nowin,loss,beat,dlwin,0,10,17,186,0.456989247,0.037634409,0.537634409,1,0.301097108
29382,136,24898,10,10,0,0,0,20,10,5,5,0,0,20,nowin,push,push,push,10,0,20,194,0.396907216,0.025773196,0.597938144,0,0.029452644
29383,89,24898,5,1,9,3,0,18,10,5,5,0,0,20,nowin,loss,beat,dlwin,0,10,6,212,0.537735849,0.047169811,0.594339623,3,0.990167191
29384,122,24898,2,9,10,0,0,21,10,5,5,0,0,20,nowin,win,plwin,beat,20,0,11,210,0.347619048,0.052380952,0.59047619,0,0.012873677
29385,14,24898,3,4,2,10,0,19,10,5,5,0,0,20,nowin,loss,beat,dlwin,0,10,7,202,0.391089109,0.01980198,0.628712871,2,0.577264877
29386,90,24898,7,10,0,0,0,17,10,5,5,0,0,20,nowin,loss,beat,dlwin,0,10,17,201,0.447761194,0.049751244,0.60199005,3,0.889945023
29387,149,24898,7,5,0,8,0,20,10,5,5,0,0,20,nowin,push,push,push,10,0,12,225,0.457777778,0.057777778,0.648888889,2,0.651965595
29388,90,24899,3,5,10,0,0,18,10,10,0,0,0,20,nowin,loss,beat,dlwin,0,10,8,201,0.447761194,0.049751244,0.60199005,3,0.889945023
29389,39,24899,10,5,0,2,0,17,10,10,0,0,0,20,nowin,loss,beat,dlwin,0,10,15,191,0.429319372,0.062827225,0.57591623,0,0.033760763
29390,43,24899,10,9,0,0,0,19,10,10,0,0,0,20,nowin,loss,beat,dlwin,0,10,19,192,0.40625,0.041666667,0.609375,2,0.576671372
29391,37,24899,10,10,0,0,0,20,10,10,0,0,0,20,nowin,push,push,push,10,0,20,208,0.394230769,0.038461538,0.581730769,0,0.024682772
29392,30,24899,10,10,0,0,0,20,10,10,0,0,0,20,nowin,push,push,push,10,0,20,206,0.393203883,0.033980583,0.601941748,0,0.029324648
29393,89,24899,7,4,10,0,0,21,10,10,0,0,0,20,nowin,win,plwin,beat,20,0,11,212,0.537735849,0.047169811,0.594339623,3,0.990167191
29394,79,24900,4,4,7,0,0,15,6,9,9,0,0,24,nowin,win,dlbust,bust,20,0,8,211,0.436018957,0.028436019,0.672985782,2,0.650131054
29395,87,24900,3,4,10,0,0,17,6,9,9,0,0,24,nowin,win,dlbust,bust,20,0,7,202,0.405940594,0.054455446,0.628712871,2,0.590599801
29396,33,24900,9,5,0,0,0,14,6,9,9,0,0,24,nowin,win,dlbust,bust,20,0,14,192,0.4375,0.057291667,0.625,2,0.616208916
29397,11,24900,10,10,0,0,0,20,6,9,9,0,0,24,nowin,win,dlbust,bust,20,0,20,236,0.457627119,0.016949153,0.588983051,3,0.889015813
29398,109,24900,4,2,10,0,0,16,6,9,9,0,0,24,nowin,win,dlbust,bust,20,0,6,221,0.461538462,0.058823529,0.597285068,3,0.901830309
29399,114,24900,9,10,0,0,0,19,6,9,9,0,0,24,nowin,win,dlbust,bust,20,0,19,198,0.47979798,0.025252525,0.611111111,3,0.937232995
29400,87,24901,4,9,0,10,0,23,10,2,10,0,0,22,nowin,loss,bust,plbust,0,10,13,202,0.405940594,0.054455446,0.628712871,2,0.590599801
29401,118,24901,7,3,4,5,0,19,10,2,10,0,0,22,nowin,win,dlbust,bust,20,0,10,216,0.393518519,0.037037037,0.555555556,0,0.018059873
29402,104,24901,6,5,3,10,0,24,10,2,10,0,0,22,nowin,loss,bust,plbust,0,10,11,209,0.363636364,0.052631579,0.593301435,0,0.018359419
29403,145,24901,2,10,0,4,10,26,10,2,10,0,0,22,nowin,loss,bust,plbust,0,10,12,188,0.441489362,0.031914894,0.622340426,2,0.617837093
29404,59,24901,2,10,0,5,0,17,10,2,10,0,0,22,nowin,win,dlbust,bust,20,0,12,228,0.429824561,0.048245614,0.543859649,1,0.287885446
29405,140,24901,2,3,2,10,0,17,10,2,10,0,0,22,nowin,win,dlbust,bust,20,0,5,210,0.466666667,0.023809524,0.604761905,3,0.915293335
29406,54,24902,8,8,0,3,0,19,10,2,9,0,0,21,nowin,loss,beat,dlwin,0,10,16,185,0.437837838,0.032432432,0.556756757,1,0.29899854
29407,144,24902,4,10,0,10,0,24,10,2,9,0,0,21,nowin,loss,bust,plbust,0,10,14,202,0.386138614,0.054455446,0.564356436,0,0.018006244
29408,88,24902,10,8,0,0,0,18,10,2,9,0,0,21,nowin,loss,beat,dlwin,0,10,18,206,0.466019417,0.033980583,0.54368932,1,0.309467903
29409,131,24902,10,10,0,0,0,20,10,2,9,0,0,21,nowin,loss,beat,dlwin,0,10,20,217,0.410138249,0.069124424,0.543778802,0,0.02015021
29410,87,24902,3,6,8,0,0,17,10,2,9,0,0,21,nowin,loss,beat,dlwin,0,10,9,202,0.405940594,0.054455446,0.628712871,2,0.590599801
29411,64,24902,10,10,0,0,0,20,10,2,9,0,0,21,nowin,loss,beat,dlwin,0,10,20,187,0.363636364,0.048128342,0.631016043,0,0.027594885
29412,107,24903,10,11,0,0,0,21,6,5,10,0,0,21,win,push,push,push,10,0,21,218,0.444954128,0.073394495,0.600917431,2,0.605210014
29413,78,24903,6,3,10,0,0,19,6,5,10,0,0,21,nowin,loss,beat,dlwin,0,10,9,201,0.517412935,0.034825871,0.587064677,3,0.95871112
29414,150,24903,3,2,8,0,0,13,6,5,10,0,0,21,nowin,loss,beat,dlwin,0,10,5,192,0.401041667,0.036458333,0.567708333,0,0.023287458
29415,54,24903,6,1,8,0,0,15,6,5,10,0,0,21,nowin,loss,beat,dlwin,0,10,7,185,0.437837838,0.032432432,0.556756757,1,0.29899854
29416,69,24903,7,2,10,0,0,19,6,5,10,0,0,21,nowin,loss,beat,dlwin,0,10,9,194,0.365979381,0.030927835,0.515463918,0,0
29417,63,24903,8,10,0,0,0,18,6,5,10,0,0,21,nowin,loss,beat,dlwin,0,10,18,216,0.467592593,0.037037037,0.62037037,3,0.931690496
29418,97,24904,11,8,0,0,0,19,11,7,0,0,0,18,nowin,win,plwin,beat,20,0,19,182,0.450549451,0.06043956,0.692307692,2,0.677372279
29419,148,24904,10,10,0,0,0,20,11,7,0,0,0,18,nowin,win,plwin,beat,20,0,20,204,0.401960784,0.078431373,0.593137255,0,0.029789521
29420,127,24904,8,10,0,0,0,18,11,7,0,0,0,18,nowin,push,push,push,10,0,18,201,0.402985075,0.029850746,0.60199005,0,0.032263937
29421,38,24904,7,11,0,0,0,18,11,7,0,0,0,18,nowin,push,push,push,10,0,18,202,0.361386139,0.03960396,0.564356436,0,0.010597953
29422,139,24904,8,10,0,0,0,18,11,7,0,0,0,18,nowin,push,push,push,10,0,18,192,0.380208333,0.036458333,0.59375,0,0.023429169
29423,54,24904,2,10,0,8,0,20,11,7,0,0,0,18,nowin,win,plwin,beat,20,0,12,185,0.437837838,0.032432432,0.556756757,1,0.29899854
29424,114,24905,7,10,0,0,0,17,4,6,2,10,0,22,nowin,win,dlbust,bust,20,0,17,198,0.47979798,0.025252525,0.611111111,3,0.937232995
29425,54,24905,5,2,5,0,0,12,4,6,2,10,0,22,nowin,win,dlbust,bust,20,0,7,185,0.437837838,0.032432432,0.556756757,1,0.29899854
29426,75,24905,8,10,0,0,0,18,4,6,2,10,0,22,nowin,win,dlbust,bust,20,0,18,191,0.418848168,0.052356021,0.570680628,0,0.029344702
29427,143,24905,3,7,4,0,0,14,4,6,2,10,0,22,nowin,win,dlbust,bust,20,0,10,203,0.463054187,0.044334975,0.57635468,3,0.883143365
29428,25,24905,5,4,8,0,0,17,4,6,2,10,0,22,nowin,win,dlbust,bust,20,0,9,190,0.463157895,0.063157895,0.536842105,1,0.304401563
29429,45,24905,5,7,0,0,0,12,4,6,2,10,0,22,nowin,win,dlbust,bust,20,0,12,196,0.428571429,0.051020408,0.612244898,2,0.598821767
29430,8,24906,9,6,0,9,0,24,8,8,5,0,0,21,nowin,loss,bust,plbust,0,10,15,181,0.44198895,0.071823204,0.596685083,2,0.599438402
29431,75,24906,10,5,0,7,0,22,8,8,5,0,0,21,nowin,loss,bust,plbust,0,10,15,191,0.418848168,0.052356021,0.570680628,0,0.029344702
29432,108,24906,7,2,3,1,10,23,8,8,5,0,0,21,nowin,loss,bust,plbust,0,10,9,193,0.435233161,0.056994819,0.559585492,1,0.298824795
29433,87,24906,4,10,0,7,0,21,8,8,5,0,0,21,nowin,push,push,push,10,0,14,202,0.405940594,0.054455446,0.628712871,2,0.590599801
29434,116,24906,10,11,0,0,0,21,8,8,5,0,0,21,win,push,push,push,10,0,21,195,0.425641026,0.056410256,0.538461538,1,0.28273747
29435,58,24906,11,8,0,0,0,19,8,8,5,0,0,21,nowin,loss,beat,dlwin,0,10,19,195,0.430769231,0.041025641,0.584615385,2,0.580497586
29436,114,24907,10,4,0,10,0,24,11,10,0,0,0,21,nowin,loss,bust,plbust,0,10,14,198,0.47979798,0.025252525,0.611111111,3,0.937232995
29437,97,24907,4,6,2,5,0,17,11,10,0,0,0,21,nowin,loss,beat,dlwin,0,10,10,182,0.450549451,0.06043956,0.692307692,2,0.677372279
29438,114,24907,5,11,5,0,0,21,11,10,0,0,0,21,nowin,push,push,push,10,0,16,198,0.47979798,0.025252525,0.611111111,3,0.937232995
29439,101,24907,6,1,6,10,0,23,11,10,0,0,0,21,nowin,loss,bust,plbust,0,10,7,205,0.424390244,0.068292683,0.63902439,2,0.614740646
29440,123,24907,10,7,0,0,0,17,11,10,0,0,0,21,nowin,loss,beat,dlwin,0,10,17,205,0.43902439,0.034146341,0.614634146,2,0.609962544
29441,60,24907,9,3,0,7,0,19,11,10,0,0,0,21,nowin,loss,beat,dlwin,0,10,12,227,0.418502203,0.022026432,0.559471366,0,0.026496258
29442,139,24908,10,5,0,10,0,25,8,2,11,0,0,21,nowin,loss,bust,plbust,0,10,15,192,0.380208333,0.036458333,0.59375,0,0.023429169
29443,79,24908,6,5,2,3,3,19,8,2,11,0,0,21,nowin,loss,beat,dlwin,0,10,11,211,0.436018957,0.028436019,0.672985782,2,0.650131054
29444,117,24908,10,10,0,0,0,20,8,2,11,0,0,21,nowin,loss,beat,dlwin,0,10,20,173,0.410404624,0.069364162,0.606936416,2,0.578610282
29445,79,24908,5,1,8,7,0,21,8,2,11,0,0,21,nowin,push,push,push,10,0,6,211,0.436018957,0.028436019,0.672985782,2,0.650131054
29446,80,24908,10,5,0,6,0,21,8,2,11,0,0,21,nowin,push,push,push,10,0,15,186,0.419354839,0.059139785,0.623655914,2,0.59892924
29447,55,24908,9,3,0,5,0,17,8,2,11,0,0,21,nowin,loss,beat,dlwin,0,10,12,191,0.371727749,0.057591623,0.54973822,0,0.01011347
29448,93,24909,7,9,0,1,0,17,9,11,0,0,0,20,nowin,loss,beat,dlwin,0,10,16,175,0.485714286,0.051428571,0.548571429,1,0.323648091
29449,67,24909,9,10,0,0,0,19,9,11,0,0,0,20,nowin,loss,beat,dlwin,0,10,19,195,0.369230769,0.041025641,0.569230769,0,0.014139427
29450,84,24909,10,7,0,0,0,17,9,11,0,0,0,20,nowin,loss,beat,dlwin,0,10,17,195,0.379487179,0.056410256,0.569230769,0,0.017209119
29451,119,24909,7,10,0,0,0,17,9,11,0,0,0,20,nowin,loss,beat,dlwin,0,10,17,190,0.405263158,0.068421053,0.515789474,0,0.011837158
29452,147,24909,2,11,8,0,0,21,9,11,0,0,0,20,nowin,win,plwin,beat,20,0,13,205,0.380487805,0.014634146,0.536585366,0,0.00951447
29453,68,24909,5,10,0,7,0,22,9,11,0,0,0,20,nowin,loss,bust,plbust,0,10,15,205,0.434146341,0.029268293,0.6,2,0.59483189
29454,98,24910,11,5,1,0,0,17,11,9,0,0,0,20,nowin,loss,beat,dlwin,0,10,16,220,0.422727273,0.054545455,0.55,1,0.28664435
29455,115,24910,10,2,0,10,0,22,11,9,0,0,0,20,nowin,loss,bust,plbust,0,10,12,194,0.427835052,0.041237113,0.592783505,2,0.583863602
29456,53,24910,10,7,0,0,0,17,11,9,0,0,0,20,nowin,loss,beat,dlwin,0,10,17,250,0.372,0.064,0.564,0,0.013687345
29457,124,24910,3,3,8,5,0,19,11,9,0,0,0,20,nowin,loss,beat,dlwin,0,10,6,202,0.47029703,0.064356436,0.584158416,3,0.899458193
29458,147,24910,10,8,0,0,0,18,11,9,0,0,0,20,nowin,loss,beat,dlwin,0,10,18,205,0.380487805,0.014634146,0.536585366,0,0.00951447
29459,8,24910,2,8,7,0,0,17,11,9,0,0,0,20,nowin,loss,beat,dlwin,0,10,10,181,0.44198895,0.071823204,0.596685083,2,0.599438402
29460,140,24911,4,6,8,0,0,18,2,10,10,0,0,22,nowin,win,dlbust,bust,20,0,10,210,0.466666667,0.023809524,0.604761905,3,0.915293335
29461,40,24911,7,9,0,0,0,16,2,10,10,0,0,22,nowin,win,dlbust,bust,20,0,16,196,0.367346939,0.030612245,0.617346939,0,0.025358183
29462,121,24911,3,10,0,0,0,13,2,10,10,0,0,22,nowin,win,dlbust,bust,20,0,13,195,0.456410256,0.025641026,0.512820513,1,0.288597791
29463,22,24911,10,2,0,5,0,17,2,10,10,0,0,22,nowin,win,dlbust,bust,20,0,12,187,0.481283422,0.042780749,0.577540107,3,0.906128176
29464,91,24911,6,5,10,0,0,21,2,10,10,0,0,22,nowin,win,dlbust,bust,20,0,11,194,0.417525773,0.046391753,0.515463918,1,0.266616552
29465,90,24911,10,3,0,0,0,13,2,10,10,0,0,22,nowin,win,dlbust,bust,20,0,13,201,0.447761194,0.049751244,0.60199005,3,0.889945023
29466,102,24912,11,10,0,0,0,21,8,4,7,0,0,19,win,win,plwin,beat,25,0,21,192,0.338541667,0.046875,0.5625,0,0.003306118
29467,143,24912,10,2,0,6,0,18,8,4,7,0,0,19,nowin,loss,beat,dlwin,0,10,12,203,0.463054187,0.044334975,0.57635468,3,0.883143365
29468,21,24912,10,7,0,0,0,17,8,4,7,0,0,19,nowin,loss,beat,dlwin,0,10,17,214,0.359813084,0.042056075,0.626168224,0,0.025263474
29469,25,24912,6,10,0,9,0,25,8,4,7,0,0,19,nowin,loss,bust,plbust,0,10,16,190,0.463157895,0.063157895,0.536842105,1,0.304401563
29470,85,24912,10,9,0,0,0,19,8,4,7,0,0,19,nowin,push,push,push,10,0,19,195,0.41025641,0.066666667,0.594871795,0,0.03269711
29471,11,24912,2,4,8,4,0,18,8,4,7,0,0,19,nowin,loss,beat,dlwin,0,10,6,236,0.457627119,0.016949153,0.588983051,3,0.889015813
29472,128,24913,3,8,9,0,0,20,10,6,9,0,0,25,nowin,win,dlbust,bust,20,0,11,227,0.356828194,0.052863436,0.577092511,0,0.012352564
29473,28,24913,8,10,0,0,0,18,10,6,9,0,0,25,nowin,win,dlbust,bust,20,0,18,199,0.422110553,0.045226131,0.542713568,1,0.282706618
29474,22,24913,10,3,0,4,0,17,10,6,9,0,0,25,nowin,win,dlbust,bust,20,0,13,187,0.481283422,0.042780749,0.577540107,3,0.906128176
29475,15,24913,10,10,0,0,0,20,10,6,9,0,0,25,nowin,win,dlbust,bust,20,0,20,212,0.410377358,0.051886792,0.561320755,0,0.024517408
29476,94,24913,7,8,0,8,0,23,10,6,9,0,0,25,nowin,loss,bust,plbust,0,10,15,183,0.43715847,0.043715847,0.540983607,1,0.290866892
29477,88,24913,9,11,0,0,0,20,10,6,9,0,0,25,nowin,win,dlbust,bust,20,0,20,206,0.466019417,0.033980583,0.54368932,1,0.309467903
29478,19,24914,2,7,10,0,0,19,8,2,5,9,0,24,nowin,win,dlbust,bust,20,0,9,237,0.41350211,0.054852321,0.628691983,2,0.597373826
29479,54,24914,5,5,8,0,0,18,8,2,5,9,0,24,nowin,win,dlbust,bust,20,0,10,185,0.437837838,0.032432432,0.556756757,1,0.29899854
29480,146,24914,10,5,0,10,0,25,8,2,5,9,0,24,nowin,loss,bust,plbust,0,10,15,221,0.43438914,0.040723982,0.542986425,1,0.290190091
29481,12,24914,4,8,0,10,0,22,8,2,5,9,0,24,nowin,loss,bust,plbust,0,10,12,189,0.470899471,0.015873016,0.613756614,3,0.929171178
29482,20,24914,3,10,0,1,10,24,8,2,5,9,0,24,nowin,loss,bust,plbust,0,10,13,186,0.456989247,0.037634409,0.537634409,1,0.301097108
29483,70,24914,3,10,0,4,0,17,8,2,5,9,0,24,nowin,win,dlbust,bust,20,0,13,228,0.385964912,0.039473684,0.557017544,0,0.016157125
29484,54,24915,4,5,10,0,0,19,10,10,0,0,0,20,nowin,loss,beat,dlwin,0,10,9,185,0.437837838,0.032432432,0.556756757,1,0.29899854
29485,142,24915,7,10,0,0,0,17,10,10,0,0,0,20,nowin,loss,beat,dlwin,0,10,17,211,0.417061611,0.047393365,0.526066351,1,0.271531309
29486,51,24915,8,4,0,8,0,20,10,10,0,0,0,20,nowin,push,push,push,10,0,12,189,0.529100529,0.068783069,0.608465608,3,0.993665715
29487,138,24915,1,5,8,4,0,18,10,10,0,0,0,20,nowin,loss,beat,dlwin,0,10,6,190,0.442105263,0.047368421,0.610526316,2,0.609711065
29488,114,24915,11,5,2,0,0,18,10,10,0,0,0,20,nowin,loss,beat,dlwin,0,10,16,198,0.47979798,0.025252525,0.611111111,3,0.937232995
29489,122,24915,10,6,0,5,0,21,10,10,0,0,0,20,nowin,win,plwin,beat,20,0,16,210,0.347619048,0.052380952,0.59047619,0,0.012873677
29490,52,24916,5,5,7,0,0,17,11,5,4,0,0,20,nowin,loss,beat,dlwin,0,10,10,217,0.414746544,0.02764977,0.599078341,2,0.576736024
29491,29,24916,10,3,0,1,5,19,11,5,4,0,0,20,nowin,loss,beat,dlwin,0,10,13,189,0.44973545,0.058201058,0.544973545,1,0.300349439
29492,20,24916,10,5,0,10,0,25,11,5,4,0,0,20,nowin,loss,bust,plbust,0,10,15,186,0.456989247,0.037634409,0.537634409,1,0.301097108
29493,72,24916,8,9,0,0,0,17,11,5,4,0,0,20,nowin,loss,beat,dlwin,0,10,17,185,0.394594595,0.032432432,0.508108108,0,0.006763115
29494,42,24916,9,11,0,0,0,20,11,5,4,0,0,20,nowin,push,push,push,10,0,20,212,0.443396226,0.051886792,0.570754717,1,0.309181312
29495,34,24916,7,3,2,10,0,22,11,5,4,0,0,20,nowin,loss,bust,plbust,0,10,10,202,0.5,0.079207921,0.618811881,3,0.968961434
29496,60,24917,10,9,0,0,0,19,5,10,1,5,0,21,nowin,loss,beat,dlwin,0,10,19,227,0.418502203,0.022026432,0.559471366,0,0.026496258
29497,95,24917,2,6,10,0,0,18,5,10,1,5,0,21,nowin,loss,beat,dlwin,0,10,8,218,0.412844037,0.04587156,0.559633028,0,0.024842385
29498,93,24917,10,10,0,0,0,20,5,10,1,5,0,21,nowin,loss,beat,dlwin,0,10,20,175,0.485714286,0.051428571,0.548571429,1,0.323648091
29499,97,24917,10,2,0,0,0,12,5,10,1,5,0,21,nowin,loss,beat,dlwin,0,10,12,182,0.450549451,0.06043956,0.692307692,2,0.677372279
29500,42,24917,6,10,0,0,0,16,5,10,1,5,0,21,nowin,loss,beat,dlwin,0,10,16,212,0.443396226,0.051886792,0.570754717,1,0.309181312
29501,11,24917,11,3,5,0,0,19,5,10,1,5,0,21,nowin,loss,beat,dlwin,0,10,14,236,0.457627119,0.016949153,0.588983051,3,0.889015813
29502,142,24918,5,8,0,0,0,13,6,10,10,0,0,26,nowin,win,dlbust,bust,20,0,13,211,0.417061611,0.047393365,0.526066351,1,0.271531309
29503,37,24918,3,9,0,0,0,12,6,10,10,0,0,26,nowin,win,dlbust,bust,20,0,12,208,0.394230769,0.038461538,0.581730769,0,0.024682772
29504,62,24918,10,6,0,0,0,16,6,10,10,0,0,26,nowin,win,dlbust,bust,20,0,16,178,0.370786517,0.028089888,0.54494382,0,0.008657722
29505,11,24918,9,8,0,0,0,17,6,10,10,0,0,26,nowin,win,dlbust,bust,20,0,17,236,0.457627119,0.016949153,0.588983051,3,0.889015813
29506,140,24918,2,10,0,0,0,12,6,10,10,0,0,26,nowin,win,dlbust,bust,20,0,12,210,0.466666667,0.023809524,0.604761905,3,0.915293335
29507,40,24918,5,6,5,0,0,16,6,10,10,0,0,26,nowin,win,dlbust,bust,20,0,11,196,0.367346939,0.030612245,0.617346939,0,0.025358183
29508,2,24919,9,2,9,0,0,20,6,7,3,10,0,26,nowin,win,dlbust,bust,20,0,11,200,0.445,0.035,0.64,2,0.633962549
29509,71,24919,7,8,0,0,0,15,6,7,3,10,0,26,nowin,win,dlbust,bust,20,0,15,193,0.352331606,0.046632124,0.585492228,0,0.013063661
29510,121,24919,8,10,0,0,0,18,6,7,3,10,0,26,nowin,win,dlbust,bust,20,0,18,195,0.456410256,0.025641026,0.512820513,1,0.288597791
29511,91,24919,10,5,0,0,0,15,6,7,3,10,0,26,nowin,win,dlbust,bust,20,0,15,194,0.417525773,0.046391753,0.515463918,1,0.266616552
29512,66,24919,11,10,0,0,0,21,6,7,3,10,0,26,win,win,dlbust,bust,25,0,21,217,0.456221198,0.064516129,0.626728111,3,0.924304367
29513,25,24919,10,6,0,0,0,16,6,7,3,10,0,26,nowin,win,dlbust,bust,20,0,16,190,0.463157895,0.063157895,0.536842105,1,0.304401563
29514,135,24920,4,8,0,10,0,22,10,7,0,0,0,17,nowin,loss,bust,plbust,0,10,12,179,0.391061453,0.067039106,0.586592179,0,0.024924662
29515,91,24920,7,10,0,0,0,17,10,7,0,0,0,17,nowin,push,push,push,10,0,17,194,0.417525773,0.046391753,0.515463918,1,0.266616552
29516,54,24920,5,10,0,9,0,24,10,7,0,0,0,17,nowin,loss,bust,plbust,0,10,15,185,0.437837838,0.032432432,0.556756757,1,0.29899854
29517,141,24920,10,4,0,3,0,17,10,7,0,0,0,17,nowin,push,push,push,10,0,14,202,0.420792079,0.074257426,0.564356436,0,0.028377851
29518,136,24920,6,7,0,6,0,19,10,7,0,0,0,17,nowin,win,plwin,beat,20,0,13,194,0.396907216,0.025773196,0.597938144,0,0.029452644
29519,93,24920,10,9,0,0,0,19,10,7,0,0,0,17,nowin,win,plwin,beat,20,0,19,175,0.485714286,0.051428571,0.548571429,1,0.323648091
29520,102,24921,8,9,0,0,0,17,4,3,10,0,0,17,nowin,push,push,push,10,0,17,192,0.338541667,0.046875,0.5625,0,0.003306118
29521,45,24921,7,9,0,0,0,16,4,3,10,0,0,17,nowin,loss,beat,dlwin,0,10,16,196,0.428571429,0.051020408,0.612244898,2,0.598821767
29522,140,24921,7,9,0,0,0,16,4,3,10,0,0,17,nowin,loss,beat,dlwin,0,10,16,210,0.466666667,0.023809524,0.604761905,3,0.915293335
29523,128,24921,5,10,0,0,0,15,4,3,10,0,0,17,nowin,loss,beat,dlwin,0,10,15,227,0.356828194,0.052863436,0.577092511,0,0.012352564
29524,148,24921,7,10,0,0,0,17,4,3,10,0,0,17,nowin,push,push,push,10,0,17,204,0.401960784,0.078431373,0.593137255,0,0.029789521
29525,104,24921,10,9,0,0,0,19,4,3,10,0,0,17,nowin,win,plwin,beat,20,0,19,209,0.363636364,0.052631579,0.593301435,0,0.018359419
29526,39,24922,4,8,0,10,0,22,10,3,4,0,0,17,nowin,loss,bust,plbust,0,10,12,191,0.429319372,0.062827225,0.57591623,0,0.033760763
29527,6,24922,10,7,0,0,0,17,10,3,4,0,0,17,nowin,push,push,push,10,0,17,191,0.439790576,0.047120419,0.581151832,1,0.31211505
29528,14,24922,6,4,11,0,0,21,10,3,4,0,0,17,nowin,win,plwin,beat,20,0,10,202,0.391089109,0.01980198,0.628712871,2,0.577264877
29529,126,24922,10,3,0,1,9,23,10,3,4,0,0,17,nowin,loss,bust,plbust,0,10,13,188,0.457446809,0.074468085,0.60106383,3,0.900633203
29530,132,24922,9,8,0,0,0,17,10,3,4,0,0,17,nowin,push,push,push,10,0,17,194,0.412371134,0.036082474,0.649484536,2,0.611633238
29531,77,24922,10,10,0,0,0,20,10,3,4,0,0,17,nowin,win,plwin,beat,20,0,20,200,0.455,0.04,0.62,3,0.916252116
29532,145,24923,10,10,0,0,0,20,2,2,8,3,7,22,nowin,win,dlbust,bust,20,0,20,188,0.441489362,0.031914894,0.622340426,2,0.617837093
29533,85,24923,7,10,0,0,0,17,2,2,8,3,7,22,nowin,win,dlbust,bust,20,0,17,195,0.41025641,0.066666667,0.594871795,0,0.03269711
29534,96,24923,6,3,3,10,0,22,2,2,8,3,7,22,nowin,loss,bust,plbust,0,10,9,190,0.468421053,0.057894737,0.584210526,3,0.897263354
29535,35,24923,10,5,0,0,0,15,2,2,8,3,7,22,nowin,win,dlbust,bust,20,0,15,202,0.410891089,0.044554455,0.633663366,2,0.598681573
29536,57,24923,10,9,0,0,0,19,2,2,8,3,7,22,nowin,win,dlbust,bust,20,0,19,192,0.46875,0.052083333,0.59375,3,0.907001181
29537,44,24923,2,4,5,9,0,20,2,2,8,3,7,22,nowin,win,dlbust,bust,20,0,6,219,0.433789954,0.050228311,0.534246575,1,0.285551035
29538,44,24924,10,9,0,0,0,19,8,3,10,0,0,21,nowin,loss,beat,dlwin,0,10,19,219,0.433789954,0.050228311,0.534246575,1,0.285551035
29539,48,24924,5,10,0,3,0,18,8,3,10,0,0,21,nowin,loss,beat,dlwin,0,10,15,203,0.413793103,0.019704433,0.600985222,2,0.577280801
29540,79,24924,8,4,0,2,10,24,8,3,10,0,0,21,nowin,loss,bust,plbust,0,10,12,211,0.436018957,0.028436019,0.672985782,2,0.650131054
29541,13,24924,2,5,4,5,4,20,8,3,10,0,0,21,nowin,loss,beat,dlwin,0,10,7,206,0.417475728,0.063106796,0.621359223,2,0.59555479
29542,76,24924,5,3,11,0,0,19,8,3,10,0,0,21,nowin,loss,beat,dlwin,0,10,8,189,0.534391534,0.079365079,0.608465608,3,1
29543,14,24924,10,10,0,0,0,20,8,3,10,0,0,21,nowin,loss,beat,dlwin,0,10,20,202,0.391089109,0.01980198,0.628712871,2,0.577264877
29544,142,24925,10,3,0,0,0,13,3,3,10,3,0,19,nowin,loss,beat,dlwin,0,10,13,211,0.417061611,0.047393365,0.526066351,1,0.271531309
29545,49,24925,5,5,10,0,0,20,3,3,10,3,0,19,nowin,win,plwin,beat,20,0,10,207,0.396135266,0.053140097,0.594202899,0,0.028306925
29546,43,24925,11,9,0,0,0,20,3,3,10,3,0,19,nowin,win,plwin,beat,20,0,20,192,0.40625,0.041666667,0.609375,2,0.576671372
29547,109,24925,10,2,0,8,0,20,3,3,10,3,0,19,nowin,win,plwin,beat,20,0,12,221,0.461538462,0.058823529,0.597285068,3,0.901830309
29548,58,24925,8,10,0,0,0,18,3,3,10,3,0,19,nowin,loss,beat,dlwin,0,10,18,195,0.430769231,0.041025641,0.584615385,2,0.580497586
29549,141,24925,8,7,0,0,0,15,3,3,10,3,0,19,nowin,loss,beat,dlwin,0,10,15,202,0.420792079,0.074257426,0.564356436,0,0.028377851
29550,105,24926,6,7,0,10,0,23,8,6,10,0,0,24,nowin,loss,bust,plbust,0,10,13,198,0.414141414,0.070707071,0.590909091,0,0.032889494
29551,110,24926,10,9,0,0,0,19,8,6,10,0,0,24,nowin,win,dlbust,bust,20,0,19,192,0.416666667,0.046875,0.557291667,0,0.025413132
29552,52,24926,4,10,0,5,0,19,8,6,10,0,0,24,nowin,win,dlbust,bust,20,0,14,217,0.414746544,0.02764977,0.599078341,2,0.576736024
29553,85,24926,3,8,10,0,0,21,8,6,10,0,0,24,nowin,win,dlbust,bust,20,0,11,195,0.41025641,0.066666667,0.594871795,0,0.03269711
29554,141,24926,4,6,10,0,0,20,8,6,10,0,0,24,nowin,win,dlbust,bust,20,0,10,202,0.420792079,0.074257426,0.564356436,0,0.028377851
29555,131,24926,9,4,0,7,0,20,8,6,10,0,0,24,nowin,win,dlbust,bust,20,0,13,217,0.410138249,0.069124424,0.543778802,0,0.02015021
29556,53,24927,10,5,0,1,8,24,11,10,0,0,0,21,nowin,loss,bust,plbust,0,10,15,250,0.372,0.064,0.564,0,0.013687345
29557,52,24927,2,7,4,10,0,23,11,10,0,0,0,21,nowin,loss,bust,plbust,0,10,9,217,0.414746544,0.02764977,0.599078341,2,0.576736024
29558,29,24927,10,5,0,5,0,20,11,10,0,0,0,21,nowin,loss,beat,dlwin,0,10,15,189,0.44973545,0.058201058,0.544973545,1,0.300349439
29559,74,24927,7,5,0,5,0,17,11,10,0,0,0,21,nowin,loss,beat,dlwin,0,10,12,209,0.411483254,0.04784689,0.531100478,0,0.017448125
29560,34,24927,10,7,0,0,0,17,11,10,0,0,0,21,nowin,loss,beat,dlwin,0,10,17,202,0.5,0.079207921,0.618811881,3,0.968961434
29561,82,24927,4,1,10,10,0,25,11,10,0,0,0,21,nowin,loss,bust,plbust,0,10,5,225,0.408888889,0.075555556,0.577777778,0,0.028101874
29562,76,24928,10,5,0,10,0,25,7,6,9,0,0,22,nowin,loss,bust,plbust,0,10,15,189,0.534391534,0.079365079,0.608465608,3,1
29563,76,24928,5,10,0,2,0,17,7,6,9,0,0,22,nowin,win,dlbust,bust,20,0,15,189,0.534391534,0.079365079,0.608465608,3,1
29564,139,24928,5,6,10,0,0,21,7,6,9,0,0,22,nowin,win,dlbust,bust,20,0,11,192,0.380208333,0.036458333,0.59375,0,0.023429169
29565,143,24928,9,4,0,7,0,20,7,6,9,0,0,22,nowin,win,dlbust,bust,20,0,13,203,0.463054187,0.044334975,0.57635468,3,0.883143365
29566,112,24928,10,5,0,10,0,25,7,6,9,0,0,22,nowin,loss,bust,plbust,0,10,15,203,0.448275862,0.054187192,0.600985222,3,0.889576933
29567,114,24928,3,4,7,6,0,20,7,6,9,0,0,22,nowin,win,dlbust,bust,20,0,7,198,0.47979798,0.025252525,0.611111111,3,0.937232995
29568,34,24929,3,6,2,9,0,20,7,10,0,0,0,17,nowin,win,plwin,beat,20,0,9,202,0.5,0.079207921,0.618811881,3,0.968961434
29569,103,24929,9,8,0,0,0,17,7,10,0,0,0,17,nowin,push,push,push,10,0,17,203,0.379310345,0.064039409,0.551724138,0,0.012869209
29570,129,24929,7,11,0,0,0,18,7,10,0,0,0,17,nowin,win,plwin,beat,20,0,18,201,0.422885572,0.064676617,0.55721393,0,0.027255383
29571,103,24929,10,10,0,0,0,20,7,10,0,0,0,17,nowin,win,plwin,beat,20,0,20,203,0.379310345,0.064039409,0.551724138,0,0.012869209
29572,24,24929,10,6,0,9,0,25,7,10,0,0,0,17,nowin,loss,bust,plbust,0,10,16,207,0.458937198,0.048309179,0.570048309,1,0.318138014
29573,74,24929,5,2,10,0,0,17,7,10,0,0,0,17,nowin,push,push,push,10,0,7,209,0.411483254,0.04784689,0.531100478,0,0.017448125
29574,141,24930,11,1,7,0,0,19,6,6,2,10,0,24,nowin,win,dlbust,bust,20,0,12,202,0.420792079,0.074257426,0.564356436,0,0.028377851
29575,33,24930,9,6,0,0,0,15,6,6,2,10,0,24,nowin,win,dlbust,bust,20,0,15,192,0.4375,0.057291667,0.625,2,0.616208916
29576,118,24930,3,4,10,0,0,17,6,6,2,10,0,24,nowin,win,dlbust,bust,20,0,7,216,0.393518519,0.037037037,0.555555556,0,0.018059873
29577,105,24930,6,10,0,0,0,16,6,6,2,10,0,24,nowin,win,dlbust,bust,20,0,16,198,0.414141414,0.070707071,0.590909091,0,0.032889494
29578,36,24930,4,1,10,0,0,15,6,6,2,10,0,24,nowin,win,dlbust,bust,20,0,5,229,0.445414847,0.056768559,0.655021834,2,0.645370571
29579,124,24930,11,10,0,0,0,21,6,6,2,10,0,24,win,win,dlbust,bust,25,0,21,202,0.47029703,0.064356436,0.584158416,3,0.899458193
29580,117,24931,10,10,0,0,0,20,4,7,6,0,0,17,nowin,win,plwin,beat,20,0,20,173,0.410404624,0.069364162,0.606936416,2,0.578610282
29581,56,24931,10,4,0,0,0,14,4,7,6,0,0,17,nowin,loss,beat,dlwin,0,10,14,175,0.4,0.057142857,0.582857143,0,0.026685297
29582,90,24931,8,6,0,0,0,14,4,7,6,0,0,17,nowin,loss,beat,dlwin,0,10,14,201,0.447761194,0.049751244,0.60199005,3,0.889945023
29583,113,24931,10,5,0,0,0,15,4,7,6,0,0,17,nowin,loss,beat,dlwin,0,10,15,199,0.407035176,0.055276382,0.668341709,2,0.620695264
29584,49,24931,10,2,0,0,0,12,4,7,6,0,0,17,nowin,loss,beat,dlwin,0,10,12,207,0.396135266,0.053140097,0.594202899,0,0.028306925
29585,111,24931,2,5,3,3,0,13,4,7,6,0,0,17,nowin,loss,beat,dlwin,0,10,7,180,0.433333333,0.055555556,0.611111111,2,0.602264492
29586,4,24932,9,10,0,0,0,19,3,10,10,0,0,23,nowin,win,dlbust,bust,20,0,19,217,0.460829493,0.036866359,0.562211982,1,0.315432839
29587,23,24932,4,10,0,0,0,14,3,10,10,0,0,23,nowin,win,dlbust,bust,20,0,14,208,0.427884615,0.0625,0.552884615,1,0.29114424
29588,66,24932,10,10,0,0,0,20,3,10,10,0,0,23,nowin,win,dlbust,bust,20,0,20,217,0.456221198,0.064516129,0.626728111,3,0.924304367
29589,28,24932,8,3,6,0,0,17,3,10,10,0,0,23,nowin,win,dlbust,bust,20,0,11,199,0.422110553,0.045226131,0.542713568,1,0.282706618
29590,141,24932,10,11,0,0,0,21,3,10,10,0,0,23,win,win,dlbust,bust,25,0,21,202,0.420792079,0.074257426,0.564356436,0,0.028377851
29591,115,24932,10,5,0,0,0,15,3,10,10,0,0,23,nowin,win,dlbust,bust,20,0,15,194,0.427835052,0.041237113,0.592783505,2,0.583863602
29592,138,24933,3,5,7,4,0,19,8,9,0,0,0,17,nowin,win,plwin,beat,20,0,8,190,0.442105263,0.047368421,0.610526316,2,0.609711065
29593,93,24933,2,5,2,1,10,20,8,9,0,0,0,17,nowin,win,plwin,beat,20,0,7,175,0.485714286,0.051428571,0.548571429,1,0.323648091
29594,16,24933,3,3,8,5,0,19,8,9,0,0,0,17,nowin,win,plwin,beat,20,0,6,220,0.427272727,0.081818182,0.6,2,0.588660176
29595,20,24933,10,3,0,5,0,18,8,9,0,0,0,17,nowin,win,plwin,beat,20,0,13,186,0.456989247,0.037634409,0.537634409,1,0.301097108
29596,123,24933,10,10,0,0,0,20,8,9,0,0,0,17,nowin,win,plwin,beat,20,0,20,205,0.43902439,0.034146341,0.614634146,2,0.609962544
29597,96,24933,11,3,2,10,0,26,8,9,0,0,0,17,nowin,loss,bust,plbust,0,10,14,190,0.468421053,0.057894737,0.584210526,3,0.897263354
29598,11,24934,10,10,0,0,0,20,7,4,6,0,0,17,nowin,win,plwin,beat,20,0,20,236,0.457627119,0.016949153,0.588983051,3,0.889015813
29599,122,24934,10,10,0,0,0,20,7,4,6,0,0,17,nowin,win,plwin,beat,20,0,20,210,0.347619048,0.052380952,0.59047619,0,0.012873677
29600,11,24934,10,11,0,0,0,21,7,4,6,0,0,17,win,win,plwin,beat,25,0,21,236,0.457627119,0.016949153,0.588983051,3,0.889015813
29601,70,24934,10,4,0,5,0,19,7,4,6,0,0,17,nowin,win,plwin,beat,20,0,14,228,0.385964912,0.039473684,0.557017544,0,0.016157125
29602,36,24934,10,10,0,0,0,20,7,4,6,0,0,17,nowin,win,plwin,beat,20,0,20,229,0.445414847,0.056768559,0.655021834,2,0.645370571
29603,87,24934,8,4,0,1,4,17,7,4,6,0,0,17,nowin,push,push,push,10,0,12,202,0.405940594,0.054455446,0.628712871,2,0.590599801
29604,135,24935,8,8,0,0,0,16,2,3,7,3,6,21,nowin,loss,beat,dlwin,0,10,16,179,0.391061453,0.067039106,0.586592179,0,0.024924662
29605,119,24935,5,7,0,5,0,17,2,3,7,3,6,21,nowin,loss,beat,dlwin,0,10,12,190,0.405263158,0.068421053,0.515789474,0,0.011837158
29606,112,24935,3,10,0,0,0,13,2,3,7,3,6,21,nowin,loss,beat,dlwin,0,10,13,203,0.448275862,0.054187192,0.600985222,3,0.889576933
29607,115,24935,6,4,5,0,0,15,2,3,7,3,6,21,nowin,loss,beat,dlwin,0,10,10,194,0.427835052,0.041237113,0.592783505,2,0.583863602
29608,145,24935,8,10,0,0,0,18,2,3,7,3,6,21,nowin,loss,beat,dlwin,0,10,18,188,0.441489362,0.031914894,0.622340426,2,0.617837093
29609,29,24935,5,5,10,0,0,20,2,3,7,3,6,21,nowin,loss,beat,dlwin,0,10,10,189,0.44973545,0.058201058,0.544973545,1,0.300349439
29610,68,24936,10,8,0,0,0,18,3,3,3,8,0,17,nowin,win,plwin,beat,20,0,18,205,0.434146341,0.029268293,0.6,2,0.59483189
29611,21,24936,5,10,0,0,0,15,3,3,3,8,0,17,nowin,loss,beat,dlwin,0,10,15,214,0.359813084,0.042056075,0.626168224,0,0.025263474
29612,87,24936,6,10,0,0,0,16,3,3,3,8,0,17,nowin,loss,beat,dlwin,0,10,16,202,0.405940594,0.054455446,0.628712871,2,0.590599801
29613,129,24936,11,10,0,0,0,21,3,3,3,8,0,17,win,win,plwin,beat,25,0,21,201,0.422885572,0.064676617,0.55721393,0,0.027255383
29614,101,24936,4,4,11,0,0,19,3,3,3,8,0,17,nowin,win,plwin,beat,20,0,8,205,0.424390244,0.068292683,0.63902439,2,0.614740646
29615,81,24936,10,8,0,0,0,18,3,3,3,8,0,17,nowin,win,plwin,beat,20,0,18,182,0.395604396,0.043956044,0.60989011,2,0.567491261
29616,8,24937,8,10,0,0,0,18,10,2,10,0,0,22,nowin,win,dlbust,bust,20,0,18,181,0.44198895,0.071823204,0.596685083,2,0.599438402
29617,55,24937,3,6,10,0,0,19,10,2,10,0,0,22,nowin,win,dlbust,bust,20,0,9,191,0.371727749,0.057591623,0.54973822,0,0.01011347
29618,48,24937,10,10,0,0,0,20,10,2,10,0,0,22,nowin,win,dlbust,bust,20,0,20,203,0.413793103,0.019704433,0.600985222,2,0.577280801
29619,1,24937,11,6,1,0,0,18,10,2,10,0,0,22,nowin,win,dlbust,bust,20,0,17,197,0.406091371,0.025380711,0.649746193,2,0.606186955
29620,144,24937,7,10,0,0,0,17,10,2,10,0,0,22,nowin,win,dlbust,bust,20,0,17,202,0.386138614,0.054455446,0.564356436,0,0.018006244
29621,14,24937,10,10,0,0,0,20,10,2,10,0,0,22,nowin,win,dlbust,bust,20,0,20,202,0.391089109,0.01980198,0.628712871,2,0.577264877
29622,90,24938,10,10,0,0,0,20,10,8,0,0,0,18,nowin,win,plwin,beat,20,0,20,201,0.447761194,0.049751244,0.60199005,3,0.889945023
29623,33,24938,10,8,0,0,0,18,10,8,0,0,0,18,nowin,push,push,push,10,0,18,192,0.4375,0.057291667,0.625,2,0.616208916
29624,133,24938,9,2,9,0,0,20,10,8,0,0,0,18,nowin,win,plwin,beat,20,0,11,201,0.47761194,0.064676617,0.611940299,3,0.935428111
29625,54,24938,10,10,0,0,0,20,10,8,0,0,0,18,nowin,win,plwin,beat,20,0,20,185,0.437837838,0.032432432,0.556756757,1,0.29899854
29626,95,24938,3,5,10,0,0,18,10,8,0,0,0,18,nowin,push,push,push,10,0,8,218,0.412844037,0.04587156,0.559633028,0,0.024842385
29627,121,24938,9,3,0,8,0,20,10,8,0,0,0,18,nowin,win,plwin,beat,20,0,12,195,0.456410256,0.025641026,0.512820513,1,0.288597791
29628,12,24939,2,6,2,7,0,17,5,10,10,0,0,25,nowin,win,dlbust,bust,20,0,8,189,0.470899471,0.015873016,0.613756614,3,0.929171178
29629,4,24939,10,6,0,0,0,16,5,10,10,0,0,25,nowin,win,dlbust,bust,20,0,16,217,0.460829493,0.036866359,0.562211982,1,0.315432839
29630,1,24939,2,7,10,0,0,19,5,10,10,0,0,25,nowin,win,dlbust,bust,20,0,9,197,0.406091371,0.025380711,0.649746193,2,0.606186955
29631,17,24939,10,8,0,0,0,18,5,10,10,0,0,25,nowin,win,dlbust,bust,20,0,18,171,0.444444444,0.070175439,0.555555556,1,0.302364894
29632,47,24939,5,11,2,0,0,18,5,10,10,0,0,25,nowin,win,dlbust,bust,20,0,16,210,0.438095238,0.057142857,0.623809524,2,0.615868808
29633,16,24939,5,8,0,0,0,13,5,10,10,0,0,25,nowin,win,dlbust,bust,20,0,13,220,0.427272727,0.081818182,0.6,2,0.588660176
29634,29,24940,9,11,0,0,0,20,4,7,8,0,0,19,nowin,win,plwin,beat,20,0,20,189,0.44973545,0.058201058,0.544973545,1,0.300349439
29635,97,24940,3,8,4,0,0,15,4,7,8,0,0,19,nowin,loss,beat,dlwin,0,10,11,182,0.450549451,0.06043956,0.692307692,2,0.677372279
29636,70,24940,2,5,11,0,0,18,4,7,8,0,0,19,nowin,loss,beat,dlwin,0,10,7,228,0.385964912,0.039473684,0.557017544,0,0.016157125
29637,55,24940,10,5,0,0,0,15,4,7,8,0,0,19,nowin,loss,beat,dlwin,0,10,15,191,0.371727749,0.057591623,0.54973822,0,0.01011347
29638,36,24940,11,8,0,0,0,19,4,7,8,0,0,19,nowin,push,push,push,10,0,19,229,0.445414847,0.056768559,0.655021834,2,0.645370571
29639,21,24940,8,10,0,0,0,18,4,7,8,0,0,19,nowin,loss,beat,dlwin,0,10,18,214,0.359813084,0.042056075,0.626168224,0,0.025263474
29640,59,24941,10,7,0,0,0,17,10,6,2,0,0,18,nowin,loss,beat,dlwin,0,10,17,228,0.429824561,0.048245614,0.543859649,1,0.287885446
29641,29,24941,10,9,0,0,0,19,10,6,2,0,0,18,nowin,win,plwin,beat,20,0,19,189,0.44973545,0.058201058,0.544973545,1,0.300349439
29642,130,24941,1,3,10,7,0,21,10,6,2,0,0,18,nowin,win,plwin,beat,20,0,4,219,0.410958904,0.03652968,0.566210046,0,0.025888739
29643,41,24941,5,9,0,1,1,16,10,6,2,0,0,18,nowin,loss,beat,dlwin,0,10,14,192,0.364583333,0.036458333,0.520833333,0,0.00089702
29644,134,24941,7,7,0,10,0,24,10,6,2,0,0,18,nowin,loss,bust,plbust,0,10,14,185,0.443243243,0.021621622,0.545945946,1,0.296939509
29645,131,24941,10,10,0,0,0,20,10,6,2,0,0,18,nowin,win,plwin,beat,20,0,20,217,0.410138249,0.069124424,0.543778802,0,0.02015021
29646,102,24942,11,10,0,0,0,21,3,2,7,10,0,22,win,win,dlbust,bust,25,0,21,192,0.338541667,0.046875,0.5625,0,0.003306118
29647,34,24942,6,10,0,0,0,16,3,2,7,10,0,22,nowin,win,dlbust,bust,20,0,16,202,0.5,0.079207921,0.618811881,3,0.968961434
29648,90,24942,11,6,1,0,0,18,3,2,7,10,0,22,nowin,win,dlbust,bust,20,0,17,201,0.447761194,0.049751244,0.60199005,3,0.889945023
29649,58,24942,6,2,10,0,0,18,3,2,7,10,0,22,nowin,win,dlbust,bust,20,0,8,195,0.430769231,0.041025641,0.584615385,2,0.580497586
29650,7,24942,10,8,0,0,0,18,3,2,7,10,0,22,nowin,win,dlbust,bust,20,0,18,183,0.442622951,0.06010929,0.62295082,2,0.619303341
29651,126,24942,10,10,0,0,0,20,3,2,7,10,0,22,nowin,win,dlbust,bust,20,0,20,188,0.457446809,0.074468085,0.60106383,3,0.900633203
29652,59,24943,10,4,0,0,0,14,5,5,2,5,0,17,nowin,loss,beat,dlwin,0,10,14,228,0.429824561,0.048245614,0.543859649,1,0.287885446
29653,138,24943,3,10,0,0,0,13,5,5,2,5,0,17,nowin,loss,beat,dlwin,0,10,13,190,0.442105263,0.047368421,0.610526316,2,0.609711065
29654,28,24943,3,9,0,0,0,12,5,5,2,5,0,17,nowin,loss,beat,dlwin,0,10,12,199,0.422110553,0.045226131,0.542713568,1,0.282706618
29655,13,24943,4,10,0,0,0,14,5,5,2,5,0,17,nowin,loss,beat,dlwin,0,10,14,206,0.417475728,0.063106796,0.621359223,2,0.59555479
29656,37,24943,5,6,6,0,0,17,5,5,2,5,0,17,nowin,push,push,push,10,0,11,208,0.394230769,0.038461538,0.581730769,0,0.024682772
29657,69,24943,7,2,6,0,0,15,5,5,2,5,0,17,nowin,loss,beat,dlwin,0,10,9,194,0.365979381,0.030927835,0.515463918,0,0
29658,132,24944,10,6,0,6,0,22,7,9,10,0,0,26,nowin,loss,bust,plbust,0,10,16,194,0.412371134,0.036082474,0.649484536,2,0.611633238
29659,42,24944,5,7,0,9,0,21,7,9,10,0,0,26,nowin,win,dlbust,bust,20,0,12,212,0.443396226,0.051886792,0.570754717,1,0.309181312
29660,18,24944,10,10,0,0,0,20,7,9,10,0,0,26,nowin,win,dlbust,bust,20,0,20,182,0.461538462,0.043956044,0.587912088,3,0.892649374
29661,67,24944,2,2,10,9,0,23,7,9,10,0,0,26,nowin,loss,bust,plbust,0,10,4,195,0.369230769,0.041025641,0.569230769,0,0.014139427
29662,87,24944,2,8,10,0,0,20,7,9,10,0,0,26,nowin,win,dlbust,bust,20,0,10,202,0.405940594,0.054455446,0.628712871,2,0.590599801
29663,16,24944,7,6,0,2,6,21,7,9,10,0,0,26,nowin,win,dlbust,bust,20,0,13,220,0.427272727,0.081818182,0.6,2,0.588660176
29664,3,24945,10,3,0,10,0,23,10,2,4,5,0,21,nowin,loss,bust,plbust,0,10,13,190,0.431578947,0.026315789,0.542105263,1,0.288076384
29665,121,24945,6,1,6,10,0,23,10,2,4,5,0,21,nowin,loss,bust,plbust,0,10,7,195,0.456410256,0.025641026,0.512820513,1,0.288597791
29666,107,24945,9,11,0,0,0,20,10,2,4,5,0,21,nowin,loss,beat,dlwin,0,10,20,218,0.444954128,0.073394495,0.600917431,2,0.605210014
29667,72,24945,2,10,0,7,0,19,10,2,4,5,0,21,nowin,loss,beat,dlwin,0,10,12,185,0.394594595,0.032432432,0.508108108,0,0.006763115
29668,69,24945,7,4,10,0,0,21,10,2,4,5,0,21,nowin,push,push,push,10,0,11,194,0.365979381,0.030927835,0.515463918,0,0
29669,70,24945,10,10,0,0,0,20,10,2,4,5,0,21,nowin,loss,beat,dlwin,0,10,20,228,0.385964912,0.039473684,0.557017544,0,0.016157125
29670,116,24946,8,8,0,4,0,20,8,3,8,0,0,19,nowin,win,plwin,beat,20,0,16,195,0.425641026,0.056410256,0.538461538,1,0.28273747
29671,53,24946,6,3,10,0,0,19,8,3,8,0,0,19,nowin,push,push,push,10,0,9,250,0.372,0.064,0.564,0,0.013687345
29672,61,24946,6,3,6,8,0,23,8,3,8,0,0,19,nowin,loss,bust,plbust,0,10,9,194,0.427835052,0.077319588,0.603092784,2,0.591437139
29673,74,24946,7,3,10,0,0,20,8,3,8,0,0,19,nowin,win,plwin,beat,20,0,10,209,0.411483254,0.04784689,0.531100478,0,0.017448125
29674,143,24946,4,5,3,8,0,20,8,3,8,0,0,19,nowin,win,plwin,beat,20,0,9,203,0.463054187,0.044334975,0.57635468,3,0.883143365
29675,77,24946,4,10,0,10,0,24,8,3,8,0,0,19,nowin,loss,bust,plbust,0,10,14,200,0.455,0.04,0.62,3,0.916252116
29676,33,24947,6,10,0,10,0,26,10,6,8,0,0,24,nowin,loss,bust,plbust,0,10,16,192,0.4375,0.057291667,0.625,2,0.616208916
29677,42,24947,6,6,0,1,10,23,10,6,8,0,0,24,nowin,loss,bust,plbust,0,10,12,212,0.443396226,0.051886792,0.570754717,1,0.309181312
29678,22,24947,10,6,0,4,0,20,10,6,8,0,0,24,nowin,win,dlbust,bust,20,0,16,187,0.481283422,0.042780749,0.577540107,3,0.906128176
29679,119,24947,6,7,0,4,0,17,10,6,8,0,0,24,nowin,win,dlbust,bust,20,0,13,190,0.405263158,0.068421053,0.515789474,0,0.011837158
29680,84,24947,2,10,0,10,0,22,10,6,8,0,0,24,nowin,loss,bust,plbust,0,10,12,195,0.379487179,0.056410256,0.569230769,0,0.017209119
29681,36,24947,10,4,0,9,0,23,10,6,8,0,0,24,nowin,loss,bust,plbust,0,10,14,229,0.445414847,0.056768559,0.655021834,2,0.645370571
29682,88,24948,3,6,3,0,0,12,5,7,10,0,0,22,nowin,win,dlbust,bust,20,0,9,206,0.466019417,0.033980583,0.54368932,1,0.309467903
29683,86,24948,11,1,5,0,0,17,5,7,10,0,0,22,nowin,win,dlbust,bust,20,0,12,196,0.454081633,0.040816327,0.591836735,3,0.887566443
29684,3,24948,10,2,0,0,0,12,5,7,10,0,0,22,nowin,win,dlbust,bust,20,0,12,190,0.431578947,0.026315789,0.542105263,1,0.288076384
29685,25,24948,7,5,0,0,0,12,5,7,10,0,0,22,nowin,win,dlbust,bust,20,0,12,190,0.463157895,0.063157895,0.536842105,1,0.304401563
29686,79,24948,3,6,9,0,0,18,5,7,10,0,0,22,nowin,win,dlbust,bust,20,0,9,211,0.436018957,0.028436019,0.672985782,2,0.650131054
29687,131,24948,5,10,0,0,0,15,5,7,10,0,0,22,nowin,win,dlbust,bust,20,0,15,217,0.410138249,0.069124424,0.543778802,0,0.02015021
29688,91,24949,10,9,0,0,0,19,10,5,10,0,0,25,nowin,win,dlbust,bust,20,0,19,194,0.417525773,0.046391753,0.515463918,1,0.266616552
29689,70,24949,10,10,0,0,0,20,10,5,10,0,0,25,nowin,win,dlbust,bust,20,0,20,228,0.385964912,0.039473684,0.557017544,0,0.016157125
29690,131,24949,8,5,0,9,0,22,10,5,10,0,0,25,nowin,loss,bust,plbust,0,10,13,217,0.410138249,0.069124424,0.543778802,0,0.02015021
29691,12,24949,4,8,0,4,9,25,10,5,10,0,0,25,nowin,loss,bust,plbust,0,10,12,189,0.470899471,0.015873016,0.613756614,3,0.929171178
29692,116,24949,5,5,10,0,0,20,10,5,10,0,0,25,nowin,win,dlbust,bust,20,0,10,195,0.425641026,0.056410256,0.538461538,1,0.28273747
29693,5,24949,10,10,0,0,0,20,10,5,10,0,0,25,nowin,win,dlbust,bust,20,0,20,203,0.42364532,0.02955665,0.596059113,2,0.582508076
29694,26,24950,7,10,0,0,0,17,2,10,3,10,0,25,nowin,win,dlbust,bust,20,0,17,203,0.463054187,0.0591133,0.541871921,1,0.306802864
29695,39,24950,4,4,10,0,0,18,2,10,3,10,0,25,nowin,win,dlbust,bust,20,0,8,191,0.429319372,0.062827225,0.57591623,0,0.033760763
29696,96,24950,4,2,8,0,0,14,2,10,3,10,0,25,nowin,win,dlbust,bust,20,0,6,190,0.468421053,0.057894737,0.584210526,3,0.897263354
29697,39,24950,10,9,0,0,0,19,2,10,3,10,0,25,nowin,win,dlbust,bust,20,0,19,191,0.429319372,0.062827225,0.57591623,0,0.033760763
29698,127,24950,6,10,0,0,0,16,2,10,3,10,0,25,nowin,win,dlbust,bust,20,0,16,201,0.402985075,0.029850746,0.60199005,0,0.032263937
29699,25,24950,7,4,10,0,0,21,2,10,3,10,0,25,nowin,win,dlbust,bust,20,0,11,190,0.463157895,0.063157895,0.536842105,1,0.304401563
29700,32,24951,5,9,0,0,0,14,4,2,10,2,0,18,nowin,loss,beat,dlwin,0,10,14,189,0.391534392,0.037037037,0.53968254,0,0.013579086
29701,127,24951,10,2,0,0,0,12,4,2,10,2,0,18,nowin,loss,beat,dlwin,0,10,12,201,0.402985075,0.029850746,0.60199005,0,0.032263937
29702,149,24951,11,7,0,0,0,18,4,2,10,2,0,18,nowin,push,push,push,10,0,18,225,0.457777778,0.057777778,0.648888889,2,0.651965595
29703,39,24951,6,5,2,0,0,13,4,2,10,2,0,18,nowin,loss,beat,dlwin,0,10,11,191,0.429319372,0.062827225,0.57591623,0,0.033760763
29704,93,24951,9,2,7,0,0,18,4,2,10,2,0,18,nowin,push,push,push,10,0,11,175,0.485714286,0.051428571,0.548571429,1,0.323648091
29705,50,24951,5,9,0,0,0,14,4,2,10,2,0,18,nowin,loss,beat,dlwin,0,10,14,202,0.405940594,0.04950495,0.54950495,0,0.020296079
29706,114,24952,4,10,0,2,7,23,7,3,10,0,0,20,nowin,loss,bust,plbust,0,10,14,198,0.47979798,0.025252525,0.611111111,3,0.937232995
29707,33,24952,10,3,0,6,0,19,7,3,10,0,0,20,nowin,loss,beat,dlwin,0,10,13,192,0.4375,0.057291667,0.625,2,0.616208916
29708,142,24952,9,10,0,0,0,19,7,3,10,0,0,20,nowin,loss,beat,dlwin,0,10,19,211,0.417061611,0.047393365,0.526066351,1,0.271531309
29709,51,24952,9,7,0,4,0,20,7,3,10,0,0,20,nowin,push,push,push,10,0,16,189,0.529100529,0.068783069,0.608465608,3,0.993665715
29710,53,24952,10,10,0,0,0,20,7,3,10,0,0,20,nowin,push,push,push,10,0,20,250,0.372,0.064,0.564,0,0.013687345
29711,95,24952,9,9,0,0,0,18,7,3,10,0,0,20,nowin,loss,beat,dlwin,0,10,18,218,0.412844037,0.04587156,0.559633028,0,0.024842385
29712,64,24953,10,3,0,0,0,13,2,2,5,4,10,23,nowin,win,dlbust,bust,20,0,13,187,0.363636364,0.048128342,0.631016043,0,0.027594885
29713,137,24953,5,4,3,6,0,18,2,2,5,4,10,23,nowin,win,dlbust,bust,20,0,9,194,0.417525773,0.046391753,0.536082474,1,0.276714602
29714,119,24953,5,10,0,0,0,15,2,2,5,4,10,23,nowin,win,dlbust,bust,20,0,15,190,0.405263158,0.068421053,0.515789474,0,0.011837158
29715,141,24953,10,10,0,0,0,20,2,2,5,4,10,23,nowin,win,dlbust,bust,20,0,20,202,0.420792079,0.074257426,0.564356436,0,0.028377851
29716,33,24953,4,3,9,0,0,16,2,2,5,4,10,23,nowin,win,dlbust,bust,20,0,7,192,0.4375,0.057291667,0.625,2,0.616208916
29717,74,24953,4,10,0,0,0,14,2,2,5,4,10,23,nowin,win,dlbust,bust,20,0,14,209,0.411483254,0.04784689,0.531100478,0,0.017448125
29718,83,24954,3,7,10,0,0,20,8,10,0,0,0,18,nowin,win,plwin,beat,20,0,10,193,0.424870466,0.051813472,0.678756477,2,0.644360335
29719,14,24954,10,7,0,0,0,17,8,10,0,0,0,18,nowin,loss,beat,dlwin,0,10,17,202,0.391089109,0.01980198,0.628712871,2,0.577264877
29720,25,24954,4,6,10,0,0,20,8,10,0,0,0,18,nowin,win,plwin,beat,20,0,10,190,0.463157895,0.063157895,0.536842105,1,0.304401563
29721,80,24954,10,8,0,0,0,18,8,10,0,0,0,18,nowin,push,push,push,10,0,18,186,0.419354839,0.059139785,0.623655914,2,0.59892924
29722,19,24954,10,5,0,10,0,25,8,10,0,0,0,18,nowin,loss,bust,plbust,0,10,15,237,0.41350211,0.054852321,0.628691983,2,0.597373826
29723,71,24954,2,10,0,4,9,25,8,10,0,0,0,18,nowin,loss,bust,plbust,0,10,12,193,0.352331606,0.046632124,0.585492228,0,0.013063661
29724,139,24955,10,10,0,0,0,20,10,8,0,0,0,18,nowin,win,plwin,beat,20,0,20,192,0.380208333,0.036458333,0.59375,0,0.023429169
29725,89,24955,10,3,0,10,0,23,10,8,0,0,0,18,nowin,loss,bust,plbust,0,10,13,212,0.537735849,0.047169811,0.594339623,3,0.990167191
29726,124,24955,5,7,0,9,0,21,10,8,0,0,0,18,nowin,win,plwin,beat,20,0,12,202,0.47029703,0.064356436,0.584158416,3,0.899458193
29727,19,24955,2,10,0,3,7,22,10,8,0,0,0,18,nowin,loss,bust,plbust,0,10,12,237,0.41350211,0.054852321,0.628691983,2,0.597373826
29728,18,24955,4,4,3,8,0,19,10,8,0,0,0,18,nowin,win,plwin,beat,20,0,8,182,0.461538462,0.043956044,0.587912088,3,0.892649374
29729,72,24955,4,7,10,0,0,21,10,8,0,0,0,18,nowin,win,plwin,beat,20,0,11,185,0.394594595,0.032432432,0.508108108,0,0.006763115
29730,104,24956,10,9,0,0,0,19,8,2,8,0,0,18,nowin,win,plwin,beat,20,0,19,209,0.363636364,0.052631579,0.593301435,0,0.018359419
29731,98,24956,10,10,0,0,0,20,8,2,8,0,0,18,nowin,win,plwin,beat,20,0,20,220,0.422727273,0.054545455,0.55,1,0.28664435
29732,121,24956,10,4,0,4,0,18,8,2,8,0,0,18,nowin,push,push,push,10,0,14,195,0.456410256,0.025641026,0.512820513,1,0.288597791
29733,137,24956,3,6,10,0,0,19,8,2,8,0,0,18,nowin,win,plwin,beat,20,0,9,194,0.417525773,0.046391753,0.536082474,1,0.276714602
29734,11,24956,4,3,4,9,0,20,8,2,8,0,0,18,nowin,win,plwin,beat,20,0,7,236,0.457627119,0.016949153,0.588983051,3,0.889015813
29735,88,24956,3,2,8,3,3,19,8,2,8,0,0,18,nowin,win,plwin,beat,20,0,5,206,0.466019417,0.033980583,0.54368932,1,0.309467903
29736,53,24957,10,10,0,0,0,20,6,2,11,0,0,19,nowin,win,plwin,beat,20,0,20,250,0.372,0.064,0.564,0,0.013687345
29737,114,24957,2,10,0,0,0,12,6,2,11,0,0,19,nowin,loss,beat,dlwin,0,10,12,198,0.47979798,0.025252525,0.611111111,3,0.937232995
29738,70,24957,7,6,0,0,0,13,6,2,11,0,0,19,nowin,loss,beat,dlwin,0,10,13,228,0.385964912,0.039473684,0.557017544,0,0.016157125
29739,80,24957,6,1,10,0,0,17,6,2,11,0,0,19,nowin,loss,beat,dlwin,0,10,7,186,0.419354839,0.059139785,0.623655914,2,0.59892924
29740,28,24957,3,7,10,0,0,20,6,2,11,0,0,19,nowin,win,plwin,beat,20,0,10,199,0.422110553,0.045226131,0.542713568,1,0.282706618
29741,150,24957,10,4,0,0,0,14,6,2,11,0,0,19,nowin,loss,beat,dlwin,0,10,14,192,0.401041667,0.036458333,0.567708333,0,0.023287458
29742,9,24958,7,5,0,10,0,22,10,4,7,0,0,21,nowin,loss,bust,plbust,0,10,12,194,0.37628866,0.015463918,0.541237113,0,0.009396796
29743,125,24958,8,10,0,0,0,18,10,4,7,0,0,21,nowin,loss,beat,dlwin,0,10,18,219,0.438356164,0.050228311,0.575342466,1,0.308411257
29744,141,24958,4,7,10,0,0,21,10,4,7,0,0,21,nowin,push,push,push,10,0,11,202,0.420792079,0.074257426,0.564356436,0,0.028377851
29745,133,24958,10,7,0,0,0,17,10,4,7,0,0,21,nowin,loss,beat,dlwin,0,10,17,201,0.47761194,0.064676617,0.611940299,3,0.935428111
29746,71,24958,9,10,0,0,0,19,10,4,7,0,0,21,nowin,loss,beat,dlwin,0,10,19,193,0.352331606,0.046632124,0.585492228,0,0.013063661
29747,84,24958,10,7,0,0,0,17,10,4,7,0,0,21,nowin,loss,beat,dlwin,0,10,17,195,0.379487179,0.056410256,0.569230769,0,0.017209119
29748,7,24959,10,6,0,0,0,16,4,9,2,1,7,23,nowin,win,dlbust,bust,20,0,16,183,0.442622951,0.06010929,0.62295082,2,0.619303341
29749,52,24959,10,10,0,0,0,20,4,9,2,1,7,23,nowin,win,dlbust,bust,20,0,20,217,0.414746544,0.02764977,0.599078341,2,0.576736024
29750,124,24959,10,7,0,0,0,17,4,9,2,1,7,23,nowin,win,dlbust,bust,20,0,17,202,0.47029703,0.064356436,0.584158416,3,0.899458193
29751,15,24959,3,10,0,0,0,13,4,9,2,1,7,23,nowin,win,dlbust,bust,20,0,13,212,0.410377358,0.051886792,0.561320755,0,0.024517408
29752,107,24959,7,10,0,0,0,17,4,9,2,1,7,23,nowin,win,dlbust,bust,20,0,17,218,0.444954128,0.073394495,0.600917431,2,0.605210014
29753,36,24959,10,7,0,0,0,17,4,9,2,1,7,23,nowin,win,dlbust,bust,20,0,17,229,0.445414847,0.056768559,0.655021834,2,0.645370571
29754,104,24960,5,10,0,0,0,15,3,2,7,5,0,17,nowin,loss,beat,dlwin,0,10,15,209,0.363636364,0.052631579,0.593301435,0,0.018359419
29755,142,24960,2,2,4,10,0,18,3,2,7,5,0,17,nowin,win,plwin,beat,20,0,4,211,0.417061611,0.047393365,0.526066351,1,0.271531309
29756,65,24960,2,4,5,8,0,19,3,2,7,5,0,17,nowin,win,plwin,beat,20,0,6,203,0.492610837,0.054187192,0.571428571,3,0.913702814
29757,108,24960,5,10,0,0,0,15,3,2,7,5,0,17,nowin,loss,beat,dlwin,0,10,15,193,0.435233161,0.056994819,0.559585492,1,0.298824795
29758,67,24960,11,10,0,0,0,21,3,2,7,5,0,17,win,win,plwin,beat,25,0,21,195,0.369230769,0.041025641,0.569230769,0,0.014139427
29759,6,24960,2,4,9,0,0,15,3,2,7,5,0,17,nowin,loss,beat,dlwin,0,10,6,191,0.439790576,0.047120419,0.581151832,1,0.31211505
29760,99,24961,2,10,0,1,7,20,10,4,10,0,0,24,nowin,win,dlbust,bust,20,0,12,207,0.47826087,0.062801932,0.637681159,3,0.961418446
29761,136,24961,10,10,0,0,0,20,10,4,10,0,0,24,nowin,win,dlbust,bust,20,0,20,194,0.396907216,0.025773196,0.597938144,0,0.029452644
29762,32,24961,10,5,0,10,0,25,10,4,10,0,0,24,nowin,loss,bust,plbust,0,10,15,189,0.391534392,0.037037037,0.53968254,0,0.013579086
29763,72,24961,9,11,0,0,0,20,10,4,10,0,0,24,nowin,win,dlbust,bust,20,0,20,185,0.394594595,0.032432432,0.508108108,0,0.006763115
29764,40,24961,10,6,0,10,0,26,10,4,10,0,0,24,nowin,loss,bust,plbust,0,10,16,196,0.367346939,0.030612245,0.617346939,0,0.025358183
29765,5,24961,6,10,0,2,0,18,10,4,10,0,0,24,nowin,win,dlbust,bust,20,0,16,203,0.42364532,0.02955665,0.596059113,2,0.582508076
29766,123,24962,10,10,0,0,0,20,10,7,0,0,0,17,nowin,win,plwin,beat,20,0,20,205,0.43902439,0.034146341,0.614634146,2,0.609962544
29767,11,24962,4,2,8,7,0,21,10,7,0,0,0,17,nowin,win,plwin,beat,20,0,6,236,0.457627119,0.016949153,0.588983051,3,0.889015813
29768,73,24962,8,7,0,1,10,26,10,7,0,0,0,17,nowin,loss,bust,plbust,0,10,15,181,0.375690608,0.011049724,0.596685083,0,0.022795773
29769,144,24962,6,7,0,6,0,19,10,7,0,0,0,17,nowin,win,plwin,beat,20,0,13,202,0.386138614,0.054455446,0.564356436,0,0.018006244
29770,64,24962,11,4,4,0,0,19,10,7,0,0,0,17,nowin,win,plwin,beat,20,0,15,187,0.363636364,0.048128342,0.631016043,0,0.027594885
29771,106,24962,10,5,0,5,0,20,10,7,0,0,0,17,nowin,win,plwin,beat,20,0,15,192,0.411458333,0.026041667,0.557291667,0,0.023854304
29772,23,24963,2,7,10,0,0,19,2,10,5,0,0,17,nowin,win,plwin,beat,20,0,9,208,0.427884615,0.0625,0.552884615,1,0.29114424
29773,13,24963,4,4,10,0,0,18,2,10,5,0,0,17,nowin,win,plwin,beat,20,0,8,206,0.417475728,0.063106796,0.621359223,2,0.59555479
29774,38,24963,6,2,4,3,0,15,2,10,5,0,0,17,nowin,loss,beat,dlwin,0,10,8,202,0.361386139,0.03960396,0.564356436,0,0.010597953
29775,120,24963,10,3,0,0,0,13,2,10,5,0,0,17,nowin,loss,beat,dlwin,0,10,13,202,0.440594059,0.034653465,0.618811881,2,0.614441029
29776,44,24963,10,2,0,10,0,22,2,10,5,0,0,17,nowin,loss,bust,plbust,0,10,12,219,0.433789954,0.050228311,0.534246575,1,0.285551035
29777,24,24963,1,3,10,0,0,14,2,10,5,0,0,17,nowin,loss,beat,dlwin,0,10,4,207,0.458937198,0.048309179,0.570048309,1,0.318138014
29778,106,24964,6,3,9,0,0,18,4,2,8,7,0,21,nowin,loss,beat,dlwin,0,10,9,192,0.411458333,0.026041667,0.557291667,0,0.023854304
29779,40,24964,2,2,3,10,0,17,4,2,8,7,0,21,nowin,loss,beat,dlwin,0,10,4,196,0.367346939,0.030612245,0.617346939,0,0.025358183
29780,66,24964,10,3,0,0,0,13,4,2,8,7,0,21,nowin,loss,beat,dlwin,0,10,13,217,0.456221198,0.064516129,0.626728111,3,0.924304367
29781,83,24964,10,7,0,0,0,17,4,2,8,7,0,21,nowin,loss,beat,dlwin,0,10,17,193,0.424870466,0.051813472,0.678756477,2,0.644360335
29782,50,24964,10,10,0,0,0,20,4,2,8,7,0,21,nowin,loss,beat,dlwin,0,10,20,202,0.405940594,0.04950495,0.54950495,0,0.020296079
29783,123,24964,8,10,0,0,0,18,4,2,8,7,0,21,nowin,loss,beat,dlwin,0,10,18,205,0.43902439,0.034146341,0.614634146,2,0.609962544
29784,101,24965,6,8,0,10,0,24,10,10,0,0,0,20,nowin,loss,bust,plbust,0,10,14,205,0.424390244,0.068292683,0.63902439,2,0.614740646
29785,116,24965,11,8,0,0,0,19,10,10,0,0,0,20,nowin,loss,beat,dlwin,0,10,19,195,0.425641026,0.056410256,0.538461538,1,0.28273747
29786,35,24965,2,1,10,5,0,18,10,10,0,0,0,20,nowin,loss,beat,dlwin,0,10,3,202,0.410891089,0.044554455,0.633663366,2,0.598681573
29787,112,24965,5,11,2,0,0,18,10,10,0,0,0,20,nowin,loss,beat,dlwin,0,10,16,203,0.448275862,0.054187192,0.600985222,3,0.889576933
29788,76,24965,11,8,0,0,0,19,10,10,0,0,0,20,nowin,loss,beat,dlwin,0,10,19,189,0.534391534,0.079365079,0.608465608,3,1
29789,87,24965,5,2,8,3,0,18,10,10,0,0,0,20,nowin,loss,beat,dlwin,0,10,7,202,0.405940594,0.054455446,0.628712871,2,0.590599801
29790,65,24966,10,9,0,0,0,19,10,6,7,0,0,23,nowin,win,dlbust,bust,20,0,19,203,0.492610837,0.054187192,0.571428571,3,0.913702814
29791,36,24966,10,9,0,0,0,19,10,6,7,0,0,23,nowin,win,dlbust,bust,20,0,19,229,0.445414847,0.056768559,0.655021834,2,0.645370571
29792,125,24966,10,10,0,0,0,20,10,6,7,0,0,23,nowin,win,dlbust,bust,20,0,20,219,0.438356164,0.050228311,0.575342466,1,0.308411257
29793,10,24966,3,11,3,0,0,17,10,6,7,0,0,23,nowin,win,dlbust,bust,20,0,14,191,0.413612565,0.057591623,0.596858639,2,0.574087175
29794,7,24966,11,10,0,0,0,21,10,6,7,0,0,23,win,win,dlbust,bust,25,0,21,183,0.442622951,0.06010929,0.62295082,2,0.619303341
29795,46,24966,11,10,0,0,0,21,10,6,7,0,0,23,win,win,dlbust,bust,25,0,21,186,0.403225806,0.048387097,0.591397849,0,0.029742194
29796,134,24967,11,4,1,3,0,19,10,4,9,0,0,23,nowin,win,dlbust,bust,20,0,15,185,0.443243243,0.021621622,0.545945946,1,0.296939509
29797,55,24967,11,7,0,0,0,18,10,4,9,0,0,23,nowin,win,dlbust,bust,20,0,18,191,0.371727749,0.057591623,0.54973822,0,0.01011347
29798,135,24967,3,11,6,0,0,20,10,4,9,0,0,23,nowin,win,dlbust,bust,20,0,14,179,0.391061453,0.067039106,0.586592179,0,0.024924662
29799,126,24967,6,10,0,1,0,17,10,4,9,0,0,23,nowin,win,dlbust,bust,20,0,16,188,0.457446809,0.074468085,0.60106383,3,0.900633203
29800,9,24967,10,5,0,5,0,20,10,4,9,0,0,23,nowin,win,dlbust,bust,20,0,15,194,0.37628866,0.015463918,0.541237113,0,0.009396796
29801,75,24967,10,10,0,0,0,20,10,4,9,0,0,23,nowin,win,dlbust,bust,20,0,20,191,0.418848168,0.052356021,0.570680628,0,0.029344702
29802,44,24968,9,3,0,6,0,18,8,9,0,0,0,17,nowin,win,plwin,beat,20,0,12,219,0.433789954,0.050228311,0.534246575,1,0.285551035
29803,135,24968,2,4,2,10,0,18,8,9,0,0,0,17,nowin,win,plwin,beat,20,0,6,179,0.391061453,0.067039106,0.586592179,0,0.024924662
29804,124,24968,8,10,0,0,0,18,8,9,0,0,0,17,nowin,win,plwin,beat,20,0,18,202,0.47029703,0.064356436,0.584158416,3,0.899458193
29805,138,24968,9,10,0,0,0,19,8,9,0,0,0,17,nowin,win,plwin,beat,20,0,19,190,0.442105263,0.047368421,0.610526316,2,0.609711065
29806,123,24968,2,4,9,2,0,17,8,9,0,0,0,17,nowin,push,push,push,10,0,6,205,0.43902439,0.034146341,0.614634146,2,0.609962544
29807,147,24968,2,2,6,8,0,18,8,9,0,0,0,17,nowin,win,plwin,beat,20,0,4,205,0.380487805,0.014634146,0.536585366,0,0.00951447
29808,140,24969,10,10,0,0,0,20,2,11,4,0,0,17,nowin,win,plwin,beat,20,0,20,210,0.466666667,0.023809524,0.604761905,3,0.915293335
29809,104,24969,10,9,0,0,0,19,2,11,4,0,0,17,nowin,win,plwin,beat,20,0,19,209,0.363636364,0.052631579,0.593301435,0,0.018359419
29810,23,24969,8,4,0,6,0,18,2,11,4,0,0,17,nowin,win,plwin,beat,20,0,12,208,0.427884615,0.0625,0.552884615,1,0.29114424
29811,69,24969,3,2,3,7,0,15,2,11,4,0,0,17,nowin,loss,beat,dlwin,0,10,5,194,0.365979381,0.030927835,0.515463918,0,0
29812,68,24969,8,2,10,0,0,20,2,11,4,0,0,17,nowin,win,plwin,beat,20,0,10,205,0.434146341,0.029268293,0.6,2,0.59483189
29813,108,24969,6,5,10,0,0,21,2,11,4,0,0,17,nowin,win,plwin,beat,20,0,11,193,0.435233161,0.056994819,0.559585492,1,0.298824795
29814,116,24970,8,10,0,0,0,18,10,5,5,0,0,20,nowin,loss,beat,dlwin,0,10,18,195,0.425641026,0.056410256,0.538461538,1,0.28273747
29815,90,24970,3,8,8,0,0,19,10,5,5,0,0,20,nowin,loss,beat,dlwin,0,10,11,201,0.447761194,0.049751244,0.60199005,3,0.889945023
29816,130,24970,10,3,0,10,0,23,10,5,5,0,0,20,nowin,loss,bust,plbust,0,10,13,219,0.410958904,0.03652968,0.566210046,0,0.025888739
29817,61,24970,10,10,0,0,0,20,10,5,5,0,0,20,nowin,push,push,push,10,0,20,194,0.427835052,0.077319588,0.603092784,2,0.591437139
29818,37,24970,10,7,0,0,0,17,10,5,5,0,0,20,nowin,loss,beat,dlwin,0,10,17,208,0.394230769,0.038461538,0.581730769,0,0.024682772
29819,112,24970,8,2,8,0,0,18,10,5,5,0,0,20,nowin,loss,beat,dlwin,0,10,10,203,0.448275862,0.054187192,0.600985222,3,0.889576933
29820,117,24971,10,9,0,0,0,19,10,4,8,0,0,22,nowin,win,dlbust,bust,20,0,19,173,0.410404624,0.069364162,0.606936416,2,0.578610282
29821,16,24971,11,10,0,0,0,21,10,4,8,0,0,22,win,win,dlbust,bust,25,0,21,220,0.427272727,0.081818182,0.6,2,0.588660176
29822,42,24971,1,2,10,3,5,21,10,4,8,0,0,22,nowin,win,dlbust,bust,20,0,3,212,0.443396226,0.051886792,0.570754717,1,0.309181312
29823,132,24971,7,10,0,0,0,17,10,4,8,0,0,22,nowin,win,dlbust,bust,20,0,17,194,0.412371134,0.036082474,0.649484536,2,0.611633238
29824,42,24971,5,10,0,10,0,25,10,4,8,0,0,22,nowin,loss,bust,plbust,0,10,15,212,0.443396226,0.051886792,0.570754717,1,0.309181312
29825,103,24971,11,10,0,0,0,21,10,4,8,0,0,22,win,win,dlbust,bust,25,0,21,203,0.379310345,0.064039409,0.551724138,0,0.012869209
29826,36,24972,3,10,0,9,0,22,10,6,4,0,0,20,nowin,loss,bust,plbust,0,10,13,229,0.445414847,0.056768559,0.655021834,2,0.645370571
29827,28,24972,2,10,0,2,10,24,10,6,4,0,0,20,nowin,loss,bust,plbust,0,10,12,199,0.422110553,0.045226131,0.542713568,1,0.282706618
29828,123,24972,7,5,0,10,0,22,10,6,4,0,0,20,nowin,loss,bust,plbust,0,10,12,205,0.43902439,0.034146341,0.614634146,2,0.609962544
29829,108,24972,7,9,0,4,0,20,10,6,4,0,0,20,nowin,push,push,push,10,0,16,193,0.435233161,0.056994819,0.559585492,1,0.298824795
29830,137,24972,6,7,0,10,0,23,10,6,4,0,0,20,nowin,loss,bust,plbust,0,10,13,194,0.417525773,0.046391753,0.536082474,1,0.276714602
29831,32,24972,2,10,0,6,0,18,10,6,4,0,0,20,nowin,loss,beat,dlwin,0,10,12,189,0.391534392,0.037037037,0.53968254,0,0.013579086
29832,82,24973,6,6,0,0,0,12,6,5,7,0,0,18,nowin,loss,beat,dlwin,0,10,12,225,0.408888889,0.075555556,0.577777778,0,0.028101874
29833,102,24973,10,10,0,0,0,20,6,5,7,0,0,18,nowin,win,plwin,beat,20,0,20,192,0.338541667,0.046875,0.5625,0,0.003306118
29834,71,24973,4,3,11,0,0,18,6,5,7,0,0,18,nowin,push,push,push,10,0,7,193,0.352331606,0.046632124,0.585492228,0,0.013063661
29835,80,24973,10,5,0,0,0,15,6,5,7,0,0,18,nowin,loss,beat,dlwin,0,10,15,186,0.419354839,0.059139785,0.623655914,2,0.59892924
29836,146,24973,10,3,0,0,0,13,6,5,7,0,0,18,nowin,loss,beat,dlwin,0,10,13,221,0.43438914,0.040723982,0.542986425,1,0.290190091
29837,92,24973,8,10,0,0,0,18,6,5,7,0,0,18,nowin,push,push,push,10,0,18,186,0.446236559,0.059139785,0.564516129,1,0.307826125
29838,71,24974,2,10,0,0,0,12,4,1,10,10,0,25,nowin,win,dlbust,bust,20,0,12,193,0.352331606,0.046632124,0.585492228,0,0.013063661
29839,83,24974,2,9,6,0,0,17,4,1,10,10,0,25,nowin,win,dlbust,bust,20,0,11,193,0.424870466,0.051813472,0.678756477,2,0.644360335
29840,37,24974,1,4,9,0,0,14,4,1,10,10,0,25,nowin,win,dlbust,bust,20,0,5,208,0.394230769,0.038461538,0.581730769,0,0.024682772
29841,95,24974,10,8,0,0,0,18,4,1,10,10,0,25,nowin,win,dlbust,bust,20,0,18,218,0.412844037,0.04587156,0.559633028,0,0.024842385
29842,97,24974,7,10,0,0,0,17,4,1,10,10,0,25,nowin,win,dlbust,bust,20,0,17,182,0.450549451,0.06043956,0.692307692,2,0.677372279
29843,109,24974,2,5,3,6,0,16,4,1,10,10,0,25,nowin,win,dlbust,bust,20,0,7,221,0.461538462,0.058823529,0.597285068,3,0.901830309
29844,55,24975,3,10,0,0,0,13,3,8,8,0,0,19,nowin,loss,beat,dlwin,0,10,13,191,0.371727749,0.057591623,0.54973822,0,0.01011347
29845,60,24975,4,5,2,8,0,19,3,8,8,0,0,19,nowin,push,push,push,10,0,9,227,0.418502203,0.022026432,0.559471366,0,0.026496258
29846,25,24975,3,4,9,0,0,16,3,8,8,0,0,19,nowin,loss,beat,dlwin,0,10,7,190,0.463157895,0.063157895,0.536842105,1,0.304401563
29847,103,24975,10,11,0,0,0,21,3,8,8,0,0,19,win,win,plwin,beat,25,0,21,203,0.379310345,0.064039409,0.551724138,0,0.012869209
29848,36,24975,5,7,0,6,0,18,3,8,8,0,0,19,nowin,loss,beat,dlwin,0,10,12,229,0.445414847,0.056768559,0.655021834,2,0.645370571
29849,64,24975,6,3,2,10,0,21,3,8,8,0,0,19,nowin,win,plwin,beat,20,0,9,187,0.363636364,0.048128342,0.631016043,0,0.027594885
29850,22,24976,9,5,0,0,0,14,2,9,10,0,0,21,nowin,loss,beat,dlwin,0,10,14,187,0.481283422,0.042780749,0.577540107,3,0.906128176
29851,108,24976,10,10,0,0,0,20,2,9,10,0,0,21,nowin,loss,beat,dlwin,0,10,20,193,0.435233161,0.056994819,0.559585492,1,0.298824795
29852,30,24976,4,10,0,0,0,14,2,9,10,0,0,21,nowin,loss,beat,dlwin,0,10,14,206,0.393203883,0.033980583,0.601941748,0,0.029324648
29853,10,24976,9,4,0,0,0,13,2,9,10,0,0,21,nowin,loss,beat,dlwin,0,10,13,191,0.413612565,0.057591623,0.596858639,2,0.574087175
29854,88,24976,10,7,0,0,0,17,2,9,10,0,0,21,nowin,loss,beat,dlwin,0,10,17,206,0.466019417,0.033980583,0.54368932,1,0.309467903
29855,51,24976,3,5,5,0,0,13,2,9,10,0,0,21,nowin,loss,beat,dlwin,0,10,8,189,0.529100529,0.068783069,0.608465608,3,0.993665715
29856,109,24977,9,6,0,0,0,15,4,9,10,0,0,23,nowin,win,dlbust,bust,20,0,15,221,0.461538462,0.058823529,0.597285068,3,0.901830309
29857,53,24977,9,8,0,0,0,17,4,9,10,0,0,23,nowin,win,dlbust,bust,20,0,17,250,0.372,0.064,0.564,0,0.013687345
29858,132,24977,6,10,0,0,0,16,4,9,10,0,0,23,nowin,win,dlbust,bust,20,0,16,194,0.412371134,0.036082474,0.649484536,2,0.611633238
29859,98,24977,8,11,0,0,0,19,4,9,10,0,0,23,nowin,win,dlbust,bust,20,0,19,220,0.422727273,0.054545455,0.55,1,0.28664435
29860,5,24977,10,9,0,0,0,19,4,9,10,0,0,23,nowin,win,dlbust,bust,20,0,19,203,0.42364532,0.02955665,0.596059113,2,0.582508076
29861,14,24977,1,2,10,0,0,13,4,9,10,0,0,23,nowin,win,dlbust,bust,20,0,3,202,0.391089109,0.01980198,0.628712871,2,0.577264877
29862,149,24978,5,10,0,1,7,23,10,4,4,0,0,18,nowin,loss,bust,plbust,0,10,15,225,0.457777778,0.057777778,0.648888889,2,0.651965595
29863,25,24978,6,10,0,7,0,23,10,4,4,0,0,18,nowin,loss,bust,plbust,0,10,16,190,0.463157895,0.063157895,0.536842105,1,0.304401563
29864,1,24978,10,4,0,10,0,24,10,4,4,0,0,18,nowin,loss,bust,plbust,0,10,14,197,0.406091371,0.025380711,0.649746193,2,0.606186955
29865,82,24978,5,10,0,2,0,17,10,4,4,0,0,18,nowin,loss,beat,dlwin,0,10,15,225,0.408888889,0.075555556,0.577777778,0,0.028101874
29866,146,24978,10,7,0,0,0,17,10,4,4,0,0,18,nowin,loss,beat,dlwin,0,10,17,221,0.43438914,0.040723982,0.542986425,1,0.290190091
29867,38,24978,2,8,2,10,0,22,10,4,4,0,0,18,nowin,loss,bust,plbust,0,10,10,202,0.361386139,0.03960396,0.564356436,0,0.010597953
29868,105,24979,10,11,0,0,0,21,4,10,4,0,0,18,win,win,plwin,beat,25,0,21,198,0.414141414,0.070707071,0.590909091,0,0.032889494
29869,15,24979,10,2,0,0,0,12,4,10,4,0,0,18,nowin,loss,beat,dlwin,0,10,12,212,0.410377358,0.051886792,0.561320755,0,0.024517408
29870,139,24979,10,10,0,0,0,20,4,10,4,0,0,18,nowin,win,plwin,beat,20,0,20,192,0.380208333,0.036458333,0.59375,0,0.023429169
29871,139,24979,10,5,0,0,0,15,4,10,4,0,0,18,nowin,loss,beat,dlwin,0,10,15,192,0.380208333,0.036458333,0.59375,0,0.023429169
29872,73,24979,4,10,0,0,0,14,4,10,4,0,0,18,nowin,loss,beat,dlwin,0,10,14,181,0.375690608,0.011049724,0.596685083,0,0.022795773
29873,91,24979,9,4,0,0,0,13,4,10,4,0,0,18,nowin,loss,beat,dlwin,0,10,13,194,0.417525773,0.046391753,0.515463918,1,0.266616552
29874,97,24980,9,4,0,10,0,23,10,11,0,0,0,21,nowin,loss,bust,plbust,0,10,13,182,0.450549451,0.06043956,0.692307692,2,0.677372279
29875,61,24980,5,10,0,9,0,24,10,11,0,0,0,21,nowin,loss,bust,plbust,0,10,15,194,0.427835052,0.077319588,0.603092784,2,0.591437139
29876,32,24980,5,6,10,0,0,21,10,11,0,0,0,21,nowin,push,push,push,10,0,11,189,0.391534392,0.037037037,0.53968254,0,0.013579086
29877,68,24980,9,7,0,6,0,22,10,11,0,0,0,21,nowin,loss,bust,plbust,0,10,16,205,0.434146341,0.029268293,0.6,2,0.59483189
29878,149,24980,10,3,0,10,0,23,10,11,0,0,0,21,nowin,loss,bust,plbust,0,10,13,225,0.457777778,0.057777778,0.648888889,2,0.651965595
29879,133,24980,10,8,0,0,0,18,10,11,0,0,0,21,nowin,loss,beat,dlwin,0,10,18,201,0.47761194,0.064676617,0.611940299,3,0.935428111
29880,84,24981,11,5,4,0,0,20,4,10,10,0,0,24,nowin,win,dlbust,bust,20,0,16,195,0.379487179,0.056410256,0.569230769,0,0.017209119
29881,106,24981,9,4,0,0,0,13,4,10,10,0,0,24,nowin,win,dlbust,bust,20,0,13,192,0.411458333,0.026041667,0.557291667,0,0.023854304
29882,70,24981,2,10,0,0,0,12,4,10,10,0,0,24,nowin,win,dlbust,bust,20,0,12,228,0.385964912,0.039473684,0.557017544,0,0.016157125
29883,71,24981,10,5,0,0,0,15,4,10,10,0,0,24,nowin,win,dlbust,bust,20,0,15,193,0.352331606,0.046632124,0.585492228,0,0.013063661
29884,128,24981,2,10,0,0,0,12,4,10,10,0,0,24,nowin,win,dlbust,bust,20,0,12,227,0.356828194,0.052863436,0.577092511,0,0.012352564
29885,88,24981,3,6,10,0,0,19,4,10,10,0,0,24,nowin,win,dlbust,bust,20,0,9,206,0.466019417,0.033980583,0.54368932,1,0.309467903
29886,23,24982,7,7,0,9,0,23,7,4,7,0,0,18,nowin,loss,bust,plbust,0,10,14,208,0.427884615,0.0625,0.552884615,1,0.29114424
29887,98,24982,6,1,10,0,0,17,7,4,7,0,0,18,nowin,loss,beat,dlwin,0,10,7,220,0.422727273,0.054545455,0.55,1,0.28664435
29888,35,24982,8,6,0,4,0,18,7,4,7,0,0,18,nowin,push,push,push,10,0,14,202,0.410891089,0.044554455,0.633663366,2,0.598681573
29889,46,24982,11,9,0,0,0,20,7,4,7,0,0,18,nowin,win,plwin,beat,20,0,20,186,0.403225806,0.048387097,0.591397849,0,0.029742194
29890,115,24982,10,10,0,0,0,20,7,4,7,0,0,18,nowin,win,plwin,beat,20,0,20,194,0.427835052,0.041237113,0.592783505,2,0.583863602
29891,104,24982,6,1,10,0,0,17,7,4,7,0,0,18,nowin,loss,beat,dlwin,0,10,7,209,0.363636364,0.052631579,0.593301435,0,0.018359419
29892,83,24983,3,3,2,4,0,12,4,10,6,0,0,20,nowin,loss,beat,dlwin,0,10,6,193,0.424870466,0.051813472,0.678756477,2,0.644360335
29893,126,24983,6,7,0,0,0,13,4,10,6,0,0,20,nowin,loss,beat,dlwin,0,10,13,188,0.457446809,0.074468085,0.60106383,3,0.900633203
29894,124,24983,6,8,0,0,0,14,4,10,6,0,0,20,nowin,loss,beat,dlwin,0,10,14,202,0.47029703,0.064356436,0.584158416,3,0.899458193
29895,32,24983,10,10,0,0,0,20,4,10,6,0,0,20,nowin,push,push,push,10,0,20,189,0.391534392,0.037037037,0.53968254,0,0.013579086
29896,97,24983,10,2,0,0,0,12,4,10,6,0,0,20,nowin,loss,beat,dlwin,0,10,12,182,0.450549451,0.06043956,0.692307692,2,0.677372279
29897,79,24983,5,1,9,0,0,15,4,10,6,0,0,20,nowin,loss,beat,dlwin,0,10,6,211,0.436018957,0.028436019,0.672985782,2,0.650131054
29898,3,24984,5,11,3,0,0,19,11,10,0,0,0,21,nowin,loss,beat,dlwin,0,10,16,190,0.431578947,0.026315789,0.542105263,1,0.288076384
29899,113,24984,4,8,0,10,0,22,11,10,0,0,0,21,nowin,loss,bust,plbust,0,10,12,199,0.407035176,0.055276382,0.668341709,2,0.620695264
29900,95,24984,8,10,0,0,0,18,11,10,0,0,0,21,nowin,loss,beat,dlwin,0,10,18,218,0.412844037,0.04587156,0.559633028,0,0.024842385
29901,142,24984,5,5,10,0,0,20,11,10,0,0,0,21,nowin,loss,beat,dlwin,0,10,10,211,0.417061611,0.047393365,0.526066351,1,0.271531309
29902,81,24984,2,2,10,9,0,23,11,10,0,0,0,21,nowin,loss,bust,plbust,0,10,4,182,0.395604396,0.043956044,0.60989011,2,0.567491261
29903,42,24984,6,10,0,2,0,18,11,10,0,0,0,21,nowin,loss,beat,dlwin,0,10,16,212,0.443396226,0.051886792,0.570754717,1,0.309181312
29904,49,24985,9,10,0,0,0,19,11,6,0,0,0,17,nowin,win,plwin,beat,20,0,19,207,0.396135266,0.053140097,0.594202899,0,0.028306925
29905,59,24985,4,2,10,10,0,26,11,6,0,0,0,17,nowin,loss,bust,plbust,0,10,6,228,0.429824561,0.048245614,0.543859649,1,0.287885446
29906,48,24985,10,7,0,0,0,17,11,6,0,0,0,17,nowin,push,push,push,10,0,17,203,0.413793103,0.019704433,0.600985222,2,0.577280801
29907,101,24985,10,11,0,0,0,21,11,6,0,0,0,17,win,win,plwin,beat,25,0,21,205,0.424390244,0.068292683,0.63902439,2,0.614740646
29908,143,24985,10,8,0,0,0,18,11,6,0,0,0,17,nowin,win,plwin,beat,20,0,18,203,0.463054187,0.044334975,0.57635468,3,0.883143365
29909,103,24985,7,2,8,0,0,17,11,6,0,0,0,17,nowin,push,push,push,10,0,9,203,0.379310345,0.064039409,0.551724138,0,0.012869209
29910,80,24986,2,3,7,0,0,12,5,2,3,5,8,23,nowin,win,dlbust,bust,20,0,5,186,0.419354839,0.059139785,0.623655914,2,0.59892924
29911,49,24986,10,4,0,0,0,14,5,2,3,5,8,23,nowin,win,dlbust,bust,20,0,14,207,0.396135266,0.053140097,0.594202899,0,0.028306925
29912,47,24986,2,8,2,0,0,12,5,2,3,5,8,23,nowin,win,dlbust,bust,20,0,10,210,0.438095238,0.057142857,0.623809524,2,0.615868808
29913,100,24986,3,1,10,0,0,14,5,2,3,5,8,23,nowin,win,dlbust,bust,20,0,4,190,0.452631579,0.036842105,0.594736842,3,0.888671154
29914,10,24986,7,11,0,0,0,18,5,2,3,5,8,23,nowin,win,dlbust,bust,20,0,18,191,0.413612565,0.057591623,0.596858639,2,0.574087175
29915,60,24986,10,7,0,0,0,17,5,2,3,5,8,23,nowin,win,dlbust,bust,20,0,17,227,0.418502203,0.022026432,0.559471366,0,0.026496258
29916,38,24987,6,3,7,5,0,21,10,11,0,0,0,21,nowin,push,push,push,10,0,9,202,0.361386139,0.03960396,0.564356436,0,0.010597953
29917,144,24987,10,7,0,0,0,17,10,11,0,0,0,21,nowin,loss,beat,dlwin,0,10,17,202,0.386138614,0.054455446,0.564356436,0,0.018006244
29918,66,24987,8,4,0,10,0,22,10,11,0,0,0,21,nowin,loss,bust,plbust,0,10,12,217,0.456221198,0.064516129,0.626728111,3,0.924304367
29919,38,24987,10,11,0,0,0,21,10,11,0,0,0,21,win,push,push,push,10,0,21,202,0.361386139,0.03960396,0.564356436,0,0.010597953
29920,128,24987,8,2,3,10,0,23,10,11,0,0,0,21,nowin,loss,bust,plbust,0,10,10,227,0.356828194,0.052863436,0.577092511,0,0.012352564
29921,118,24987,6,8,0,8,0,22,10,11,0,0,0,21,nowin,loss,bust,plbust,0,10,14,216,0.393518519,0.037037037,0.555555556,0,0.018059873
29922,18,24988,8,11,0,0,0,19,10,3,9,0,0,22,nowin,win,dlbust,bust,20,0,19,182,0.461538462,0.043956044,0.587912088,3,0.892649374
29923,123,24988,7,9,0,8,0,24,10,3,9,0,0,22,nowin,loss,bust,plbust,0,10,16,205,0.43902439,0.034146341,0.614634146,2,0.609962544
29924,127,24988,10,10,0,0,0,20,10,3,9,0,0,22,nowin,win,dlbust,bust,20,0,20,201,0.402985075,0.029850746,0.60199005,0,0.032263937
29925,108,24988,7,10,0,0,0,17,10,3,9,0,0,22,nowin,win,dlbust,bust,20,0,17,193,0.435233161,0.056994819,0.559585492,1,0.298824795
29926,144,24988,4,8,0,10,0,22,10,3,9,0,0,22,nowin,loss,bust,plbust,0,10,12,202,0.386138614,0.054455446,0.564356436,0,0.018006244
29927,113,24988,11,9,0,0,0,20,10,3,9,0,0,22,nowin,win,dlbust,bust,20,0,20,199,0.407035176,0.055276382,0.668341709,2,0.620695264
29928,7,24989,6,3,6,2,0,17,10,2,10,0,0,22,nowin,win,dlbust,bust,20,0,9,183,0.442622951,0.06010929,0.62295082,2,0.619303341
29929,96,24989,2,4,7,5,0,18,10,2,10,0,0,22,nowin,win,dlbust,bust,20,0,6,190,0.468421053,0.057894737,0.584210526,3,0.897263354
29930,126,24989,10,9,0,0,0,19,10,2,10,0,0,22,nowin,win,dlbust,bust,20,0,19,188,0.457446809,0.074468085,0.60106383,3,0.900633203
29931,138,24989,8,6,0,10,0,24,10,2,10,0,0,22,nowin,loss,bust,plbust,0,10,14,190,0.442105263,0.047368421,0.610526316,2,0.609711065
29932,38,24989,7,2,10,0,0,19,10,2,10,0,0,22,nowin,win,dlbust,bust,20,0,9,202,0.361386139,0.03960396,0.564356436,0,0.010597953
29933,38,24989,10,5,0,10,0,25,10,2,10,0,0,22,nowin,loss,bust,plbust,0,10,15,202,0.361386139,0.03960396,0.564356436,0,0.010597953
29934,15,24990,11,4,3,0,0,18,9,10,0,0,0,19,nowin,loss,beat,dlwin,0,10,15,212,0.410377358,0.051886792,0.561320755,0,0.024517408
29935,135,24990,5,7,0,3,8,23,9,10,0,0,0,19,nowin,loss,bust,plbust,0,10,12,179,0.391061453,0.067039106,0.586592179,0,0.024924662
29936,17,24990,10,10,0,0,0,20,9,10,0,0,0,19,nowin,win,plwin,beat,20,0,20,171,0.444444444,0.070175439,0.555555556,1,0.302364894
29937,86,24990,7,3,9,0,0,19,9,10,0,0,0,19,nowin,push,push,push,10,0,10,196,0.454081633,0.040816327,0.591836735,3,0.887566443
29938,136,24990,2,5,10,0,0,17,9,10,0,0,0,19,nowin,loss,beat,dlwin,0,10,7,194,0.396907216,0.025773196,0.597938144,0,0.029452644
29939,45,24990,3,4,11,0,0,18,9,10,0,0,0,19,nowin,loss,beat,dlwin,0,10,7,196,0.428571429,0.051020408,0.612244898,2,0.598821767
29940,81,24991,9,10,0,0,0,19,7,8,1,5,0,21,nowin,loss,beat,dlwin,0,10,19,182,0.395604396,0.043956044,0.60989011,2,0.567491261
29941,74,24991,5,11,4,0,0,20,7,8,1,5,0,21,nowin,loss,beat,dlwin,0,10,16,209,0.411483254,0.04784689,0.531100478,0,0.017448125
29942,110,24991,5,10,0,1,10,26,7,8,1,5,0,21,nowin,loss,bust,plbust,0,10,15,192,0.416666667,0.046875,0.557291667,0,0.025413132
29943,58,24991,9,8,0,0,0,17,7,8,1,5,0,21,nowin,loss,beat,dlwin,0,10,17,195,0.430769231,0.041025641,0.584615385,2,0.580497586
29944,6,24991,8,4,0,7,0,19,7,8,1,5,0,21,nowin,loss,beat,dlwin,0,10,12,191,0.439790576,0.047120419,0.581151832,1,0.31211505
29945,48,24991,2,8,7,0,0,17,7,8,1,5,0,21,nowin,loss,beat,dlwin,0,10,10,203,0.413793103,0.019704433,0.600985222,2,0.577280801
29946,4,24992,2,9,4,0,0,15,6,9,10,0,0,25,nowin,win,dlbust,bust,20,0,11,217,0.460829493,0.036866359,0.562211982,1,0.315432839
29947,7,24992,10,3,0,0,0,13,6,9,10,0,0,25,nowin,win,dlbust,bust,20,0,13,183,0.442622951,0.06010929,0.62295082,2,0.619303341
29948,7,24992,7,8,0,0,0,15,6,9,10,0,0,25,nowin,win,dlbust,bust,20,0,15,183,0.442622951,0.06010929,0.62295082,2,0.619303341
29949,46,24992,9,9,0,0,0,18,6,9,10,0,0,25,nowin,win,dlbust,bust,20,0,18,186,0.403225806,0.048387097,0.591397849,0,0.029742194
29950,125,24992,10,7,0,0,0,17,6,9,10,0,0,25,nowin,win,dlbust,bust,20,0,17,219,0.438356164,0.050228311,0.575342466,1,0.308411257
29951,60,24992,7,11,0,0,0,18,6,9,10,0,0,25,nowin,win,dlbust,bust,20,0,18,227,0.418502203,0.022026432,0.559471366,0,0.026496258
29952,68,24993,10,7,0,0,0,17,11,9,0,0,0,20,nowin,loss,beat,dlwin,0,10,17,205,0.434146341,0.029268293,0.6,2,0.59483189
29953,63,24993,6,2,8,4,0,20,11,9,0,0,0,20,nowin,push,push,push,10,0,8,216,0.467592593,0.037037037,0.62037037,3,0.931690496
29954,44,24993,10,11,0,0,0,21,11,9,0,0,0,20,win,win,plwin,beat,25,0,21,219,0.433789954,0.050228311,0.534246575,1,0.285551035
29955,120,24993,5,5,9,0,0,19,11,9,0,0,0,20,nowin,loss,beat,dlwin,0,10,10,202,0.440594059,0.034653465,0.618811881,2,0.614441029
29956,127,24993,8,10,0,0,0,18,11,9,0,0,0,20,nowin,loss,beat,dlwin,0,10,18,201,0.402985075,0.029850746,0.60199005,0,0.032263937
29957,100,24993,10,8,0,0,0,18,11,9,0,0,0,20,nowin,loss,beat,dlwin,0,10,18,190,0.452631579,0.036842105,0.594736842,3,0.888671154
29958,34,24994,7,6,0,8,0,21,10,3,10,0,0,23,nowin,win,dlbust,bust,20,0,13,202,0.5,0.079207921,0.618811881,3,0.968961434
29959,30,24994,10,10,0,0,0,20,10,3,10,0,0,23,nowin,win,dlbust,bust,20,0,20,206,0.393203883,0.033980583,0.601941748,0,0.029324648
29960,126,24994,3,1,10,10,0,24,10,3,10,0,0,23,nowin,loss,bust,plbust,0,10,4,188,0.457446809,0.074468085,0.60106383,3,0.900633203
29961,94,24994,3,2,10,7,0,22,10,3,10,0,0,23,nowin,loss,bust,plbust,0,10,5,183,0.43715847,0.043715847,0.540983607,1,0.290866892
29962,139,24994,4,10,0,9,0,23,10,3,10,0,0,23,nowin,loss,bust,plbust,0,10,14,192,0.380208333,0.036458333,0.59375,0,0.023429169
29963,20,24994,10,5,0,2,0,17,10,3,10,0,0,23,nowin,win,dlbust,bust,20,0,15,186,0.456989247,0.037634409,0.537634409,1,0.301097108
29964,136,24995,10,10,0,0,0,20,4,11,5,0,0,20,nowin,push,push,push,10,0,20,194,0.396907216,0.025773196,0.597938144,0,0.029452644
29965,120,24995,2,7,8,0,0,17,4,11,5,0,0,20,nowin,loss,beat,dlwin,0,10,9,202,0.440594059,0.034653465,0.618811881,2,0.614441029
29966,66,24995,4,3,4,2,0,13,4,11,5,0,0,20,nowin,loss,beat,dlwin,0,10,7,217,0.456221198,0.064516129,0.626728111,3,0.924304367
29967,106,24995,10,10,0,0,0,20,4,11,5,0,0,20,nowin,push,push,push,10,0,20,192,0.411458333,0.026041667,0.557291667,0,0.023854304
29968,123,24995,2,11,6,0,0,19,4,11,5,0,0,20,nowin,loss,beat,dlwin,0,10,13,205,0.43902439,0.034146341,0.614634146,2,0.609962544
29969,102,24995,11,9,0,0,0,20,4,11,5,0,0,20,nowin,push,push,push,10,0,20,192,0.338541667,0.046875,0.5625,0,0.003306118
29970,96,24996,7,10,0,0,0,17,4,9,10,0,0,23,nowin,win,dlbust,bust,20,0,17,190,0.468421053,0.057894737,0.584210526,3,0.897263354
29971,1,24996,10,4,0,0,0,14,4,9,10,0,0,23,nowin,win,dlbust,bust,20,0,14,197,0.406091371,0.025380711,0.649746193,2,0.606186955
29972,145,24996,9,7,0,0,0,16,4,9,10,0,0,23,nowin,win,dlbust,bust,20,0,16,188,0.441489362,0.031914894,0.622340426,2,0.617837093
29973,92,24996,2,4,9,0,0,15,4,9,10,0,0,23,nowin,win,dlbust,bust,20,0,6,186,0.446236559,0.059139785,0.564516129,1,0.307826125
29974,150,24996,10,4,0,0,0,14,4,9,10,0,0,23,nowin,win,dlbust,bust,20,0,14,192,0.401041667,0.036458333,0.567708333,0,0.023287458
29975,30,24996,10,10,0,0,0,20,4,9,10,0,0,23,nowin,win,dlbust,bust,20,0,20,206,0.393203883,0.033980583,0.601941748,0,0.029324648
29976,84,24997,3,6,2,8,0,19,10,4,8,0,0,22,nowin,win,dlbust,bust,20,0,9,195,0.379487179,0.056410256,0.569230769,0,0.017209119
29977,66,24997,2,7,4,7,0,20,10,4,8,0,0,22,nowin,win,dlbust,bust,20,0,9,217,0.456221198,0.064516129,0.626728111,3,0.924304367
29978,75,24997,10,10,0,0,0,20,10,4,8,0,0,22,nowin,win,dlbust,bust,20,0,20,191,0.418848168,0.052356021,0.570680628,0,0.029344702
29979,108,24997,10,2,0,10,0,22,10,4,8,0,0,22,nowin,loss,bust,plbust,0,10,12,193,0.435233161,0.056994819,0.559585492,1,0.298824795
29980,101,24997,5,8,0,10,0,23,10,4,8,0,0,22,nowin,loss,bust,plbust,0,10,13,205,0.424390244,0.068292683,0.63902439,2,0.614740646
29981,12,24997,6,2,10,0,0,18,10,4,8,0,0,22,nowin,win,dlbust,bust,20,0,8,189,0.470899471,0.015873016,0.613756614,3,0.929171178
29982,94,24998,10,3,0,10,0,23,10,11,0,0,0,21,nowin,loss,bust,plbust,0,10,13,183,0.43715847,0.043715847,0.540983607,1,0.290866892
29983,139,24998,10,6,0,10,0,26,10,11,0,0,0,21,nowin,loss,bust,plbust,0,10,16,192,0.380208333,0.036458333,0.59375,0,0.023429169
29984,79,24998,4,10,0,7,0,21,10,11,0,0,0,21,nowin,push,push,push,10,0,14,211,0.436018957,0.028436019,0.672985782,2,0.650131054
29985,139,24998,4,6,10,0,0,20,10,11,0,0,0,21,nowin,loss,beat,dlwin,0,10,10,192,0.380208333,0.036458333,0.59375,0,0.023429169
29986,61,24998,10,3,0,8,0,21,10,11,0,0,0,21,nowin,push,push,push,10,0,13,194,0.427835052,0.077319588,0.603092784,2,0.591437139
29987,117,24998,1,5,6,10,0,22,10,11,0,0,0,21,nowin,loss,bust,plbust,0,10,6,173,0.410404624,0.069364162,0.606936416,2,0.578610282
29988,118,24999,8,10,0,0,0,18,9,6,5,0,0,20,nowin,loss,beat,dlwin,0,10,18,216,0.393518519,0.037037037,0.555555556,0,0.018059873
29989,77,24999,6,10,0,10,0,26,9,6,5,0,0,20,nowin,loss,bust,plbust,0,10,16,200,0.455,0.04,0.62,3,0.916252116
29990,31,24999,9,5,0,10,0,24,9,6,5,0,0,20,nowin,loss,bust,plbust,0,10,14,188,0.473404255,0.058510638,0.515957447,1,0.300306557
29991,139,24999,6,7,0,2,3,18,9,6,5,0,0,20,nowin,loss,beat,dlwin,0,10,13,192,0.380208333,0.036458333,0.59375,0,0.023429169
29992,10,24999,10,10,0,0,0,20,9,6,5,0,0,20,nowin,push,push,push,10,0,20,191,0.413612565,0.057591623,0.596858639,2,0.574087175
29993,82,24999,8,8,0,4,0,20,9,6,5,0,0,20,nowin,push,push,push,10,0,16,225,0.408888889,0.075555556,0.577777778,0,0.028101874
29994,130,25000,7,8,0,2,0,17,10,10,0,0,0,20,nowin,loss,beat,dlwin,0,10,15,219,0.410958904,0.03652968,0.566210046,0,0.025888739
29995,136,25000,6,10,0,6,0,22,10,10,0,0,0,20,nowin,loss,bust,plbust,0,10,16,194,0.396907216,0.025773196,0.597938144,0,0.029452644
29996,63,25000,6,5,1,9,0,21,10,10,0,0,0,20,nowin,win,plwin,beat,20,0,11,216,0.467592593,0.037037037,0.62037037,3,0.931690496
29997,5,25000,2,9,6,0,0,17,10,10,0,0,0,20,nowin,loss,beat,dlwin,0,10,11,203,0.42364532,0.02955665,0.596059113,2,0.582508076
29998,74,25000,10,10,0,0,0,20,10,10,0,0,0,20,nowin,push,push,push,10,0,20,209,0.411483254,0.04784689,0.531100478,0,0.017448125
29999,6,25000,2,8,10,0,0,20,10,10,0,0,0,20,nowin,push,push,push,10,0,10,191,0.439790576,0.047120419,0.581151832,1,0.31211505
